	coreid	status	nwords_original	nwords_result	nwords_val	nwords_recovered	nwords_omitted	nwords_created	nwords_recovered_val	nwords_created_val	common_words	original_only	result_only	common_words_val	val_only
0	wfo-0001025652	success	156	113	70	90	66	23	68	2	.3,.5,0.5-1,1,1.5-2,10-20,15-19,2-6,20-50,3-5,4,4-7,9-11,abruptly,acuminate,acute,anther,anthesi,apex,bark,base,bilobed,calyx,closed,closely,cm,completely,connate,corolla,decurrent,densely,elliptic,envelope,filament,fleshy,flower,fruit,furcate,glabrate,green,greyish,growth,irregular,leaf,lobe,matte,minor,minute,minutely,mm,narrowing,new,occasionally,onto,opposite,ovary,ovoid,ovoid-reniform,papillose,pedicel,petiole,pinkish-grey,pitted,planar,plant,pore,poricidal,red-papillose,scar,shape,shaped,shrub,simple,size,small,spaced,stem,stigma,strongly,style,surface,tear-drop,tightly,tip,tree,tube,white,winged,x,young	1-1.5,15-17,2-3,2-5,3-3.5,3-5-flowered,4-6,appearing,blade,broad,campanulate,dia,differing,difoliate,dry,eaf,edicel,eed,emerge,free,geminat,glabrous,greyi,growing,lateral,like,live,lobed,lon,long,lower,main,major,margin,middle,nearly,nflorescence,older,one,overlappin,pair,pale,paler,papillae,papillo,parallel,portion,rather,ry,shiny,soon,specimen,straight,tall,tan,tapering,tear,thick,thicker,ud,unit,vein,wider,widest,wing,ympodial	arrangement,bud,colour,connation,decurrency,feature,form,height,history,inflorescence,length,life,na,number,overlapping,papilla,reproduction,seed,spacing,texture,type,width,winging	.3,.5,0.5-1,1,1.5-2,10-20,15-19,2-6,20-50,3-5,4,4-7,9-11,abruptly,acuminate,acute,anthesi,bilobed,calyx,closed,closely,cm,completely,connate,decurrent,densely,elliptic,envelope,fleshy,flower,furcate,glabrate,green,greyish,irregular,leaf,matte,minute,minutely,mm,narrowing,occasionally,onto,opposite,ovoid,ovoid-reniform,papillose,petiole,pinkish-grey,pitted,planar,poricidal,red-papillose,shape,shaped,shrub,simple,small,spaced,strongly,tear-drop,tightly,tip,tree,tube,white,winged,x	na,overlapping
1	wfo-0001025657	success	239	115	67	84	155	31	63	4	1-1.1,1-1.3,1-3,1.2-1.5,1.3-2,1.7-1.9,2-10,25-60,3-4.8,3-6,4-4.4,4-4.5,5-14,6-12,7-27,acute,anther,apex,base,berry,bluish,blunt-tipped,branched,brown,bud,calyx,cm,conical,cordate,corolla,dark,deltoid,dendritic-multangulate,dried,elliptic,filament,fleshy,flower,free,fruit,glandular,granular,green,hair,lanate-pubescent,leaf,length,lobe,long-stalked,mixed,mm,multangulate,narrowly,oblong,orbicular,ovate,ovate-lanceolate,pedicel,petiole,pore,poricidal,pseudo-terminal,reticulate-punctate,ripe,short-,shrub,simple,soft,stellate,stem,stigma,style,subcampanulate,suborbicular,surface,tip,tomentose,tree,tube,white,x,yellow,yellowish,young	-2,/3,0.1-0.4,0.2-0.4,0.5-2.5,1-1.6,1.5-1.8,12x,2-3.5,2.2-5.5,2.5-9.3,2.7-4.3,2/3,3-4,3.2-6,4-7,5-16,6-8,6.5-10,7-9,7-9.5,8-10.5,8.3-12,abaxially,accrescent,adaxially,ag,also,anthesi,apart,apparently,appearing,ark,around,articulated,ascending,axe,axillary,ba,blade,branch,broadly,capitat,central,chartaceous,closely,cylindrical,dendritic-multangulat,dense,densely,diameter,directed,distally,due,eaf,earl,edge,eed,entire,especially,evident,exerted,expanded,exserted,farinose,few-rayed,fruiting,glabrous,glandula,half,inserted,lanceolate,lateral,lengthening,light,lobed,long,longitudinal,lower,m.,magnification,main,margin,midrib,minutely,nearly,nflorescence,obtuse,occasional,often,older,open,orolla,ovat,overlapping,pale,part,parted,partly,peduncle,perfect,persistent,persistently,plurifoliate,porrect-stellate,present,pubescence,pubescent,rachi,ray,reportedly,ruit,scented,semi-ovate,sessile,short,short-stalked,side,slightly,slit,somewhat,spaced,splitting,stamen,stellate-pubescent,stipitate-glandular,stipitate-multangulate,strongly,subcoriaceous,suture,tall,tamen,tan,terete,thick-stalked,thickened,thin-stalked,time,tomentose-pubescent,tomentum,transparent,two-third,ud,unarme,unarmed,unit,upper,usually,vary,vein,velutinous-pubescent,way,weakly,wide,ympodial	arrangement,capitate,colour,connation,decurrency,feature,form,growth,height,history,inflorescence,life,minor,new,number,ovary,papilla,perennial,plant,reproduction,scar,seed,shape,size,spacing,texture,tommentose-pubescent,type,unknown,width,winging	1-1.1,1-1.3,1-3,1.2-1.5,1.3-2,1.7-1.9,2-10,25-60,3-4.8,3-6,4-4.4,4-4.5,5-14,6-12,7-27,acute,berry,bluish,blunt-tipped,branched,brown,cm,conical,cordate,dark,deltoid,dendritic-multangulate,dried,elliptic,fleshy,free,glandular,granular,green,hair,lanate-pubescent,long-stalked,mixed,mm,multangulate,narrowly,oblong,orbicular,ovate,ovate-lanceolate,poricidal,pseudo-terminal,reticulate-punctate,ripe,short-,shrub,simple,soft,stellate,subcampanulate,suborbicular,tip,tomentose,tree,white,x,yellow,yellowish	capitate,perennial,tommentose-pubescent,unknown
2	wfo-0001025669	success	214	126	78	91	123	35	73	5	.5,0.1-0.3,1-10,1-2,1-2.2,1-4,13-35,2,2-4,2.2-6,3-7,9-24.5,acuminate,acute,anther,apart,apex,base,berry,blue,broadly,cell,clavate,cm,connivent,corolla,covering,cuneate,decurrent,diameter,distinct,filament,flower,fruit,glabrous,globose,green,hair,hair-like,herb,lanceolate,lateral,lengthening,like,lobe,long,mm,moderately,monochasium,mottled,oblique,obtuse,odd-pinnate,orbicular,ovate,ovoid,pedicel,petiole,petiolulate,plant,pore,poricidal,pubescent,purple,rarely,ripe,rotate,rounded,seed,sessile,size,slightly,slit,sometimes,species,stem,stigma,streaked,style,subglabrous,testal,thick,tinged,tip,truncate,tube,typically,unwinged,wall,white,yellow	0-1,0-5,0-7,0.8-2.4,1,1-3,1.3-4.2,1.4-2.5,1.6-4.4,2-3,2.2-6.5,2.4-7,3-5,4-6,5-merou,abaxially,absen,absent,acumen,adaxially,ag,along,alyx,apparently,articulation,axe,blade,brownish,capitat,chartaceous,ciliate,clearly,condition,contracted,digestion,discussion,distal,dorsally,drying,eaf,edge,eed,elliptic,end,enzyme,erec,especially,exceeding,except,extra,flat,flowered,folded,forming,fresh,geminat,glabrou,greatly,green-white,greenish,half,highly,homostylous,honeycomb-shaped,interjected,larger,leaflet,living,lower,make,margin,membranous,midrib,minute,minutely,mucilaginous,multicellular,near,nflorescence,obovate,often,one,orolla,pair,peduncle,perfect,petiolule,placed,plurifoliate,proximal,puberulent,reduced,removed,rosette,ruit,scale-like,see,seudostipule,short,single,spaced,specimen,stamen,ste,stolo,straight,subequal,tall,tamen,tem,terminal,throughout,tri-,tuber,unbranched,unequal,unit,vary,wet,whitish,wide,x,ympodial	age,arrangement,bud,calyx,capitate,colour,connation,decurrency,feature,form,geminate,growth,height,history,inflorescence,leaf,length,life,minor,na,new,number,ovary,papilla,perennial,reproduction,scar,shape,spacing,surface,texture,type,width,winging,young	.5,0.1-0.3,1-10,1-2,1-2.2,1-4,13-35,2,2-4,2.2-6,3-7,9-24.5,acuminate,acute,apart,berry,blue,broadly,cell,clavate,cm,connivent,covering,cuneate,decurrent,distinct,glabrous,globose,green,hair,hair-like,herb,lanceolate,lateral,lengthening,like,long,mm,moderately,monochasium,mottled,oblique,obtuse,odd-pinnate,orbicular,ovate,ovoid,petiolulate,poricidal,pubescent,purple,rarely,ripe,rotate,rounded,sessile,slightly,slit,sometimes,species,stem,streaked,subglabrous,testal,thick,tinged,tip,truncate,typically,unwinged,wall,white,yellow	age,capitate,geminate,na,perennial
3	wfo-0001025697	success	181	105	69	81	100	24	65	4	-9,0-14,0.15-0.75,0.6-3.5,1-1.7,1-2,1-3,1.5-1.8,10-26,2-10.5,2-2.6,2-6,3-10,3-4,3-6,3.3-11,4-7.5,5.5-11.5,6.5-13.5,anther,axillary,blade,blue,bud,cell,clavate,cm,connivent,coriaceous,corolla,covering,dark,deep,diameter,elliptic,flower,forked,fruit,glabrescent,glabrous,globose,green,hair-like,herb,homostylous,interjected,lanceolate,lateral,leaf,leaflet,light,lilac,lobe,long,medium,mm,odd-pinnate,ovate,ovoid,pentagonal,petiole,plant,poricidal,purple,ripe,rotate,seed,size,stigma,straight,stripe,style,subtending,terminal,testal,thick,tip,tube,wall,x,yellow	0.8-2,1.7-8.6,2-4,25-35,3-5,5-merou,abaxially,acumen,acuminate,acute,adaxiall,adaxially,ag,alyx,apart,apex,apparently,articulated,asymmetric,attenuate,axe,base,basiscopic,berry,brownish,capitat,condition,decreasing,decurrent,digestion,distal,dorsally,drying,eaf,edge,eed,enzyme,erec,exceeding,filament,flat,folded,fresh,geminat,generally,glabrou,green-white,greenish,hair,hal,half,high,honeycomb-shaped,lengthening,linear,living,lower,make,mucilaginous,nflorescence,orbicular,orolla,pair,pedicel,peduncle,perfect,petiolulate,plurifoliate,pore,rachi,removed,rounded,ruit,sessile,seudostipule,short,side,slightly,slit,spaced,specimen,stamen,subequal,subglabrou,tall,tamen,tem,throughout,tissue,toward,tri-,typically,unit,unwinged,usually,vary,wet,whitish,wood,ympodial	5-merous,abaxial,adaxial,arrangement,calyx,capitate,colour,connation,feature,form,growth,height,inflorescence,length,number,ovary,pseudostipule,shape,stem,subglabrous,surface,texture,type,woody	-9,0-14,0.15-0.75,0.6-3.5,1-1.7,1-2,1-3,1.5-1.8,10-26,2-10.5,2-2.6,2-6,3-10,3-4,3-6,3.3-11,4-7.5,5.5-11.5,6.5-13.5,axillary,blue,bud,cell,clavate,cm,connivent,coriaceous,covering,dark,deep,diameter,elliptic,forked,glabrescent,glabrous,globose,green,hair-like,herb,homostylous,lanceolate,lateral,light,lilac,long,medium,mm,odd-pinnate,ovate,ovoid,pentagonal,poricidal,purple,ripe,rotate,straight,stripe,subtending,terminal,testal,thick,tip,wall,x,yellow	5-merous,capitate,subglabrous,woody
4	wfo-0001025699	success	181	123	67	86	95	37	62	5	0.5,1,1-2,1-2.5,1.5-2,1/3,10,15-20,2,2-6,3-15,3-3.5,3-8,5-winged,5.5-14,8-9,acute,age,anther,anthesi,apart,apex,attenuate,base,becoming,berry,calyx,capitate,cm,corolla,cup-shaped,dry,ellipsoid,elliptic,filament,flower,glabrous,globose,green,grey-brown,growth,immature,inflorescence,lanceolate,leaf,leaf-opposed,leafy,lengthening,less,lobe,lobed,minutely,mm,narrowly,new,ovary,pale,pedicel,petiole,pore,poricidal,reniform,reticulate-pitted,rounded,rounded-sagittate,scar,shoot,short,simple,slightly,slit,somewhat,stem,stigma,style,surface,tip,tree,triangular,tube,way,white,woody,x,young,Â½	.2,.5,1-1.5,1-3,1.5,2-2.5,2cm,3-5.5,4-5,499,5-8,abaxially,absent,adaxially,almost,apparently,appearing,articulating,bark,branching,brown,c.,campanulate,completely,conical,conspicuously,continuing,corrugate,crystal,dark,darker,deltate,densely,diameter,difoliate,dorsal,drying,eaf,eed,entire,erect,exerted,face,fide,free,fruiting,glabrou,included,inclusion,inflorescenc,irregularly,leaving,lower,margin,markedly,midrib,nflorescence,nodding,older,one,onto,oxalate,pair,papillat,papillose,peduncle,peg,penden,per,perfect,plurifoliate,portion,primary,red,reddish,ruit,sand,small,spaced,stearn,straight,strongly,tangled,thickened,time,trichome,ud,unit,vein,white-spotted,wide,wing,winged,yellow,ympodial	1.2,3,arrangement,bud,coat,colour,connation,decurrency,embryo,feature,form,fruit,height,history,length,life,midpoint,minor,na,number,papilla,papillate,pendent,plant,prickle,ray,reproduction,seed,shape,size,spacing,specimen,texture,tuberculation,type,width,winging	0.5,1,1-2,1-2.5,1.5-2,1/3,10,15-20,2,2-6,3-15,3-3.5,3-8,5-winged,5.5-14,8-9,acute,age,apart,attenuate,base,becoming,berry,capitate,cm,cup-shaped,ellipsoid,elliptic,glabrous,globose,green,grey-brown,immature,lanceolate,leaf-opposed,leafy,lengthening,less,lobed,minutely,mm,narrowly,pale,poricidal,reniform,reticulate-pitted,rounded,rounded-sagittate,shoot,short,simple,slightly,slit,somewhat,tip,tree,triangular,way,white,woody,x,Â½	1.2,3,na,papillate,pendent
5	wfo-0001025700	success	189	86	46	60	129	26	43	3	0.30-2.0,0.5-2,0.8-2.6,1-2,1.5-2,10-40,10.5-12,15-40,2-12,2-7,2.5-4,3-8,5-15,5-20,5.3-17.5,5.5-18,5.5-8,9-31,anther,apiculate,chartaceous,clavate,cm,connivent,corolla,diameter,dot,elliptic,filament,flower,fruit,glabrous,globose,green,greenish,herb,lanceolate,lateral,leaf,light,lobe,medium,mm,odd-pinnate,ovate,ovoid,pedicel,peduncle,pentagonal,petiole,plant,purple,rotate-pentagonal,seed,size,stigma,style,terminal,tube,whitish	0-16,0.7-2.7,0.8-4,1-3,1.1-2.3,3-4,3.5-10.5,3.7-8.6,4-5,5-merou,abaxially,acuman,acumen,acuminate,acute,adaxially,ag,alyx,apex,apparently,articulated,asymmetric,attenuate,axe,axillary,basal,base,basiscopic,berry,blade,brownish,bud,capitat,cell,condition,considerably,covering,decrease,decreasing,digestion,distal,dorsally,drying,eaf,edge,eed,enzyme,erec,exceeding,except,flat,folded,forked,fresh,geminat,generally,glabrescent,glabrou,green-white,hair,hair-like,hal,half,high,homostylous,honeycomb-shaped,interjected,larger,leaflet,lengthening,lilac,linear,living,long,lower,make,mucilaginous,narrowly,nflorescence,orbicular,orolla,pair,par,perfect,petiolulate,plurifoliate,pore,poricidal,proximal,removed,ripe,rounded,ruit,sessile,seudostipule,short,side,slightly,slit,sometimes,specimen,stamen,straight,subequal,subglabrou,subtending,tall,tamen,tem,testal,thick,throughout,tip,tissue,toward,tri-,typically,unit,unwinged,usually,vary,wall,wet,white,whose,winged,x,yellow,ympodial	abaxial,adaxial,arrangement,calyx,capitate,colour,connation,feature,form,growth,height,history,inflorescence,length,life,na,number,ovary,pseudostipule,reproduction,shape,stem,subglabrous,surface,texture,width	0.30-2.0,0.5-2,0.8-2.6,1-2,1.5-2,10-40,10.5-12,15-40,2-12,2-7,2.5-4,3-8,5-15,5-20,5.3-17.5,5.5-18,5.5-8,9-31,apiculate,chartaceous,clavate,cm,connivent,dot,elliptic,glabrous,globose,green,greenish,herb,lanceolate,lateral,light,medium,mm,odd-pinnate,ovate,ovoid,pentagonal,purple,rotate-pentagonal,terminal,whitish	capitate,na,subglabrous
6	wfo-0001025704	success	247	142	91	109	138	33	89	2	0.1-0.3,0.3-0.8,0.5-1.5,0.7-1,1-3.5,1-4,1-6,1.2-3,1/2-4/5,1/5,2-10,2-3,2-4.5,2-5,2.7-4,3-10,3-15,3-5,3-6,4-12,4-5,5-20,6-12,8-15,8-17,acute,almost,anther,apart,apex,articulated,auriculate,base,berry,branched,broad-deltate,calyx,cell,cm,connivent,cordate,curved,densely,ellipsoid,erect,evenly,filament,flattened,flattened-reniform,flower,fruit,glabrous,green,green-yellow,lateral,leaf,length,lobe,lobed,long,maturity,mauve,midpoint,mm,occasionally,orange,orange-brown,outline,pedicel,petiole,pit,plant,poricidal,prickle,prickly,prominent,raised,rarely,ray,round,scar,shape,shrub,small,smooth,sometimes,sparsely,spherical,spreading,stellate-pubescent,stem,straight,strongly,style,surface,tapering,terminal,tip,tree,truncate,tube,unarmed,unbranched,upper,way,white,yellow,young,Ã	/6,0-10,0-100,0-2,0-3.5,0-5,0.1,0.1-0.5,0.15-0.8,1,1-2,1-3,1-5,1.5-2,1.5-3.2,1.5-4.5,1.8-3.5,1/4-3/4,2,2-7,2.5-4.5,4.5-6.5,5-merous,6-15,8-12,abaxial,abaxially,adaxial,age,alyx,andromonoecious,apar,apically,apiculate,apparently,axe,ba,bark,blade,brow,chartaceous,covering,deltate,development,diameter,discolorous,distal,distance,drying,eaf,eed,elliptic,elongating,end,equal,extending,free,fruiting,glabrescent,gray,half,hermaphrodite,heterostylous,infructescence,irregular,less,lobing,long-styled,longer,lower,lowermost,margin,mature,midvein,moderately,multangulate,near,nflorescence,obtuse,often,older,one,open,orolla,oung,ovate,pair,pale,peduncle,pendulous,per,pericarp,plurifoliat,porrect,portion,prickl,primary,recurved,red-brown,red-green,reflexed,retaining,rounded,ruit,secondary,sessile,short-styled,shorter,side,slender,somewhat,spaced,stalk,stalked,staminat,stellate,stellate-pubescen,stout,tamen,terete,tertiary,throughout,time,trichome,unit,variously,vary,vein,venation,visible,warty,white-gray,wide,widening,woody,yellow-green,yellowish,ympodial	anthesi,arrangement,bud,coat,colour,connation,corolla,decurrency,dry,embryo,feature,form,growth,height,inflorescence,minor,na,new,number,ovary,papilla,plurifoliate,pore,seed,size,spacing,specimen,stigma,texture,tuberculation,type,width,winging	0.1-0.3,0.3-0.8,0.5-1.5,0.7-1,1-3.5,1-4,1-6,1.2-3,1/2-4/5,1/5,2-10,2-3,2-4.5,2-5,2.7-4,3-10,3-15,3-5,3-6,4-12,4-5,5-20,6-12,8-15,8-17,acute,almost,apart,articulated,auriculate,base,berry,branched,broad-deltate,cell,cm,connivent,cordate,curved,densely,ellipsoid,erect,evenly,flattened,flattened-reniform,glabrous,green,green-yellow,lateral,lobed,long,maturity,mauve,mm,occasionally,orange,orange-brown,outline,pit,poricidal,prickle,prickly,prominent,raised,rarely,round,shrub,small,smooth,sometimes,sparsely,spherical,spreading,stellate-pubescent,straight,strongly,tapering,terminal,tip,tree,truncate,unarmed,unbranched,upper,way,white,yellow,young,Ã	na,plurifoliate
7	wfo-0001025729	success	177	124	82	95	82	29	76	6	.5,/4,0.25-0.5,0.7-1.2,1-1.5,1-5,1.1-1.5,1.75,2,2-3.5,3-6,4-5,4-8,6-8,9-17,abaxial,acute,anther,apiculate,bark,base,berry,blackish,bright,bristly,bud,calyx,cm,corolla,deltoid,densely,dia,difoliate,dirty,drying,elliptic,filament,flattened-reniform,fleshy,furcate,glabrous,globose,green,greenish-yellow,greyish-brown,leaf,live,lobe,lobed,long,minor,minutely,mm,occasionally,opposite,ovary,pale,papillose,pedicel,petiole,pit,pitted,plant,pore,poricidal,pubescent,ripening,rounded,scar,shaped,shiny,short,simple,size,sparsely,stem,stigma,stout,style,surface,tapering,tear-drop,tip,tree,treelet,trichome,tube,tuft,uniseriate,unit,usually,way,white,x,young	-20,1.2-1.8,1.5-2,20,5-50-flowered,7-8,abaxially,abrupt,adaxially,along,anthesi,apar,apex,apical,appearing,axil,basal,black,branched,covered,covering,cyathiform,dark,deflexed,denser,diam,differing,eaf,edicel,eed,enclosed,expanded,f,free,fruiting,geminat,gently,glabrou,growing,incrassate,lamina,lat,lateral,like,lon,lower,m.,main,mainly,major,margin,member,middle,minute,nflorescence,oblique,often,older,one,overlapping,overtopping,pair,papillo,partially,portion,prominent,quite,raised,reflexed,ruit,straight,tall,terminal,touching,tub,ud,vein,widening,widest,woody,yellow,ympodial	4-20,5-50,adaxial,apart,arrangement,colour,feature,flower,form,fruit,geminate,growth,hair,height,history,inflorescence,length,life,na,number,papilla,reproduction,seed,shape,spacing,sympodial,texture,type,width	.5,/4,0.25-0.5,0.7-1.2,1-1.5,1-5,1.1-1.5,1.75,2,2-3.5,3-6,4-5,4-8,6-8,9-17,acute,apiculate,base,berry,blackish,bright,bristly,bud,cm,deltoid,densely,dia,difoliate,dirty,drying,elliptic,flattened-reniform,fleshy,furcate,glabrous,globose,green,greenish-yellow,greyish-brown,leaf,live,lobed,long,minutely,mm,occasionally,opposite,pale,papillose,pit,pitted,plant,pore,poricidal,pubescent,ripening,rounded,shaped,shiny,short,simple,sparsely,stout,tapering,tear-drop,tip,tree,treelet,trichome,tuft,uniseriate,unit,usually,way,white,x	4-20,5-50,apart,geminate,na,sympodial
8	wfo-0001025749	success	215	125	69	87	128	38	68	1	.5,0-10,0.1-0.2,0.2-1.5,0.3-1.5,0.5-0.8,0.5-0.9,0.5-3,0.6-4.5,0.8-0.9,1-13,1-8.5,1-9,1.5-2.5,2-10,2-2.5,3-20,5-10-12,acute,anther,apart,apex,bark,base,berry,calyx,cm,cuneate,curved,dull,filament,flattened,flattened-reniform,flower,fruit,gently,glabrescent,glabrous,gray,lateral,leaf,length,light,lobe,lobed,long-ovate,maturity,mauve,midpoint,mm,moderately,narrow-deltate,narrow-ovate,orange-brown,orange-red,pedicel,petiole,poricidal,porrect,prickle,prickly,ray,rounded,scar,sessile,shrub,sparsely,spherical,spreading,stalked,stellate,stellate-pubescent,stem,straight,straw-yellow,style,surface,tapering,tip,toward,trichome,tube,variously,white,yellow,yellow-orange,yellowish	/5,0-3,0-5,0-6,0-8,0.1,0.1-0.3,0.1-0.4,0.2,0.4-0.7,0.5-1,0.5-1.3,1,1-10,1-2,1-3,1-6,1.5,1.5-2,1/4-1/3,1/5-1/2,2.5-6,2/3,3-5,4-8,5-20,5-6-8,5-merous,6-8,abaxial,abaxially,acuminat,adaxial,adaxially,adnate,almost,alyx,apar,apically,apparently,articulated,blade,branched,broad-deltate,chartaceous,concolorous,dark,densely,diameter,difoliate,discolorous,distance,drying,eaf,eed,elongating,equal,erect,extending,filiform,free,fruiting,geminat,green-brown,herbaceous,indistinct,infructescence,lon,long,longer,lower,magnification,margin,markedly,mature,midvein,nflorescence,oblong,obtuse,occasionally,older,one,open,orange-brow,orbicular,orolla,oung,ovate,pair,pale,peduncle,pendulous,per,perfec,pericarp,portion,prickl,primary,procumbent,purple,rarely,recurved,red-brown,reduced,ruit,shorter,side,smooth,sometimes,spaced,stalk,strongly,tamen,terete,tertiary,time,unit,usually,vary,vein,venation,visible,way,wide,without,yellow-green,ympodial,Â½-2/	anthesi,arrangement,bud,coat,colour,connation,corolla,decurrency,dry,embryo,feature,form,growth,height,history,inflorescence,life,minor,na,new,number,ovary,papilla,plant,pore,reproduction,seed,shape,size,spacing,specimen,stigma,texture,tuberculation,type,width,winging,young	.5,0-10,0.1-0.2,0.2-1.5,0.3-1.5,0.5-0.8,0.5-0.9,0.5-3,0.6-4.5,0.8-0.9,1-13,1-8.5,1-9,1.5-2.5,2-10,2-2.5,3-20,5-10-12,acute,apart,apex,berry,cm,cuneate,curved,dull,flattened,flattened-reniform,gently,glabrescent,glabrous,gray,lateral,light,lobed,long-ovate,maturity,mauve,mm,moderately,narrow-deltate,narrow-ovate,orange-brown,orange-red,poricidal,porrect,prickle,prickly,rounded,sessile,shrub,sparsely,spherical,spreading,stalked,stellate,stellate-pubescent,straight,straw-yellow,tapering,tip,toward,trichome,variously,white,yellow,yellow-orange,yellowish	na
9	wfo-0001025754	success	164	113	82	86	78	27	76	6	-celled,.5,0.5-1,0.5-1.5,1,1-2,1-3,1-3.5,1.5,1.5-4,10-20,10-35,2-5-celled,3-10,3-6,4,4-6,5-12,5-15,abundant,acuminate,acute,anther,apex,asymmetrical,base,berry,brown,calyx,center,cm,cordate,cordiform,decurrent,diameter,dm,drying,edge,eglandular,fine,flower,fruit,glabrous,globose,hair,herb,immature,interpetalar,leaf,lobe,long,margin,maturing,mm,moderately,nearly,oblong,often,parallel,pedicel,per,petiole,pubescent,radiating,raised,ridge,rotate,running,semitransparent,shallow,slightly,solitary,sparsely,stem,stigma,straight,style,surface,tissue,triangular,truncate,tube,unbranched,white,x,yellow	0.1-0.2,1.5-3,2-4,2-7,2-foliate,3-5,abaxially,absent,adaxiall,adaxially,along,axe,barely,beyond,blade,branch,chartaceous,ciliate,connected,decumbent,dehiscing,densely,denser,dried,eaf,eed,emarginat,entire,equal,erect,explosively,exserted,filament,flat,geminat,glandular,held,leaving,like,linear-lanceolate,lower,lying,main,material,maturit,membranaceous,mesocarp,mixed,much-branched,nfloresence,notch,orolla,palmately,peduncle,penden,placenta,pressure,probably,pubescen,rachi,ruit,short,small,sometimes,stamen,swollen,tal,tamen,tem,unit,upright,vary,vein,visible,watery,wid,woody,ympodial	abaxial,adaxial,arrangement,colour,corolla,emarginate,feature,form,geminate,greyish,growth,inflorescence,length,na,number,ovary,papilla,pendent,seed,shape,size,texture,tip,type,wide,width,young	-celled,.5,0.5-1,0.5-1.5,1,1-2,1-3,1-3.5,1.5,1.5-4,10-20,10-35,2-5-celled,3-10,3-6,4,4-6,5-12,5-15,abundant,acuminate,acute,apex,asymmetrical,base,berry,brown,center,cm,cordate,cordiform,decurrent,diameter,dm,drying,edge,eglandular,fine,flower,fruit,glabrous,globose,hair,herb,immature,interpetalar,long,margin,maturing,mm,moderately,nearly,oblong,often,parallel,per,petiole,pubescent,radiating,raised,ridge,rotate,running,semitransparent,shallow,slightly,solitary,sparsely,straight,tissue,triangular,truncate,unbranched,white,x,yellow	emarginate,geminate,greyish,na,pendent,wide
10	wfo-0001025760	success	207	125	75	89	118	36	72	3	-10,.5,/3,0.3-1,0.4-0.8,0.45-0.9,0.5-2,1-1.8,1-2,1-4,1.5-4.5,1/5,2-2.5,2.1-3.5,2.5-10,5-18,acute,annual,anther,apex,apically,base,berry,broad-deltate,calyx,cm,connivent,cream,cuneate,curved,dark,deltate,diameter,dull,elliptic,filament,flattened-reniform,flower,fruit,gently,glabrous,green,herb,lateral,leaf,length,lobe,lobed,long,marking,maturity,mm,moderately,orange,orange-brown,ovate,pale,pedicel,perennial,petiole,poricidal,porrect,rounded,scar,sessile,shape,smooth,sometimes,spherical,spreading,stalked,stellate-pubescent,stem,style,subentire,surface,tapering,tip,trichome,tube,unbranched,upper,variously,way,weakly,white,wide,yellow,young	-12,-6,0-0.5,0-100,0.1,0.1-0.2,0.15-0.3,0.2-0.35,0.5-1.5,0.7-2.5,0.8-1.8,1-1.5-2.5-5,1-3,1.5,1.5-5,1/4,1/4-1/2,1/4-1/3,2-3,2.3-4,2.5-8,2/3,3,3-6,3.5-17,3.5-9,5-10-merous,8-10-12,abaxial,abaxially,acut,adaxial,almost,alyx,apar,apparently,articulated,bark,black,blade,brow,chartaceous,concolorous,cultivar,difoliate,discolorous,distance,drying,eaf,eed,elongating,equal,erect,extending,free,fruiting,geminat,geminate,glabrescent,hair,infructescence,lengt,longer,lower,margin,mature,membranous,midpoint,midvein,minute,nflorescence,often,older,one,open,orolla,oung,pair,peduncle,pendulous,per,perfec,pericarp,portion,primary,ray,recurved,red-brown,reflexe,ruit,shorter,shrub,side,simple,slender,spaced,stalk,stellate,stellate-pubescen,stout,straight,tamen,terete,tertiary,thick-stalked,time,unarme,unarmed,unit,usually,various,vary,vein,venation,visible,woody,yellow-green,ympodial	apart,arrangement,brown,bud,coat,colour,connation,corolla,decurrency,embryo,feature,form,growth,height,history,inflorescence,life,minor,na,new,number,ovary,papilla,plant,pore,prickle,reproduction,seed,size,spacing,stigma,texture,tuberculation,type,width,winging	-10,.5,/3,0.3-1,0.4-0.8,0.45-0.9,0.5-2,1-1.8,1-2,1-4,1.5-4.5,1/5,2-2.5,2.1-3.5,2.5-10,5-18,acute,annual,apically,base,berry,broad-deltate,cm,connivent,cream,cuneate,curved,dark,deltate,diameter,dull,elliptic,flattened-reniform,gently,glabrous,green,herb,lateral,lobed,long,marking,maturity,mm,moderately,orange,orange-brown,ovate,pale,perennial,poricidal,porrect,rounded,sessile,smooth,sometimes,spherical,spreading,stalked,stellate-pubescent,subentire,tapering,tip,trichome,unbranched,upper,variously,way,weakly,white,wide,yellow,young	apart,brown,na
11	wfo-0001025782	success	199	118	83	96	103	22	81	2	.5,0-10,0-5,0.1-0.15,0.1-0.25,0.3-1,0.5-1,0.55-0.75,0.9-1.3,1,1-4,1.2-6,2-10,2-2.5,2-3,2-7,2/3-3/4,20,3-4,4,4.5-9,5.5-6,6-14,6-8,abaxial,adaxial,also,andromonoecious,anther,apart,apex,articulated,bark,base,berry,brown,calyx,cm,connivent,curved,densely,elongated,evenly,flattened-reniform,flower,fruit,geminate,gently,glabrescent,glabrous,green,hair,lateral,leaf,length,lobed,long,long-styled,maturity,midpoint,minute,mm,moderately,occasionally,pedicel,petiole,plant,poricidal,porrect,prickle,prickly,ray,reduced,scar,sessile,shrub,simple,sparsely,spherical,stellate,stellate-pubescent,stem,style,surface,tapering,terete,tip,toward,trichome,tube,way,weakly,white,wide,yellow,young	0.1-0.2,0.4-0.6,1-1.7,1-2,1-2.5,1.3-1.6,1.5-3,1/4-1/2,1/4-1/3,1/6,10-13,2-5,2.5-3.5,3-5,4-4.5,5-20,5-6.5,5-8,5-merous,abaxially,acuminat,acuminate,alyx,apar,apically,apparently,blade,chartaceous,climbing,concolorous,conical,cuneate,deltate,diameter,difoliate,discolorous,distal,distance,drying,dull,eaf,eed,elliptic,elongating,equal,extending,filament,flattened,free,fruiting,geminat,green-brown,hermaphrodite,heterostylous,infructescence,lengt,less,lobe,longer,lower,lowermost,margin,mature,membranous,midvein,nflorescence,older,one,open,orange-brown,orolla,oung,pair,peduncle,pendulous,per,pericarp,portion,prickl,primary,red-brow,ruit,short-styled,shorter,side,smooth,spaced,spreading,staminat,stout,straight,tamen,tertiary,time,unbranched,unit,vary,vein,venation,visible,woody,yellow-green,ympodial	arrangement,colour,corolla,feature,form,growth,height,history,inflorescence,life,number,ovary,perennial,red-brown,reproduction,seed,shape,size,spacing,texture,type,width	.5,0-10,0-5,0.1-0.15,0.1-0.25,0.3-1,0.5-1,0.55-0.75,0.9-1.3,1,1-4,1.2-6,2-10,2-2.5,2-3,2-7,2/3-3/4,20,3-4,4,4.5-9,5.5-6,6-14,6-8,also,andromonoecious,apart,apex,articulated,base,berry,brown,cm,connivent,curved,densely,elongated,evenly,flattened-reniform,flower,geminate,gently,glabrescent,glabrous,green,hair,lateral,lobed,long,long-styled,maturity,midpoint,minute,mm,moderately,occasionally,poricidal,porrect,prickle,prickly,ray,reduced,sessile,shrub,simple,sparsely,spherical,stellate,stellate-pubescent,surface,tapering,terete,tip,toward,trichome,way,weakly,white,wide,yellow,young	perennial,red-brown
12	wfo-0001025783	success	179	126	68	83	96	43	63	5	0.5,0.5-1,0.5-1.5,0.8-3.5,1-1.2,1-1.5,1-3,2,2-5,2-6.5,5,7-10,acute,anther,anthesi,apart,apex,base,berry,branched,brown,bud,c.,calyx,cluster,cm,conical,corolla,ellipsoid,elliptic,filiform,flattened,flexuous,flower,glabrous,globose,greyish,growth,keeled,lateral,lax,lobe,lobed,long,minutely,mm,narrowly,new,number,obtuse,pale,pedicel,petiole,pitted,pubescent,purple,reniform,ripe,sagittate,scar,shoot,short,shrub,simple,sparsely,stellate,stem,stigma,style,surface,suture,terminal,thin,triangular,truncate,tube,type,vine,violet,way,wide,within,woody	.5,1.8-2,2-3+,3-4,5-merou,<,abaxiall,abaxially,adaxiall,adaxially,along,alyx,ape,ark,articulated,axil,branching,cell,completely,confined,coriaceous,dendritic,densely,diameter,eaf,eed,entire,erect,expanded,exposed,exserted,fleshy,free,fruiting,glabrou,green,groove,hromosome,ilament,inserted,known,less,long/tall,lower,margin,mature,midrib,midvein,minute,mmm,near,nflorescence,nodding,obscured,occasionally,older,orolla,outlin,pair,peduncle,penden,pentagonal,perfect,pericarp,plurifoliat,point,portion,possibly,primary,revolute,ruit,scarious,see,shiny,sleeve,slightly,sometimes,somewhat,spaced,sparse,strongly,testal,time,transparent,trichome,tuft,twinin,ud,uniseriate,unit,upper,vary,vein,weak,yellowish,ympodial	1,3,5.5,arrangement,bark,coat,colour,connation,decurrency,dry,embryo,feature,filament,form,fruit,height,history,inflorescence,leaf,length,life,midpoint,minor,na,ovary,papilla,pendent,plant,pore,prickle,ray,reproduction,seed,shape,size,spacing,specimen,texture,tip,tuberculation,width,winging,young	0.5,0.5-1,0.5-1.5,0.8-3.5,1-1.2,1-1.5,1-3,2,2-5,2-6.5,5,7-10,acute,apart,base,berry,branched,brown,c.,cluster,cm,conical,ellipsoid,elliptic,filiform,flattened,flexuous,glabrous,globose,greyish,keeled,lateral,lax,lobed,long,minutely,mm,narrowly,obtuse,pale,pitted,pubescent,purple,reniform,ripe,sagittate,shoot,short,shrub,simple,sparsely,stellate,suture,terminal,thin,triangular,truncate,vine,violet,way,wide,within,woody	1,3,5.5,na,pendent
13	wfo-0001025788	success	156	80	39	53	103	27	36	3	0.5-2,1-5,1.8-2.7,1.8-3.9,10-24,14-48,15-30,2-13,2-3,2-5,2.8-9.5,4-5.5,4.5-10.1,4.5-12.5,5-8,6.2-12.5,8-38,branched,calyx,cm,conical,connate,corolla,cyme,diameter,dichasially,finely,flower,forked,herbaceous,interjected,lateral,leaf,leaflet,long,mm,mucilaginous,odd-pinnate,ovoid,pedicel,peduncle,perennial,petiole,plant,pubescent,rotate,seed,size,stigma,straight,style,terminal,yellow	0-6,1-4,2-10,2m,3-6-7-8,3-6-foliat,4-3.,abaxiall,abaxially,acumen,acuminate,acute,adaxially,apex,apical,apically,articulate,attenuate,base,blue,cell,covering,cuneate,deep,dehiscent,dichasial,digestion,diminishing,distal,dorsally,eaf,ebracteate,edge,eed,elliptical,emoval,enzyme,exceeding,filament,flat,folded,generally,globo,gradually,green,green-white,hair-like,half,honeycomb,introrse,living,lobe,lon,long-attenuate,lower,lunat,make,maturing,medium,monochasial,narrowly,nflorescence,nther,oblique,obtuse,often,orolla,ovate,pair,pattern,perfect,petiolule,plan,poricidally,proximal,purple,reveal,rounded,ruit,sessile,seudostipule,short,slit,specimen,stamen,subequal,subsessile,tal,tem,testal,thick,throughou,throughout,tip,toward,tuber-bearing,typically,unit,vary,wall,wide,ympodial,Â¼	4-31,abaxial,adaxial,anther,arrangement,colour,connation,feature,form,fruit,globose,growth,height,history,inflorescence,length,life,na,number,ovary,reproduction,shape,stem,surface,texture,type,width	0.5-2,1-5,1.8-2.7,1.8-3.9,10-24,14-48,15-30,2-13,2-3,2-5,2.8-9.5,4-5.5,4.5-10.1,4.5-12.5,5-8,6.2-12.5,8-38,branched,cm,conical,connate,cyme,dichasially,finely,forked,herbaceous,long,mm,mucilaginous,odd-pinnate,ovoid,perennial,pubescent,rotate,straight,yellow	4-31,globose,na
14	wfo-0001025792	success	203	137	91	109	94	28	87	4	0.4-0.7,1-10,1-2,1-3,10-15,2-11,2-3,2.5-3.5,2.5-4,21-28,3-4,3-5,3.5-6,4-12,5,5-10,5-6,5-9,7-10,7.5-8,8-10,9-12,abaxially,acute,adaxially,anther,apex,auriculate,axillary,base,blade,blue-mauve,blue-purple,brownish,bud,cell,chartaceous,cm,condition,connivent,corolla,covering,dark,densely,diameter,distinctly,drying,elliptic,filament,flower,fresh,fruit,glabrous,globose,green,greenish,hair,hair-like,half,herb,homostylous,interjected,lanceolate,lateral,leaflet,like,lobe,long,mauve,membranous,minute,mm,narrowly,oblique,odd-pinnate,ovoid,pair,papillose,pedicel,peduncle,petiole,plant,pore,poricidal,proximal,pubescent,purple,ripe,rotate-pentagonal,rounded,seed,size,stem,stigma,straight,streak,style,subtending,terminal,testal,thick,tinged,tip,tube,wall,white,whitish,x,yellow	1-4,2-3.5,4-6,4.5-7,5-merou,acumen,acuminate,ag,along,alyx,apart,apparently,articulated,articulation,axe,basiscopic,berry,broadly,capitat,ciliate,decurrent,developing,digestion,distal,distinct,dorsally,eaf,edge,eed,enzyme,especially,exceeding,except,flat,folded,forked,geminat,generally,glabrou,greatly,green-white,hal,high,honeycomb-shaped,indistinct,lengthening,living,lower,make,margin,midrib,minutely,mottle,mucilaginous,narrow,nflorescence,often,onto,orolla,perfect,petiolulate,plurifoliate,puberulent,rachi,reduced,removed,ruit,semi-erec,semi-rosette,sessile,seudostipule,short,shortly,side,slightly,slit,spaced,specimen,stamen,ste,sub-rosette,subequal,tall,tamen,tem,throughout,tri-,unit,usually,vary,wet,wing,ympodial,young	5-merous,arrangement,calyx,capitate,colour,connation,feature,form,growth,height,history,inflorescence,leaf,length,life,mottled,na,number,ovary,papilla,pseudostipule,pubescence,reproduction,shape,spacing,staman,surface,texture	0.4-0.7,1-10,1-2,1-3,10-15,2-11,2-3,2.5-3.5,2.5-4,21-28,3-4,3-5,3.5-6,4-12,5,5-10,5-6,5-9,7-10,7.5-8,8-10,9-12,abaxially,acute,adaxially,auriculate,axillary,blue-mauve,blue-purple,brownish,bud,cell,chartaceous,cm,condition,connivent,covering,dark,densely,diameter,distinctly,drying,elliptic,fresh,glabrous,globose,green,greenish,hair,hair-like,half,herb,homostylous,lanceolate,lateral,like,long,mauve,membranous,minute,mm,narrowly,oblique,odd-pinnate,ovoid,papillose,poricidal,proximal,pubescent,purple,ripe,rotate-pentagonal,rounded,stem,straight,streak,subtending,terminal,testal,thick,tinged,tip,wall,white,whitish,x,yellow	5-merous,capitate,mottled,na
15	wfo-0001025804	success	155	132	77	94	61	38	74	3	.25,.5,0.5-1,1-1.5,1-3,1.4-1.7,1.5-2,10-20,11-20,16-35,2-2.5,2.5-4,3.5-12,4-10,6-8,?,acute,age,anther,anthesi,apex,apiculate,attenuate,bark,base,berry,bilobed,calyx,cm,conical,corolla,cream,dark,decurrent,deflexed,difoliate,drying,ellipsoid,elliptic,erect,filament,flattened,flower,glabrous,globose,green,incrassate,internodal,leaf,lengthening,lobe,lobed,margin,minor,minutely,mm,near,nearly,obovate,occasionally,opposite,ovary,paler,papillate,pedicel,pitted,planar,plurifoliate,pore,poricidal,projection,red-papillose,reddish-brown,reniform,rim,scar,sessile,shrub,size,slit,somewhat,stem,stigma,strongly,style,surface,tip,tube,white,whitish-green,winged,woody,x,young	1.2-1.5,3-4.5,5,7-10,abaxially,adaxially,apar,ape,ba,branched,c.,clavate,covered,cucullate,densely,dia,differing,eaf,edicel,eed,exserted,fleshy,free,fruiting,geminat,glandular,later,lateral,light,long,lower,main,major,many,mere,middle,minute,nflorescence,often,older,onto,pair,papillae,papillat,papillose,portion,red,reddish-brow,regularly,ruit,spaced,tall,thick,time,tub,ud,unit,vein,widest,wing,ympodial	apart,arrangement,bud,coat,colour,connation,decurrency,dry,embryo,feature,form,fruit,geminate,growth,height,history,inflorescence,length,life,midpoint,na,new,number,papilla,petiole,plant,prickle,ray,reproduction,seed,shape,spacing,specimen,texture,tuberculation,type,width,winging	.25,.5,0.5-1,1-1.5,1-3,1.4-1.7,1.5-2,10-20,11-20,16-35,2-2.5,2.5-4,3.5-12,4-10,6-8,?,acute,age,anthesi,apiculate,attenuate,base,berry,bilobed,cm,conical,cream,dark,decurrent,deflexed,difoliate,drying,ellipsoid,elliptic,erect,flattened,glabrous,globose,green,incrassate,internodal,leaf,lengthening,lobed,margin,minutely,mm,near,nearly,obovate,occasionally,opposite,paler,papillate,pitted,planar,plurifoliate,poricidal,projection,red-papillose,reddish-brown,reniform,rim,sessile,shrub,slit,somewhat,strongly,tip,white,whitish-green,winged,woody,x	apart,geminate,na
16	wfo-0001025813	success	195	141	108	119	76	22	105	3	0-2,1-1.5,1-10,1-2,1-4,1.2-4.5,1.3-7,1.5-1.8,1.5-6.5,15-30,2-3,2-4,2-5,3-3.5,3-4,3-5,3-6,3-7,5-18.5,5-6,6-7,abaxially,absent,acuminate,acute,adaxially,anther,apart,base,berry,blue,borne,broadly,brownish,cell,chartaceous,cm,condition,connivent,corolla,covering,dark,decreasing,densely,diameter,drying,elliptic,end,extra,flower,fresh,fruit,glabrous,globose,green,green-white,greenish,hair,hair-like,herb,homostylous,interjected,lanceolate,lateral,leaflet,lengthening,light,like,lobe,long,make,membranous,minute,mm,monochasium,mucilaginous,odd-pinnate,orbicular,ovate,ovoid,pair,pedicel,peduncle,petiolulate,pilose,plant,pore,poricidal,pubescent,rarely,rotate,seed,sessile,short,singly,size,slit,stem,stigma,straight,style,suborbicular,terminal,testal,thick,throughout,tip,toward,tube,tuber,typically,unwinged,violet,wall,wet,white,whitish,x,yellow	0.7-1.7,1.5-2,5-merou,acumen,ag,along,alyx,apex,apparently,articulated,axe,blade,ciliate,contracted,cuneate,decurrent,digestion,discussion,distal,distinct,dorsally,eaf,edge,eed,enzyme,especially,exceeding,filament,flat,folded,geminat,glabrou,half,highly,honeycomb-shaped,larger,living,longer,lower,margin,midrib,minutely,near,nflorescence,obtuse,often,orolla,ovoi,perfect,petiole,plurifoliate,puberulent,rachi,removed,rosette-formin,ruit,see,seudostipule,single-flowered,sometimes,spaced,species,specimen,stamen,ste,stolo,strongly,tamen,tem,thir,tri-,unforked,unit,vary,vein,ympodial	age,arrangement,calyx,colour,feature,form,growth,height,inflorescence,leaf,length,na,ovary,presence,pseudostipule,reproduction,shape,spacing,stolon,surface,texture,type	0-2,1-1.5,1-10,1-2,1-4,1.2-4.5,1.3-7,1.5-1.8,1.5-6.5,15-30,2-3,2-4,2-5,3-3.5,3-4,3-5,3-6,3-7,5-18.5,5-6,6-7,abaxially,absent,acuminate,acute,adaxially,apart,base,berry,blue,borne,broadly,brownish,cell,chartaceous,cm,condition,connivent,covering,dark,decreasing,densely,diameter,drying,elliptic,end,extra,flower,fresh,fruit,glabrous,globose,green,green-white,greenish,hair,hair-like,herb,homostylous,lanceolate,lateral,lengthening,light,like,long,make,membranous,minute,mm,monochasium,mucilaginous,odd-pinnate,orbicular,ovate,ovoid,petiolulate,pilose,pore,poricidal,pubescent,rarely,rotate,seed,sessile,short,singly,size,slit,stem,straight,suborbicular,testal,thick,throughout,tip,toward,typically,unwinged,violet,wall,wet,white,whitish,x,yellow	age,na,stolon
17	wfo-0001025825	success	187	105	60	73	114	32	56	4	0.4-1,0.5-10.4,1-2,1-5.5,1.1-1.4,10-24,10.5-26,2-3.7,2-5,22-86,3-10,3-5,4-8,4-9,5-10,6-10,6.6-14,anther,axillary,berry,bud,cell,clavate,cm,connivent,coriaceous,corolla,covering,dark,diameter,filament,flower,forked,fruit,glabrescent,glabrous,green,hair,hair-like,herb,lanceolate,lateral,leaf,light,lobe,medium,mm,odd-pinnate,ovate,ovoid,pedicel,peduncle,pentagonal,petiole,plant,pore,poricidal,rotate-pentagonal,seed,shiny,short,size,stigma,style,subtending,terminal,testal,thick,tip,tube,unwinged,wall,winged	0-0.21,0.4-3,0.5-0.8,0.7-2.2,0.9-2,0.9-4,1-3,14-85,3-8.5,3.7-6.5,5-7,5-merou,abaxially,acumen,acuminate,acute,adaxiall,adaxially,ag,alyx,apart,apex,apparently,articulated,asymmetric,attenuate,axe,back,base,basiscopic,blade,brownish,capitat,condition,cuneate,decreasing,decurrent,digestion,distal,dorsally,drying,eaf,edge,eed,elliptic,enzyme,erec,exceeding,flat,folded,fresh,geminat,generally,glabrou,green-white,greenish,hal,half,high,homostylous,honeycomb-shaped,increasing,interjected,leaflet,lengthening,lilac,living,long,lower,make,middle,mucilaginous,nflorescence,orbicular,orolla,pair,perfect,petiolulate,plurifoliate,rachi,removed,rounded,ruit,sessile,seudostipule,side,slightly,slit,smaller,spaced,specimen,stamen,straight,streak,subequal,subglabrou,tall,tamen,tem,throughout,tissue,toward,tri-,unit,usually,vary,wet,white,whitish,wide,wing,x,yellow,ympodial	abaxial,adaxial,arrangement,calyx,capitate,colour,connation,feature,form,geminate,growth,height,history,inflorescence,length,life,na,new,number,ovary,papilla,pseudostipule,reproduction,shape,spacing,stem,subglabrous,surface,texture,type,width,young	0.4-1,0.5-10.4,1-2,1-5.5,1.1-1.4,10-24,10.5-26,2-3.7,2-5,22-86,3-10,3-5,4-8,4-9,5-10,6-10,6.6-14,axillary,berry,bud,cell,clavate,cm,connivent,coriaceous,covering,dark,diameter,forked,glabrescent,glabrous,green,hair,hair-like,herb,lanceolate,lateral,light,medium,mm,odd-pinnate,ovate,ovoid,pentagonal,poricidal,rotate-pentagonal,shiny,short,subtending,terminal,testal,thick,tip,unwinged,wall,winged	capitate,geminate,na,subglabrous
18	wfo-0001025838	success	215	144	91	107	108	37	87	4	0.5-1,0.7-2,1-1.2,1.2-5,1.5-2.5,1.5-5,10-60,2-2.5,2-5,2.5-3,2/3,3.5-6-15,4-15,5,6.5-7,abruptly,acuminate,anther,anthesi,apart,apex,attenuate,base,berry,black,branched,calyx,capitate,clavate,cm,connivent,corolla,cucullate,cup-shaped,dendritic,densely,ellipsoidal,elliptic,erect,filament,flattened,flower,fruit,glabrescent,glabrous,globose,greenish,growth,inflorescence,lanceolate,lateral,leaf,lengthening,less,lobe,lobed,loosely,many,minute,minutely,mm,narrowing,narrowly,new,nodding,often,ovoid,pedicel,petiole,pitted,pointed,pore,poricidal,pubescent,purple,reniform,ripe,scar,seed,shrub,simple,slender,slightly,slit,spreading,stellate,stem,stigma,strongly,style,surface,terminal,time,tinged,tip,tree,trichome,tube,turbinate,uniseriate,way,weight,white,winged,woody,x,Â¾	.5,0.5,1-1.5,1.5-1.7,1.5-2,1.5-3.5,1.8-2,10-15-20,20-40,4.5-5.5,5-merou,adaxial,adaxially,ag,along,alyx,apiculate,appearing,archin,ark,articulated,axil,basall,branch,broad,brown,cell,clustered,dark,decurrent,dense,denser,diameter,disintegrating,drying,eaf,eed,entire,exserted,extending,fleshy,free,fruiting,hairy,ilament,inserted,insertion,irregularly,keeled,lamina,like,long,lower,m.,margin,membranous,midrib,mostly,never,nflorescence,occasionally,older,onto,orolla,pair,pale,papillat,papillo,peduncle,per,perfect,pericarp,platform,plurifoliat,point,portion,primary,quadrate,reddish,revolute,ruit,shin,shiny,short,sinus,sleeve,small,sometimes,spaced,sparsely,square,tall,tem,testal,thi,thin,tuft,twinin,ud,unit,upper,vary,vein,wall,wing,yellow,yellowish,ympodial	1,age,arrangement,bud,coat,colour,connation,decurrency,dry,embryo,feature,form,height,history,length,life,midpoint,minor,na,number,ovary,papilla,papillose,plant,prickle,ray,reproduction,shape,size,spacing,specimen,texture,tuberculation,type,width,winging,young	0.5-1,0.7-2,1-1.2,1.2-5,1.5-2.5,1.5-5,10-60,2-2.5,2-5,2.5-3,2/3,3.5-6-15,4-15,5,6.5-7,abruptly,acuminate,apart,attenuate,base,berry,black,branched,capitate,clavate,cm,connivent,cucullate,cup-shaped,dendritic,densely,ellipsoidal,elliptic,erect,flattened,fruit,glabrescent,glabrous,globose,greenish,lanceolate,lateral,lengthening,less,lobed,loosely,many,minute,minutely,mm,narrowing,narrowly,nodding,often,ovoid,pedicel,pitted,pointed,pore,poricidal,pubescent,purple,reniform,ripe,shrub,simple,slender,slightly,slit,spreading,stellate,strongly,terminal,time,tinged,tip,tree,trichome,turbinate,uniseriate,way,weight,white,winged,woody,x,Â¾	1,age,na,papillose
19	wfo-0001025845	success	180	111	78	92	88	19	78	0	0.3-0.5,0.4-1.5,0.5-11,0.5-2.5,1-1.8,1-4.5,1.5,1.5-13,1.5-2,1.5-2.5,1.5-7,2,2-15,2-5-lobed,2.5-4,3-13,3-4,4-5,4-6,6-6.5,6-9,acuminate,acute,along,anther,apart,apex,apiculate,base,branch,brown,calyx,cm,compressed,corolla,cuneate,decurrent,deltate,diameter,distally,ellipsoidal,entire,extra-axillary,filament,flattened,fork,fruit,glabrous,greenish,herb,laterally,leaf,light,lobe,lobed,located,margin,minutely,mm,narrowly,near,obtuse,orange,ovoid,patch,pedicel,peduncle,petiole,pinnately,puberulent,rachi,rotate-stellate,rugose-verrucate,sagittate,shrub,simple,sparsely,stigma,strongly,style,subcordate,tapered,tip,triangular,truncate,tube,unbranched,unlobed,white,x,yellow,yellowish	.5,1,1-2,2-3,3,3-6,3-foliat,5-6,7-10,abaxially,abundantly,adaxial,adaxially,aggregate,around,articulated,ascending,axe,ba,blade,cell,channe,chartaceous,connivent,cylindrical,dark,diamete,directed,distall,divided,eaf,eed,eglandular,elliptic,especially,flower,free,glabrou,green,inserted,lateral,long,longitudinal,lower,major,membranaceous,mesocarp,midrib,nearly,nflorescence,obovate,often,orolla,ovate,part,perfect,pore,pubescent,purple,radiu,rarely,rounded,ruit,sand-punctate,shorter,side,sinus,small,spaced,stone,stripe,tal,tamen,tem,terminal,thecae,thick,tightly,time,tomento,truncat,unit,vary,vein,veiny,wide,ympodial,youn	arrangement,colour,feature,form,growth,height,inflorescence,length,ovary,plant,seed,shape,size,spacing,staman,stem,surface,texture,thicknes	0.3-0.5,0.4-1.5,0.5-11,0.5-2.5,1-1.8,1-4.5,1.5,1.5-13,1.5-2,1.5-2.5,1.5-7,2,2-15,2-5-lobed,2.5-4,3-13,3-4,4-5,4-6,6-6.5,6-9,acuminate,acute,along,apart,apex,apiculate,base,branch,brown,cm,compressed,corolla,cuneate,decurrent,deltate,distally,ellipsoidal,entire,extra-axillary,flattened,fork,glabrous,greenish,herb,laterally,light,lobed,located,minutely,mm,narrowly,near,obtuse,orange,ovoid,patch,petiole,pinnately,puberulent,rotate-stellate,rugose-verrucate,sagittate,shrub,simple,sparsely,strongly,subcordate,tapered,tip,triangular,truncate,unbranched,unlobed,white,x,yellow,yellowish	
20	wfo-0001025850	success	195	109	71	86	109	23	67	4	.5,.8,0.5-1,0.5-1-3-5,0.5-1.5-5,0.5-3,0.6-1,1,1-celled,2,2-12,2-6.5,30,6-7,abaxial,acute,anther,apex,base,berry,calyx,capitate,cm,corolla,cyathiform,deciduous,deflexed,denser,ellipsoid,flattened,flower,fruiting,glabrous,gland,glandular,globose,growth,inflorescence,irregularly,later,lateral,lax,lengthening,lobed,minute,minutely,mm,nearly,new,node,often,orange,pedicel,peduncle,petiole,pinnatifid,pitted,pore,poricidal,pubescent,reniform,ripe,rounded,scar,scattered,shallowly,shrub,simple,slit,soon,spreading,stellate,stem,stigma,style,surface,terminal,tip,trichome,truncate,tube,uniseriate,vine,white,woody,x	-7,0.5,1-1.5,1.5,15-20,3-4,4-5,5-7,5-merou,ag,along,alyx,anthesi,apar,apparently,ark,articulated,axi,basal,branched,broadly,brown,cell,connivent,cupped,deltate,densely,diameter,divaricate,divided,drying,eaf,eed,elliptic,elongate,em,entire,erect,exserted,extending,filament,fleshy,free,geminat,glabrou,green,half,halfway,ilament,lamina,leaving,less,lobe,long,loosely,lower,many,margin,membranous,midrib,narrowly,nflorescence,nodding,occasionally,older,openly,orolla,outline,pair,pale,papillate-puberulent,papillo,peg,per,perfect,planar,plurifoliate,portion,primary,puberulen,reddish,rhomboid,ruit,shiny,sinuate,sinus,sleeve,slender,slightly,small,sometimes,spaced,splitting,spreadin,strongly,surfac,tan,testal,thin,time,tiny,twinin,ud,unit,vary,vein,yellow,ympodial,young	adaxial,age,apart,arrangement,colour,feature,form,fruit,height,leaf,length,number,ovary,papillose,plant,puberulent,seed,shape,size,spacing,texture,type,width	.5,.8,0.5-1,0.5-1-3-5,0.5-1.5-5,0.5-3,0.6-1,1,1-celled,2,2-12,2-6.5,30,6-7,acute,base,berry,capitate,cm,cyathiform,deciduous,deflexed,denser,ellipsoid,flattened,glabrous,gland,glandular,globose,irregularly,later,lateral,lax,lengthening,lobed,minute,minutely,mm,nearly,node,often,orange,pinnatifid,pitted,pore,poricidal,pubescent,reniform,ripe,rounded,scattered,shallowly,shrub,simple,slit,soon,spreading,stellate,terminal,tip,trichome,truncate,uniseriate,vine,white,woody,x	age,apart,papillose,puberulent
21	wfo-0001025872	success	160	124	71	89	71	35	67	4	.1,.5,0.25-0.5,0.5-1,0.6-1,1-1.3,1-2,1.7-3,10-25-flowered,2-2.5,2-5,2/3,3.5-4,4.5-13,6-8,anther,anthesi,apart,apically,bark,base,becoming,berry,branched,broadly,calyx,capitate,cm,coriaceous,corolla,crinkled,cup-shaped,dark,deeply,deflexed,densely,dry,elliptic,filament,flattened,flattened-reniform,fleshy,flower,glabrous,globose,green,later,lateral,leaf,lobe,lobed,long,margin,minutely,mm,narrowly,occasionally,older,opposite,ovary,papillae,papillose,pedicel,petiole,pitted,plant,poricidal,pubescent,red-papillose,revolute,scar,several,shaped,shrub,specimen,stem,stigma,style,surface,tear-drop,terminal,time,tip,tube,way,white,woody,x,young	0.5,1,1-1.5,1.2-1.5,1.2-1.6,4-4.5,6-10,acute,along,apex,auriculate,ba,beginning,beneath,blade,bright,brownish,crowded,decurrent,dense,dia,eaf,edicel,eed,exserted,free,fruiting,glandular-resinous,grayish-brow,greenish-tan,incrassate,inflorescenc,irregularly,junction,live,lon,lower,main,material,midrib,nflorescence,often,onto,pair,paler,papillo,planar,plurifoliat,pore,portion,prominent,rounded,rounded-triangular,ruit,simple,somewhat,soon,spaced,straight,tall,tapering,thick,thickened,trichome,tub,ud,uniseriate,unit,vein,visible,ympodial	abaxial,adaxial,arrangement,bud,coat,colour,connation,feature,form,fruit,grayish-brown,greyish,growth,hair,height,history,inflorescence,length,life,midpoint,na,number,papilla,plurifoliate,prickle,ray,reproduction,seed,shape,size,spacing,texture,tuberculation,type,width	.1,.5,0.25-0.5,0.5-1,0.6-1,1-1.3,1-2,1.7-3,10-25-flowered,2-2.5,2-5,2/3,3.5-4,4.5-13,6-8,apart,apically,base,becoming,berry,branched,broadly,capitate,cm,coriaceous,crinkled,cup-shaped,dark,deeply,deflexed,densely,elliptic,flattened,flattened-reniform,fleshy,glabrous,globose,green,later,lateral,leaf,lobed,long,minutely,mm,narrowly,occasionally,opposite,papillae,papillose,pitted,poricidal,pubescent,red-papillose,revolute,several,shaped,shrub,tear-drop,terminal,time,tip,way,white,woody,x,young	grayish-brown,greyish,na,plurifoliate
22	wfo-0001025893	success	157	116	63	82	75	34	60	3	.25,.5,0.5-1.5,0.8-1,1-1.2,1-1.5,1-4,1.5-2,11-20,2-3,3-5,5-6,anther,anthesi,bark,base,berry,bi-lobed,branched,broadly,calyx,capitate,closely,cm,corolla,cup-shaped,decurrent,deflexed,densely,dry,ellipsoid,elliptic,erect,faintly,filament,flower,fruit,glabrate,glabrous,globose,golden-puberulent,green,greyish,internodal,leaf,lobe,lobed,longitudinally,minutely,mm,narrowly,nearly,obovate,older,opposite,ovary,overlapping,ovoid-reniform,papillose,pedicel,petiole,pitted,poricidal,red-papillose,scar,shaped,shrub,sometimes,spaced,specimen,stem,stigma,style,surface,tear-drop,tip,tube,white,winged,woody,x,young	.4,1-2.5,1.5-1.7,2-2.5,6-10,accrescent,along,apex,attenuate,bank,barely,bearing,beginning,beneath,blade,brownish-green,deltoid,dia,difoliate,eaf,early,eed,even,exserted,free,fruiting,geminate,gravelly,growing,impressed,inflorescenc,lateral,lon,long,long-acuminate,lower,main,many,margin,material,middle,nflorescence,occasionally,pair,pale,papillo,planar,plurifoliat,pore,portion,puberulent,reflexed,river,rocky,ruit,sandy,slender,slightly,straight,stream,striat,tall,tapering,thickened,time,trichome,ud,unicellular,unit,usually,vein,visible,widest,yellowish,ympodial	abaxial,adaxial,alternate,arrangement,bud,coat,colour,connation,feature,form,growth,height,history,inflorescence,length,life,midpoint,na,number,papilla,plant,prickle,ray,reproduction,seed,shape,size,spacing,striate,texture,tuberculation,type,width,winging	.25,.5,0.5-1.5,0.8-1,1-1.2,1-1.5,1-4,1.5-2,11-20,2-3,3-5,5-6,base,berry,bi-lobed,branched,broadly,capitate,closely,cm,cup-shaped,decurrent,deflexed,densely,ellipsoid,elliptic,erect,faintly,glabrate,glabrous,globose,golden-puberulent,green,greyish,internodal,leaf,lobed,longitudinally,minutely,mm,narrowly,nearly,obovate,opposite,overlapping,ovoid-reniform,papillose,pitted,poricidal,red-papillose,shaped,shrub,sometimes,spaced,tear-drop,tip,white,winged,woody,x	alternate,na,striate
23	wfo-0001025896	success	146	112	56	66	80	46	53	3	0.5-2,1-25,1-8,1.5-2,2-14,2.5-14,4,4-12,4-23,4-5,5-15,5-7,6-10,acuminate,also,angled,apart,apex,base,brownish,calyx,cm,connivent,constricted,cuneate,densely,eglandular,elliptic-ovate,flower,forked,fruit,glabrous,gland,globose,hair,inflated,lobe,mm,moderately,often,orange,ovate,pale,pedicel,petiole,pore,pubescent,purple,red,rotate-stellate,rugose,short-stalked,shrub,simple,smooth,stem,stigma,style,subcordate,surface,tip,triangular-ovate,tube,unbranched,white,x	-3,-30,.5-2.5,0.5,1-1.5,1-3,1-6.5,1.5-9,10-15,10-25,2-2.5,2.5-5,4-6,6-13,7-,7743,abaxial,abaxially,absen,acosta,acute,adaxiall,adaxially,aggregate,articulated,axe,ba,blade,branched,cell,chartaceous,cylindrical,deltate,dendritically,diameter,directed,distall,eaf,eed,entire,especially,greenish,like,long,lower,many-foliat,margin,membranaceous,near,nearly,nflorescence,nther,obtuse,occasionally,orolla,peduncle,perfect,present,puberulent,pubescen,rachi,radiu,ripe,ruit,solÃ­,spaced,sparsely,stalked,stone,tal,tem,time,triangular-subulate,truncat,unit,vary,vein,wide,yellow,ympodial	6-30,anther,anthesi,arrangement,bud,coat,colour,connation,corolla,decurrency,dry,embryo,feature,filament,form,growth,height,history,inflorescence,leaf,length,life,midpoint,minor,na,new,number,ovary,papilla,plant,prickle,ray,reproduction,scar,seed,shape,size,spacing,specimen,texture,truncate,tuberculation,type,width,winging,young	0.5-2,1-25,1-8,1.5-2,2-14,2.5-14,4,4-12,4-23,4-5,5-15,5-7,6-10,acuminate,also,angled,apart,apex,brownish,cm,connivent,constricted,cuneate,densely,eglandular,elliptic-ovate,forked,glabrous,gland,globose,hair,inflated,mm,moderately,often,orange,ovate,pale,pubescent,purple,red,rotate-stellate,rugose,short-stalked,shrub,simple,smooth,subcordate,triangular-ovate,tube,unbranched,white,x	6-30,na,truncate
24	wfo-0001025902	success	211	146	90	108	103	38	85	5	/2,0.1-0.5,0.5-2,1-1.2,1-1.5,1.5,1.5-2,1.5-3,11-15,1983,2-6,3-10,4,4-13,8-10,8-15,8-9,acute,aid,anther,anthesi,apex,attenuate,bark,base,becoming,berry,black,branch,cabrera,calyx,clavate,cm,completely,conical,connivent,corolla,dull,ellipsoid,except,fide,filament,flattened-reniform,flower,glabrous,globose,green,growth,inflorescence,lanceolate,lateral,leaf,leaf-opposed,length,lengthening,linear,lobe,lobed,loosely,mature,minute,minutely,mm,new,occasionally,ovary,pale,papillose,pedicel,petiole,pitted,planar,pore,poricidal,pubescent,ridged,rotate-stellate,rounded,scar,simple,slender,slit,sometimes,spreading,stem,stigma,strongly,style,surface,tangled,tapering,terminal,tip,trichome,tube,twining,ultimate,uniseriate,usually,vine,violet,way,weak,whitish,wing,woody,x,yellowish	.2,.5,0.5-2.5,1.2-1.5,1/3,2.5-4,4-5,4-6,40,5-6,5-merou,>,abaxially,absent,accompanied,adaxially,ag,along,always,alyx,apar,ark,articulated,axi,beginning,berr,branched,branching,broadly,c.,cell,chartaceous,circular,climbin,deciduou,deltate,densely,diameter,eaf,eed,either,entire,exfoliatin,exserted,fleshy,free,fruiting,geminat,ilament,leaving,less,long,low,lower,margin,markedly,midvei,nflorescence,obscured,often,older,one,orolla,pair,papillat,peduncle,peg,pendant,per,perfect,pericarp,plurifoliate,portion,primary,prominent,revolute,ruit,scattered,scrambling,semi-aquati,semi-circular,shallow,sleeve,small,somewhat,soon,spaced,sparsely,tem,testal,thin,time,ud,unit,vary,vegetation,vein,water,weight,widely,yellow,ympodial,Â½	age,apart,arrangement,bud,climbing,coat,colour,connation,decurrency,dry,embryo,feature,form,fruit,height,history,life,midpoint,minor,na,number,papilla,papillate,plant,prickle,ray,reproduction,seed,shape,size,spacing,specimen,texture,tuberculation,type,width,winging,young	/2,0.1-0.5,0.5-2,1-1.2,1-1.5,1.5,1.5-2,1.5-3,11-15,1983,2-6,3-10,4,4-13,8-10,8-15,8-9,acute,aid,anthesi,attenuate,base,becoming,berry,black,branch,cabrera,clavate,cm,completely,conical,connivent,dull,ellipsoid,except,fide,flattened-reniform,glabrous,globose,green,lanceolate,lateral,leaf-opposed,lengthening,linear,lobed,loosely,mature,minute,minutely,mm,occasionally,pale,papillose,pitted,planar,poricidal,pubescent,ridged,rotate-stellate,rounded,simple,slender,slit,sometimes,spreading,strongly,tangled,tapering,terminal,tip,trichome,twining,ultimate,uniseriate,usually,vine,violet,way,weak,whitish,wing,woody,x,yellowish	age,apart,climbing,na,papillate
25	wfo-0001025906	success	188	114	74	87	101	27	70	4	0.1-2,0.20-0.60,1-2,1-3,1.1-2,1.6-12.4,16-51,2-4.4,2-6,3-10,3-5,4-5,4-7,5-6,5-7,5.2-9,8-16,8.5-12.5,acumen,anther,axillary,berry,blue,bud,cell,clavate,cm,connivent,coriaceous,corolla,covering,dark,delimited,diameter,filament,flower,fruit,glabrous,globose,green,green-white,hair-like,herb,homostylous,lanceolate,lateral,leaf,light,lilac,linear,lobe,long,make,mm,mucilaginous,odd-pinnate,ovoid,pedicel,peduncle,pentagonal,petiole,plant,poricidal,purple,ripe,rotate,seed,shiny,size,stigma,straight,stripe,style,sub-glabrous,subglabrous,subtending,terminal,testal,thick,throughout,tip,tube,wall,well,wet,width,yellow	0-14,0.15-0.6,0.2-0.6,1-6,1.8-4.8,2.6-5.2,4-10,4-12,5-merou,abaxially,acute,adaxiall,adaxially,ag,alyx,apart,apex,apparently,articulated,axe,base,blade,brownish,capitat,condition,cuneate,decreasing,decurrency,decurrent,digestion,diminishing,distal,dorsally,drying,eaf,edge,eed,enzyme,erec,exceeding,falcate,first,flat,folded,forked,fresh,geminat,generally,glabrou,greenish,hair,hal,half,high,honeycomb-shaped,interjected,leaflet,lengthening,living,lower,next,nflorescence,obtuse,orolla,pair,perfect,plurifoliate,pore,pubescent,rachi,removed,ruit,second,sessile,seudostipule,short,slightly,slit,smaller,spaced,sparsely,specimen,stamen,subequal,subglabrou,tall,tamen,tem,third,toward,tri-,typically,unit,unwinged,usually,vary,white,whitish,wood,x,ympodial	5-merous,abaxial,adaxial,arrangement,calyx,capitate,colour,feature,form,growth,height,history,inflorescence,length,life,ovary,perennial,pseudostipule,reproduction,shape,spacing,staman,stem,surface,texture,type,woody	0.1-2,0.20-0.60,1-2,1-3,1.1-2,1.6-12.4,16-51,2-4.4,2-6,3-10,3-5,4-5,4-7,5-6,5-7,5.2-9,8-16,8.5-12.5,acumen,axillary,berry,blue,bud,cell,clavate,cm,connivent,coriaceous,covering,dark,delimited,glabrous,globose,green,green-white,hair-like,herb,homostylous,lanceolate,lateral,light,lilac,linear,long,make,mm,mucilaginous,odd-pinnate,ovoid,pentagonal,poricidal,purple,ripe,rotate,seed,shiny,straight,stripe,sub-glabrous,subglabrous,subtending,terminal,testal,thick,throughout,tip,wall,well,wet,yellow	5-merous,capitate,perennial,woody
26	wfo-0001025907	success	147	115	66	76	71	39	57	9	.05,.5,.5-1,0.8-1.8,1-1.2,1-2.3,1-3,1-5,1.5-2.2,12-45,2,2-3.5,4-5,anther,anticlinal,axillary,base,berry,calyx,cm,conical,densely,diameter,elliptic,filament,flattened,flower,free,fruit,fruiting,glabrous,globose,green,growth,highly,irregular,lobe,lobed,long,minutely,mm,nearly,new,obovate,ovary,ovoid-reniform,pedicel,petiole,plant,poricidal,portion,projection,pubescent,raised,red-papillate,round,rugose,scar,scattered,seed,shrub,simple,sinuous,size,stigma,style,surface,thickening,tip,trichome,tube,uniseriate,white,white-lenticellate,without,x	-4,0,0-60,1,1.5-2,10-15,2-8,2/3,3-4,3-5-15,3/2,absent,acuminate,acute,along,anthesi,anthesis5-7,apex,appearing,attenuate,axil,beak,bearing,breaking,brown,c,cell,clavat,conspicuously,deciduous,eaf,edicel,eed,epidermal,erec,greenish,included,iquito,isolated,lamina,lon,lower,margin,near,nflorescence,occasionally,open,pair,papillate,papillose,per,population,primary,reflexed,remaining,ruit,single-stemmed,slender,soon,sparsely,tal,tem,time,truncate,tub,ud,unifoliat,unit,variable,vein,ympodial	2-4,3-15,40-60,5-7,abaxial,adaxial,arrangement,bud,clavate,coat,colour,connation,corolla,embryo,erect,feature,form,greyish,hair,height,history,inflorescence,leaf,length,life,na,number,papilla,pore,reproduction,shape,spacing,stem,texture,tuberculation,type,unifoliate,width,young	.05,.5,.5-1,0.8-1.8,1-1.2,1-2.3,1-3,1-5,1.5-2.2,12-45,2,2-3.5,4-5,anticlinal,axillary,base,berry,cm,conical,densely,elliptic,filament,flattened,free,glabrous,globose,green,highly,irregular,lobed,long,minutely,mm,nearly,obovate,ovoid-reniform,plant,poricidal,portion,projection,pubescent,raised,red-papillate,round,rugose,scattered,shrub,simple,sinuous,thickening,tip,trichome,uniseriate,white,white-lenticellate,without,x	2-4,3-15,40-60,5-7,clavate,erect,greyish,na,unifoliate
27	wfo-0001026203	success	197	110	72	85	112	25	70	2	0.06-0.86,0.3-11,0.4-3,0.5-2.3,0.7-2.6,1-13,1-2,1-9,2-10,2-4.9,2-43,2-5,2.2-13.3,3-10,3.2-22,3.2-23,anther,axillary,berry,blue,bud,cell,clavate,cm,connivent,coriaceous,corolla,covering,dark,deep,diameter,filament,flower,forked,fruit,glabrescent,glabrous,globose,green,green-white,hair,hair-like,herb,lanceolate,lateral,leaf,light,lilac,lobe,long,make,medium,mm,moniliform,mucilaginous,odd-pinnate,ovate,ovoid,pentagonal,petiole,plant,poricidal,ripe,rotate,seed,short,size,sometimes,stigma,stripe,style,subglabrous,subtending,terminal,testal,thick,throughout,tip,tube,tuber,unwinged,wall,wet,wide,x	0-39,0-7,0.3-6,0.38-11.3,0.5-3.2,1-4,1-5,1.1-7.9,1.2-5.5,2-8.5,3-11,3-5,5-merou,7-47,abaxially,acumen,acuminate,acute,adaxially,ag,along,alyx,apart,apex,apparently,arranged,articulated,asymmetric,attenuate,axe,base,basiscopic,bead,blade,brownish,capitat,condition,decreasing,decurrent,digestion,distal,dorsally,drying,eaf,edge,eed,elliptic,enzyme,erect,exceeding,flat,folded,fresh,geminat,generally,glabrescen,glabrou,greenish,hal,half,high,homostylous,honeycomb-shaped,interjected,leaflet,lengthening,like,linear,living,lower,middle,multiple,necklace,nflorescence,orbicular,orolla,pair,pedicel,peduncle,perfect,plurifoliate,pore,rachi,removed,rosett,rounded,ruit,sessile,seudostipule,side,slightly,slit,spaced,specimen,stamen,stolon,straight,subequal,tall,tamen,tem,tissue,toward,tri-,typically,unit,usually,vary,white,whitish,yellow,ympodial	abaxial,adaxial,arrangement,calyx,capitate,colour,connation,feature,form,growth,height,history,inflorescence,length,life,na,number,ovary,pseudostipule,reproduction,shape,stem,surface,texture,type	0.06-0.86,0.3-11,0.4-3,0.5-2.3,0.7-2.6,1-13,1-2,1-9,2-10,2-4.9,2-43,2-5,2.2-13.3,3-10,3.2-22,3.2-23,axillary,berry,blue,bud,cell,clavate,cm,connivent,coriaceous,covering,dark,deep,forked,glabrescent,glabrous,globose,green,green-white,hair,hair-like,herb,lanceolate,lateral,light,lilac,long,make,medium,mm,moniliform,mucilaginous,odd-pinnate,ovate,ovoid,pentagonal,poricidal,ripe,rotate,seed,short,sometimes,stripe,subglabrous,subtending,terminal,testal,thick,throughout,tip,unwinged,wall,wet,wide,x	capitate,na
28	wfo-0001026208	success	210	127	73	88	122	39	70	3	.5,/3,0.5-1.2,0.6-0.8,0.6-0.9,0.7-2,1-5,1.8-2.3,1.8-2.5,2-3,2-4,2.5-6,5-17,5-22,acuminate,acute,anther,apart,apex,base,berry,bright,brown,calyx,cm,connivent,cuneate,dark,deltate,densely,diameter,dull,erect,evenly,filament,flattened-reniform,flower,fruit,glabrous,green,lateral,leaf,length,lobe,lobed,long,maturity,mauve,midpoint,mm,moderately,orange,orange-brown,pale,pedicel,petiole,poricidal,prickle,prickly,ray,recurved,red,rounded,scar,shrub,sometimes,sparsely,spherical,spreading,stellate,stellate-pubescent,stem,straw-yellow,style,subentire,surface,tapering,terminal,tip,toward,trichome,tube,unarmed,way,white,wide,yellow,young	0-20,0-4,0-5,0-8,0.1,0.1-0.2,0.1-0.25,0.1-0.3,0.5-0.8,0.8-1.3,0.8-1.5,1-2,1-4,1.5,1.5-2.5,1/3,1/3-1/2,1/4-1/3,1/4-1/6,2,2-20,2.5-5,3-30,3-5,3-6,3.5-5,3/,4-7,4-9,5,5-10,5-11-25,5-merous,6-22,6-8,abaxial,abaxially,acut,adaxial,alyx,apar,apically,apparently,articulated,bark,becoming,blade,branched,broad-deltate,chartaceous,conical,curved,difoliate,discolorous,distance,drying,eaf,eed,elliptic,elongated,elongating,equal,extending,flattened,free,fruiting,geminat,geminate,glabrescent,gray-greenish,green-brown,infructescence,longer,lower,margin,mature,membranous,midvein,nflorescence,older,one,open,orolla,oung,ovate,pair,peduncle,pendulous,per,perfec,pericarp,porrect,portion,primary,pubescent,red-brow,ruit,sessile,shorter,side,slender,smooth,somewhat,spaced,stalk,stalked,stout,straight,tamen,terete,tertiary,time,unarme,unit,usually,variously,vary,vein,venation,visible,woody,ympodial	11-25,anthesi,arrangement,bud,coat,colour,connation,corolla,decurrency,dry,embryo,feature,form,growth,height,history,inflorescence,life,minor,new,number,ovary,papilla,perennial,plant,pore,reproduction,seed,shape,size,spacing,specimen,stigma,texture,tuberculation,type,unknown,width,winging	.5,/3,0.5-1.2,0.6-0.8,0.6-0.9,0.7-2,1-5,1.8-2.3,1.8-2.5,2-3,2-4,2.5-6,5-17,5-22,acuminate,acute,apart,apex,base,berry,bright,brown,cm,connivent,cuneate,dark,deltate,densely,diameter,dull,erect,evenly,flattened-reniform,glabrous,green,lateral,lobed,long,maturity,mauve,mm,moderately,orange,orange-brown,pale,poricidal,prickly,recurved,red,rounded,shrub,sometimes,sparsely,spherical,spreading,stellate,stellate-pubescent,straw-yellow,subentire,tapering,terminal,tip,toward,trichome,unarmed,way,white,wide,yellow,young	11-25,perennial,unknown
29	wfo-0001026215	success	150	121	81	96	54	25	77	4	-3,.05,.5,0.5-1,1-3,1.5,1.5-2,1.5-2.2,13-35,15-2,2-3,2-3.5,2-4,3/4,4-15,4-5,7-8,absent,anther,anticlinal,apex,axillary,base,beak,broadly,brown,calyx,cell,clavate,cm,completely,conical,conspicuously,corolla,densely,diameter,elliptic,enlarged,epidermal,erect,filament,flattened-round,flower,fruit,fruiting,glabrous,globose,green,greenish,herb,highly,horizontal,internode,irregular,kink,length,lobed,long,marked,markedly,mm,nearly,occasionally,often,ovary,ovoid-reniform,papillae,papillate,pedicel,petiole,poricidal,portion,projection,purple,raised,red-papillose,rugose,seed,shrub,sinuous,stem,stigma,strongly,style,surface,thickening,tip,tube,usually,way,white,white-lenticellate,white-pubescent,winged,without,x	0,0.05,1,18-20,2,abaxially,abruptly,acuminate,along,anthesi,ape,axil,berry,bifi,continually,deltate,eaf,edicel,eed,entire,exserted,free,less,lobe,lower,minutely,narrowing,nflorescence,noddin,nodding,onto,pair,papillat,per,primary,reflexed,rounded,ruit,scar,shortsympodial,simple,single-stemmed,small,ste,tal,tem,time,tub,ud,unifoliat,unit,vein,wide,wing	abaxial,adaxial,arrangement,bifid,bud,colour,feature,form,growth,height,history,inflorescence,leaf,life,na,number,plant,reproduction,shape,short,size,texture,unifoliate,width,winging	-3,.05,.5,0.5-1,1-3,1.5,1.5-2,1.5-2.2,13-35,15-2,2-3,2-3.5,2-4,3/4,4-15,4-5,7-8,absent,anticlinal,apex,axillary,base,broadly,brown,cell,clavate,cm,completely,conical,conspicuously,densely,elliptic,enlarged,epidermal,erect,flattened-round,glabrous,globose,green,greenish,herb,highly,horizontal,irregular,kink,lobed,long,marked,markedly,mm,nearly,occasionally,often,ovoid-reniform,papillae,papillate,poricidal,portion,projection,purple,raised,red-papillose,rugose,shrub,sinuous,strongly,surface,thickening,tip,usually,way,white,white-lenticellate,white-pubescent,winged,without,x	bifid,na,short,unifoliate
30	wfo-0001026229	success	299	131	90	91	208	40	75	15	1,5,acute,anther,apex,articulated,asymmetric,attenuate-caudate,base,berry,black,brown,calyx,clavate,cm,connivent,corolla,cuneate,cyme,dark,deltoid,densely,developed,drying,elliptic,elongated,flattened,flower,fruit,glabrous,globose,green,growth,hirsute,hispid,immature,inflorescence,internodal,irregular,lanceolate,lateral,leaf,lobe,lobed,long,longitudinal,mature,mm,moderately,narrow-ovate,narrowly,new,oblong,ovate,ovate-elliptic,pale,papillose,pedicel,petiole,pink,pit,pore,poricidal,porrect-stellate,purple,purplish,reniform,rounded,shiny,shrub,simple,size,slightly,slit,small,stellate,stem,stigma,style,subopposite,surface,terminal,tree,trichome,tube,type,unbranched,white,whitish-green,wide,Â¾	0.1â1.47,0.2â0.8,0.35,0.3â0.9,0.3â1.2,0.4,0.8â1.2,0.8â2,0.9,0.9â4.3,1-celled,1.2â4.8,1.3â1.5,1.3â1.7,1.4,1.7â11.8,1.7â2.3,1.8,1.8â5.5,1.9â2.5,1/3,13,1â1.4,1â2,1â4,2,2.3â3.4,2.8â4,2â3,2â3-celled,2â4-celled,3,35,3â4,3â5,4.5â6.5,4â6,5-merou,5â9,6â15,6â7,6â8,8.6â12,8â10,9â31,abaxial,abaxially,accrescent,acuminate,adaxial,adaxiall,adaxially,ag,almost,also,always,alyx,anthesi,ark,associated,axe,ba,barely,beneath,blade,branch,branching,broadly,broken,camptodromous,capitate,celled,central,changing,commentary,commonly,completely,concentrated,cordate,covered,creating,cylindrical,develope,diameter,differing,directed,discolorous,diÂ­,dried,eaf,eed,eglandular,ellipsoidal,entire,even,faces,few-rayed,found,free,frequently,fresh,fully,geminate,glabrescent,gland,glandular,glandular-capitate,golden,hair,head,hyaline,ilament,impressed,included,insertion,introrsely,involute,lamina,larger,less,like,long-stalked,longer,lower,mainly,margin,material,maturit,membranaceous,midpoint,midri,midvein,minute,mixed,much,multangulate,multangulate-stellate,multiseriate,near,nearly,nflorescence,often,old,older,one,open,opening,orientation,orolla,other,oung,pair,paired,peduncle,pedunculate,per,perfect,plurifoliate,point,poorly,portion,primary,pubescent,ra,rachi,raised,rarely,ray,remnant,revolute,ruit,secondary,see,sessile,shin,short-,short-stalked,shorter,smaller,solitary,sometimes,somewhat,sparsely,spread,spreadin,spreading,stalk,strongly,subsessile,supported,surfac,three,trifoliate,tuft,ud,unequal,unit,upper,usually,vary,vein,venation,vestiture,visible,weakly,yellow,yellowish-white,ympodial	0.3-1.2,0.35-4.3,1-1.4,1-2,1.2-4.8,1.7-11.8,1.7-2.3,1.8-5.5,1.9-2.5,2.3-3.4,4.5-6.5,6-15,6-7,age,arrangement,bud,colour,connation,decurrency,feature,filament,form,height,history,length,life,minor,na,number,ovary,papilla,plant,reproduction,seed,shape,texture,tip,width,winging,young	1,5,acute,apex,articulated,asymmetric,attenuate-caudate,base,berry,black,brown,calyx,clavate,cm,connivent,cuneate,cyme,dark,deltoid,densely,developed,drying,elliptic,elongated,flattened,flower,fruit,glabrous,globose,green,hirsute,hispid,immature,internodal,irregular,lanceolate,lateral,lobe,lobed,long,longitudinal,mature,mm,moderately,narrow-ovate,narrowly,oblong,ovate,ovate-elliptic,pale,papillose,pink,pit,poricidal,porrect-stellate,purple,purplish,reniform,rounded,shiny,shrub,simple,slightly,slit,small,stellate,subopposite,terminal,tree,trichome,unbranched,white,whitish-green,wide,Â¾	0.3-1.2,0.35-4.3,1-1.4,1-2,1.2-4.8,1.7-11.8,1.7-2.3,1.8-5.5,1.9-2.5,2.3-3.4,4.5-6.5,6-15,6-7,age,na
31	wfo-0001026230	success	144	124	72	85	59	39	68	4	.25,.5,0.3-1.5,0.5-3,0.9-2,1-1.4,1-1.5,1-4,1.1-1.8,1.9-4.1,12.6-20.8,2-4,2-5,4.6-9.3,acuminate,acute,anisomorphic,anther,anthesi,apart,apex,area,bark,base,berry,broadly,bud,calyx,cm,cordate,corolla,deltoid,distal,elliptic,except,filament,fruit,glabrous,globose,green,grey,large,leaf,lobe,lobed,long-acuminate,long-triangular,minor,minutely,mm,nearly,obtuse,opposite,orbicular,ovary,ovoid,papillose,pedicel,petiole,pore,poricidal,rounded,rusty-papillose,scar,shaped,shrub,simple,slender,slightly,small,stem,stigma,strongly,style,surface,tapering,tear-drop,tip,tree,tube,white,winged,woody,x,young	.8,0.75-1,1.8-2.3,3-4,5-10,5-20-flowered,anisophyllou,apiculate,appears,back,beginning,beneath,clavate,clu,completely,coroll,deflexed,dia,difoliate,eaf,edicel,eed,enclosing,erect,evenly,free,fruiting,geminate,immature,inflorescenc,lateral,lon,long,lower,main,major,margin,middle,nflorescence,older,pair,pointed,portion,raised,reflexed,ruit,sinus,spaced,straight,tall,thickened,ud,umbonate,unit,unknown,vein,white-lenticellat,widest,ympodial	5-20,abaxial,adaxial,arrangement,club,coat,colour,connation,decurrency,dry,feature,flower,form,growth,height,history,inflorescence,length,life,midpoint,na,new,number,papilla,plant,prickle,ray,reproduction,seed,shape,size,spacing,specimen,texture,tuberculation,type,white-lenticellate,width,winging	.25,.5,0.3-1.5,0.5-3,0.9-2,1-1.4,1-1.5,1-4,1.1-1.8,1.9-4.1,12.6-20.8,2-4,2-5,4.6-9.3,acuminate,acute,anisomorphic,apart,area,base,berry,broadly,bud,calyx,cm,cordate,deltoid,distal,elliptic,except,glabrous,globose,green,grey,large,leaf,lobed,long-acuminate,long-triangular,minutely,mm,nearly,obtuse,opposite,orbicular,ovoid,papillose,petiole,poricidal,rounded,rusty-papillose,shaped,shrub,simple,slender,slightly,small,strongly,tapering,tear-drop,tip,tree,tube,white,winged,woody,x,young	5-20,club,na,white-lenticellate
32	wfo-0001026233	success	157	109	52	65	92	44	49	3	0.8-1.55-1.9,0.8-4,1.1,2.1,2.3-7,2.6,3.5-4.5-5.5,5-30-50,6,acute,annual,annular,anther,apex,base,bearing,berry,broadly,calyx,campanulate,capitate,cm,coat,conspicuous,cuneate-attenuate,densely,ellipsoidal,elliptic,embryo,filament,glabrous,globose,herb,herbaceous,leaf,less,lilac,lobe,longitudinal,longitudinally,mm,moderately,narrowly,non-glandular,ovate,petiole,pore,poricidal,protuberance,pubescent,ridged,seed,simple,slit,sparsely,stigma,style,surface,tip,trans-ovoidal,trichome,tube,tuberculate,winged,x	.25,.75,0.3,0.5,0.7-0.8-1,0.7-0.8-1.3,1,1-,1.2-2.7,1.5,1/2,2,2-,2.4-3.5-3.8,2/3,3.2-3.7,3.2-4.7,4-5-6.2-8.1,abundant,accrescent,ag,antrorse,articulated,ascending,basal,curved,cylindrical,diameter,difoliat,dimorphic,eaf,eed,entire,evident,few-,fruiting,hair,hig,interlobular,investing,lamina,larger,lobed,long,lower,margin,membrane,minutely,multicellular,near,obtuse,occasionally,opening,orolla,other,outer,ovule,pale,papery-scarious,partially,pinnatipartite,pinnatisect,portion,present,pubescen,ree,reticulate,rounded,ruit,scarcely,seede,serrate,shorter,slender,slightly,small,smaller,striate,strongly,styl,subglobose,tem,unequal,unifoliate,uniseriate,unit,vary,venatio,verrucose,wider,yellow,ympodial	4-6.2-8.1,age,anthesi,arrangement,bud,colour,connation,corolla,decurrency,dry,feature,flower,form,fruit,growth,height,history,inflorescence,length,life,midpoint,minor,na,new,number,ovary,papilla,pedicel,plant,prickle,ray,reproduction,scar,shape,size,spacing,specimen,stem,texture,tuberculation,type,width,winging,young	0.8-1.55-1.9,0.8-4,1.1,2.1,2.3-7,2.6,3.5-4.5-5.5,5-30-50,6,acute,annual,annular,bearing,berry,broadly,campanulate,capitate,cm,conspicuous,cuneate-attenuate,densely,ellipsoidal,elliptic,glabrous,globose,herb,herbaceous,less,lilac,longitudinal,longitudinally,mm,moderately,narrowly,non-glandular,ovate,poricidal,protuberance,pubescent,ridged,simple,slit,sparsely,tip,trans-ovoidal,trichome,tuberculate,winged,x	4-6.2-8.1,age,na
33	wfo-0001026241	success	220	141	88	92	128	49	72	16	0.5,109,2-flowered,abaxially,anther,anthesi,apex,apical,appearing,appears,articulated,base,basiscopically,beak,berry,black,brown,calyx,campanulate,capitate,cell,cm,cordate,corolla,covered,cup,curving,dehiscing,deltate,densely,depressed-globose,dry,et,extended,filament,flower,fruit,galiano,glandular-pubescent,globose,herb,inflorescence,internodal,leaf,lobe,lobed,longitudinal,mm,oblique,open,orangish,outline,ovary,ovoid,papillate,pedicel,perennial,petiole,pinnatifid,pitted,pore,prolonged,pubescent,pulp,remain,reniform,seed,shallowly,simple,sinuate,slightly,slit,small,somewhat,stellate,stem,stigma,stout,style,subshrub,surface,ternate,testa,thickened,tip,trichome,truncate,tube,tuberculate,uniseriate,white,x	.2,.3,.5,0.1â0.15,0.2â,0.3â,0.3â0.4,0.3â0.6,0.3â1,0.5â0.7,0.5â0.8,0.5â1,0.7â1.1,1-,1-celled,1.2â1.5,1.2â2,1.5â1.7,1.5â2.5,1.5â3.5,1.9â2.1,1/3â1/2,10-20,1â,1â1.1,1â1.4,1â1.5,1â2,2.5â3,2â2.1,2â3,3,3-,30â50,3â3.1,4-,4.5â5,5,5-celled,5-merous,6,adaxially,always,attenuate,ba,basal,branching,brittle,broader,center,conical,connecting,curved,darker,decurrent,deflexe,denser,dia,difoliate,discrete,drying,dwarf,eaf,eglandular,elliptic,enclosed,entire,equal,erect,erose,foliat,foliose,free,fruiting,geminate,glabrous,gland,glandular,intially,irregularly,larger,lateral,leaflet,like,lon,long,main,margin,midvein,mixture,much,near,nflorescence,one,onto,ovate,papillat,peduncle,per,perfect,pericarp,portion,pubescen,rachi,robust,ruit,shiny,smaller,sometimes,spatulate,stamen,strongly,succulent,sulcate,taproot,terminal,thick,tissue,triangular,ud,unit,usually,vein,way,wide,wing,woody,ympodial	0.3-0.5,0.5-0.7,1-1.1,1-1.4,1-2,1-2.5,1-3.5,1.9-2.1,2,3-3.1,30-50,4.5-5,arrangement,bud,coat,colour,connation,decurred,decurrency,deflexed,feature,form,growth,height,history,initially,length,life,midpoint,minor,na,new,number,papilla,plant,prickle,ray,reproduction,scar,shape,size,spacing,specimen,texture,tuberculation,type,width,winging,young	0.5,109,2-flowered,abaxially,apical,appearing,appears,articulated,base,basiscopically,beak,berry,black,brown,campanulate,capitate,cell,cm,cordate,covered,cup,curving,dehiscing,deltate,densely,depressed-globose,dry,et,extended,fruit,galiano,glandular-pubescent,globose,herb,internodal,lobed,longitudinal,mm,oblique,open,orangish,outline,ovoid,papillate,perennial,pinnatifid,pitted,pore,prolonged,pubescent,pulp,remain,reniform,shallowly,simple,sinuate,slightly,slit,small,somewhat,stellate,stout,subshrub,ternate,testa,thickened,trichome,truncate,tuberculate,uniseriate,white,x	0.3-0.5,0.5-0.7,1-1.1,1-1.4,1-2,1-2.5,1-3.5,1.9-2.1,2,3-3.1,30-50,4.5-5,decurred,deflexed,initially,na
34	wfo-0001026242	success	205	121	74	89	116	32	71	3	/4,0.4-0.5,0.4-2,0.5-0.7,0.5-1,0.55-0.9,0.7-1.3,1-1.5,1-2.5,1.2-2,1.5-3,1.5-4,1/2,10-20,2-2.5,2.5-2.8,3-6.5,7-17,acute,anther,apart,apex,apically,bark,base,berry,branched,bright,calyx,cm,connivent,cuneate,deltate,densely,diameter,dull,erect,evenly,filament,flattened-reniform,flower,fruit,glabrescent,glandular,green,hair,lateral,leaf,length,lobe,lobed,long,maturity,minute,mm,moderately,narrow-deltate,obtuse,orange-brown,pedicel,petiole,poricidal,prickle,prickly,recurved,red,reflexed,scar,shrub,smooth,sometimes,sparsely,spherical,spreading,stellate-pubescent,stem,style,subentire,surface,tapering,terete,tip,tube,upper,way,white,wide,yellow,young	-1.5,-6,0,0-2,0-5,0.05-0.2,0.1,0.3-0.5,0.35-0.4-0.55-0.9,0.5,0.7,1-3,1/5-1/3,1/6-1/4,10-30-80,2-5,2.5-4.5,4-10,4-13,4-5-merous,4.5-5.5,5-18,5-7,5-8-20,6.5-8,abaxial,abaxially,acut,almost,alyx,ame,apar,apparently,articulated,blade,broad-deltate,c.,concolorous,curved,difoliate,distance,drying,eaf,eed,elliptic,elongating,equal,extending,eye,filiform,flattened,free,fruiting,geminat,glabrou,glabrous,green-gra,infructescence,irregularly,largely,longer,lower,margin,mature,membranous,midpoint,midvein,multangulate,naked,nflorescence,occasionally,older,one,open,orolla,oung,pair,pale,pale-brown,peduncle,per,perfec,pericarp,porrect,portion,prickl,primary,ray,red-brown,rounded,ruit,sessile,shorte,shorter,side,simple,spaced,stalk,stalked,stellate,straight,tamen,tertiary,time,trichome,unarme,unarmed,unit,variously,vary,vein,venation,visible,weakly,woody,ympodial	0.35-0.55-0.9,arrangement,bud,coat,colour,connation,corolla,decurrency,embryo,feature,form,green-gray,growth,height,inflorescence,minor,na,number,ovary,papilla,plant,pore,seed,shape,size,spacing,stigma,texture,tuberculation,type,width,winging	/4,0.4-0.5,0.4-2,0.5-0.7,0.5-1,0.55-0.9,0.7-1.3,1-1.5,1-2.5,1.2-2,1.5-3,1.5-4,1/2,10-20,2-2.5,2.5-2.8,3-6.5,7-17,acute,apart,apically,base,berry,branched,bright,cm,connivent,cuneate,deltate,densely,diameter,dull,erect,evenly,flattened-reniform,glabrescent,glandular,green,hair,lateral,lobed,long,maturity,minute,mm,moderately,narrow-deltate,obtuse,orange-brown,poricidal,prickly,recurved,red,reflexed,shrub,smooth,sometimes,sparsely,spherical,spreading,stellate-pubescent,subentire,tapering,terete,tip,upper,way,white,wide,yellow,young	0.35-0.55-0.9,green-gray,na
35	wfo-0001026259	success	233	155	104	119	114	36	100	4	.1,.7,0.3â1.2,0404,0â2,1.0â1.2,1.2â8.4,1.4â4.0,1.5,1m,1â2-celled,1â3-celled,2/3,2â17,2â3-celled,4â5,5â14,6,?,acuminate,acute,affected,age,anther,anthesi,apex,appressed,base,becoming,berry,broadly,brown,calyx,central,cm,concave-reniform,conical-ellipsoid,corolla,cream-coloured,decurrent,deltate,diameter,ellipsoid,end,et,filament,flower,fruit,glabrous,globose,green,green-orange,herb,inflorescence,internodal,knapp,lateral,leaf,length,lengthening,lilac,live,lobe,long,minutely,mm,much,narrower,narrowly,nearly,occasionally,once-branched,one,ovary,ovate-lanceolate,pale,papillate,pathogen,pedicel,petiole,plant,pore,poricidal,pubescent,purple-black,purple-coloured,rarely,recurving,reduced,reflexed,ripe,rounded,scar,shrub,simple,slit,sparsely,spreading,star,stellate,stem,stigma,straight,style,surface,tip,translucent,trichome,tube,turning,uniseriate,white,wide,winged,woody,yellow,yellow-green,young,â15	.8,0.1â0.2,0.2â0.4,0.4â0.6,0.5,0.5â0.6,0.7â0.9,1,1-celled,1.0â3.3,1.5â2.0,11â22,12â24,1â2,2-ridged,3.0â3.4,35â45,5-merous,5â7-celled,7â10,8â11,abaxial,abaxially,adaxial,adaxially,apar,arising,beyond,branch,branched,branching,cell,close,coloured,cone,congested,cylindrical,dehiscing,densely,difoliate,drop,eaf,eed,elongating,entire,especially,exerted,fleshy,free,fruiting,geminat,gradually,growt,halfway,hilum,individual,larger,leave,less,like,lobed,lon,longer,lower,lowermost,margin,membranous,near,nflorescence,node,often,outline,pair,peduncle,pentagonal,per,perfect,pericarp,portion,positioned,primary,purple,rachi,relatively,remaining,ruit,shiny,short,shorter,similar,slightly,smooth,sometimes,somewhat,spaced,splitting,stone,stout,strongly,sub-laterally,tall,tapering,tem,testal,thick,tightly,tinged,together,toward,two,ud,unit,vein,ympodial	apart,arrangement,bud,coat,colour,connation,decument,decurrency,dry,embryo,feature,form,growth,height,history,life,midpoint,minor,na,new,number,papilla,prickle,ray,reproduction,seed,shape,size,spacing,specimen,texture,tuberculation,type,width,winging,â11	.1,.7,0.3â1.2,0404,0â2,1.0â1.2,1.2â8.4,1.4â4.0,1.5,1m,1â2-celled,1â3-celled,2/3,2â17,2â3-celled,4â5,5â14,6,?,acuminate,acute,affected,age,anthesi,apex,appressed,base,becoming,berry,broadly,brown,central,cm,concave-reniform,conical-ellipsoid,cream-coloured,decurrent,deltate,diameter,ellipsoid,end,et,fruit,glabrous,globose,green,green-orange,herb,internodal,knapp,lateral,lengthening,lilac,live,long,minutely,mm,much,narrower,narrowly,nearly,occasionally,once-branched,one,ovate-lanceolate,pale,papillate,pathogen,petiole,plant,poricidal,pubescent,purple-black,purple-coloured,rarely,recurving,reduced,reflexed,ripe,rounded,shrub,simple,slit,sparsely,spreading,star,stellate,straight,tip,translucent,trichome,turning,uniseriate,white,wide,winged,woody,yellow,yellow-green,â15	apart,decument,na,â11
36	wfo-0001026267	success	162	125	70	86	76	39	65	5	0.5-1,0.6-1.7,0.7-1.1,1-1.2,1-2.6,1-4,1.5-2,2.5-3,3-15,3-6.1,3.2-8.6,4-8,5-7,8.5-15,acuminate,acute,anther,anthesi,apex,attenuate,bark,base,berry,blackish,bright,broadly,calyx,closely,cm,corolla,crateriform,cuneate,deflexed,drying,filament,flattened-reniform,glabrous,globose,green,greenish-white,leaf,lobe,lobed,minor,minutely,mm,narrowly,nearly,occasionally,opposite,ovary,ovate,overlapping,papillose,pedicel,petiole,pitted,pore,poricidal,ripening,rough,scar,scattered,shaped,shrub,simple,size,slightly,small,spaced,stem,stigma,style,surface,tear-drop,tip,tree,triangular,trichome,tube,uniseriate,white,woody,x,yellow-green,young	.25,.5,0.1-1,1-1.5,1.5-2.3,20-30-flowered,8-10,axil,ba,beginning,beneath,body,decurrent,densely,depressed,dia,differing,difoliate,distally,distinct,eaf,edicel,eed,except,exerted,free,fruiting,geminat,greyish-green,hard,incrassate,inflorescenc,larger,lateral,lavender,lon,long,longinflorescence,lower,main,major,margin,maturity,middle,often,older,one,pair,pale,papillo,pitting,portion,pubescent,quickly,raised,reflexed,remaining,ruit,scarious,slender,softening,soon,sparsely,straight,tall,tan,tapering,tinge,tuft,ud,unit,vein,widest,wing,winged,ympodial	0.25,0.5,1,20-30,arrangement,bud,coat,colour,connation,decurrency,dry,embryo,feature,flower,form,fruit,growth,height,history,inflorescence,length,life,midpoint,na,number,papilla,plant,prickle,ray,reproduction,seed,shape,spacing,specimen,texture,tuberculation,type,width,winging	0.5-1,0.6-1.7,0.7-1.1,1-1.2,1-2.6,1-4,1.5-2,2.5-3,3-15,3-6.1,3.2-8.6,4-8,5-7,8.5-15,acuminate,acute,attenuate,base,berry,blackish,bright,broadly,closely,cm,crateriform,cuneate,deflexed,drying,flattened-reniform,glabrous,globose,green,greenish-white,leaf,lobed,minutely,mm,narrowly,nearly,occasionally,opposite,ovate,overlapping,papillose,pitted,poricidal,ripening,rough,scattered,shaped,shrub,simple,slightly,small,spaced,tear-drop,tip,tree,triangular,trichome,uniseriate,white,woody,x,yellow-green	0.25,0.5,1,20-30,na
37	wfo-0001026279	success	244	155	100	115	129	40	95	5	0.2-0.4,0.8-2.3,0.9-1,1-10,1-3.5,1.1-1.6,1.5-1.8,1.9-3.2,14-27,2.5-3.2,2.6-4.8,3-4,3.4-5.2-5.9,3.5-7.8,4-7.5,5-200,8,9-22,acuminate,anther,anthesi,apart,apex,appressed,around,axe,base,berry,black,blunt-tipped,branched,brown,bud,calyx,capitate,cm,corolla,dark,deltoid,dendritic-echinoid,diameter,drying,echinoid,edge,elliptic,elongated,farinose,filament,fleshy,flower,free,fruit,glabrescent,globose,granular,grayish,grayish-green,green,hair,immature,lanceolate,lavender,leaf,length,lengthening,lilac,lobe,longitudinal,many,mature,minute,mm,multangulate,oblong,obovate,occasionally,orbicular,ovate-lanceolate,pale,pedicel,petiole,plant,pore,poricidal,porrect-stellate,pseudo-terminal,reticulate-punctate,rounded,scabridulous,scabrous,sessile,shrub,simple,slit,slowly,stellate,stem,stigma,style,subcampanulate,suborbicular,surface,time,tip,tomentose-pubescent,tree,tube,unarmed,unwinged,white,whitish,x,yellow,yellowish,young	-4,/14-1/8,0.25-0.4,0.9-1.8-2.9,1-1.4,1.1-1.9,1.5-3,1.7-2.3,1.9-3,1/2,11.5-19.7-34.3,2.4-3.2,2/3,3.1-3.6,3.1-4.2,3.8-5.1,5-8,8-11,8.5-10.5-11.4,abaxially,accrescent,acute,adaxiall,adaxially,ag,apparently,appearing,ark,articulated,attenuate,axillary,ba,blade,branch,chartaceous,closely,completely,conical,covering,cuneate,cylindrical,dendritic-echinoi,dense,directed,distally,due,eaf,earl,echinoi,eed,entire,enveloping,equal,evident,exerted,expanded,few-rayed,fruiting,glabrescen,glabrous,half,inserted,lateral,lobed,long,long-stalked,longer,longitudinall,lower,m.,main,margin,midrib,mixed,multangulate-pubescent,multiseriate,narrowly,nflorescence,occasional,often,older,open,orolla,overlapping,partly,peduncle,perfect,plurifoliate,present,prominent,pubescence,rachi,ruit,scattered,secondary,semi-ovate,short,short-,short-decurrent,short-stalked,side,slightly,somewhat,spaced,splitting,stalk,stamen,subcoriaceous,subsessile,sulcate,suture,tall,tamen,tertiary,thickened,thin,thin-stalked,tomentose,ud,unarme,unit,upper,usually,vary,vein,way,wide,yellowish-tan,ympodial	abaxial,adaxial,age,arrangement,bark,coat,colour,connation,dry,embryo,feature,form,growth,height,history,inflorescence,life,longitudinally,midpoint,minor,na,number,ovary,papilla,perennial,prickle,ray,reproduction,scar,seed,shape,size,spacing,specimen,texture,tuberculation,type,unknown,width,winging	0.2-0.4,0.8-2.3,0.9-1,1-10,1-3.5,1.1-1.6,1.5-1.8,1.9-3.2,14-27,2.5-3.2,2.6-4.8,3-4,3.4-5.2-5.9,3.5-7.8,4-7.5,5-200,8,9-22,acuminate,apart,apex,appressed,around,axe,berry,black,blunt-tipped,branched,brown,capitate,cm,dark,deltoid,dendritic-echinoid,diameter,drying,echinoid,edge,elliptic,elongated,farinose,fleshy,flower,free,fruit,glabrescent,globose,granular,grayish,grayish-green,green,hair,immature,lanceolate,lavender,lengthening,lilac,longitudinal,many,mature,minute,mm,multangulate,oblong,obovate,occasionally,orbicular,ovate-lanceolate,pale,poricidal,porrect-stellate,pseudo-terminal,reticulate-punctate,rounded,scabridulous,scabrous,sessile,shrub,simple,slit,slowly,stellate,subcampanulate,suborbicular,time,tip,tomentose-pubescent,tree,unarmed,unwinged,white,whitish,x,yellow,yellowish	age,longitudinally,na,perennial,unknown
38	wfo-0001026299	success	236	142	96	110	126	32	92	4	-10,0.1-0.5,0.15-0.2,0.2-1,0.25-0.5,0.4-0.5,0.5,0.5-0.6-0.8,0.5-0.7,0.5-2.5-3.5,0.8-1,1,1-1.4,1.1-1.7,2-locular,2.2-3.2,2.5-7,5-20,6-20,7-12,acute,along,anther,apex,articulated,base,basiscopically,broadly,brown,calyx,capitate,cell,change,cm,conical,corolla,could,dark,decurrent,densely,diameter,distal,elliptic,filament,flower,fruit,glabrous,glandular,globose,green,hair-like,half,herb,imparipinnate,inflorescence,interrupted,lacking,lanceolate,lateral,leaf,lobe,long,long-acuminate,longer,margin,maturity,middle,minute,minutely,mixture,mm,narrowly,oblique,obovate,outgrowth,ovary,pale,patent,pedicel,pentagonal,perennial,petiole,population,pubescent,purple,short,simple,size,sparsely,stem,stigma,stout,straight,stripe,style,surface,testa,tip,trichome,truncate,tube,uniseriate,variously,vein,velvety,wall,white,wide,winged,yellow	--,-2.5,.5,0-8,0.1-0.2,0.1-0.2-1,0.1-0.25,0.1-0.4,0.1-0.4-1,0.2-0.25,0.3-0.4,0.4-2,0.5-0.6,0.5-1,0.6-2,0.7-3.5-5,0.8-0.9,0.9-1,1-celled,1.2-1.6,1.2-5,1.5-2.3,1.5-3.5-10,1.8-2,2-4,2-6,2-foliate,2.5,25,3-5-15,5,abaxially,absent,abundant,acroscopically,adaxially,almost,angled,anthesi,apical,appearance,appendage,approximately,axi,basal,beneath,berr,bract,bracteate,chota,column,crenat,crenate-serrate,developed,diamete,eaf,ebracteate,edicel,eed,eglandular,entire,erect,exserted,fruiting,give,gree,hal,head,interjected,intermixed,internode,investing,irregularly,jequetepeque,larger,leaflet,less,like,lobed,lon,loosely,lower,maraÃ±Ã³n,multicellular,nearly,nflorescence,node,occasionally,often,pair,peduncle,petiolule,present,primary,prostrate,pseudostipule,pubescence,rachi,reflexed,regularly,rest,ruit,scarcely,scattered,secondary,sessile,silky,sparse,spreading,staminal,sterile,tall,tem,terminal,tertiary,thick,toward,ud,unicellular,unit,usually,valley,way,weak-walled,woody,ympodial	3-15-25,abaxial,adaxial,alternate,arrangement,berry,bud,colour,connation,decurrency,feature,form,growth,height,history,length,life,minor,na,new,number,papilla,plant,pore,reproduction,seed,shape,texture,type,width,winging,young	-10,0.1-0.5,0.15-0.2,0.2-1,0.25-0.5,0.4-0.5,0.5,0.5-0.6-0.8,0.5-0.7,0.5-2.5-3.5,0.8-1,1,1-1.4,1.1-1.7,2-locular,2.2-3.2,2.5-7,5-20,6-20,7-12,acute,along,apex,articulated,base,basiscopically,broadly,brown,capitate,cell,change,cm,conical,could,dark,decurrent,densely,distal,elliptic,glabrous,glandular,globose,green,hair-like,half,herb,imparipinnate,interrupted,lacking,lanceolate,lateral,lobe,long,long-acuminate,longer,margin,maturity,middle,minute,minutely,mixture,mm,narrowly,oblique,obovate,outgrowth,pale,patent,pentagonal,perennial,population,pubescent,purple,short,simple,sparsely,stout,straight,stripe,testa,tip,trichome,truncate,uniseriate,variously,vein,velvety,wall,white,wide,winged,yellow	3-15-25,alternate,berry,na
39	wfo-0001026305	success	135	124	70	83	52	41	65	5	.25,/4,0.2-1,0.25-0.5,0.5-2,0.6-1,0.7-1,1-1.5,1.3-1.5,2.5-3,3-8.5,4-4.5,5-7,7-16,acute,anther,anthesi,apex,apical,area,attenuate,bark,base,beige-tan,berry,calyx,closely,cm,conical,corolla,deflexed,deltate,dendritic,densely,dia,difoliate,elliptic,filament,glabrate,glabrous,globose,green,greenish-white,knob-like,leaf,leaf-opposed,lobe,lobed,long,minute,minutely,mm,occasionally,ovary,ovoid-reniform,papillose,pedicel,petiole,pitted,pore,poricidal,projection,pubescent,rounded,scar,shaped,shrub,simple,slender,spaced,stem,stigma,style,surface,tear-drop,tip,trichome,tube,unifoliate,way,woody,x,young	2-2.5,2-6-flowered,6-9,7-9,abaxial,abaxially,adaxially,along,ba,congested,dark,drying,eaf,edicel,eed,exserted,free,fruiting,geminat,interlocking,lamina,lateral,like,lon,lower,main,margin,middle,midrib,nflorescence,older,overlappin,pair,pale,planar,portion,reddish-brow,ruit,scattered,shining,sparsely,strongly,styl,tall,tan,tub,ud,unit,vein,visible,widest,ympodial	2-6,arrangement,bud,coat,colour,connation,decurrency,dry,feature,flower,form,fruit,geminate,growth,height,history,inflorescence,length,life,midpoint,minor,na,new,number,overlapping,papilla,plant,prickle,ray,reddish-brown,reproduction,seed,shape,size,spacing,specimen,texture,tuberculation,type,width,winging	.25,/4,0.2-1,0.25-0.5,0.5-2,0.6-1,0.7-1,1-1.5,1.3-1.5,2.5-3,3-8.5,4-4.5,5-7,7-16,acute,apical,area,attenuate,base,beige-tan,berry,closely,cm,conical,deflexed,deltate,dendritic,densely,dia,difoliate,elliptic,glabrate,glabrous,globose,green,greenish-white,knob-like,leaf-opposed,lobed,long,minute,minutely,mm,occasionally,ovoid-reniform,papillose,pitted,pore,poricidal,projection,pubescent,rounded,shaped,shrub,simple,slender,spaced,style,tear-drop,tip,trichome,unifoliate,way,woody,x	2-6,geminate,na,overlapping,reddish-brown
40	wfo-0001026307	success	193	120	70	80	113	40	55	15	0.6,9,abaxial,acute,acute-acuminate,adaxial,age,anther,anthesi,apex,base,berry,black,broadly,calyx,central,clavate,cm,corolla,cuneate,cylindrical,decurrent,densely,ellipsoid,eye,filament,flattened-reniform,flower,fruit,glabrous,glandular,globose,green,growth,herb,internodal,lateral,length,lengthening,lobe,long,minutely,mm,new,ovary,ovate,paler,pedicel,petiole,pore,poricidal,pubescent,purple,purple-yellow,reflexed,ripe,scar,shallow,shape,shrub,simple,slit,sparsely,spreading,stellate,stem,stigma,straight,strongly,style,surface,tinged,tip,trichome,tube,turning,vigorous,white,wide,yellow-green	.0â1.2,.3,.5,.5â4.0,.6,.8,0.2â0.5,0.2â1.5,0.4,0.5â0.6,0.5â0.7,0.5â5.0,0.8â0.9,0.8â2,0.8â5,1.0â1.2,1.0â1.5,1.0â2.0,1.0â2.4,1.0â2.5,1â3-celled,1â6-celled,2.0,2.0â3.0,2.0â3.5,2.6â13,2/3,3.0â4.0,3.5â7.0,35â45,3â8,3â8-celled,4â5.7,5-merous,5â7,8â12,abaxially,adaxially,angled,apar,appressed,articulated,becoming,beyond,cell,cone,diameter,difoliate,eaf,eed,end,entire,exerted,facing,free,fruiting,geminat,gradually,hilum,later,like,lobed,longer,lower,margin,membranous,middle,narrower,narrowing,nflorescence,one,outline,pair,papillat,peduncle,pentagonal,per,perfect,portion,positioned,primary,recurved,reflexe,restricted,ruit,shallowly,shorter,side,slightly,spaced,ste,stone,sub-laterally,tal,tem,testal,three,toward,translucent,triangular,two,ud,undulate,unequal,unevenly,uniseriate,unit,upper,variable,vein,weak-stemmed,yellow,ympodial	0.2-1.5,0.5-0.7,0.5-5.0,0.8,0.8-5,1.0-1.2,1.0-1.5,1.0-2.5,2.0-3.5,2.6-13,3-8,3.5-7.0,4-5.7,arrangement,bud,colour,embryo,feature,form,height,history,inflorescence,leaf,life,midpoint,na,number,papilla,papillate,plant,prickle,ray,reproduction,seed,size,spacing,texture,type,width,young	0.6,9,acute,acute-acuminate,age,anthesi,berry,black,broadly,central,clavate,cm,cuneate,cylindrical,decurrent,densely,ellipsoid,eye,flattened-reniform,glabrous,glandular,globose,green,herb,internodal,lateral,lengthening,long,minutely,mm,ovate,paler,poricidal,pubescent,purple,purple-yellow,reflexed,ripe,shallow,shrub,simple,slit,sparsely,spreading,stellate,straight,strongly,tinged,tip,trichome,turning,vigorous,white,wide,yellow-green	0.2-1.5,0.5-0.7,0.5-5.0,0.8,0.8-5,1.0-1.2,1.0-1.5,1.0-2.5,2.0-3.5,2.6-13,3-8,3.5-7.0,4-5.7,na,papillate
41	wfo-0001026317	success	167	130	81	94	73	36	76	5	/4,0.25-1,0.3-1.2,0.5,0.5-0.6,0.5-0.8,0.5-1,2-2.5,2-3-foliate,2.5-10,3,3-3.5,4-5,50-200,6x,acuminate,acute,age,anther,anthesi,apart,apex,attenuate,bark,base,berry,branched,bright,brown,calyx,capitate,clonal,closely,cm,conical,corolla,dark,deltate,dendritic,densely,diameter,distally,erect,flattened,flower,glabrous,globose,growth,inflorescence,internodal,lengthening,less,lobe,lobed,many,minutely,mm,new,nodding,orange,ovary,packed,papillate,pedicel,petiole,pitted,plant,poricidal,pubescent,red,reniform,scar,shiny,shrub,simple,slit,sparsely,stem,stigma,style,surface,terminal,time,tip,toward,trichome,tube,uniseriate,unit,way,white,woody,x,yellowish	.5,0.6-1-5.7,0.7-0.9,0.8-1,1-1.2,1-1.5,10-12,2-3.5-15,2-4,6-8,?,abaxially,absent,adaxially,apically,approximately,correlated,dense,drying,eaf,eed,elliptic,em,entire,erec,essentially,exerted,extremely,filament,found,free,fruiting,geminat,halfwa,lamina,like,longer,lower,margin,maturity,narrowly,nflorescence,occasionally,often,pair,pale,papillat,peduncle,per,perfect,pericarp,planar,plane,population,pore,portion,primary,pubescen,pubescence,pulp,rachi,reflexed,ruit,slightly,sticky,straight,swollen,thin,triangular,ud,variable,vein,ympodial	0.6-5.7,2,2.5-15,abaxial,adaxial,arrangement,bud,coat,colour,connation,dry,feature,form,fruit,height,history,leaf,length,life,midpoint,number,papilla,prickle,ray,reproduction,seed,shape,size,spacing,specimen,sympodial,texture,tuberculation,type,unknown,width	/4,0.25-1,0.3-1.2,0.5,0.5-0.6,0.5-0.8,0.5-1,2-2.5,2-3-foliate,2.5-10,3,3-3.5,4-5,50-200,6x,acuminate,acute,age,anthesi,apart,apex,attenuate,base,berry,branched,bright,brown,capitate,clonal,closely,cm,conical,dark,deltate,dendritic,densely,diameter,distally,erect,flattened,glabrous,globose,inflorescence,internodal,lengthening,less,lobed,many,minutely,mm,nodding,orange,packed,papillate,pitted,poricidal,pubescent,red,reniform,shiny,shrub,simple,slit,sparsely,terminal,time,tip,toward,trichome,uniseriate,unit,way,white,woody,x,yellowish	0.6-5.7,2,2.5-15,sympodial,unknown
42	wfo-0001026335	success	157	113	72	84	73	29	69	3	0.1-0.3,0.25-0.5,0.5-1,0.8-1.3,1-1.5,1-2,1-4,1.5-2,10-20,10-30,2,2-3,2-4,2-7.5,3-18,3-5,5-15,5-7,7-8,acuminate,anther,apart,apex,base,branched,calyx,chartaceous,cm,cuneate,curved,cylindrical,dense,densely,directed,distally,entire,flattened,flower,forked,fruit,glabrescent,glabrous,glandular,hair,lanceolate,large,leaf,leaf-opposed,like,lobe,long,longitudinal,margin,midpoint,mm,moderately,multangulate,oblong,often,opening,pedicel,petiole,pore,pubescence,pubescent,reticulate,rounded,sessile,shrub,simple,slit,stellate,stem,stigma,straight,style,surface,tip,tube,usually,white,whitish,x,yellowish	.5,.5-3.5,0.6-1,1,1-3,1.5-4,4-5,5-,abaxially,accrescent,acute,adaxiall,adaxially,ag,apparently,articulated,axe,ba,blade,capitat,connivent,covering,deltate,diameter,eaf,eed,elliptic,elliptic-ovate,equal,erect,especially,filament,frui,fruiting,geminate,glandula,globose,green,held,lower,many-foliate,much,nflorescence,orolla,paired,peduncle,perfect,probably,rachi,ray,ripe,ruit,scattered,slightly,smaller,sometimes,spaced,ste,stellate-pubescent,subtending,tal,tamen,tem,time,toward,unit,unripe,uprigh,vary,vein,wide,yellow,ympodial	abaxial,adaxial,age,arrangement,capitate,coat,colour,corolla,embryo,feature,form,growth,height,inflorescence,length,na,number,ovary,papilla,plant,seed,shape,size,spacing,texture,tuberculation,type,width,young	0.1-0.3,0.25-0.5,0.5-1,0.8-1.3,1-1.5,1-2,1-4,1.5-2,10-20,10-30,2,2-3,2-4,2-7.5,3-18,3-5,5-15,5-7,7-8,acuminate,apart,branched,chartaceous,cm,cuneate,curved,cylindrical,dense,densely,directed,distally,entire,flattened,flower,forked,fruit,glabrescent,glabrous,glandular,hair,lanceolate,large,leaf-opposed,like,long,longitudinal,midpoint,mm,moderately,multangulate,oblong,often,opening,pubescence,pubescent,reticulate,rounded,sessile,shrub,simple,slit,stellate,stem,straight,usually,white,whitish,x,yellowish	age,capitate,na
43	wfo-0001026343	success	218	142	87	105	113	37	85	2	-4,-7,.5,/5,0-2,0-5,0.05-0.5,0.45-1,0.5-1.5,1-4,1.3-1.7,1.5-2.5-3.5,1.8-2.2,1.8-3,1/3,10-30,2-3,2-4,2-6,2-8,2.2-3.2,2.5-8,3.5-4.5,5-10,5.5-9,acute,anther,apart,apex,apparently,articulated,bark,base,berry,broadly,calyx,cm,connivent,cream,cuneate,curved,dark,densely,diameter,dull,erect,filament,flattened,flattened-reniform,flower,fruit,glabrescent,green,lateral,leaf,length,lobe,lobed,long,lower,marking,maturity,mauve,midpoint,mm,moderately,multangulate,narrow-deltate,orange,orange-brown,pale,pedicel,petiole,plant,poricidal,porrect,prickle,prickly,purple,ray,reddish,rounded,scar,shrub,small,sparsely,spherical,spreading,stalked,stellate-pubescent,stem,style,surface,tapering,terete,tip,tree,trichome,tube,upper,variously,way,wide,yellow,young	-15,/2,0-1,0-10,0-4,0-40,0.05-0.2,0.1-0.2,0.15,0.2,0.2-0.3,0.2-0.7-1.5,0.3,0.5,0.8-1.5,1-2,1-3,1.5-2,1/,1/4-2/3,1/5,2-3.2,2-5,3-4,3-5,5-merous,6-9,7-12,7-14,7-8,7-9,abaxial,abaxially,acuminat,adaxial,alyx,andromonoecious,apar,apically,blade,branched,brow,chartaceous,concolorous,deltate,distal,distance,drying,eed,elliptic,elongating,equal,extending,faint,free,fruiting,glabrous,green-brown,hermaphrodite,heterostylous,infructescence,less,lobing,lon,long-styled,longer,lowermost,margin,mature,midvein,nflorescence,obtuse,older,one,open,orolla,oung,ovate,pair,peduncle,pendulous,per,pericarp,plurifoliat,portion,prickl,primary,reduced,reflexed,ruit,secondary,sessile,short-styled,side,smooth,sometimes,spaced,stalk,staminat,stellate,stout,tamen,tertiary,time,unarmed,unit,vary,vein,venation,visible,weakly,woody,ympodial	anthesi,arrangement,brown,bud,coat,colour,connation,corolla,decurrency,dry,embryo,feature,form,growth,height,history,inflorescence,life,minor,na,new,number,ovary,papilla,pore,reproduction,seed,shape,size,spacing,specimen,stigma,texture,tuberculation,type,width,winging	-4,-7,.5,/5,0-2,0-5,0.05-0.5,0.45-1,0.5-1.5,1-4,1.3-1.7,1.5-2.5-3.5,1.8-2.2,1.8-3,1/3,10-30,2-3,2-4,2-6,2-8,2.2-3.2,2.5-8,3.5-4.5,5-10,5.5-9,acute,apart,apparently,articulated,base,berry,broadly,cm,connivent,cream,cuneate,curved,dark,densely,diameter,dull,erect,flattened,flattened-reniform,glabrescent,green,lateral,lobed,long,lower,marking,maturity,mauve,mm,moderately,multangulate,narrow-deltate,orange,orange-brown,pale,poricidal,porrect,prickle,prickly,purple,reddish,rounded,shrub,small,sparsely,spherical,spreading,stalked,stellate-pubescent,tapering,terete,tip,tree,trichome,upper,variously,way,wide,yellow,young	brown,na
44	wfo-0001026352	success	207	118	62	83	124	35	60	2	.3,.5,0.5,0.5-0.8,0.6-1.5-4.6,0.7-2,1-10,1-3.5-9,1.5-2,12-60,3-15,5-6,<,acuminate,acute,anther,anthesi,antrorsely,apart,apex,base,berry,blue,broadly,calyx,capitate-truncate,cm,conical,cordate,corolla,curved,deltate,densely,discolorous,ellipsoid,filament,flower,glabrous,globose,green,growth,inflorescence,leafy,length,lengthening,lobe,minutely,mm,narrowly,new,outline,ovate,pale,pedicel,petiole,pink,pore,poricidal,pubescent,scar,shallowly,shoot,short,simple,slit,specimen,stellate,stem,stigma,strongly,style,surface,terminal,tip,trichome,truncate,tube,uniseriate,unspecified,vine,white,woody,yellowish	0.5-1,0.5-1.5,0.5-3,0.9-1,1-1.5,1-2-celled,1.2-1.7,1.5,10+,2,2-3-celled,4-4.5,5-merou,6-7,7-9,?,abaxially,adaxiall,ag,almost,alyx,angle,apparently,appearance,arising,articulated,articulation,axi,bark,basal,bending,branch,branching,brown,cell,chartaceous,deciduous,denser,diameter,eaf,eed,entire,evenly,eventually,expanded,exserted,few-celled,flattened,free,fruiting,giving,greenish,half,heigh,herbarium,ilament,immature,impressed,inflorescenc,irregularly,junction,lamina,large,largest,leave,leaving,like,lobed,long,lower,many,margin,mature,membranous,near,nearly,nflorescence,older,orolla,pair,papillate,papillo,peduncle,peg,per,perfect,pericarp,plurifoliat,point,portion,primary,principal,rachi,reflexed,reniform,rest,revolute,right,ruit,seen,shiny,sleeve,small,spaced,sparser,spreadin,spreading,straw-colored,tem,thin,third,time,tub,tuberculate,ud,unit,upper,vary,vein,violet,weak,wide,widest,ympodial	age,arrangement,bud,coat,colour,connation,decurrency,dry,feature,form,fruit,height,history,leaf,life,midpoint,minor,number,ovary,papilla,papillose,plant,prickle,ray,reproduction,seed,shape,size,spacing,texture,tuberculation,type,width,winging,young	.3,.5,0.5,0.5-0.8,0.6-1.5-4.6,0.7-2,1-10,1-3.5-9,1.5-2,12-60,3-15,5-6,<,acuminate,acute,antrorsely,apart,berry,blue,broadly,capitate-truncate,cm,conical,cordate,curved,deltate,densely,discolorous,ellipsoid,glabrous,globose,green,leafy,lengthening,minutely,mm,narrowly,outline,ovate,pale,pink,poricidal,pubescent,shallowly,shoot,short,simple,slit,stellate,strongly,terminal,tip,trichome,truncate,uniseriate,unspecified,vine,white,woody,yellowish	age,papillose
45	wfo-0001026352	success	212	100	60	77	135	23	56	4	.3,.5,0.5,0.5-0.8,0.7-2,1-10,1.5-2,12-60,3-15,5-6,<,anther,antrorsely,apart,berry,blue,broadly,brown,calyx,capitate-truncate,cm,conical,corolla,curved,deltate,densely,ellipsoid,evenly,filament,flattened-reniform,flower,form,glabrous,globose,green,greenish,growth,inflorescence,leaf,leafy,length,lengthening,lobe,minutely,mm,narrowly,new,ovate,pale,pedicel,petiole,pink,pore,poricidal,pubescent,scar,shiny,shoot,short,simple,slit,stellate,stem,stigma,style,surface,terminal,tip,trichome,tube,tuberculate,uniseriate,unspecified,vine,white,woody,yellowish	0.5-1,0.5-1.5,0.5-3,0.6-1.5-4.6,0.9-1,1-1.5,1-2-celled,1-3.5-9,1.2-1.7,1.5,10+,2,2-3-celled,4-4.5,5-merou,6-7,7-9,?,abaxially,acuminate,acute,adaxially,ag,almost,alyx,angle,anthesi,apex,apparently,appearance,arising,ark,articulated,articulation,axi,basal,base,bending,branch,branching,cell,chartaceous,connivent,cordate,deciduous,denser,diameter,discolorous,eaf,eed,entire,eventually,expanded,exserted,few-celled,free,fruiting,geminat,giving,half,heigh,herbarium,ilament,immature,impressed,inflorescenc,irregularly,junction,lamina,large,largest,leaving,like,lobed,long,lower,many,margin,mature,membranous,near,nearly,nflorescence,older,orolla,outline,pair,papillate,papillo,peduncle,peg,per,perfect,pericarp,plurifoliate,point,portion,primary,principal,rachi,reflexed,rest,revolute,right,ruit,seen,shallowly,sleeve,small,spaced,sparser,speciman,specimen,spreadin,spreading,straw-colored,strongly,tem,thin,third,time,truncate,tub,twining,ud,unit,upper,vary,vein,violet,weak,widest,x,yellow,ympodial	1.5-4.6,3.5-9,abaxial,adaxial,age,arrangement,bark,bud,colour,feature,fruit,number,ovary,papilla,papillose,seed,shape,size,spacing,texture,type,width,young	.3,.5,0.5,0.5-0.8,0.7-2,1-10,1.5-2,12-60,3-15,5-6,<,antrorsely,apart,berry,blue,broadly,brown,capitate-truncate,cm,conical,curved,deltate,densely,ellipsoid,evenly,flattened-reniform,glabrous,globose,green,greenish,leafy,lengthening,minutely,mm,narrowly,ovate,pale,pink,poricidal,pubescent,shiny,shoot,short,simple,slit,stellate,terminal,tip,trichome,tuberculate,uniseriate,unspecified,vine,white,woody,yellowish	1.5-4.6,3.5-9,age,papillose
46	wfo-0001026379	success	218	152	105	125	93	27	100	5	0.2-0.38,0.2-0.4,0.7-1,0.7-2.5,0.8-1.2,0.9-1.2,1-1.7,1-10,1-2,1-3.7,1.3-2.1,1.5-2.3-4.5,1.7-4.9,1.8-2.6,1.8-3.2,1.9-3.4,13,2-2.8,2-7,2.9-4,3-11,4.1-7,5.3-10.2,6-10.6,8-13,8-15,8-29,8.3-10,9-14,acute,adaxially,along,anther,apart,apex,attenuate,bark,base,blunt-tipped,branched,brown,calyx,cm,conical,corolla,cylindrical,dark,dendritic-echinoid,densely,diameter,directed,distally,dried,echinoid,echinoid-pubescent,ellipsoid,entire,filament,finely,flower,fruit,globose,granular,gray-brown,grayish,growth,hair,large,lateral,leaf,length,lobe,long-attenuate,main,many,margin,midrib,minutely,mm,multangulate,nearly,oblong,obovate,ovate,ovate-lanceolate,pale,pedicel,peduncle,persistently,petiole,pitted,plant,pore,porrect-stellate,rachi,reniform,rich,scabrous,semi-ovate,sessile,short-stalked,shrub,side,simple,size,small,somewhat,stellate,stellate-tomentose,stelliform,stem,stigma,style,terete,time,tomentose-pubescent,tree,tube,vein,velutinous-pubescent,violet,whitish,x,yellow,young	1.8-5,1/2,2.4-5.1,2.6-3.7,2/3,3/4,4-5,50-450,abaxially,accrescent,adaxiall,ag,anthesi,apparently,around,articulated,axillary,ba,basal,berry,blade,branch,capitat,chartaceous,closely,completely,covering,distal,eaf,echinoi,edge,eed,enveloping,evident,farinose,few-rayed,fleshy,free,fruiting,glabrous,hig,included,inserted,lacking,lengthening,line,lobed,long,lower,m.,mature,minute,mostly,multangulat,multangulate-pubescent,nflorescence,obtuse,often,older,orolla,partly,perfect,plurifoliate,poricidal,present,pubescen,rather,recent,ruit,runk,scattered,slit,sometimes,spaced,sparse,stellate-,stellate-pubescent,suture,tamen,testa,thin,tip,translucent,ud,uneven,unit,upper,usually,vary,vestigial,way,whitish-brown,ympodial	150-450,abaxial,adaxial,arrangement,bud,capitate,colour,feature,form,height,history,inflorescence,insertion,life,number,ovary,perennial,pubescent,reproduction,seed,shape,spacing,staman,surface,texture,unknown,width	0.2-0.38,0.2-0.4,0.7-1,0.7-2.5,0.8-1.2,0.9-1.2,1-1.7,1-10,1-2,1-3.7,1.3-2.1,1.5-2.3-4.5,1.7-4.9,1.8-2.6,1.8-3.2,1.9-3.4,13,2-2.8,2-7,2.9-4,3-11,4.1-7,5.3-10.2,6-10.6,8-13,8-15,8-29,8.3-10,9-14,acute,adaxially,along,apart,attenuate,base,blunt-tipped,branched,brown,cm,conical,cylindrical,dark,dendritic-echinoid,densely,diameter,directed,distally,dried,echinoid,echinoid-pubescent,ellipsoid,entire,finely,flower,fruit,globose,granular,gray-brown,grayish,large,length,long-attenuate,many,midrib,minutely,mm,multangulate,nearly,oblong,obovate,ovate,ovate-lanceolate,pale,persistently,petiole,pitted,porrect-stellate,reniform,rich,scabrous,semi-ovate,sessile,short-stalked,shrub,side,simple,small,somewhat,stellate,stellate-tomentose,stelliform,terete,time,tomentose-pubescent,tree,velutinous-pubescent,violet,whitish,x,yellow	150-450,capitate,perennial,pubescent,unknown
47	wfo-0001026400	success	187	114	73	92	95	22	72	1	0.2-0.8,0.4-1,0.5-1,0.5-1.2,1-10,1-2,1.3-2.6,1.7-2.2,10-18,10-28,12-27,13-30,2-6,2-8,3.4-4.8,3.5-5.9,30-55,4-7,6-13,6-15,6.5-20,8-12,9-13,anther,axillary,blade,blue,bud,cell,clavate,cm,connivent,coriaceous,corolla,covering,dark,deep,diameter,finely,flower,fruit,glabrescent,glabrous,globose,green,hair,hair-like,herb,interjected,lanceolate,lateral,leaf,leaflet,light,lilac,lobe,long,mm,moderately,odd-pinnate,ovoid,pedicel,peduncle,pentagonal,petiole,plant,pore,poricidal,puberulent,pubescent,purple,ripe,seed,semi-stellate,short,simple,size,stigma,straight,stripe,style,subtending,terminal,testal,thick,tip,tube,wall,white,whitish,x,yellow	0.7-1.1,2.4-5.9,3-6,5-7,5-merou,abaxially,acumen,acuminate,acute,adaxiall,adaxially,ag,alyx,apart,apex,apparently,articulated,asymmetric,attenuate,axe,base,basiscopic,berry,brownish,capitat,condition,decreasing,decurrent,digestion,distal,dorsally,drying,eaf,edge,eed,elliptic,enzyme,erec,exceeding,filament,flat,folded,forked,fresh,geminat,generally,glabrou,gree,green-white,greenish,hal,half,high,homostylous,honeycomb-shaped,lengthening,linear,living,lower,make,mucilaginous,nflorescence,orbicular,orolla,ovate,pair,perfect,petiolulate,plurifoliate,removed,rounded,ruit,sessile,seudostipule,side,slightly,slit,spaced,specimen,stamen,subequal,tall,tamen,tem,throughout,tissue,toward,tri-,typically,unit,unwinged,usually,vary,wet,ympodial	abaxial,adaxial,arrangement,calyx,capitate,colour,connation,feature,form,growth,height,inflorescence,length,number,ovary,pseudostipule,shape,spacing,stem,surface,texture,type	0.2-0.8,0.4-1,0.5-1,0.5-1.2,1-10,1-2,1.3-2.6,1.7-2.2,10-18,10-28,12-27,13-30,2-6,2-8,3.4-4.8,3.5-5.9,30-55,4-7,6-13,6-15,6.5-20,8-12,9-13,axillary,blue,bud,cell,clavate,cm,connivent,coriaceous,covering,dark,deep,finely,glabrescent,glabrous,globose,green,hair,hair-like,herb,lanceolate,lateral,light,lilac,long,mm,moderately,odd-pinnate,ovoid,pentagonal,poricidal,puberulent,pubescent,purple,ripe,semi-stellate,short,simple,straight,stripe,subtending,terminal,testal,thick,tip,wall,white,whitish,x,yellow	capitate
48	wfo-0001026406	success	219	123	71	87	132	36	67	4	.5,0.4-0.9,0.5-1.5,1-2,1.3-1.5,1.5-5,2-2.7,2-3,2-6,2.5-8,2.9-3.2,3-10.5,3.2-3.8,5-50,5-8,6-12,9-15,acute,anther,apart,apex,base,berry,broad-deltate,calyx,cm,conical,connivent,cordate,cream,curved,dark,deltate,densely,erect,filament,flattened,flattened-reniform,flower,fruit,gently,green,herb,lateral,leaf,length,lobe,lobed,long,long-styled,marking,mature,mauve,midpoint,midvein,mm,oblong,obtuse,orange-brown,ovate,pale,pedicel,pendent,petiole,plant,poricidal,prickle,prickly,purple,ray,scar,short-styled,shrub,spherical,stellate-pubescent,stem,straight,style,surface,tapering,terminal,tip,tube,white,wide,yellow,young	.2,0,0-3,0-30,0-5,0.3,0.3-0.5,0.3-0.5-1,0.3-0.7,0.4-0.8,0.5,0.5-2.5,0.8,00-200,1,1.5-2,1.8-2.4,1/,1/3,1/4,1/4-1/2,1/4-1/3,10-30,12-19,20-60,3-4,30-60,5,5-25,5-6,5-7,5-merous,6-15,6.5-7,7-10,7-8,7-9,abaxial,abaxially,adaxial,adaxially,alyx,ame,andromonoecious,apar,apically,apparently,articulated,bark,blade,branched,c.,chartaceous,diameter,dirty-whitish,discolorous,distal,distance,drying,eaf,eed,elongated,elongating,equal,extending,foliaceous,free,fruiting,fully,glabrous,hermaphrodite,heterostylous,infructescence,least,lon,longer,lower,lowermost,margin,maturity,moderately,nflorescence,older,one,open,opening,orolla,oung,pair,peduncle,pendulous,per,pericarp,plurifoliat,porrect,portion,prickl,primary,red-brown,reflexed,rounded,ruit,sessile,side,smooth,sometimes,spaced,sparsely,spreading,stalk,stalked,staminat,stellate,stout,tamen,terete,tertiary,time,trichome,unit,upper,variously,vary,vein,velvety,venation,visible,way,weakly,woody,yellow-brow,ympodial	/,5-10,anthesi,arrangement,bud,coat,colour,connation,corolla,decurrency,dry,embryo,feature,form,growth,height,inflorescence,minor,na,new,number,ovary,papilla,plurifoliate,pore,seed,shape,size,spacing,specimen,stigma,texture,tuberculation,type,width,winging	.5,0.4-0.9,0.5-1.5,1-2,1.3-1.5,1.5-5,2-2.7,2-3,2-6,2.5-8,2.9-3.2,3-10.5,3.2-3.8,5-50,5-8,6-12,9-15,acute,apart,base,berry,broad-deltate,cm,conical,connivent,cordate,cream,curved,dark,deltate,densely,erect,flattened,flattened-reniform,gently,green,herb,lateral,lobed,long,long-styled,marking,mature,mauve,midvein,mm,oblong,obtuse,orange-brown,ovate,pale,pendent,poricidal,prickly,purple,short-styled,shrub,spherical,stellate-pubescent,straight,tapering,terminal,tip,white,wide,yellow,young	/,5-10,na,plurifoliate
49	wfo-0001026407	success	221	148	96	110	111	38	94	2	+,-11,-6,.5,/3,0.5-0.6,0.5-2,0.9-3,1,1-10,1.3,1.5-7,2-2.5,2.5-3,20-40,3.5,3.5-5.5,5,5-10,5-7,7-8,acute,anther,anthesi,apart,apex,appearing,basal,base,becoming,berry,black,branched,broadly,calyx,capitate,cell,cm,conical,connivent,corolla,deep,deltate,dendritic,dense,densely,ellipsoid,elliptic,filament,flattened-reniform,flower,glabrous,globose,golden,growth,inflorescence,internodal,lateral,lax,lengthening,like,lobe,lobed,long,loosely,many,minutely,mm,narrowly,new,oblique,occasionally,outline,papillate,pedicel,pentagonal,petiole,pitted,planar,pore,poricidal,pubescence,pubescent,purple,purplish,ripe,scar,shiny,shrub,simple,slit,spreading,stellate,stem,stiff,stigma,stout,style,surface,terminal,time,tip,trichome,truncate,tube,vine,violet,way,woody,x	0.5,0.5-1,1-1.2,1.2-1.5,1.5-1.7,1.5-2,20-30,4-5,5-merou,7-10,abaxially,adaxially,ag,aid,along,always,alyx,area,ark,around,articulated,axi,beneath,berr,blunt,branch,brown,brownish,chartaceous,clear,climbin,congested,denser,diameter,discolorous,eaf,eed,entire,erect,evenly,exserted,fleshy,free,fruiting,geminat,glabrescen,glabrou,golden-pubescent,ilament,interpetalar,irregularly,lamina,leafy,leaving,lower,margin,markedly,membranous,midvein,mixture,near,nflorescence,numerous,obscured,often,older,open,orolla,pair,pale,paler,papillat,pedice,peduncle,peg,per,perfect,pericarp,persistent,plurifoliate,portion,primary,pubescenc,reddish,revolute,ruit,short,sinus,sleeve,slightly,small,spaced,sparsely,sparser,strongly,tangled,tem,testal,thin,transition,twining,ud,undulate,unit,upper,usually,vary,vein,weak,yellow,ympodial	age,arrangement,bud,coat,colour,connation,decurrency,dry,embryo,feature,form,fruit,height,history,leaf,length,life,midpoint,minor,na,number,ovary,papilla,plant,prickle,ray,reproduction,seed,shape,size,spacing,specimen,texture,tuberculation,type,width,winging,young	+,-11,-6,.5,/3,0.5-0.6,0.5-2,0.9-3,1,1-10,1.3,1.5-7,2-2.5,2.5-3,20-40,3.5,3.5-5.5,5,5-10,5-7,7-8,acute,anthesi,apart,appearing,basal,base,becoming,berry,black,branched,broadly,capitate,cell,cm,conical,connivent,deep,deltate,dendritic,dense,densely,ellipsoid,elliptic,flattened-reniform,glabrous,globose,golden,internodal,lateral,lax,lengthening,like,lobe,lobed,long,loosely,many,minutely,mm,narrowly,oblique,occasionally,outline,papillate,pentagonal,pitted,planar,pore,poricidal,pubescence,pubescent,purple,purplish,ripe,shiny,shrub,simple,slit,spreading,stellate,stem,stiff,stout,terminal,time,tip,trichome,truncate,vine,violet,way,woody,x	age,na
50	wfo-0001026424	success	135	92	49	56	79	36	45	4	1-1.5,1.5-2,10,10-15,15,15-30,acuman,acuminate,acute,angular,apex,base,becoming,blush-violet,broad,calyx,campanulate,clonal,cm,corolla,cuneate,cyme,distinct,ellipsoid,exceeding,flower,glabrous,glandular,hair,interacuminal,lasting,leaf,line,lobe,minute,oblique,pedicel,petiole,pinnatisect,raised,rotate-stellate,scorpioid,several,shrub,simple,slightly,soft-wooded,stem,tip,tissue,toward,unwinged,usually,woody,year,young	-3.5,-4,0.75-1.5,1,1-10,1-2,12-60,3-11,3-4,637/1,8-10-25,acumen,age,anthesi,aspect,axil,ba,blunt,bluntly,broadly,cell,close,common,conspicuous,cut,dia,downard,eaf,elliptic,erect,except,exerted,facetted,facing,floral,fork,forked,general,gree,growing,lacking,lanceolate,lanceolate-elliptic,larger,lavender,lobed,lon,long,lower,midvein,mm,nflorescence,obovate,often,part,pedicellate,peduncle,plurifoliat,point,rachi,rarely,rh,rounded,second,shallowly,short,sinus,soon,stone,straggly,time,triangular,tub,ud,unit,violet,within,x,ympodial	1-4,anther,arrangement,bud,colour,connation,feature,filament,form,fruit,green,growth,height,history,inflorescence,length,life,na,number,ovary,papilla,plant,plurifoliate,pore,reproduction,seed,shape,size,stigma,style,surface,texture,tube,type,width,winging	1-1.5,1.5-2,10,10-15,15,15-30,acuman,acuminate,acute,angular,base,becoming,blush-violet,broad,campanulate,clonal,cm,cuneate,cyme,distinct,ellipsoid,exceeding,glabrous,glandular,hair,interacuminal,lasting,line,minute,oblique,pinnatisect,raised,rotate-stellate,scorpioid,several,shrub,simple,slightly,soft-wooded,tissue,toward,unwinged,usually,woody,year	1-4,green,na,plurifoliate
51	wfo-0001026440	success	181	146	111	120	61	26	108	3	0-15,1-5,1.1-1.4,1.1-1.5,1.5-2.1,1/2,1/2-2/3,14-30,2-2.8,2-4,3-7,3-8,3/4,4-12,9,adaxially,always,anther,anthesi,appressed,articulated,axillary,bark,basal,base,blunt-tipped,bract-like,branch,branched,broadly,brown,calyx,chartaceous,closely,cm,conical,corolla,dendritic-echinoid,dense,developed,diameter,dichotomy,directed,distal,distally,echinoid,elliptic,filament,first,flower,globose,granular,green,greenish-yellow,hair,included,large,leaf,length,lengthening,lobe,lobed,many,minute,minutely,mm,mostly,multangulate,multangulate-pubescent,nearly,oblong,obovate,obovoid-oblong,obscure,often,ovate,pair,pale,pedicel,peduncle,petiole,pitted,plurifoliate,pore,poricidal,porrect-stellate,reniform,ripe,scabrous,sessile,short-stalked,shrub,simple,size,slit,small,sometimes,somewhat,spaced,stellate,stellate-pubescent,stem,stigma,style,suture,terete,time,tip,tomentose,tomentose-pubescent,tomentum,tree,truncate,turning,usually,way,white,x,yellow,young	1.3-1.7,1.8-4.5,1.9-3.7,2.9-4.4,3-5,3.9-6.5,5-7,7-14,abaxially,accrescent,acute,adaxiall,ag,along,apex,apparently,ba,berry,blade,branche,capitat,eaf,echinoi,eed,entire,fleshy,free,fruiting,high,inserted,long,long-attenuate,lower,m.,margin,multangulat,nflorescence,obtuse,older,openly,orolla,perfect,persistently,pubescen,rather,ruit,runk,semi-ovate,short-acuminate,sparse,tamen,testa,thick,thin,translucent,tube,ud,uneven,unit,vary,ympodial	abaxial,adaxial,age,arrangement,bud,capitate,colour,feature,form,fruit,growth,height,history,inflorescence,life,na,ovary,plant,reproduction,seed,shape,spacing,surface,texture,thicknes,width	0-15,1-5,1.1-1.4,1.1-1.5,1.5-2.1,1/2,1/2-2/3,14-30,2-2.8,2-4,3-7,3-8,3/4,4-12,9,adaxially,always,anthesi,appressed,articulated,axillary,basal,base,blunt-tipped,bract-like,branch,branched,broadly,brown,calyx,chartaceous,closely,cm,conical,dendritic-echinoid,dense,developed,diameter,dichotomy,directed,distal,distally,echinoid,elliptic,first,flower,globose,granular,green,greenish-yellow,hair,included,large,leaf,lengthening,lobe,lobed,many,minute,minutely,mm,mostly,multangulate,multangulate-pubescent,nearly,oblong,obovate,obovoid-oblong,obscure,often,ovate,pair,pale,pitted,plurifoliate,pore,poricidal,porrect-stellate,reniform,ripe,scabrous,sessile,short-stalked,shrub,simple,slit,small,sometimes,somewhat,spaced,stellate,stellate-pubescent,suture,terete,time,tip,tomentose,tomentose-pubescent,tomentum,tree,truncate,turning,usually,way,white,x,yellow,young	age,capitate,na
52	wfo-0001026441	success	197	113	74	90	107	23	71	3	0.3-0.7,0.5-1.5,0.8,1-10,1-2,1.5-2.5,10,10-14,15-20,2-2.5,2-5.5,2-8,4-6,4-8,4-8.5,4.5-6.5,5,5-10.5,7-20,7-8,9-14,abaxially,adaxially,anther,apart,axillary,berry,blade,bud,cell,chartaceous,cm,conical,corolla,covering,diameter,end,flower,fruit,glabrous,green,hair,hair-like,herb,homostylous,lanceolate,lateral,leaf,leaflet,light,like,lobe,long,minute,mm,mottled,narrow,odd-pinnate,one,ovoid,pale,pedicel,peduncle,petiole,placed,plant,poricidal,pubescent,purple,ripe,seed,size,sparsely,stem,stigma,straight,style,subtending,terminal,testal,thick,tip,tube,tuber,typically,usually,violet,wall,wing,x	.5,0-2,0.4-3,1-1.5,1.5-2,3-5,5-merou,6-15,absent,acumen,acuminate,ag,alyx,apex,apparently,articulated,attenuate,axe,base,brownish,capitat,ciliate,condition,connivent,decreasing,digestion,distal,dorsally,drying,eaf,edge,eed,elliptic-lanceolate,enzyme,equal,erec,especially,exceeding,filament,flat,folded,forked,fourt,fresh,geminat,generally,glabrou,gradually,green-white,greenish,half,honeycomb-shaped,interjected,internal,larger,lengthening,living,lower,make,margin,middle,minutely,mucilaginous,nflorescence,obtuse,orbicular,orolla,ovate,pair,perfect,petiolule,plurifoliate,pore,puberulent,removed,rotate,rounded,ruit,secondary,semierect,seudostipule,short,slightly,slit,spaced,specimen,stamen,star,ste,stolo,subequal,subsessile,symmetrical,tall,tamen,tem,throughout,toward,tri-,unit,vary,wet,white,whitish,wide,yellow,ympodial	arrangement,calyx,capitate,colour,feature,form,growth,height,history,inflorescence,length,life,na,number,ovary,placement,pseudostipule,reproduction,shape,spacing,stolon,surface,texture	0.3-0.7,0.5-1.5,0.8,1-10,1-2,1.5-2.5,10,10-14,15-20,2-2.5,2-5.5,2-8,4-6,4-8,4-8.5,4.5-6.5,5,5-10.5,7-20,7-8,9-14,abaxially,adaxially,apart,axillary,berry,bud,cell,chartaceous,cm,conical,covering,end,glabrous,green,hair,hair-like,herb,homostylous,lanceolate,lateral,light,like,long,minute,mm,mottled,narrow,odd-pinnate,one,ovoid,pale,placed,poricidal,pubescent,purple,ripe,sparsely,stem,straight,subtending,terminal,testal,thick,tip,typically,usually,violet,wall,wing,x	capitate,na,stolon
53	wfo-0001026460	success	131	115	60	70	61	45	52	8	0.5-1.5,1-1.5,1/2,10-15,13.5-21,2.5-3,4.5-5,6-7,6-9,acute-acuminate,anther,anthesi,apex,base,berry,branched,calyx,capitate,closely,cm,conical,corolla,deflexed,deltate,distal,elliptic,filament,filiform,floccose,flower,glabrous,globose,green,inflorescence,leaf,less,lobe,lobed,minutely,mm,nearly,opposite,ovary,ovoid-reniform,papillose,pedicel,pitted,pore,poricidal,puberulent,reddish,scar,shaped,shrub,simple,spaced,stem,stigma,style,subshrub,surface,tear-drop,tiny,tip,trichome,tube,white,woody,x,young	.1,.5,1.5-2,2-2.5,5,513,7-9,8-10,abaxially,acut,adaxially,axi,becoming,brown,completely,dark,dia,do,drying,eaf,edicel,eed,erect,fide,free,frui,fruiting,greenish,inflorescenc,internodal,like,long,long-exserted,lower,major,membraneous,middle,nflorescence,often,older,pair,pale,papillo,portion,reddish-brow,reflexed,ruit,santo,slightly,somewhat,soon,tall,tapering,tub,ud,unifoliat,unit,vein,widest,yellow,ympodial	0.1,0.5,1,3,acute,arrangement,bark,bud,coat,colour,connation,decurrency,dry,embryo,feature,form,fruit,growth,height,history,length,life,midpoint,minor,na,new,number,papilla,petiole,plant,prickle,ray,reddish-brown,reproduction,seed,shape,size,spacing,specimen,texture,tuberculation,type,unifoliate,width,winging	0.5-1.5,1-1.5,1/2,10-15,13.5-21,2.5-3,4.5-5,6-7,6-9,acute-acuminate,base,berry,branched,capitate,closely,cm,conical,deflexed,deltate,distal,elliptic,filiform,floccose,glabrous,globose,green,inflorescence,leaf,less,lobed,minutely,mm,nearly,opposite,ovoid-reniform,papillose,pitted,poricidal,puberulent,reddish,shaped,shrub,simple,spaced,subshrub,tear-drop,tiny,tip,trichome,white,woody,x	0.1,0.5,1,3,acute,na,reddish-brown,unifoliate
54	wfo-0001026489	success	153	128	78	90	63	38	73	5	.3,0.05-0.1,0.25-0.5,0.5-0.75,0.5-2,0.6-1.4,0.8-1.3,0.8-3.7,1-1.5,1.3-3,1.5-5,2-3,2-4,2-5,2.5-13,2/3,5-6,acute,along,anther,anthesi,apex,area,bark,base,berry,broadly,calyx,closely,cm,corolla,cup-shaped,deflexed,dry,elliptic,erect,filament,flattened,flattened-reniform,glabrous,globose,green,later,leaf,lobe,lobed,long,minor,minutely,mm,occasionally,opposite,ovary,papillose,pedicel,perpendicular,petiole,pitted,planar,pore,poricidal,rhachi,scar,shaped,shiny,shrub,simple,size,slender,somewhat,spaced,specimen,stem,stigma,style,surface,tapering,tear-drop,tip,trichome,tube,uniseriate,usually,way,white,whitish,widened,woody,x,young	0.5,0.5-1,0.8-1.2,2-8-flowered,2.5-4,8-13,appearing,axil,ba,beneath,branched,brown,dark,deltoid,densely,dia,differing,difoliate,eaf,edicel,eed,exserted,extending,fleshy,free,fruiting,geminat,gra,incrassate,lamina,lateral,lon,lower,main,major,margin,middle,nflorescence,often,older,one,overlappin,pair,paler,papillo,parallel,portion,prominent,pubescent,red-papillose,ruit,soon,straight,strongly,tall,terminal,thickened,tub,ud,unit,vein,widest,ympodial	2-8,arrangement,bud,coat,colour,connation,decurrency,embryo,feature,flower,form,fruit,gray,growth,height,history,inflorescence,length,life,midpoint,na,new,number,overlapping,papilla,perennial,plant,prickle,ray,reproduction,seed,shape,spacing,texture,tuberculation,type,width,winging	.3,0.05-0.1,0.25-0.5,0.5-0.75,0.5-2,0.6-1.4,0.8-1.3,0.8-3.7,1-1.5,1.3-3,1.5-5,2-3,2-4,2-5,2.5-13,2/3,5-6,acute,along,anthesi,area,base,berry,broadly,calyx,closely,cm,cup-shaped,deflexed,elliptic,erect,flattened,flattened-reniform,glabrous,globose,green,later,leaf,lobed,long,minutely,mm,occasionally,opposite,papillose,pedicel,perpendicular,pitted,planar,poricidal,rhachi,shaped,shiny,shrub,simple,slender,somewhat,spaced,style,tapering,tear-drop,tip,trichome,tube,uniseriate,usually,way,white,whitish,widened,woody,x,young	2-8,gray,na,overlapping,perennial
55	wfo-0001026490	success	270	145	110	109	161	36	92	18	6,7-pinnate,along,anther,anthesi,apart,apex,axillary,branched,calyx,cm,connivent,contiguously,corolla,covered,crisped,darker,densely,directed,distally,ellipsoidal,expanded,extra-axillary,filament,flat,flattened,flower,fruit,glabrous,green,immature,incurved,inflorescence,large,latrorse-introrse,leaf,length,lenticular,lobe,long,longitudinal,lower,main,margin,mature,middle,midvein,mm,moderately,mottled,near,node,oblong,obtusely,opening,orange,ovate-lanceolate,papillose,pedicel,pentagonal,petiole,plurifoliate,pointed,pore,present,pseudostipule,pubescence,pubescent,punctate,radial,reflexed,rounded,sand,seed,shape,shoot,short,simple,size,slightly,slit,smooth,sometimes,somewhat,sparsely,spur,stem,stigma,striation,striping,strongly,style,surface,tawny,teardrop-shaped,terminal,tip,transparent,trichome,tube,vine,violet,white,wing,woody,yellow,yellowish-tan,Â½,Ã	.5,0.1â0.2,0.1â2.5,0.2â1,0.2â1.5,0.3â3.5,0.4â0.8,0.5â1,0.5â1.5,0.5â3.5,0.5â8,0.7â3,0.8â1.5,0.8â12,1.2â8,1.5,1.5â2,1.5â3.5,1.5â5,1.8â2.2,1.9,10â20,1â1.2,1â15,1â2.5,1â3,1â8,2,2.5â3.5,2â2.5,2â4,2â6,2â8,3,3â4.2,3â4.5,3â5,3â5-pinnate,3â8,4.6,4â4.5,4â5,5-merous,5â7,7,7â15,=,abaxially,absent,accrescent,acuminate,acute,adaxially,ag,alyx,apical,apicall,apparently,around,articulated,axe,ba,base,becoming,blade,bract,bracteate,broadly,brown,capitat,cauline,chartaceous,ciliate,climbing,commonly,completely,cordate,cylindrical,decreasing,diameter,distal,eaf,eed,eglandular,elliptic,entire,equal,exceeding,free,fruiting,fused,geminat,ground,interjected,irregularly,lacking,lateral,leaflet,light,lobed,lowermost,lunate,markedly,match,mean,mean=,medium,minute,multicellular,nearly,nflorescence,obliqu,oblique,obliquely,oblon,obtuse,occasionally,one,orolla,ovate,pair,part,peduncle,per,perfec,perfect,petiolule,pubescen,pur,rachi,reniform,resulting,revolute,rooting,ruit,seudostipule,shorter,similar,slender,smaller,spaced,stamen,tamen,tem,thickened,toward,trailing,trichomessympodial,truncate,typically,unbranched,undulate,unit,vary,vegetation,wide,youn,â4,â4.5,â8,â9.5	0.1-2.5,0.5-1.5,0.5-8,0.8-12,1-8,1.5-2,1.5-3.5,1.5-5,10-20,2-2.5,2-4,2-6,3-4.2,5-7,7-15,abaxial,adaxial,age,arrangement,bud,capitate,colour,connation,feature,form,growth,hair,na,number,ovary,papilla,scar,spacing,texture,type,width	6,7-pinnate,along,anthesi,apart,apex,axillary,branched,cm,connivent,contiguously,covered,crisped,darker,densely,directed,distally,ellipsoidal,expanded,extra-axillary,flat,flattened,flower,fruit,glabrous,green,immature,incurved,large,latrorse-introrse,lenticular,lobe,long,longitudinal,lower,main,margin,mature,middle,midvein,mm,moderately,mottled,near,node,oblong,obtusely,opening,orange,ovate-lanceolate,papillose,pentagonal,plurifoliate,pointed,pore,present,pubescence,pubescent,punctate,radial,reflexed,rounded,sand,shoot,short,simple,slightly,slit,smooth,sometimes,somewhat,sparsely,spur,stem,striation,striping,strongly,tawny,teardrop-shaped,terminal,tip,transparent,trichome,vine,violet,white,wing,woody,yellow,yellowish-tan,Â½,Ã	0.1-2.5,0.5-1.5,0.5-8,0.8-12,1-8,1.5-2,1.5-3.5,1.5-5,10-20,2-2.5,2-4,2-6,3-4.2,5-7,7-15,age,capitate,na
56	wfo-0001026491	success	165	127	77	85	80	42	73	4	.5,1,1-2,1.5-2,1.5-3.5,1.7,10-50,2-3,2-celled,3,3-pinnate,5-6,5-8,6-8,7-8,absent,acuminate,acute,anther,apex,appressed,articulated,averaging,base,bayonet,berry,branched,broadly,cellular-papillose,cm,connivent,conspicuously,cuneate,deciduous,deep,deltoid,densely,diameter,directed,filament,flower,globose,green,hair,highly,inflorescence,leaf,less,light,lobe,middle,minutely,mm,oblong-elliptic,obtuse,often,ovate,ovoid,pale,pedicel,petiole,pore,poricidal,porrect-incurved,purple,readily,rotate-pentagonal,rotate-substellate,rounded,shortly,shrub,simple,small,spotted,stigma,strigose,surface,tawny,tightly,tip,tube,uniseriate,white,whitish,x	1.5-2.5,1977,2-4,2.5-3.5,5-merou,abaxiall,abaxially,adaxially,alyx,anderson,apparently,axe,ba,bent,blade,bract,branching,capitat,cellular-pilose,central,crinkly,distall,eaf,eed,elliptic-lanceolate,entire,equal,first,geminat,glistening,greatly,growing,homostylous,interjected,lanceolate,lateral,leaflet,long,lower,lunulat,margin,mean,near,nflorescence,orolla,ovate-elliptic,peduncle,perfect,pilose,plurifoliate,point,present,pubescent,rachi,rarely,reduced,row,ruit,scandent,seudostipule,sharp,similar,slender,straight,strigo,strong,strongly,subacute,suborbicular-ovate,tal,tamen,tem,terminal,tyle,unit,upright,usually,ventral,yellow,ympodial	arrangement,bud,calyx,capitate,colour,connation,corolla,decurrency,distally,embryo,feature,form,fruit,growth,height,history,length,life,midpoint,minor,na,new,number,ovary,papilla,perennial,plant,prickle,ray,reproduction,scar,seed,shape,size,spacing,stem,style,texture,type,width,winging,young	.5,1,1-2,1.5-2,1.5-3.5,1.7,10-50,2-3,2-celled,3,3-pinnate,5-6,5-8,6-8,7-8,absent,acuminate,acute,apex,appressed,articulated,averaging,base,bayonet,berry,branched,broadly,cellular-papillose,cm,connivent,conspicuously,cuneate,deciduous,deep,deltoid,densely,diameter,directed,globose,green,hair,highly,less,light,middle,minutely,mm,oblong-elliptic,obtuse,often,ovate,ovoid,pale,poricidal,porrect-incurved,purple,readily,rotate-pentagonal,rotate-substellate,rounded,shortly,shrub,simple,small,spotted,strigose,tawny,tightly,tip,uniseriate,white,whitish,x	capitate,distally,na,perennial
57	wfo-0001026501	success	194	114	68	82	112	32	66	2	.5,.6,/3,0.27-0.7,0.5-0.6,0.5-0.9,0.5-1,0.6-2,1-2,1-2.5,1.8-2.2,1/4,2.5-4,2.8-3,3-5,4-7,?,acute,anther,apart,apex,apically,articulated,base,berry,branched,brown,calyx,cm,cuneate,deltate,densely,dull,entire,erect,filament,flattened-reniform,flower,fruit,glabrous,gray,green,leaf,length,light,lobe,lobed,long,mauve,mm,moderately,orange-brown,pale,pedicel,petiole,poricidal,prickly,rounded,scandent,scar,shoot,short,shrub,simple,sparsely,spherical,spreading,stellate,stellate-pubescent,stem,style,surface,tapering,terminal,tip,tube,unarmed,upper,way,white,wide,yellow	.1,.35,.7,0,0-1,0-2,0-3,0.05-0.3,0.1,0.2-1.8,0.5,0.6-1,0.6-1.1-1.7,0.9-2.2,1,1/2-2/3,1/6-1/2,2-10,3-4,3-9,3.5-4,4-5,5-merous,6-9,7-9,abaxially,acicular,almost,alyx,apar,apparently,bark,becoming,blade,borne,brown-green,chartaceous,color,concolorous,curved,diameter,discolorous,drying,eaf,eed,elliptic,elongated,elongating,equal,eye,filiform,filiform-acuminat,flattened,free,fruiting,glabrou,infructescence,known,longer,lower,margin,mature,midpoint,naked,nflorescence,often,older,one,open,orbicular,orolla,oung,ovate,pair,peduncle,pendulous,per,perfec,pericarp,plurifoliat,porrect,portion,prickl,prickle,primary,ray,reddish,ruit,sessile,shorter,slender,small,smooth,sometimes,somewhat,spaced,stalk,stalked,straight,subsessile,tamen,terete,time,trichome,unarme,unit,variously,vary,vein,visible,yellow-green,ympodial	arrangement,bud,colour,connation,corolla,decurrency,feature,filiform-acuminate,form,growth,height,history,inflorescence,life,minor,na,new,number,ovary,papilla,plant,pore,seed,shape,size,spacing,stigma,texture,type,width,winging,young	.5,.6,/3,0.27-0.7,0.5-0.6,0.5-0.9,0.5-1,0.6-2,1-2,1-2.5,1.8-2.2,1/4,2.5-4,2.8-3,3-5,4-7,?,acute,apart,apically,articulated,base,berry,branched,brown,cm,cuneate,deltate,densely,dull,entire,erect,flattened-reniform,glabrous,gray,green,light,lobed,long,mauve,mm,moderately,orange-brown,pale,poricidal,prickly,rounded,scandent,shoot,short,shrub,simple,sparsely,spherical,spreading,stellate,stellate-pubescent,tapering,terminal,tip,unarmed,upper,way,white,wide,yellow	filiform-acuminate,na
58	wfo-0001026513	success	138	86	42	56	82	30	35	7	0.8-2,1-3,2-5,3-5,6-8,8-16,anther,anthesi,area,bark,berry,calyx,cm,corolla,deflexed,dry,elliptic,erect,filament,flower,fruit,glabrous,globose,green,lanceolate,leaf,lobe,lobed,long-styled,mm,opposite,ovary,pale,papillose,pedicel,petiole,plant,poricidal,shaped,shiny,short-styled,shrub,simple,slender,small,specimen,stem,stigma,style,surface,tear-drop,tip,treelet,tube,white,young	.1,.25,.3,.75,/3,1-1.5,2-2.2,3-6-flowered,4-5,7-9,acute,apex,apiculate,ba,base,broadly,caly,closely,completely,darkish,decurrent,delicate,deltoid,dia,differentiated,eaf,edicel,eed,except,exserted,free,fruiting,gre,hirsute,immature,known,lateral,leave,less,live,long,longer,lower,main,mature,middle,minute,minutely,much,nflorescence,obscure,older,overlappin,pair,pore,portion,prominent,raised,reflexed,rest,ruit,scar,somewhat,soon,spaced,straight,styl,tall,trichome,ud,undersurface,unifoliat,uniseriate,unit,vein,venation,way,wide,widest,woody,x,ympodial	0.25,1,3,3-6,abaxial,adaxial,arrangement,colour,connation,feature,form,grey,growth,hair,height,history,inflorescence,length,life,na,number,papilla,reproduction,seed,shape,size,texture,type,unifoliate,width	0.8-2,1-3,2-5,3-5,6-8,8-16,area,berry,cm,deflexed,elliptic,erect,glabrous,globose,green,lanceolate,leaf,lobed,long-styled,mm,opposite,pale,papillose,poricidal,shaped,shiny,short-styled,shrub,simple,slender,small,tear-drop,tip,treelet,white	0.25,1,3,3-6,grey,na,unifoliate
59	wfo-0001026529	success	219	115	76	89	130	26	73	3	0.3-1,0.5-4.5,1-10,1-2,1.1-2.5,1.5-2.5,10-28,11-14,12-22,120-210,3-5,3-9.5,5-15,5-17,6-20,?,anther,attenuate,axillary,berry,blue,bud,cell,chartaceous,clavate,cm,connivent,corolla,covering,creamy,dark,deep,densely,diameter,faintly,flower,fruit,glabrous,globose,greatly,green,hair-like,head,herb,homostylous,lanceolate,lateral,length,light,lilac,long,lunate,medium,membranous,mm,moderately,odd-pinnate,ovoid,pedicel,peduncle,pentagonal,petiole,plant,pore,poricidal,pubescent,pure,rarely,ripe,seed,shape,size,slightly,stem,stigma,style,substellate,subtending,terminal,testal,tetralobulate,thick,tip,tube,varying,wall,white,x,yellowish	0-25,1,1-3,1-4.5,1.5-4,10,2,2-5,2-7.5,20-60,3-12,3-6,4-8,5-9,5-merou,50-70,600-950,abaxially,acumen,acuminate,acute,adaxially,ag,along,alyx,apart,apex,apparently,articulated,axe,base,blade,broadly,brownish,capitat,ciliate,condition,cordate,digestion,distal,dorsally,dot,drying,eaf,edge,eed,elliptic,enzyme,erec,especially,exceeding,except,filament,flat,folded,forked,fresh,geminat,generally,glabrou,gland,glandular,gree,green-white,greenish,hair,hal,half,honeycomb-shaped,interjected,leaflet,lengthening,like,living,lobe,longer,lower,make,margin,midrib,minutely,mucilaginous,narrowly,nflorescence,non-glandular,oblique,often,orbicular,orolla,ovate,pair,perfect,petiolulate,petiolule,plurifoliate,proximal,puberulent,reduced,removed,rounded,ruit,scattered,sessile,seudostipule,short,slit,spaced,specimen,stamen,ste,straight,subequal,subsessile,tall,tamen,tem,throughout,tri-,trichome,typically,unit,unwinged,usually,vary,wet,whitish,wide,wing,yellow,ympodial	5-merous,abaxial,adaxial,arrangement,calyx,capitate,colour,connation,feature,form,growth,height,history,inflorescence,leaf,life,number,ovary,perennial,pseudostipule,reproduction,spacing,surface,texture,type,young	0.3-1,0.5-4.5,1-10,1-2,1.1-2.5,1.5-2.5,10-28,11-14,12-22,120-210,3-5,3-9.5,5-15,5-17,6-20,?,attenuate,axillary,berry,blue,bud,cell,chartaceous,clavate,cm,connivent,covering,creamy,dark,deep,densely,faintly,glabrous,globose,greatly,green,hair-like,head,herb,homostylous,lanceolate,lateral,light,lilac,long,lunate,medium,membranous,mm,moderately,odd-pinnate,ovoid,pentagonal,poricidal,pubescent,pure,rarely,ripe,shape,size,slightly,substellate,subtending,terminal,testal,tetralobulate,thick,tip,varying,wall,white,x,yellowish	5-merous,capitate,perennial
60	wfo-0001026534	success	149	114	57	68	81	46	56	1	0.5-1,10-20,10-50,2-3,2-7,2.5-15,2.5-4,3-10,3-25,3-4,3-5,3.5-4,4-10,5-6,6-35,7-40,acuminate,acute,apex,auriculate,base,calyx,cm,connivent,cordate,deltate,densely,eglandular,ellipsoidal,flattened,fleshy,flower,fruit,glabrous,glandular,hair,lanceolate,lobe,mm,moderately,narrowly,obtuse,orange,ovate,ovoid,pale,pedicel,petiole,pinkish,pore,puberulent,pubescent,purple,red,simple,stellate,stigma,style,subcoriaceous,tip,tree,triangular,truncate,tube,unbranched,white,x,yellow	-1.5,1-2,1-2.5,1-3,1.5-6,1.5-9,10-15,15-50,2-2.5,2-8,3-4-foliat,4.5-5,7-12,abaxially,absent,adaxially,aggregate,apart,ape,apiculate,articulated,axe,basal,beyond,blade,branched,bright,cell,chartaceous,connective,cylindrical,darker,diameter,directed,distally,eaf,eed,entire,equal,exserted,leaving,lemon-yello,lon,long,longitudinal,lower,m.,margin,nflorescence,nther,often,orolla,pedicellar,peduncle,perfect,presen,puberulen,rachi,radiu,remnant,ruit,shorter,slightly,small,spaced,sparsely,stamen,stone,stripe,tal,tem,thecae,time,tomento,truncat,ud,unit,vary,vein,wide,ympodial	anther,anthesi,arrangement,bud,coat,colour,connation,corolla,decurrency,dry,embryo,feature,filament,form,growth,height,history,inflorescence,leaf,length,life,midpoint,minor,na,new,number,ovary,papilla,plant,prickle,ray,reproduction,scar,seed,shape,size,spacing,specimen,stem,surface,texture,tuberculation,type,width,winging,young	0.5-1,10-20,10-50,2-3,2-7,2.5-15,2.5-4,3-10,3-25,3-4,3-5,3.5-4,4-10,5-6,6-35,7-40,acuminate,acute,apex,auriculate,cm,connivent,cordate,deltate,densely,eglandular,ellipsoidal,flattened,fleshy,glabrous,glandular,hair,lanceolate,mm,moderately,narrowly,obtuse,orange,ovate,ovoid,pale,pinkish,puberulent,pubescent,purple,red,simple,stellate,subcoriaceous,tree,triangular,truncate,unbranched,white,x,yellow	na
61	wfo-0001026535	success	248	137	87	105	143	32	82	5	.4,0.2-0.3,0.5-1,0.7-1.5,1,1-2,1-3,1-5,1.2-2,1.3,2-3,2-5,3,3-4.5,7-8,acute,almost,along,anther,anthesi,apex,apically,apparently,bark,base,berry,black,brachyblast,branch,branched,branching,broadly,brown,calyx,clavate,clustered,cm,corolla,cuneate,cupular,dendritic-pubescent,developed,diameter,dilated,distributed,dry,drying,elliptic,elongated,evenly,filament,flexuous,flower,free,fruit,glabrous,leaf,length,liana,linear,lobe,lobed,long,minutely,mm,number,oblong,obovate,older,orange-brown,ovate,ovoid,partly,pedicel,pericarp,petiole,plant,pointed,pore,poricidal,pubescent,rarely,ray,ridged,rounded,scar,shrub,smooth,stem,stigma,style,surface,terminal,thin,tip,truncate,tube,unarmed,unevenly,violet,white,widely,x,yellowish,young	.1,.2,.5,.8,0-0.5,0.1-0.2,0.15,0.2,0.2-1.5,1.5-2,1.5-3,1/2-2/3,1/3,2.5,3-5,3.5-4,4-15,5-10,5-7,5Â°,abaxial,abaxially,absent,accrescent,adaxially,age,alternate,alyx,apar,area,around,articulated,becoming,chartaceous,clearly,concolorous,condensed,conical,cup,curved,dark,deeply,delineate,delineated,deltoid,dendritic,dense,detaching,developing,discolorous,divided,domatia,dorsal,eaf,eed,ellipsoi,entire,equal,except,eye,fertilisation,fine,flat,forming,frui,fruiting,green-brown,increasing,inside,known,leave,lengthening,like,lon,loop,loose,lower,m.,main,margin,marginal,membranous,midvein,minute,mostly,much,naked,network,nflorescence,nther,obscure,orolla,outside,pair,papillo,peduncle,pendulous,perfec,plurifoliat,portion,primary,prominent,protruding,rachi,raised,reaching,ruit,secondary,see,short,side,simple,sinus,slender,slightly,smaller,soon,spaced,sparsely,spreading,stump,tearing,terete,tertiary,tissue,toward,translucent,trichome,tufted,two,ud,uneven,unit,unlignified,vary,vein,venation,visible,weakly,wide,wider,ympodial,youngest	1.5,apart,arrangement,bud,coat,colour,connation,decurrency,ellipsoid,embryo,feature,form,growth,inflorescence,midpoint,minor,na,new,ovary,papilla,papillose,prickle,seed,shape,size,spacing,specimen,texture,tuberculation,type,width,winging	.4,0.2-0.3,0.5-1,0.7-1.5,1,1-2,1-3,1-5,1.2-2,1.3,2-3,2-5,3,3-4.5,7-8,acute,almost,along,apically,apparently,base,berry,black,brachyblast,branch,branched,branching,broadly,brown,clavate,clustered,cm,cuneate,cupular,dendritic-pubescent,developed,diameter,dilated,distributed,dry,drying,elliptic,elongated,evenly,flexuous,free,fruit,glabrous,liana,linear,lobed,long,minutely,mm,oblong,obovate,older,orange-brown,ovate,ovoid,partly,pericarp,plant,pointed,poricidal,pubescent,rarely,ridged,rounded,shrub,smooth,terminal,thin,tip,truncate,unevenly,violet,white,widely,x,yellowish,young	1.5,apart,ellipsoid,na,papillose
62	wfo-0001026604	success	192	115	74	94	98	21	74	0	.4,.75,0.1,0.8-0.9,1-1.2,1.2-1.7,1.5-2,10-30,2.3-3.5,3-3.5,3-5,3.5-4,4.5-7,50-100,<,acuminate,age,anther,anthesi,apart,apex,bark,base,berry,brown,c.,calyx,capitate,cm,cordate,corolla,dark,deflexed,ellipsoid,exserted,filament,flattened,flower,fruit,glabrous,globose,growth,inflated,later,leaf-opposed,lengthening,liana,lobe,lobed,minutely,mm,narrowly,new,oblique,ovary,ovate,ovoid,papillose,pedicel,petiole,pitted,pore,poricidal,pubescent,purple,red,reddish,reniform,ripe,scar,shape,shrub,simple,slender,slit,somewhat,stellate,stem,stigma,stout,strongly,style,surface,terminal,tip,trichome,truncate,tube,uniseriate,vining,violet,way,woody,x	.5,0,0.4-0.6,0.8-1,1.1-1.3,1.5-9,2-2.3,2-2.5,4-4.5,5,5-7,?,absent,aid,along,always,appearing,articulated,articulation,atop,basal,branching,brow,cell,clearly,climbing,comical,conical,cucullate,cupped,densely,diameter,differentiated,distal,distinct,drying,due,eaf,eed,elongate,entire,expanding,flexuous,free,fruiting,leaving,lower,margin,mere,midrib,minute,nflorescence,nodding,occasionally,older,outline,overall,pair,pale,papillo,part,particularly,peduncle,peg,per,perfect,pericarp,planar,plurifoliat,poin,point,portion,primary,quarter,receptacle-like,rim,ruit,series,shiny,sinuate,slightly,spaced,structure,support,swolle,testal,thin,time,tub,twisting,ud,undulation,unit,upper,vein,widely,ympodial,Â½	abaxial,adaxial,arrangement,bud,colour,connation,dry,feature,form,inflorescence,leaf,length,number,papilla,seed,size,spacing,specimen,texture,type,width	.4,.75,0.1,0.8-0.9,1-1.2,1.2-1.7,1.5-2,10-30,2.3-3.5,3-3.5,3-5,3.5-4,4.5-7,50-100,<,acuminate,age,apart,base,berry,brown,c.,calyx,capitate,cm,cordate,dark,deflexed,ellipsoid,exserted,flattened,glabrous,globose,inflated,later,leaf-opposed,lengthening,liana,lobed,minutely,mm,narrowly,oblique,ovate,ovoid,papillose,pitted,pore,poricidal,pubescent,purple,red,reddish,reniform,ripe,shrub,simple,slender,slit,somewhat,stellate,stout,strongly,terminal,tip,trichome,truncate,tube,uniseriate,vining,violet,way,woody,x	
63	wfo-0001026607	success	204	119	74	88	116	31	70	4	0.1-0.3,0.8-3.4,0.8-4.5,0.8-5,1-10,1-2,1-8,1.5-4,10-30,2-10,2-2.5,2.4-5.8,2.5-3.8,3-8,4-10,5,5.8-19.8,6-10,absent,anther,attenuate,axillary,berry,bud,cell,chartaceous,clavate,cm,coarse,connivent,corolla,covering,deep,diameter,distal,filament,finely,flower,forked,fruit,glabrous,globose,green,hair,hair-like,half,herb,high,lanceolate,lateral,leaf,like,lobe,long,medium,membranous,minute,mm,moderately,odd-pinnate,ovoid,pedicel,peduncle,pentagonal,petiole,plant,poricidal,puberulent,pubescent,rachi,rarely,ripe,seed,simple,size,stem,stigma,style,subtending,terminal,testal,thick,tip,tube,violet,wall,white,whitish	0-3,0-4,0.3-1.8,0.5-5.8,1-3.8,1-5,2-3,2.7-19,4-6,5-merou,abaxially,acumen,acute,adaxially,ag,along,alyx,apart,apex,apparently,articulated,axe,base,basiscopic,blade,brownish,capitat,ciliate,clearly,condition,decreasing,decurrent,digestion,dorsally,dot,drying,eaf,edge,eed,elliptic,enzyme,especially,exceeding,flat,folded,forming,fresh,geminat,generally,glabrou,greatly,gree,green-white,greenish,hal,homostylous,honeycomb,interjected,larger,leaflet,lengthening,living,lower,make,margin,marked,midrib,minutely,much,mucilaginous,nflorescence,obtuse,often,orbicular,orolla,ovate,pair,perfect,petiolulate,plurifoliate,pore,present,removed,rosette,rounded,ruit,scattered,semierec,sessile,seudostipule,shaped,short,side,slit,sometimes,spaced,specimen,stamen,ste,straight,tall,tamen,tem,throughout,toward,tri-,typically,unit,unwinged,usually,vary,wet,without,x,yellow,ympodial	abaxial,adaxial,arrangement,articulation,calyx,capitate,colour,connation,feature,form,geminate,greyish,growth,height,history,inflorescence,length,life,na,number,ovary,papilla,pseudostipule,reproduction,shape,spacing,surface,texture,type,width,winging	0.1-0.3,0.8-3.4,0.8-4.5,0.8-5,1-10,1-2,1-8,1.5-4,10-30,2-10,2-2.5,2.4-5.8,2.5-3.8,3-8,4-10,5,5.8-19.8,6-10,absent,attenuate,axillary,berry,bud,cell,chartaceous,clavate,cm,coarse,connivent,covering,deep,distal,finely,forked,glabrous,globose,green,hair,hair-like,half,herb,high,lanceolate,lateral,like,long,medium,membranous,minute,mm,moderately,odd-pinnate,ovoid,pentagonal,poricidal,puberulent,pubescent,rarely,ripe,simple,stem,subtending,terminal,testal,thick,tip,violet,wall,white,whitish	capitate,geminate,greyish,na
64	wfo-0001026613	success	159	133	89	106	53	27	86	3	0.5-1,0.6,1-10,1-2,1.5-4,11-19.5,2-7.5,2.3-8,2.5-2.8,3-10,3-5,4-5,4.5-8.5,5,5-6,5-7,6-12,6-8,6.2-9.5,8-18,8.5-10,8.5-9,9.5-13.5,abaxially,acumen,acuminate,adaxially,along,anther,apex,apparently,attenuate,axillary,base,berry,blade,borne,bud,chartaceous,ciliate,cm,connivent,cordate,corolla,densely,diameter,distal,dorsally,edge,end,especially,filament,flat,flower,folded,forked,fruit,generally,glabrous,green,hair,half,herb,lanceolate,lateral,leaf,leaflet,like,lobe,long,m-1.2,margin,membranous,midrib,minute,minutely,mm,mottled,odd-pinnate,ovate,pedicel,peduncle,perfect,petiole,petiolule,plant,poricidal,puberulent,pubescent,purple,rotate-pentagonal,singly,size,stem,stigma,style,subtending,terminal,tip,tube,tuber,typically,unwinged,usually,x,yellow	5-merou,5.5-7,absent,ag,alyx,apart,articulated,axe,capitat,conical,decreasing,eaf,eed,erec,geminat,greatly,hal,homostylous,immature,interjected,larger,lengthening,lower,mature,middle,nflorescence,orolla,pair,plurifoliate,pore,proximal,pubescen,ruit,secondary,semierect,seudostipule,slit,spaced,sparsely,ste,stolo,subequal,symmetrical,tall,tamen,tem,toward,tri-,unit,unknow,unknown,vary,ympodial	arrangement,branching,calyx,capitate,colour,feature,form,growth,height,history,inflorescence,length,life,na,number,ovary,presence,pseudostipule,reproduction,seed,shape,spacing,staman,stolon,surface,texture,type	0.5-1,0.6,1-10,1-2,1.5-4,11-19.5,2-7.5,2.3-8,2.5-2.8,3-10,3-5,4-5,4.5-8.5,5,5-6,5-7,6-12,6-8,6.2-9.5,8-18,8.5-10,8.5-9,9.5-13.5,abaxially,acumen,acuminate,adaxially,along,apex,apparently,attenuate,axillary,base,berry,borne,bud,chartaceous,ciliate,cm,connivent,cordate,corolla,densely,distal,dorsally,end,especially,flat,folded,forked,generally,glabrous,green,hair,half,herb,lanceolate,like,long,m-1.2,margin,membranous,midrib,minute,minutely,mm,mottled,odd-pinnate,ovate,perfect,plant,poricidal,puberulent,pubescent,purple,rotate-pentagonal,singly,stem,subtending,terminal,tip,typically,unwinged,usually,x,yellow	capitate,na,stolon
65	wfo-0001026614	success	199	145	105	103	96	42	90	15	.8,0.4-0.7,2.2,2.5,3.2-5.2,5,5.3-8.2,absent,acuminate,acute,adaxially,anther,apart,apex,articulated,base,berry,black,blunt-tipped,brown,calyx,campanulate,clavate,cm,commonly,dark,denser,developed,diameter,directed,distally,dried,entire,erect,expanded,extra-axillary,flattened-reniform,flower,foveolate,fruit,glabrescent,glabrous,gland-tipped,globose,hair,interpetalar,irregularly,leaf,linear,lobe,lobed,margin,midpoint,minute,minutely,mm,mottled,nearly,oblique,often,orange,orange-red,ovate,ovoid,pair,pedicel,petiole,pore,prickle,pubescence,pubescent,ray,reflexed,repand,ripe,rotate-pentagonal,rounded,sessile,shallowly,shrub,similar,simple,slightly,sometimes,somewhat,soon,sparsely,stellate,stellate-pubescent,stem,stigma,style,surface,tapering,tissue,tube,usually,weakly,well,white,x,yellowish,young	0.2,0.2â0.3,0.5,0.5â2,1-2â4-branched,1.3-1.8,1.5â2,11-15,15â30,1â2,1â3,1â5,2.2-5.5,2.5â3,20â25,2â4,2â6.5,3-foliate,3â10,4-7,4.5â11,4.5â5.5,5-merou,50,6.4-8.4,6â8,7.2-9.8,8â10,9â16,>,abaxially,across,adaxiall,alyx,apparently,armed,axe,ba,blade,broad-based,capitat,chartaceous,closely,concentrated,cylindrical,densely,eaf,eed,especially,evenly,filament,fleshy,fruiting,geminate,globo,golden,homostylous,internode,lanceolate-attenuate,lateral,less,lon,long,lower,midvein,nflorescence,obtuse,orolla,ovate-lanceolate,peduncle,per,perfect,rachi,rarely,ruit,scattered,shin,side,smaller,spaced,spreading,stellae,tall,tamen,tem,time,tissu,ud,unarme,unarmed,vary,vein,wide,yellow,ympodia,â5	0.2-0.3,0.5-3,1-2,1-2-4-branched,1-3,15-30,2-6.5,20-25,3-10,4.5-11,6-8,8-10,9-16,arrangement,bud,capitate,colour,corolla,embryo,feature,form,growth,height,history,inflorescence,length,life,na,number,ovary,papilla,plant,reproduction,scar,seed,shape,size,spacing,texture,tip,type,width	.8,0.4-0.7,2.2,2.5,3.2-5.2,5,5.3-8.2,absent,acuminate,acute,adaxially,apart,apex,articulated,base,berry,black,blunt-tipped,brown,campanulate,clavate,cm,commonly,dark,denser,developed,diameter,directed,distally,dried,entire,erect,expanded,extra-axillary,flattened-reniform,flower,foveolate,fruit,glabrescent,glabrous,gland-tipped,globose,hair,interpetalar,irregularly,linear,lobe,lobed,midpoint,minute,minutely,mm,mottled,nearly,oblique,often,orange,orange-red,ovate,ovoid,pair,pubescence,pubescent,ray,reflexed,repand,ripe,rotate-pentagonal,rounded,sessile,shallowly,shrub,similar,simple,slightly,sometimes,somewhat,soon,sparsely,stellate,stellate-pubescent,stem,tapering,tissue,usually,weakly,well,white,x,yellowish	0.2-0.3,0.5-3,1-2,1-2-4-branched,1-3,15-30,2-6.5,20-25,3-10,4.5-11,6-8,8-10,9-16,capitate,na
66	wfo-0001026642	success	193	135	85	81	112	54	65	20	0.4,0.5,1.0,annual,anther,anthesi,apart,apex,appressed,axillary,base,bipinnate,black,blue,borne,branched,calyx,chartaceous,clavate,cm,connivent,densely,either,elliptic,filament,flattened,flower,fruit,glabrous,globose,green-purple,hair,herb,lavender,leaf,length,lilac,lobe,long,longitudinal,mm,moderately,multicellular,narrow,number,oblong,obtuse,occasionally,opening,ovate,pale,pedicel,pentagonal,perennial,petiole,pinnate,pitted,pore,poricidal,pubescent,rapidly,shallowly,shoot,side,simple,slit,sparsely,stigma,style,surface,time,tip,tube,unicellular,unifoliate,uniseriate,violet,wide,wing,woody,x	.05,.1,.8,0.1,0.1â0.3,0.2,0.25,0.4â2.2,0.5â,0.5â0.7,0.5â1.7,0.5â2.0,0.5â3.5,0.6,0.6â1.0,0.75â1.0,0.75â2.0,0.7â1.6,0.8â1.2,1.0â2.0,1.2â1.7,1.2â2.0,1.2â3.5,1.2â6.2,1.6â8.0,1.9â3.0,12â30,1â10,1â3,2.0â4.0,2.5â3.5,2.5â4.0,2.8â3.0,3.0â5.1,3â5,4.0â6.0,4â7,5,5.0â7.0,50â100,6,<,abaxial,abaxially,acute,adaxiall,adaxially,ag,along,articulated,axe,ba,blade,brown,cell,circular,cylindrical,dark,decreasing,decumbent,denser,diameter,divided,eaf,eed,equal,erect,fleshy,geminat,glabrescen,gland,glandular,half,indumentum,lon,lower,m.,nflorescence,often,orolla,pair,peduncle,perfect,pinnae,present,primary,probably,rounded,ruit,secondary,sessile,sometimes,spaced,stone,straight,subglabrous,tal,tamen,tem,unit,usually,vary,vein,white,yellow,ympodial,â1.2,â11.0,â2.0,â4.5,â6,â7	0.4-4.5,0.75-1.0,0.8-1.2,1-10,1-3,1.0-2.0,1.2-1.7,1.2-3.5,1.2-6.2,12-30,2.5-4.0,2.8-3.0,3.0-5.1,4-7,4.0-6.0,50-100,age,arrangement,bud,coat,colour,connation,corolla,decurrency,embryo,feature,form,geminate,glabrescent,growth,height,history,inflorescence,life,minor,na,new,ovary,papilla,plant,prickle,reproduction,scar,seed,shape,size,spacing,stem,texture,tuberculation,type,width,winging,young	0.4,0.5,1.0,annual,anthesi,apart,appressed,axillary,base,bipinnate,black,blue,borne,branched,chartaceous,clavate,cm,connivent,densely,either,elliptic,flattened,fruit,glabrous,globose,green-purple,hair,herb,lavender,lilac,long,longitudinal,mm,moderately,multicellular,narrow,oblong,obtuse,occasionally,opening,ovate,pale,pentagonal,perennial,pinnate,pitted,poricidal,pubescent,rapidly,shallowly,shoot,side,simple,slit,sparsely,time,tip,unicellular,unifoliate,uniseriate,violet,wide,wing,woody,x	0.4-4.5,0.75-1.0,0.8-1.2,1-10,1-3,1.0-2.0,1.2-1.7,1.2-3.5,1.2-6.2,12-30,2.5-4.0,2.8-3.0,3.0-5.1,4-7,4.0-6.0,50-100,age,geminate,glabrescent,na
67	wfo-0001026651	success	222	123	77	96	126	27	75	2	-celled,0.2â1.3,0.35â2.6,0.9â3,1.8,2â11.5,2â13,2â3,2â3.3,2â4.5,2â8,3,3â7,4,4â6,4â7.8,6â14,8,absent,acuminate,acute,anther,apex,articulated,attenuate,base,berry,broadly,calyx,capitate,circular,cm,connivent,cyme,dark,densely,drying,dull,elliptic,emarginate,filament,flattened,flower,fruit,glabrous,globose,green,herb,introrsely,lanceolate,lateral,leaf,length,lobe,long,minor,mm,moderate,narrowly-elliptic,new,oblong-ellipsoid,obtuse,ovate-deltate,ovate-lanceolate,ovate-reniform,pedicel,pedunculate,petiole,plant,pore,poricidal,pubescent,ripe,rounded,seed,shape,shrub,simple,size,slightly,stellate,stem,stigma,style,sub-opposite,surface,terminal,translucent,trichome,unbranched,undulate,uniseriate,white,woody,young,Ã	1,1â2,2.2â10,2.8,2â4,3-plurifoliate,3â5,5-merou,6â10,abaxially,accrescent,adaxiall,adaxially,along,alyx,anisophyllous,antror,antrorse,antrorsely,apar,appressed,arcuate,ark,asymmetric,axi,beneath,beyond,branch,brochidodromous,brown,brownish-green,capitat,cell,chartaceous,ciliate,cordate,cylindrical,decumbent,decurrent,diameter,differing,directed,discolorous,eaf,eed,entire,equal,erect,exfoliating,exserted,eye,flexuous,frui,geminate,geniculate,glabrescent,glabrou,glandular,growt,hair,head,highly,hilum,hollow,impressed,less,light,like,longitudinal,lower,lying,major,margin,markedly,matte,membranaceous,midrib,moderately,mostly,much-branched,multicellular,naked,nflorescence,normally,older,one,onto,opening,orolla,parallel,peduncle,per,perfect,prominent,pubescence,reduce,region,revolute,ruit,secondary,shiny,similar,single-celled,slit,small,smaller,sometimes,spaced,stalk,stamen,straight,subapical,tall,tamen,tem,turning,unit,upper,usually,vary,vein,venation,visible,wide,yellow,ympodial	apart,arrangement,bud,colour,connation,corolla,decurrency,feature,form,growth,height,history,inflorescence,life,na,number,ovary,papilla,reproduction,scar,spacing,texture,tip,tube,type,width,winging	-celled,0.2â1.3,0.35â2.6,0.9â3,1.8,2â11.5,2â13,2â3,2â3.3,2â4.5,2â8,3,3â7,4,4â6,4â7.8,6â14,8,absent,acuminate,acute,articulated,attenuate,base,berry,broadly,capitate,circular,cm,connivent,cyme,dark,densely,drying,dull,elliptic,emarginate,flattened,flower,fruit,glabrous,globose,green,herb,introrsely,lanceolate,lateral,long,mm,moderate,narrowly-elliptic,oblong-ellipsoid,obtuse,ovate-deltate,ovate-lanceolate,ovate-reniform,pedunculate,poricidal,pubescent,ripe,rounded,shrub,simple,slightly,stellate,sub-opposite,terminal,translucent,trichome,unbranched,undulate,uniseriate,white,woody,Ã	apart,na
68	wfo-0001026656	success	211	124	80	95	116	29	76	4	1-1.8,1-10,1-2,1.1-8.1,1.5-7,2-6,2.5-17,20-60,4-10,4-13,4-8,5-18,5-35,5.5-27,9-11,abaxially,acuminate,acute,anther,apex,attenuate,base,blue,broadly,bud,capitate,cell,chartaceous,cm,connate,connivent,corolla,covering,cuneate,dark,densely,diameter,dot,elliptic,especially,filament,flower,fruit,glabrous,glaucous,globose,green,hair,hair-like,herb,lanceolate,lateral,leaflet,light,lobe,long,lunate,membranous,mm,moderately,mottled,narrowly,non-glandular,oblique,odd-pinnate,ovate,ovoid,pedicel,peduncle,pentagonal,petiolule,plant,pubescent,purple,rotate-pentagonal,scale-like,scattered,seed,short,sometimes,stem,stigma,style,subglabrous,subtending,symmetrical,terminal,testal,thick,tinged,truncate,tube,violet,wall,white	0-4,0.3-3,0.3-4.2,0.4-6.5,0.7-10.5,0.9-13,1,1-3.8,1-4,1-5,10,2-8,5,5-merou,absent,acumen,adaxially,ag,along,alyx,apart,articulated,bearing,blade,borne,brownish,ciliate,clavat,condition,curved,decurrent,digestion,distal,dorsally,drying,eaf,edge,eed,end,enzyme,erec,exceeding,flat,folded,forked,fresh,geminat,generally,greatly,green-white,greenish,greenish-yellow,half,homostylous,honeycomb-shaped,interjected,larger,lengthening,like,living,lower,make,margin,middl,midvein,minutely,mucilaginous,nflorescence,occasionally,often,orolla,pair,petiole,petiolulate,plurifoliate,pore,poricidal,puberulent,pubescen,rachi,ranging,removed,ruit,seudostipule,singly,slightly,slit,somewhat,spaced,specimen,stamen,star,ste,stolo,straight,subequal,tall,tamen,tem,tertiary,therefore,throughout,tip,tri-,tuber,typically,unit,unwinged,vary,wet,whitish,wide,wing,without,yellow,ympodial	0.3-5,abaxial,adaxial,arrangement,calyx,clavate,colour,connation,feature,form,growth,height,history,inflorescence,leaf,length,life,na,number,ovary,perennial,reproduction,shape,size,spacing,surface,texture,width,young	1-1.8,1-10,1-2,1.1-8.1,1.5-7,2-6,2.5-17,20-60,4-10,4-13,4-8,5-18,5-35,5.5-27,9-11,abaxially,acuminate,acute,attenuate,blue,broadly,bud,capitate,cell,chartaceous,cm,connate,connivent,covering,cuneate,dark,densely,dot,elliptic,especially,glabrous,glaucous,globose,green,hair,hair-like,herb,lanceolate,lateral,light,long,lunate,membranous,mm,moderately,mottled,narrowly,non-glandular,oblique,odd-pinnate,ovate,ovoid,pentagonal,pubescent,purple,rotate-pentagonal,scale-like,scattered,short,sometimes,subglabrous,subtending,symmetrical,terminal,testal,thick,tinged,truncate,violet,wall,white	0.3-5,clavate,na,perennial
69	wfo-0001026663	success	247	105	66	77	170	28	61	5	1,1-3.2,1-5,1.1,1.1-2.1,1.6-2.3,1/3,10-26,2-12,2.1-2.6,2/3,24-45,4.5-5.7-8,8-17,adaxially,anther,apex,bark,becoming,berry,blunt-tipped,brown,bud,cm,corolla,dark,directed,distally,drying,elongated,filament,fleshy,flower,fruit,globose,granular,green,greenish-brown,hair,immature,lanceolate,leaf,length,less,lobe,lower,mm,obtuse,ovate-lanceolate,pale,pedicel,petiole,pore,poricidal,pseudo-terminal,pubescent,rich,scabrous,shrub,simple,small,somewhat,sparsely,stellate,stem,stigma,style,subglabrous,tip,tomentose,tree,tube,unarmed,upper,violet,white,x	-2.9,.5-2.5,/25-1/15,/3,0-160,0.2-0.6,0.3-0.8,0.4-2.2,0.9-1.5,1-2.5,1.2-2,1.4-2.6,1.4-3.1,1.9-2.6,1/2,1/4-1/2,10.3-13.2-15,12-14,2.5-3.7,2.8-5.3,2.9-5,3-5,3.5-5,3.8-5.7,31,4.7-25.9,5-8,5.5-7.5-9,5.5-8.8-9.7,abaxially,accrescent,acuminate,acute,adaxiall,ag,along,angled,anthesi,apart,apparently,appressed,around,articulated,ascending,attenuate,axe,axillary,base,blade,branch,branched,broadly,calyx,capitat,chartaceous,closely,completely,conical,constricted,covering,cylindrical,densely,diameter,distributed,eaf,echinoi,echinoid,echinoid-pubescent,edge,eed,entire,enveloping,especially,evident,exserted,farinose,flared,free,fruiting,glabrescen,glabrescent,glabrous,granular-tomentose,grooved,inserted,lateral,lengthening,light,line,lined,lobed,long,long-stalke,long-stalked,longer,longitudinal,longitudinally,m.,main,many,margin,matur,midrib,midvein,minute,multangulate,multangulate-pubescent,nearly,nflorescence,occasional,occuring,older,opening,openly,orolla,ovate,ovate-lanceolat,peduncle,perfect,persistent,plurifoliate,porrect-stellate,present,pubescence,rachi,rather,ray,ridged,robust,ruit,runk,sessile,short,short-stalked,side,slightly,slit,sometimes,soon,spaced,stalk,stalked,stamen,strongly,subcampanulate,subcoriaceous,subglobose,suture,tall,tamen,tangled,terete,thick,thin,time,tomentose-pubescent,tomentum,touching,ud,unarme,unit,usually,vary,vein,way,whitish,wide,yellow,ympodial,young	5.5-9,70-160,abaxial,adaxial,arrangement,capitate,colour,feature,form,growth,height,history,inflorescence,life,number,ovary,papilla,perennial,plant,reproduction,seed,shape,size,surface,texture,type,unknown,width	1,1-3.2,1-5,1.1,1.1-2.1,1.6-2.3,1/3,10-26,2-12,2.1-2.6,2/3,24-45,4.5-5.7-8,8-17,adaxially,apex,becoming,berry,blunt-tipped,brown,cm,dark,directed,distally,drying,elongated,fleshy,flower,fruit,globose,granular,green,greenish-brown,immature,lanceolate,less,lower,mm,obtuse,ovate-lanceolate,pale,poricidal,pseudo-terminal,pubescent,rich,scabrous,shrub,simple,small,somewhat,sparsely,stellate,subglabrous,tip,tomentose,tree,unarmed,upper,violet,white,x	5.5-9,70-160,capitate,perennial,unknown
70	wfo-0001026686	success	196	111	65	82	114	29	61	4	.4,0.6-0.9,1-10,1-2,1.2-3.4,1.5-7,1.7-2.5,10-28,2.4-3.6,3-4,3.7-8,4-6,5,5-16.5,5-8,6.5-12.7,7-9,8-10,8-14,8-27,acuminate,anther,axillary,base,berry,bud,cell,chartaceous,cm,conical,connivent,corolla,covering,densely,diameter,elliptic-lanceolate,filament,flower,fruit,glabrous,green,hair-like,herb,homostylous,lanceolate,lateral,leaf,leaflet,light,lobe,long,minute,mm,mottled,obtuse,odd-pinnate,ovoid,pair,pedicel,peduncle,petiole,plant,pore,poricidal,pubescent,purple,purple-violet,ripe,rotate-stellate,round,seed,size,sparsely,stigma,style,subtending,terminal,testal,thick,tip,tube,wall	0.2-0.5,1,1-2.5,1.2-3.6,2-10,2-9,2.5-8,3-5,5-merou,abaxially,absent,acumen,adaxially,ag,along,alyx,apart,apex,apparently,articulated,axe,blade,borne,brownish,capitat,ciliate,condition,decreasing,digestion,distal,dorsally,drying,eaf,edge,eed,end,enzyme,equal,erec,especially,exceeding,flat,folded,forked,fresh,geminat,generally,glabrou,gradually,green-white,greenish,hair,half,honeycomb-shaped,interjected,larger,lengthening,like,living,lower,make,margin,middle,midrib,minutely,mucilaginous,nflorescence,often,orbicular,orolla,ovate,perfect,petiolule,plurifoliate,puberulent,pubescen,removed,ruit,secondary,semierect,seudostipule,singly,slightly,slit,spaced,specimen,stamen,star,ste,stolo,straight,stripe,subequal,subsessile,symmetrical,tall,tamen,tem,throughout,toward,tri-,tuber,typically,unit,usually,vary,wet,white,whitish,wide,wing,x,yellow,ympodial	5-merous,abaxial,adaxial,arrangement,calyx,capitate,colour,connation,feature,form,geminate,growth,height,history,inflorescence,length,life,na,number,ovary,pseudostipule,reproduction,shape,spacing,stem,surface,texture,width,young	.4,0.6-0.9,1-10,1-2,1.2-3.4,1.5-7,1.7-2.5,10-28,2.4-3.6,3-4,3.7-8,4-6,5,5-16.5,5-8,6.5-12.7,7-9,8-10,8-14,8-27,acuminate,axillary,berry,bud,cell,chartaceous,cm,conical,connivent,covering,densely,elliptic-lanceolate,glabrous,green,hair-like,herb,homostylous,lanceolate,lateral,light,long,minute,mm,mottled,obtuse,odd-pinnate,ovoid,poricidal,pubescent,purple,purple-violet,ripe,rotate-stellate,round,sparsely,subtending,terminal,testal,thick,tip,wall	5-merous,capitate,geminate,na
71	wfo-0001026696	success	139	101	66	76	63	25	63	3	0.3-4.5,0.8-7,1,1-4,1.3-2.1,2-3,3-17,3-3.5,3-6,3-8.5,5-35,9,acute,apex,apical,base,branched,broadly,calyx,cell,cm,connate,corolla,covering,cuneate,cyme,decurrent,dehiscent,densely,diameter,dichasial,dichasially,ebracteate,filament,flower,forked,globose,green,hair-like,herbaceous,introrse,lanceolate,lateral,light,linear,long,make,maturing,mm,monochasial,mucilaginous,obtuse,odd-pinnate,often,ovate,ovoid,pedicel,peduncle,perennial,petiole,plant,poricidally,pubescent,rounded,seed,short,slit,stellate,stigma,style,testal,thick,throughout,wall,white-cream,yellow	0.9-7.2,1-1.3,1.5-3,2-17,3-6-foliat,4-16,abaxially,acumen,adaxially,apically,apiculate,articulate,digestion,distal,dorsally,eaf,edge,eed,emoval,entire,enzyme,exceeding,flat,folded,generally,globo,green-white,half,honeycomb,light-yello,living,lobe,lon,lower,lunat,margin,nflorescence,nther,oblong,orolla,pattern,perfect,plan,proximal,reveal,ruit,seudostipule,simple,sinuate,specimen,stamen,straight,tal,tem,throughou,tuber-bearing,typically,unit,vary,wide,without,ympodial,Â¼	anther,arrangement,colour,connation,dehiscence,feature,form,fruit,growth,height,history,inflorescence,leaf,length,life,light-yellow,na,number,reproduction,shape,size,stem,surface,texture,wet	0.3-4.5,0.8-7,1,1-4,1.3-2.1,2-3,3-17,3-3.5,3-6,3-8.5,5-35,9,acute,apical,branched,broadly,cell,cm,connate,covering,cuneate,cyme,decurrent,dehiscent,densely,dichasial,dichasially,ebracteate,forked,globose,green,hair-like,herbaceous,introrse,lanceolate,lateral,light,linear,long,make,maturing,mm,monochasial,mucilaginous,obtuse,odd-pinnate,often,ovate,ovoid,perennial,poricidally,pubescent,rounded,seed,short,slit,stellate,testal,thick,throughout,wall,white-cream,yellow	light-yellow,na,wet
72	wfo-0001026706	success	228	126	71	90	138	36	69	2	-5.5,0-240,0.2-0.3,0.8-1.2,0.8-2.8-4.4,0.9-1.9,0.9-2,1-5,1.5-3,14-32,2.3-3.8,2.5-3,2.7-4,3.1-3.8,4,4.2-12,4.5-5.5,5.3-6.4,7-16,acute,anther,anthesi,apart,apex,attenuate,bark,base,berry,blunt-tipped,branched,brown,bud,calyx,cm,corolla,cuneate,diameter,filament,fleshy,flower,free,fruit,globose,golden,grayish,green,lanceolate,leaf,length,lobe,many,mm,oblong,obtuse,ovate,ovate-elliptic,ovate-lanceolate,pale,pedicel,petiole,pore,poricidal,pseudo-terminal,reddish,reticulate-punctate,shrub,simple,small,softly,specimen,stellate,stem,stigma,strongly,style,subcampanulate,suborbicular,sulcate,surface,tall,time,tip,tomentose-pubescent,tree,tube,unarmed,white,x,yellow,young	.5,/14-1/6,0.2-0.5,0.6-2.2-6.1,0.8-1.5,1-2.2-3.1,1.1-4,1/2-2/3,10-15,12,2.2-3.3,2.9-6,2/3-3/4,3-4.6,3.6-5.7,5-6.5,6-10,6-8,6.1-9.8-15.4,8-14,abaxially,accrescent,adaxiall,adaxially,ag,apparently,appearing,around,articulated,axe,axillary,ba,becoming,blade,branch,capitat,chartaceous,closely,completely,coriaceous,covering,crisped,cylindrical,dark,dendritic-echinoid,dendritic-multangulate,densely,directed,distally,eaf,edge,eed,entire,enveloping,exserted,farinose,fourth,fruiting,furfuraceou,glabrate,glabrous,hair,herbarium,indument,inserted,lackin,lacking,lateral,lengthening,lobed,long,long-stalked,longitudinal,lower,m.,main,margin,matted,midrib,minute,mixed,multangulat,multangulate,nearly,nflorescence,obscured,occasionally,often,older,orolla,peduncle,perfect,persistent,plurifoliate,porrect-stellate,pubescence,pubescent,rachi,rather,ruit,runk,semi-ovate,sessile,short-,short-stalked,side,slightly,slit,somewhat,soon,spaced,sparsely,splitting,stalked,stamen,subconical,subglobose,suture,tamen,thin-walled,tomentu,touching,translucent,transparent,ud,unarme,unevenly,unit,upper,vary,vein,velutinous,wavy,way,whitish,wide,yellowish-tan,ympodial	arrangement,capitate,coat,colour,connation,decurrency,dry,embryo,feature,form,growth,height,history,inflorescence,life,midpoint,minor,na,new,number,ovary,papilla,plant,prickle,ray,reproduction,scar,seed,shape,size,spacing,texture,tuberculation,type,width,winging	-5.5,0-240,0.2-0.3,0.8-1.2,0.8-2.8-4.4,0.9-1.9,0.9-2,1-5,1.5-3,14-32,2.3-3.8,2.5-3,2.7-4,3.1-3.8,4,4.2-12,4.5-5.5,5.3-6.4,7-16,acute,apart,attenuate,base,berry,blunt-tipped,branched,brown,cm,cuneate,diameter,fleshy,flower,free,fruit,globose,golden,grayish,green,lanceolate,many,mm,oblong,obtuse,ovate,ovate-elliptic,ovate-lanceolate,pale,poricidal,pseudo-terminal,reddish,reticulate-punctate,shrub,simple,small,softly,stellate,strongly,subcampanulate,suborbicular,sulcate,tall,time,tip,tomentose-pubescent,tree,unarmed,white,x,yellow	capitate,na
73	wfo-0001026707	success	194	114	67	80	114	34	64	3	.5,.8,/3,0.3-0.8,0.5-1,0.6-0.7,0.7-1,0.7-1.4,1-5,1.5-1.8,1/3,2-2.3,2.5-3,3-4.5,3-7,3-8,4,?,acute,anther,apart,apex,apically,apparently,articulated,attenuate,base,berry,broad-deltate,calyx,clustered,cm,connivent,decurrent,diameter,entire,erect,filament,flattened-reniform,flower,fruit,green,lateral,leaf,length,lobe,lobed,long,mauve,mm,moderately,narrow-deltate,obtuse,pedicel,petiole,poricidal,red-brown,reflexed,rounded,scar,shrub,simple,small,spherical,spreading,stellate,stellate-pubescent,stem,style,surface,tapering,terminal,tip,tree,tube,unarmed,upper,way,white,wide	0-20,0-3,0-5,0.05,0.05-0.15,0.1-0.2,0.5-3,0.6-0.8,0.7-1.5,1-1.7,1-3,1.6-2,1/3-1/2,1/3-3/4,1/4-1/3,1/8-1/4-1/3,11-16,2-10,2-6,2.5-4,2.5-6,3-4,5-10,5-25,5-7,5-8,5-merous,8-15,abaxially,alyx,apar,bark,blade,branche,branched,broadly,chartaceous,color,concolorous,curved,cuspidat,densely,discolorous,drying,eaf,eed,elongating,equal,eye,foliaceous,free,fruiting,fused,gently,glabrescent,glabrou,glabrous,gray,inflated,infructescence,juvenil,known,less,longer,lower,margin,mature,midpoint,naked,narrow-oblong,nflorescence,older,one,open,orange-brown,orolla,oung,peduncle,per,perfec,pericarp,plurifoliat,porrect,porrect-lepidote,portion,prickle,prickly,pubescent,ray,ruit,sessile,shorter,slender,smooth,sometimes,spaced,sparsely,stalk,stalked,stout,straight,tamen,terete,time,trichome,unit,variously,vary,venation,visible,weakly,yellow-green,ympodial,Â¼	arrangement,branch,bud,colour,connation,corolla,cuspidate,decurrency,feature,form,growth,height,history,inflorescence,life,minor,na,new,number,ovary,papilla,plant,pore,reproduction,seed,shape,size,spacing,stigma,texture,type,width,winging,young	.5,.8,/3,0.3-0.8,0.5-1,0.6-0.7,0.7-1,0.7-1.4,1-5,1.5-1.8,1/3,2-2.3,2.5-3,3-4.5,3-7,3-8,4,?,acute,apart,apically,apparently,articulated,attenuate,base,berry,broad-deltate,clustered,cm,connivent,decurrent,diameter,entire,erect,flattened-reniform,green,lateral,lobed,long,mauve,mm,moderately,narrow-deltate,obtuse,poricidal,red-brown,reflexed,rounded,shrub,simple,small,spherical,spreading,stellate,stellate-pubescent,tapering,terminal,tip,tree,unarmed,upper,way,white,wide	branch,cuspidate,na
74	wfo-0001026711	success	207	141	87	102	105	39	84	3	-5,.5,.8,0.2-0.3,0.3-1,0.5-1.5,0.7-0.9,0.7-1.4,0.75-1,0.8,0.8-2.2,1-30,1.7-4,1/2-2/3,1/3,2-2.2,2-3.5,2-6,2.1-2.5,3-5,acicular,acute,anther,apart,apex,apically,apparently,articulated,base,berry,calyx,cell,cm,connivent,cuneate,deltate,densely,erect,evenly,filament,flattened-reniform,flower,fruit,glabrous,green,lateral,leaf,length,less,lobe,lobed,long,lower,maturity,mauve,midpoint,mm,narrow-deltate,obtuse,occasionally,orange,outline,pale,pedicel,perpendicular,petiole,pit,poricidal,prickle,prickly,purple,raised,ray,red,reflexed,rounded,scar,shrub,small,smooth,sometimes,somewhat,spherical,spreading,stellate,stellate-pubescent,stem,straight,style,surface,tapering,terminal,tip,trichome,tube,unarmed,upper,way,weakly,wide,yellow,young	-15,-7,.2,0-0.2,0-2,0-25,0-4,0-5,0-6,0-7,0.1,0.15,0.7-0.9-1.1,0.9-1.5,1-2,1-2-4-6,1.5-2-2.5,1.5-2.2,1/,1/4,1/4-1/3,3-4,3-4.5,3-7,3.5-5.2,4-8,4.5-7,5-merous,7-8,abaxially,acuminat,alyx,ame,apar,bark,blade,branched,brow,c.,concolorous,curved,diameter,difoliate,discolorous,distance,drying,dull,eaf,eed,elliptic,elongating,equal,extending,faint,free,fruiting,geminat,infructescence,longer,margin,mature,midvein,moderately,nflorescence,older,one,open,orange-brown,orolla,oung,pair,peduncle,pendulous,per,perfec,pericarp,porrect,portion,prickl,primary,reduced,ruit,sessile,shallowly,shorter,side,slender,spaced,stalk,stalked,tamen,terete,tertiary,thick-chartaceous,time,uniform,unit,variously,vary,vein,venation,visible,woody,yellow-green,ympodial	0.9-1.1,acuminate,anthesi,arrangement,bud,coat,colour,connation,corolla,decurrency,dry,embryo,feature,form,growth,height,history,inflorescence,life,minor,na,new,number,ovary,papilla,plant,pore,reproduction,seed,shape,size,spacing,specimen,stigma,texture,tuberculation,type,width,winging	-5,.5,.8,0.2-0.3,0.3-1,0.5-1.5,0.7-0.9,0.7-1.4,0.75-1,0.8,0.8-2.2,1-30,1.7-4,1/2-2/3,1/3,2-2.2,2-3.5,2-6,2.1-2.5,3-5,acicular,acute,apart,apically,apparently,articulated,base,berry,cell,cm,connivent,cuneate,deltate,densely,erect,evenly,flattened-reniform,glabrous,green,lateral,less,lobed,long,lower,maturity,mauve,mm,narrow-deltate,obtuse,occasionally,orange,outline,pale,perpendicular,pit,poricidal,prickly,purple,raised,red,reflexed,rounded,shrub,small,smooth,sometimes,somewhat,spherical,spreading,stellate,stellate-pubescent,stem,straight,tapering,terminal,tip,trichome,unarmed,upper,way,weakly,wide,yellow,young	0.9-1.1,acuminate,na
75	wfo-0001026717	success	207	154	114	125	82	29	108	6	0.3-0.6,0.6-1.5,0.8,1-10,1-2,1-2.5,1-3,1.3-2.5,1.4-2.2,1.8-3,13-28,15-34,2.5-4.5,2.5-5.5,3-4,3.3-11,4-6,4-8,4-9,5,5-11,5-13.5,5-6,5.3-9,abaxially,acuminate,adaxially,anther,apart,apex,attenuate,axillary,base,berry,borne,bud,cell,chartaceous,cm,conical,connivent,corolla,covering,dark,decurrent,diameter,distal,elliptic,end,filament,flower,forked,fruit,generally,glabrous,green,green-white,hair,hair-like,half,herb,homostylous,interjected,lanceolate,lateral,leaf,leaflet,light,like,lobe,long,make,medium,membranous,minute,mm,mottled,mucilaginous,narrow,obtuse,odd-pinnate,orbicular,ovate,ovoid,pedicel,peduncle,pentagonal,petiole,petiolule,plant,poricidal,present,pubescent,purple,ripe,rotate,round,secondary,seed,sessile,singly,size,sparsely,stigma,straight,style,subsessile,subtending,symmetrical,terminal,testal,thick,throughout,tip,tube,tuber,typically,usually,violet,wall,wet,wide,wing,x,yellow	0.3-2.5,0.3-5,14-22,2.2-5,3-5,3-6,5-merou,7-11,acumen,ag,along,alyx,apparently,articulated,axe,blade,brownish,capitat,ciliate,condition,darker,decreasing,digestion,dorsally,drying,eaf,edge,eed,enzyme,equal,erec,especially,exceeding,flat,folded,fresh,geminat,glabrou,gradually,greenish,honeycomb-shaped,larger,lengthening,living,lower,margin,middle,midrib,minutely,nflorescence,often,one-quarte,orolla,pair,perfect,plurifoliate,pore,puberulent,pubescen,removed,ruit,semierect,seudostipule,slightly,slit,spaced,specimen,stamen,ste,stolo,stripe,subequal,subglabrous,tall,tamen,tem,toward,tri-,unit,vary,whitish,ympodial	5-merous,arrangement,calyx,capitate,colour,feature,form,growth,height,history,inflorescence,length,life,na,number,ovary,perennial,presence,pseudostipule,reproduction,shape,spacing,staman,stem,stolon,surface,texture,type,width	0.3-0.6,0.6-1.5,0.8,1-10,1-2,1-2.5,1-3,1.3-2.5,1.4-2.2,1.8-3,13-28,15-34,2.5-4.5,2.5-5.5,3-4,3.3-11,4-6,4-8,4-9,5,5-11,5-13.5,5-6,5.3-9,abaxially,acuminate,adaxially,apart,attenuate,axillary,berry,borne,bud,cell,chartaceous,cm,conical,connivent,covering,dark,decurrent,distal,elliptic,end,flower,forked,fruit,generally,glabrous,green,green-white,hair,hair-like,half,herb,homostylous,lanceolate,lateral,leaflet,light,like,long,make,medium,membranous,minute,mm,mottled,mucilaginous,narrow,obtuse,odd-pinnate,orbicular,ovate,ovoid,pentagonal,petiolule,plant,poricidal,present,pubescent,purple,ripe,rotate,round,secondary,seed,sessile,singly,sparsely,straight,subsessile,subtending,symmetrical,terminal,testal,thick,throughout,tip,typically,usually,violet,wall,wet,wide,wing,x,yellow	5-merous,capitate,na,perennial,stem,stolon
76	wfo-0001026725	success	166	128	76	93	73	35	72	4	.3,.5,/4,0.2,0.7-1.2,1-1.2,1-1.5,1-4.5,1-5,1.2-1.7,1.5-2,1/2,2,2.2-4,3.5-4,3.6-7.7,5-5.5,5-6,8-18.6,acute,anther,anthesi,apart,apex,attenuate,bark,base,berry,broadly,calyx,capitate,cm,corolla,cup-shaped,dark,dia,dry,drying,ellipsoid,elliptic,extremely,filament,flattened-reniform,fruit,glabrous,glandular-papillose,globose,green,greenish-white,leaf,less,lobe,lobed,long,minor,minutely,mm,onto,opposite,ovary,ovate,ovoid,paler,papillose,pedicel,petiole,pitted,pore,rounded,scar,shaped,short,shrub,simple,size,slender,stem,stigma,stretching,style,subshrub,surface,tapering,tear-drop,tip,triangular,tube,upper,way,white,winged,woody,x	1.5,1.6-2,5-20-flowered,8-9,accrescent,axil,becoming,beneath,black,bluish,brownish-papillose,character,crackin,deflexed,differing,difoliate,eaf,edicel,eed,evenly,free,fruiting,geminat,geographically,incrassate,inflorescenc,interpetalar,large,lateral,lon,lower,main,major,margin,margine,material,middle,nflorescence,occasionally,often,older,one,open,pair,pale,papillo,planar,poricidal,portion,prominent,proximal,pubescent,reddish-brown,reflexed,ruit,scarious,sinus,slightly,spaced,split,straight,tall,tan,trichome,tuft,ud,uniseriate,unit,varying,vein,widest,ympodial,young	5-20,arrangement,bud,coat,colour,connation,cracking,decurrency,embryo,feature,flower,form,growth,height,history,inflorescence,length,life,midpoint,na,number,papilla,plant,prickle,ray,reproduction,seed,shape,spacing,specimen,texture,tuberculation,type,width,winging	.3,.5,/4,0.2,0.7-1.2,1-1.2,1-1.5,1-4.5,1-5,1.2-1.7,1.5-2,1/2,2,2.2-4,3.5-4,3.6-7.7,5-5.5,5-6,8-18.6,acute,apart,attenuate,base,berry,broadly,calyx,capitate,cm,cup-shaped,dark,dia,drying,ellipsoid,elliptic,extremely,flattened-reniform,glabrous,glandular-papillose,globose,green,greenish-white,leaf,less,lobed,long,minutely,mm,onto,opposite,ovate,ovoid,paler,papillose,petiole,pitted,rounded,shaped,short,shrub,simple,slender,stretching,subshrub,tapering,tear-drop,triangular,upper,way,white,winged,woody,x	5-20,cracking,inflorescence,na
77	wfo-0001026733	success	183	134	79	85	98	49	75	4	-13,-4,0.3-0.5,0.3-2,0.5-4,1-2,1-3,1-7,1.5-14,10-20,2-3,2.5-7.5,3-15,3-3.5,3-7,4,4-23,4-5,5-8,acuminate,acute,acute-acuminate,apart,apex,basal,base,calyx,chartaceous,cm,color,connivent,cordate,deltate,densely,eglandular-pubescent,ellipsoidal,elliptic-ovate,flattened,flower,forked,fruit,fusiform,glabrate,glabrous,glandular-,glandular-puberulent,green,greyish,hair,hirsute,immature,lanceolate,lobe,long,longitudinal,membranaceous,mm,moderately,narrowly,oblique,ovate,ovoid,pedicel,petiole,pilose,pore,ripe,shining,simple,sometimes,stellate,stigma,stripe,style,submarginally,tree,triangular,truncate,tube,unbranched,unknown,white-puberulent,wide,x,yellowish	-11,-7,-8,.5-3,0.3-0.5-1,0.5,0.5-1,0.5-2,1-1.5,1.5-2,1.5-2.5,15-20-50,2-2.5,2-4,2-6,25-40,3-4-foliat,4.5-5,7-10-14,8-12-15,abaxially,adaxially,aggregate,ape,articulated,axe,beyond,blade,capitat,cell,ciliat,connective,curled,cylindrical,dense,dia,diameter,directed,distally,eaf,eed,eglandular-pilose,eglandular-villous,entire,equal,especially,exceeding,exserted,gland-tipped,glandula,glandular-tomentose,leaving,linear-triangular,lon,lower,margin,midrib,near,nflorescence,nther,orolla,ovum,pedicellar,peduncle,perfect,present,pubescent,pubescent-pilo,pubescent-pilose,rachi,radiu,remnant,round,ruit,shorter,slightly,small,smooth,spaced,sparsely,stamen,stone,swelling,tal,tem,thecae,time,toward,ud,unit,unknow,usually,vary,vein,villous,white,yellow,ympodial	15-50,anther,anthesi,arrangement,bud,capitate,coat,colour,connation,corolla,decurrency,dry,feature,filament,form,growth,height,history,inflorescence,leaf,length,life,midpoint,minor,na,new,number,ovary,papilla,perennial,plant,prickle,ray,reproduction,scar,seed,shape,size,spacing,specimen,stem,surface,texture,tip,tuberculation,type,width,winging,young	-13,-4,0.3-0.5,0.3-2,0.5-4,1-2,1-3,1-7,1.5-14,10-20,2-3,2.5-7.5,3-15,3-3.5,3-7,4,4-23,4-5,5-8,acuminate,acute,acute-acuminate,apart,apex,basal,chartaceous,cm,color,connivent,cordate,deltate,densely,eglandular-pubescent,ellipsoidal,elliptic-ovate,flattened,forked,fusiform,glabrate,glabrous,glandular-,glandular-puberulent,green,greyish,hair,hirsute,immature,lanceolate,lobe,long,longitudinal,membranaceous,mm,moderately,narrowly,oblique,ovate,ovoid,pilose,ripe,shining,simple,sometimes,stellate,stripe,submarginally,tree,triangular,truncate,unbranched,unknown,white-puberulent,wide,x,yellowish	15-50,capitate,na,perennial
78	wfo-0001026734	success	266	129	84	88	178	41	72	12	0.5,0.6,3,acuminate,anther,apex,articulated,base,becoming,berry,calyx,clavate,cm,congested,connivent,corolla,covered,cuneate,cylindrical,cyme,densely,distally,elliptic,flattened,flower,fruit,glabrescent,glabrous,globose,gray,green,growth,immature,internodal,irregular,lanceolate,lateral,leaf,length,lobe,lobed,long,long-attenuate,longitudinal,maturity,mm,moderately,narrow,new,oblong,obtuse,opening,ovary,ovate,pale,papillose,pedicel,petiole,pit,pore,poricidal,porrect,porrect-stellate,pubescent,purple,purplish,reniform,sessile,shape,short-stalked,shrub,simple,size,slightly,slit,sparsely,stellate,stem,stigma,style,subopposite,surface,trichome,tube,unbranched,white,wide,Â¾	0.1,0.2,0.3,0.7â0.9,0.7â1,0.8â1,1,1.6â2,1.6â2.5,1.8â2.2,1.8â3,1/4,1â1.2,1â3,2.2â7,2.3â5,2.5â3,2â2.4,2â3,3.2â3.8,3â4,3â4-celled,3â8,4â6,4â7,4â8,4â9,5-merou,5â9,8,abaxial,abaxially,absent,accrescent,acute,adaxial,adaxiall,adaxially,ag,also,always,alyx,anthesi,apical,apice,archin,ark,associated,asymmetric,axi,barely,beneat,beneath,blade,branch,branched,bright,broadly,brown,caly,camptodromous,capitate,celled,central,chartaceous,closely,commonly,covering,dark,dense,denser,diameter,differing,directed,discolorous,downward,dried,drying,due,eaf,eed,eglandular,emergent,entire,erect,f.,fewer,flat,foliate,forked,found,free,frequently,geminate,glabrescen,glandular,hair,held,ilament,initially,introrsely,j,lamina,large,less,longer,lower,lying,margin,material,mature,maturit,membranaceous,midpoint,midri,minute,mostly,much,multiseriate,near,nflorescence,normally,obovate,observed,often,old,older,one,one-celled,orolla,other,oung,pair,paired,peduncle,perfect,plane,pointing,portion,pubescence,rachi,raised,rarely,ray,rayed,reaching,rounded,ruit,scandent,secondary,shiny,shorter,smaller,sometimes,spaced,sparse,spread,spreading,stalk,still,subsessile,surfac,terminal,tuft,ud,unequal,uniseriate,unit,upward,vary,vein,venation,vestiture,visible,whole,yellow,yellowish,ympodial	0.7-0.9,1-3,1.8-2.2,1.8-3,2-2.4,2.2-7,2.3-5,2.5-3,3-8,5-9,age,arrangement,bud,coat,colour,connation,decurrency,embryo,feature,filament,form,height,history,inflorescence,life,minor,na,number,papilla,plant,prickle,reproduction,seed,spacing,texture,tip,tuberculation,type,width,winging,young	0.5,0.6,3,acuminate,apex,articulated,base,becoming,berry,clavate,cm,congested,connivent,covered,cuneate,cylindrical,cyme,densely,distally,elliptic,flattened,flower,fruit,glabrescent,glabrous,globose,gray,green,immature,internodal,irregular,lanceolate,lateral,leaf,length,lobed,long,long-attenuate,longitudinal,maturity,mm,moderately,narrow,oblong,obtuse,opening,ovate,pale,papillose,pit,poricidal,porrect,porrect-stellate,pubescent,purple,purplish,reniform,sessile,short-stalked,shrub,simple,slightly,slit,sparsely,stellate,stem,subopposite,trichome,unbranched,white,wide,Â¾	0.7-0.9,1-3,1.8-2.2,1.8-3,2-2.4,2.2-7,2.3-5,2.5-3,3-8,5-9,age,na
79	wfo-0001026740	success	171	132	76	87	84	45	75	1	0-10,0.5-1,1-10,1-2,1-5,10-20,10-30,2-3,2.5-27,2.5-4.5,3-15,3-3.5,3-5,3.5-40,4-5,4.5-10,5-40,6-10,acuminate,acute,acute-acuminate,also,apart,apex,apiculate,basal,base,branched,calyx,cm,connivent,cordate,curled,darker,deltate,densely,eglandular,ellipsoidal,elliptic,flattened,fleshy,flower,fruit,glabrate,glabrous,glandular-puberulent,greenish,hair,immature,lanceolate,lobe,long,mature,mm,moderately,narrowly,oblong,obtuse,often,ovate,ovoid,pedicel,petiole,pilose,pore,present,puberulent,purple,reticulate,scar,simple,sparsely,stellate,stigma,stripe,style,subcoriaceous,tree,triangular,truncate,tube,unbranched,white-puberulent,whitish,x,yellow,young	-17,-2,1-12,1-3,1-4,2-4,2.5-3,2.5-6,20-50,3-foliat,5-8,8-19,abaxially,absen,absent,adaxially,aggregate,ape,articulated,axe,beyond,blade,browni,cell,ciliate,connective,corky,cylindrical,diameter,directed,distally,eaf,eed,entire,equal,especially,exceeding,exserted,leaving,lon,lower,margin,near,nearly,nflorescence,nther,orange,orolla,pedicellar,peduncle,perfect,pilo,pubescent,rachi,radiu,rarely,remnant,ruit,sessile,shorter,slightly,small,sometimes,spaced,stamen,stone,swelling,tal,tems,thecae,time,tomentose,toward,truncat,ud,unit,unlobed,vary,vein,villous,violet,wide,woody,ympodial	anther,anthesi,arrangement,bud,coat,colour,connation,corolla,decurrency,dry,embryo,feature,filament,form,growth,height,history,inflorescence,leaf,length,life,midpoint,minor,na,new,number,ovary,papilla,plant,prickle,ray,reproduction,seed,shape,size,spacing,specimen,stem,surface,texture,tip,tuberculation,type,width,winging	0-10,0.5-1,1-10,1-2,1-5,10-20,10-30,2-3,2.5-27,2.5-4.5,3-15,3-3.5,3-5,3.5-40,4-5,4.5-10,5-40,6-10,acuminate,acute,acute-acuminate,also,apart,apex,apiculate,basal,branched,cm,connivent,cordate,curled,darker,deltate,densely,eglandular,ellipsoidal,elliptic,flattened,fleshy,glabrate,glabrous,glandular-puberulent,greenish,hair,immature,lanceolate,lobe,long,mature,mm,moderately,narrowly,oblong,obtuse,often,ovate,ovoid,pilose,present,puberulent,purple,reticulate,simple,sparsely,stellate,stripe,subcoriaceous,tree,triangular,truncate,unbranched,white-puberulent,whitish,x,yellow	na
80	wfo-0001026752	success	166	135	93	102	64	33	89	4	-4,0-1-2-3,1,1-12,1-3,1-5,1-6,1.5-12,1.5-2.5,10-20-25,15-35-50,2-4,2.5-20,2.5-5,20-30,3,3-18,3.5-4,4-45,4-5,abaxially,abruptly,acute,adaxially,also,apart,apex,apiculate,basal,base,black,branched,calyx,campanulate,cm,connective,cordate,coriaceous,cuneate,cylindrical,darker,deltate,densely,dilated,directed,distally,ellipsoidal,entire,equal,exceeding,finely,flattened,fleshy,flower,forked,fruit,glabrous,globose,green,greenish-brown,hair,immature,lanceolate,laterally,lobe,long,margin,mm,moderately,narrowly,ovoid,pedicel,peduncle,petiole,pilose,pore,possibly,pubescent,pubescent-pilose,purplish,rachi,rarely,ripe,short-acuminate,simple,slightly,somewhat,stellate,stigma,stripe,style,thecae,tree,triangular,truncate,tube,unbranched,violet,white,whitish,x,yellow	1-1.5,1-2,1.5-2,2,2-2.5,2-3,3-4,3-5,3-foliat,7-15,8-16,absent,aggregate,ape,articulated,axe,beyond,blade,capitat,cell,chartaceous,connivent,diameter,eaf,eed,elliptic-oblong,elliptic-ovate,exserted,leaving,less,lon,lower,near,nearly,nflorescence,nther,obtuse,orolla,papillose,pedicellar,perfect,pilo,presence,present,radiu,rather,remnant,ruit,small,spaced,stamen,stone,tal,tem,time,tomento,ud,unit,unknow,vary,vein,wide,yello,ympodial	abaxial,adaxial,alternate,anther,arrangement,bud,capitate,colour,corolla,feature,form,growth,height,hermaphroditic,history,inflorescence,leaf,length,life,number,ovary,perennial,plant,reproduction,seed,shape,size,spacing,stem,surface,texture,tip,width	-4,0-1-2-3,1,1-12,1-3,1-5,1-6,1.5-12,1.5-2.5,10-20-25,15-35-50,2-4,2.5-20,2.5-5,20-30,3,3-18,3.5-4,4-45,4-5,abaxially,abruptly,acute,adaxially,also,apart,apex,apiculate,basal,base,black,branched,campanulate,cm,cordate,coriaceous,cuneate,cylindrical,darker,deltate,densely,dilated,directed,distally,ellipsoidal,entire,equal,exceeding,finely,flattened,fleshy,forked,glabrous,globose,green,greenish-brown,hair,immature,lanceolate,laterally,lobe,long,mm,moderately,narrowly,ovoid,pilose,possibly,pubescent,pubescent-pilose,purplish,rarely,ripe,short-acuminate,simple,slightly,somewhat,stellate,stripe,thecae,tree,triangular,truncate,unbranched,violet,white,whitish,x,yellow	alternate,capitate,hermaphroditic,perennial
81	wfo-0001026754	success	175	122	90	100	75	22	85	5	0.5,0.5-1,0.9-1.1,1,1/2,10,2-4,2.5-3.5,2/3,3-4-celled,30+,5-lobed,5.5-9,abaxially,acute,adaxially,along,anther,anthesi,apex,asymmetric,axi,basal,base,berry,calyx,clavate,cm,conical,connivent,corolla,deeply,dendritic,densely,diameter,distal,ellipsoid,especially,extending,filament,flower,glabrous,globose,growth,half,inflorescence,irregularly,lamina,later,lateral,leaf,lengthening,like,lobe,lobed,long,loosely,midvein,minute,minutely,mixture,mm,mostly,new,oblique,pedicel,petiole,pore,poricidal,pubescent,simple,slender,slit,sometimes,sparsely,splitting,spreading,stellate-rotate,stem,stigma,style,surface,tangled,terminal,tip,transparent,trichome,truncate,tube,twining,uniseriate,upper,vein,vine,way,weak,white,woody,yellow,yellowish	-6+,.5,1-1.5-3,198.,2,2-2.5,2-3,4-5,5,5-merou,7-9,9,9-11,ag,alyx,apar,apparently,ark,articulated,branched,broadly,brow,cabrera,complete,cucullat,denser,divided,eaf,ed,elliptic,entire,exerted,fide,free,halfway,ilament,leaving,lower,many,margin,mature,membranous,narrowly,nflorescence,older,orolla,outline,pair,papillo,peduncle,peg,perfect,pinnate,planar,plurifoliat,portion,primary,puberulent,ruit,scandent,scar,seen,sleeve,small,spaced,tem,time,tub,twinin,ud,unit,vary,within,x,ympodial	1-6,abaxial,adaxial,age,arrangement,bark,brown,colour,connation,feature,form,fruit,length,na,number,ovary,papillose,seed,shape,size,texture,width	0.5,0.5-1,0.9-1.1,1,1/2,10,2-4,2.5-3.5,2/3,3-4-celled,30+,5-lobed,5.5-9,abaxially,acute,adaxially,along,anthesi,asymmetric,axi,basal,base,berry,clavate,cm,conical,connivent,deeply,dendritic,densely,diameter,distal,ellipsoid,especially,extending,glabrous,globose,half,inflorescence,irregularly,lamina,later,lateral,lengthening,like,lobe,lobed,long,loosely,midvein,minute,minutely,mixture,mm,mostly,oblique,pore,poricidal,pubescent,simple,slender,slit,sometimes,sparsely,splitting,spreading,stellate-rotate,surface,tangled,terminal,tip,transparent,trichome,truncate,twining,uniseriate,upper,vein,vine,way,weak,white,woody,yellow,yellowish	1-6,age,brown,na,papillose
82	wfo-0001026756	success	147	120	65	80	67	40	59	6	0-7-1.2,0.5-1,0.5-3,1-1.5,1.5-1.7,1.5-10,1.5-2,1.8-3,3-4,3.5-8.5,5-10,5-5.5,6-16,acute,anther,anthesi,apex,attenuate,bark,base,berry,bilobed,broadly,calyx,closely,cm,conical,corolla,deltate,dendritic,densely,difoliate,elliptic,erect,filament,glabrous,globose,green,lax,leaf,lobe,lobed,long,minor,minutely,mm,nearly,opposite,ovary,ovate,ovoid-reniform,pale,pedicel,petiole,pinkish-white,pitted,pore,poricidal,pubescent,scar,shape,shaped,shrub,simple,spaced,stem,stigma,style,surface,tear-drop,thick,tip,tree,trichome,tube,unifoliate,white,wide,woody,young	.25,.5,0.25-0.5,1-2,1.5-3,5-10-flowered,6-10,abaxial,abaxially,adaxially,along,apiculate,ba,brown,corresponding,dark,deflexed,denser,dia,differing,distal,eaf,edicel,eed,exserted,fleshy,free,fruiting,geminat,glabrescent,grayish-brow,hard,inflorescenc,irregular,lamina,lateral,like,lower,main,major,middle,nflorescence,occasionally,older,overlappin,pair,papillo,perhaps,pericarp,planar,portion,present,pubescence,rest,ruit,somewhat,soon,sparsely,strongly,tall,tub,ud,uniseriate,unit,vein,widest,ympodial	0.25,0.5,arrangement,bud,coat,colour,connation,decurrency,dry,feature,flower,form,fruit,grayish-brown,growth,height,history,inflorescence,length,life,midpoint,na,new,number,overlapping,papilla,papillose,plant,prickle,ray,reproduction,seed,size,spacing,specimen,texture,tuberculation,type,width,winging	0-7-1.2,0.5-1,0.5-3,1-1.5,1.5-1.7,1.5-10,1.5-2,1.8-3,3-4,3.5-8.5,5-10,5-5.5,6-16,acute,attenuate,base,berry,bilobed,broadly,closely,cm,conical,deltate,dendritic,densely,difoliate,elliptic,erect,glabrous,globose,green,lax,leaf,lobed,long,minutely,mm,nearly,opposite,ovate,ovoid-reniform,pale,pinkish-white,pitted,poricidal,pubescent,shaped,shrub,simple,spaced,tear-drop,thick,tip,tree,trichome,unifoliate,white,wide,woody	0.25,0.5,grayish-brown,na,overlapping,papillose
83	wfo-0001026777	success	168	128	72	92	76	36	69	3	.5,0.25-0.5,0.5-1,0.5-1.5,0.5-5,0.9-3,1-1.3,1-1.5,1-10,1-2,1-4,1.5-3,1.5-5,2-4,2-4.5,2-5,5-14,5-7,acuminate,acute,anther,anthesi,apart,apex,apiculate,base,berry,blue,calyx,capitate,cell,cm,corolla,cup,decurrent,deflexed,elliptic,fide,filament,filiform,flattened,flattened-reniform,glabrate,glabrous,globose,green,growth,lateral,leaf,lobe,lobed,long,minor,minutely,mm,narrowly,nearly,new,onto,opposite,outline,ovary,papillose,pedicel,petiole,pore,pubescent,quadrate-deltoid,scar,seed,shaped,shrub,sinuate,size,slightly,smooth,sparsely,stem,stigma,style,surface,tear-drop,testa,tip,trichome,tube,uniseriate,vellozo,wall,white,x,young	.25,/3,1.2-1.8,3-3.5,4-8,5-50-flowered,axil,ba,beginning,beneath,body,branching,brown,campanulate,dense,dia,differing,difoliate,distal,eaf,edicel,eed,end,exserted,flexuous,free,fruiting,geminat,greyi,hyaline,incrassate,inflorescenc,irregularly,like,lon,lower,main,major,margin,matted,middle,near,nflorescence,occasionally,often,older,one,overtopping,pair,papillo,pitted,planar,poricidal,portion,prominent,quite,rest,ruit,russet,shiny,somewhat,soon,spaced,straight,tall,tapering,thread-like,tuft,ud,unit,vein,way,widest,woody,yellowish,ympodial	5-50,arrangement,bark,bud,coat,colour,connation,decurrency,dry,embryo,feature,flower,form,fruit,greyish,height,history,inflorescence,length,life,midpoint,na,number,papilla,plant,prickle,ray,reproduction,shape,spacing,specimen,texture,tuberculation,type,width,winging	.5,0.25-0.5,0.5-1,0.5-1.5,0.5-5,0.9-3,1-1.3,1-1.5,1-10,1-2,1-4,1.5-3,1.5-5,2-4,2-4.5,2-5,5-14,5-7,acuminate,acute,apart,apiculate,base,berry,blue,capitate,cell,cm,cup,decurrent,deflexed,elliptic,fide,filiform,flattened,flattened-reniform,glabrate,glabrous,globose,green,lateral,leaf,lobed,long,minutely,mm,narrowly,nearly,onto,opposite,outline,papillose,petiole,pubescent,quadrate-deltoid,shaped,shrub,sinuate,slightly,smooth,sparsely,tear-drop,testa,trichome,uniseriate,vellozo,wall,white,x	5-50,greyish,na
84	wfo-0001026819	success	218	140	97	107	111	33	92	5	0.5-1.5,1-10,1-2,1.5-12,1.5-3.3,1.6-3.5,2-5,3-120,3-18,3-20,3-35,3-38,4-10,5-30,6-11,7,abaxially,absent,acuminate,acute,anther,apart,apex,articulated,attenuate,base,blue,bud,capitate,cell,chartaceous,cm,connate,connivent,corolla,covering,cuneate,dark,decurrent,densely,diameter,distal,dot,especially,filament,flower,fruit,glabrous,glaucous,globose,green,hair,hair-like,herb,lanceolate,lateral,leaflet,lengthening,light,like,lobe,long,lunate,membranous,middle,mm,moderately,mottled,non-glandular,oblique,odd-pinnate,ovoid,pedicel,pentagonal,petiole,plant,pore,poricidal,pubescent,purple,rotate-pentagonal,scale-like,scattered,seed,short,slightly,slit,sometimes,somewhat,stem,stigma,stripe,style,subglabrous,subtending,symmetrical,terminal,testal,thick,tinged,tip,truncate,tube,violet,wall,white,whitish	0-27,0.3-4.7,1-2.3,1-5,1.2-36,1.5-10,1.5-3.0,1.5-3.5,10,10-26,2-6,2.5-5,4,4-7,5-merou,acumen,adaxially,ag,along,alyx,ascending,bearing,blade,borne,broadly,brownish,ciliate,clavat,condition,curved,digestion,dorsally,drying,eaf,edge,eed,elliptic,end,enzyme,erec,exceeding,flat,folded,forked,fresh,geminat,generally,glabrou,greatly,green-white,greenish,greenish-yellow,half,homostylous,honeycomb-shaped,interjected,larger,living,lower,make,margin,midvein,minutely,mucilaginous,narrowly,nflorescence,often,orolla,ovate,pair,pedice,peduncle,petiolule,plurifoliate,puberulent,rachi,ranging,removed,ruit,seudostipule,singly,spaced,specimen,stamen,star,ste,stolo,straight,subequal,suborbicular,subrosette,tall,tamen,tem,tertiary,therefore,throughout,tri-,tuber,typically,unit,unwinged,usually,vary,wet,wide,wing,within,without,yellow,ympodial	age,arrangement,calyx,clavate,colour,connation,feature,form,geminate,growth,height,history,inflorescence,leaf,length,life,na,new,number,ovary,papilla,perennial,reproduction,scar,shape,size,spacing,surface,texture,type,width,winging,young	0.5-1.5,1-10,1-2,1.5-12,1.5-3.3,1.6-3.5,2-5,3-120,3-18,3-20,3-35,3-38,4-10,5-30,6-11,7,abaxially,absent,acuminate,acute,apart,articulated,attenuate,blue,bud,capitate,cell,chartaceous,cm,connate,connivent,covering,cuneate,dark,decurrent,densely,distal,dot,especially,glabrous,glaucous,globose,green,hair,hair-like,herb,lanceolate,lateral,leaflet,lengthening,light,like,lobe,long,lunate,membranous,middle,mm,moderately,mottled,non-glandular,oblique,odd-pinnate,ovoid,pentagonal,poricidal,pubescent,purple,rotate-pentagonal,scale-like,scattered,short,slightly,slit,sometimes,somewhat,stem,stripe,subglabrous,subtending,symmetrical,terminal,testal,thick,tinged,tip,truncate,tube,violet,wall,white,whitish	age,clavate,geminate,na,perennial
85	wfo-0001026821	success	204	110	77	87	117	23	75	2	.2,0.4-1.5,0.5-1.2,0.7-1.8,1-1.5,1-2,1-20,1-5,1.2-1.5,1.5-2.5,10-15,2-celled,2.5-18,3-18,3-branched,4-4.5,5-12,5-20,5-34,anther,apart,apically,appressed,auriculate,base,bayonet,blade,broadly,cm,cordate,dark,deltate,diameter,due,ellipsoidal,flattened,flower,forked,fruit,gglobose,glabrous,green,hair,herb,incurved,lanceolate,lateral,leaf-opposed,length,light,lobe,long,mature,membranous,mm,obliquely,oblong,odd-pinnate,pale,pedicel,peduncle,petiole,pilose,present,puberulent,pubescent,rachi,rarely,remnant,reniform,rounded,short,small,sparsely,stellate,stigma,stripe,style,subglabrous,substellate,surface,thickening,tube,unbranched,wall,x,yellow	/3,0-20,0.2-1.5,0.3-1.2,0.3-2.5,0.5-3.5,0.8-1,1-3,17,1977,2-15,2-3.5,2-6,3-11,3-6,3-7,3-celled,5-10,5-merou,abaxially,acuminate,acut,adaxial,adaxially,ag,alyx,anderson,angular,apex,apical,apiculate,articulated,axe,ba,basal,berry,bract,brown,cell,chartaceous,ciliat,cuneate,directed,distal,distally,eaf,eed,elliptic,equal,especially,exceeding,filament,frequent,fused,geminat,glabrou,gland-tipped,greatly,homostylous,interjected,interstaminal,large,leaflet,long-attenuate,longitudinal,lower,lowermost,many,margin,mean,membrane,minute,minutely,moderately,much,narrowly,nflorescence,oblique,obtuse,occasional,occasionally,one-celled,opening,orolla,pair,paired,per,perfect,petiolule,plurifoliate,pore,pseudostipular,pubescen,reduced,ruit,scandent,seudostipule,slender,slightly,slit,smaller,somewhat,spaced,stamen,subtended,tamen,tem,terminal,time,tri-,truncat,unit,vary,white,wide,winged,ympodial	10-20,arrangement,calyx,colour,corolla,feature,form,growth,inflorescence,leaf,number,ovary,presence,pseudostipule,seed,shape,size,spacing,staman,stem,texture,truncate,width	.2,0.4-1.5,0.5-1.2,0.7-1.8,1-1.5,1-2,1-20,1-5,1.2-1.5,1.5-2.5,10-15,2-celled,2.5-18,3-18,3-branched,4-4.5,5-12,5-20,5-34,apart,apically,appressed,auriculate,base,bayonet,broadly,cm,cordate,dark,deltate,diameter,due,ellipsoidal,flattened,flower,forked,fruit,gglobose,glabrous,green,hair,herb,incurved,lanceolate,lateral,leaf-opposed,light,long,mature,membranous,mm,obliquely,oblong,odd-pinnate,pale,pilose,present,puberulent,pubescent,rarely,remnant,reniform,rounded,short,small,sparsely,stellate,stripe,subglabrous,substellate,thickening,unbranched,wall,x,yellow	10-20,truncate
86	wfo-0001026827	success	142	105	60	77	65	28	57	3	/3,0.4-0.6,0.5-2,0.6-1,1-1.1,1-1.5,1-2,1-2.1,1.3-1.6,2-4,3-9,acute,age,and/or,anther,anthesi,apart,apex,arachnoid,attenuate,bark,base,branched,broadly,calyx,clavate,cm,conical,corolla,deltate,dendritic,densely,ellipsoid,filament,flower,glabrescent,glabrous,growth,inflorescence,internodal,lanceolate,leaf,lengthening,less,like,lobe,lobed,minutely,mm,narrowly,new,nodding,oblanceolate,ovary,papillate,pedicel,petiole,pore,poricidal,pubescent,reddish,scar,shrub,simple,slit,sparsely,stem,stigma,stout,style,surface,tip,trichome,tube,uniseriate,way,white	.5,0.2-0.5,1-2-2.5,1.5-2,2-2.2,5-6,7-9,?,abaxially,adaxiall,appearing,branch,crowded,deciduou,dense,diameter,distally,dry,drying,eaf,erect,especially,exerted,fleshy,free,irregularly,know,known,lamina,lower,margin,near,nflorescence,ot,pair,paler,papillat,peduncle,perfect,planar,plane,plurifoliat,portion,primary,rachi,revolute,sinus,slender,small,soon,straight,strongly,surfac,terminal,thick,thickened,third,tub,ud,unit,upper,vein,widest,x,ympodial	1,abaxial,adaxial,adaxially,arrangement,bud,colour,connation,feature,form,fruit,height,history,length,life,na,number,papilla,plant,reproduction,seed,shape,size,spacing,texture,type,width,winging	/3,0.4-0.6,0.5-2,0.6-1,1-1.1,1-1.5,1-2,1-2.1,1.3-1.6,2-4,3-9,acute,age,and/or,anthesi,apart,arachnoid,attenuate,base,branched,broadly,clavate,cm,conical,deltate,dendritic,densely,ellipsoid,glabrescent,glabrous,inflorescence,internodal,lanceolate,lengthening,less,like,lobed,minutely,mm,narrowly,nodding,oblanceolate,papillate,pore,poricidal,pubescent,reddish,shrub,simple,slit,sparsely,stout,tip,trichome,uniseriate,way,white	1,adaxially,na
87	wfo-0001026830	success	198	110	69	85	113	25	67	2	0.3-1.3,0.9-1.9,1-10,1-11,1-2,1.5-4,10-57,2.5-5,4-10,4-14.5,4-7,4.4-14.5,4.5-17.5,5-11,6-13,7-18,anther,axillary,brown,brownish,bud,ciliate,clavate,cm,connivent,coriaceous,corolla,deep,diameter,distal,elliptic,finely,flower,fruit,glabrescent,glabrous,globose,green,green-white,hair,half,herb,high,lanceolate,leaf,light,linear,lobe,long,margin,medium,mm,moderately,moniliform,mucilaginous,odd-pinnate,ovate,ovoid,pedicel,peduncle,pentagonal,plant,pore,poricidal,puberulent,pubescent,purple,rotate,seed,short,size,stigma,stripe,style,subtending,terminal,throughout,tip,tube,tuber,wet,whitish,x,yellow,yellowish	0-10,0.4-1,0.5-1.0,0.5-1.2,1.1-2.7,1.4-4,2-4,2-6,2.5-4.4,2.7-8,3.5-8.5,5-merou,abaxially,acumen,acuminate,acute,adaxiall,adaxially,ag,along,alyx,apart,apex,apparently,arranged,articulated,asymmetric,attenuate,axe,base,basiscopic,bead,berry,blade,capitat,cell,condition,covering,decreasing,digestion,dorsally,drying,eaf,edge,eed,enzyme,erec,exceeding,filament,flat,folded,forked,fresh,geminat,generally,glabrou,greenish,hair-like,hal,homostylous,honeycomb,interjected,lateral,leaflet,lengthening,like,living,lower,make,multiple,necklace,nflorescence,orbicular,orolla,pair,perfect,petiole,petiolulate,plurifoliate,removed,ripe,rounded,ruit,sessile,seudostipule,shaped,side,simple,slit,spaced,specimen,stamen,stolon,straight,subequal,subglabrou,subglabrous,tall,tamen,tem,testal,thick,tissue,toward,tri-,typically,unit,unwinged,usually,vary,wall,white,ympodial	abaxial,adaxial,arrangement,articulation,calyx,capitate,colour,connation,feature,form,growth,height,history,inflorescence,length,life,number,ovary,perennial,reproduction,shape,spacing,stem,surface,texture	0.3-1.3,0.9-1.9,1-10,1-11,1-2,1.5-4,10-57,2.5-5,4-10,4-14.5,4-7,4.4-14.5,4.5-17.5,5-11,6-13,7-18,axillary,brown,brownish,bud,ciliate,clavate,cm,connivent,coriaceous,deep,distal,elliptic,finely,glabrescent,glabrous,globose,green,green-white,hair,half,herb,high,lanceolate,light,linear,long,medium,mm,moderately,moniliform,mucilaginous,odd-pinnate,ovate,ovoid,pentagonal,poricidal,puberulent,pubescent,purple,rotate,short,stripe,subtending,terminal,throughout,tip,wet,whitish,x,yellow,yellowish	capitate,perennial
88	wfo-0001026831	success	205	145	90	106	99	39	87	3	-5,-6.5,.5,/4,0-3,0.1-0.25,0.2-1,0.3-0.65,0.5-1.2,0.6,0.6-2,1-10,1-2,1-2.5,1-4,1-6,1.2-2,1.5-2.5-9,1/3,2-2.5,2.3-2.9,3-5,acute,anther,apart,apex,apically,articulated,attenuate,bark,base,berry,bright,calyx,cell,cm,connivent,cream,curved,dark,deltate,densely,erect,filament,flattened-reniform,flower,fruit,fully,glabrescent,glabrous,gray-brown,green,lateral,leaf,length,lobe,lobed,long,marking,maturity,mauve,midpoint,mm,moderately,multangulate,narrow-cuneate,occasionally,opening,orange,orange-brown,outline,ovate,pale,pedicel,petiole,poricidal,porrect,prickle,prickly,raised,ray,rounded,scar,sessile,shiny,shrub,smooth,sometimes,spherical,spreading,stellate-pubescent,stem,style,subsessile,surface,tapering,tip,trichome,tube,upper,way,white,white-gray,wide,yellow,young	0-10,0-20,0-6,0.1,0.1-0.2-0.25,0.15-0.25,0.2-0.4,0.3-0.6,0.65-1,0.7-1.1,0.7-2,1-2.2,1-3,1/3-1/,1/3-2/3,1/5-1/4,2-3,2-4,2.5-4.5,3-6,3.5-10,5-merous,7-10,7-8,abaxially,alyx,apar,apparently,blade,branched,broad-deltate,brow,caudat,chartaceous,concolorous,diameter,difoliate,distance,drying,dull,eaf,eed,elliptic,elongating,equal,extending,eye,free,fruiting,geminat,herbaceous,infructescence,less,longer,lower,margin,mature,membranous,midvein,naked,nflorescence,oblong,older,one,open,orolla,oung,pair,peduncle,pendulous,per,perfec,pericarp,portion,prickl,primary,red-brown,reduced,ruit,scandent,shorter,side,slender,spaced,sparsely,stalk,stellate,tamen,terete,tertiary,time,unit,usually,vary,vein,venation,visible,yellow-green,ympodial	anthesi,arrangement,brown,bud,caudate,coat,colour,connation,corolla,decurrency,dry,embryo,feature,form,growth,height,history,inflorescence,life,minor,na,new,number,ovary,papilla,plant,pore,reproduction,seed,shape,size,spacing,specimen,stigma,texture,tuberculation,type,width,winging	-5,-6.5,.5,/4,0-3,0.1-0.25,0.2-1,0.3-0.65,0.5-1.2,0.6,0.6-2,1-10,1-2,1-2.5,1-4,1-6,1.2-2,1.5-2.5-9,1/3,2-2.5,2.3-2.9,3-5,acute,apart,apically,articulated,attenuate,base,berry,bright,cell,cm,connivent,cream,curved,dark,deltate,densely,erect,flattened-reniform,fully,glabrescent,glabrous,gray-brown,green,lateral,lobed,long,marking,maturity,mauve,mm,moderately,multangulate,narrow-cuneate,occasionally,opening,orange,orange-brown,outline,ovate,pale,poricidal,porrect,prickle,prickly,raised,rounded,sessile,shiny,shrub,smooth,sometimes,spherical,spreading,stellate-pubescent,subsessile,tapering,tip,trichome,upper,way,white,white-gray,wide,yellow,young	brown,caudate,na
89	wfo-0001026841	success	139	112	61	74	65	38	57	4	.5,/4,0.25-0.3,0.25-0.5,0.5-2,0.6-1,0.8-1,0.8-3,1.5,3-6.5,3.5-5,4-8,9.2-18,acute,anther,anthesi,apart,apex,bark,base,berry,bi-lobed,broadly,calyx,clavate,cm,conical,corolla,curly-tipped,decurrent,deltoid,ellipsoid,elliptic,filament,filiform,glabrate,glabrous,globose,green,hyaline,inflorescence,later,leaf,lobe,lobed,long,minutely,mm,opposite,ovary,papillose,pedicel,petiole,pore,poricidal,pubescent,scar,shaped,shrub,simple,slightly,sparsely,stem,stigma,style,tear-drop,tip,trichome,tube,uniseriate,way,white,woody,young	.25,0.05,0.5-0.75,0.5-1,0.75-1,1.5-2,2-2.5,5-8-flowered,6-8,7-9,along,arch,axi,ba,beneath,coroll,deflexed,dia,eaf,edicel,eed,exsertion,free,fruiting,greyish-gree,immature,joined,known,lateral,like,lon,lower,main,margin,middle,nflorescence,older,pair,paler,papillo,portion,prominent,raised,reddish,reflexed,rest,ruit,series,shining,slender,spaced,straight,tall,tapering,terminal,thickened,ud,unevenly,unifoliat,unit,vein,widest,winged,x,ympodial	5-8,arrangement,bud,coat,colour,connation,dry,embryo,feature,flower,form,fruit,greyish-green,growth,height,history,length,life,midpoint,na,new,number,papilla,plant,prickle,ray,reproduction,seed,shape,size,spacing,specimen,surface,texture,tuberculation,type,unifoliate,width	.5,/4,0.25-0.3,0.25-0.5,0.5-2,0.6-1,0.8-1,0.8-3,1.5,3-6.5,3.5-5,4-8,9.2-18,acute,apart,base,berry,bi-lobed,broadly,clavate,cm,conical,curly-tipped,decurrent,deltoid,ellipsoid,elliptic,filiform,glabrate,glabrous,globose,green,hyaline,later,leaf,lobed,long,minutely,mm,opposite,papillose,petiole,poricidal,pubescent,shaped,shrub,simple,slightly,sparsely,tear-drop,tip,trichome,uniseriate,way,white,woody,young	5-8,greyish-green,na,unifoliate
90	wfo-0001026849	success	177	105	60	78	99	27	57	3	0.5-1,1,1-2,1-6,1.5-2.5,1.75-2,38/2,5-10,637/2,7-8,acute,anther,apex,aster,base,berry,calyx,capitate,cm,colour,conical,corolla,cyme,discoidal,distinctly,ellipsoid,erect,expanded,flower,flowered,free,glabrous,glandular,globose,green,growth,hair,inflorescence,lavender,leaf,linear-lanceolate,lobe,long,long-cuneate,loosely,minutely,mm,oblong,oblong-lanceolate,ovary,pale,pedicel,petiole,poricidal,pruinose,purple,reproducing,reticulate,rh,rotate,rounded,sea,seed,short-lived,shrub,simple,slightly,soft-wooded,stem,stigma,stout,style,surface,tip,tube,vegetatively,violet,young	0-10,1-1.5,11,2,2-3,30-40-50,5,80-100-130,adherent,adult,amongst,appearing,aspect,australian,axil,brown,cell,composed,conspicuous,curved,cut,deflexed,developed,dia,distinct,eed,emarginate,enlarge,entire,exceeding,except,exerted,facetted,filament,filled,flesh,floral,fork,fruiting,general,globular,granule,greater,gree,grey-brown,half,interacuminal,large,leave,lengthening,less,little,lon,lower,margin,mature,maturity,mid-vein,minute,native,nflorescence,occasionally,often,pal,pedicellate,peduncle,petal,plurifoliat,pore,preparation,rarely,relatively,rhachi,ruit,ruiting,shallow,shed,sinus,slende,slit,solanum,solitary,sometimes,somewhat,soon,stone,stony,thus,tissue,tub,ud,unarmed,undulate,unit,uvenile,way,well,x,ympodial	arrangement,bud,coat,embryo,enlarged,feature,form,fruit,height,history,length,life,na,new,number,papilla,plant,prickle,reproduction,shape,size,slender,spacing,texture,tuberculation,type,width	0.5-1,1,1-2,1-6,1.5-2.5,1.75-2,38/2,5-10,637/2,7-8,acute,aster,berry,capitate,cm,conical,cyme,discoidal,distinctly,ellipsoid,erect,expanded,flowered,free,glabrous,glandular,globose,green,hair,lavender,linear-lanceolate,long,long-cuneate,loosely,minutely,mm,oblong,oblong-lanceolate,pale,poricidal,pruinose,purple,reproducing,reticulate,rh,rotate,rounded,sea,short-lived,shrub,simple,slightly,soft-wooded,stout,tip,vegetatively,violet	enlarged,na,slender
91	wfo-0001026858	success	150	118	77	90	60	28	73	4	0.8,0.8-1,1-10,1-11.5,1-4,1-5,1.3-1.5,1.5-4,2-3,2-4,2.5-3,3-4,4-24,4.5-10.5,6-10,6-7,acute,apex,apical,apically,base,branched,calyx,cell,cm,connate,cordate,corolla,covering,cuneate,cyme,dehiscent,diameter,dichasial,dichasially,ebracteate,filament,flower,forked,glabrescent,glabrous,globose,green,hair-like,herbaceous,interjected,introrse,lateral,leaf,leaflet,light,long,make,maturing,mm,monochasial,mucilaginous,oblique,oblong,obtuse,odd-pinnate,often,ovate,ovate-lanceolate,ovoid,pedicel,peduncle,perennial,petiole,plant,poricidally,rounded,seed,shiny,short,size,slightly,slit,stellate,stigma,straight,style,testal,thick,throughout,triangular,tuber-bearing,wall,wide,yellow	0-.,0.5,1-2-3-4,2-2.5,3-5-15-30,3-6-foliat,6-18,abaxially,abruptly,acumen,adaxially,articulate,digestion,diminishing,distal,dorsally,eaf,edge,eed,emoval,enzyme,exceeding,flat,folded,generally,globo,green-white,half,honeycomb,living,lobe,lon,lower,lunat,minute,mucronate,nflorescence,nther,orolla,pair,pattern,perfect,plan,proximal,reveal,ruit,seudostipule,specimen,stamen,tal,tem,throughou,toward,typically,unit,vary,white-crea,without,ympodial,Â¼	0-2,3-15-30,abaxial,adaxial,anther,arrangement,colour,connation,dehiscence,feature,form,fruit,growth,height,history,inflorescence,length,life,number,ovary,reproduction,shape,stem,surface,texture,wet,white-cream,width	0.8,0.8-1,1-10,1-11.5,1-4,1-5,1.3-1.5,1.5-4,2-3,2-4,2.5-3,3-4,4-24,4.5-10.5,6-10,6-7,acute,apical,apically,branched,cell,cm,connate,cordate,covering,cuneate,cyme,dehiscent,dichasial,dichasially,ebracteate,forked,glabrescent,glabrous,globose,green,hair-like,herbaceous,introrse,lateral,light,long,make,maturing,mm,monochasial,mucilaginous,oblique,oblong,obtuse,odd-pinnate,often,ovate,ovate-lanceolate,ovoid,perennial,poricidally,rounded,seed,shiny,short,slightly,slit,stellate,straight,testal,thick,throughout,triangular,tuber-bearing,wall,wide,yellow	0-2,3-15-30,wet,white-cream
92	wfo-0001026895	success	166	128	72	90	76	38	67	5	0.5-1,0.5-1.2,0.5-1.5,0.5-2,0.8-1,1-1.5,1-5,1.4-2.1,2-2.5,2-3,2/3,3-12,acute,anther,anthesi,apex,apically,attenuate,bark,base,berry,broadly,calyx,campanulate,capitate,closely,cm,conical,corolla,dark,deflexed,dendritic,drying,ellipsoid,elliptic,filament,filiform,flattened,glabrate,glabrous,globose,green,incrassate,internodal,leaf,lobe,lobed,margin,minor,minutely,mm,mustard,narrowly,obovate,often,ovary,pedicel,petiole,pitted,pointed,pore,poricidal,pubescent,reniform,scar,shape,shaped,shrub,shrublet,simple,size,small,soon,spaced,sparsely,stem,stigma,style,surface,tear-drop,tip,trichome,tube,type,way,white,woody,x,yellow,young	.5,0-0.5,1.5-2,2-2.3,2.5-3.2,4.5-5,5-6,5-8-flowered,abaxial,adaxial,along,apical,appearing,ba,borne,broad,brown,contracted,deltoid,denser,dia,differing,difoliate,eaf,edicel,eed,elongate,erect,free,fruiting,geminat,hard,lamina,lateral,like,lon,long,long-exserted,lower,main,major,middle,minute,nflorescence,older,overlappin,pair,pale,papillo,pericarp,portion,present,projection,reddish,reddish-brow,ruit,scattered,shoot,short,side,somewhat,swollen,swollen-based,tall,tan,thin,toothed,tub,tuft,ud,uniseriate,unit,usually,vein,widest,ympodial	5-8,arrangement,bud,coat,colour,connation,decurrency,dry,embryo,feature,flower,form,fruit,growth,height,history,inflorescence,length,life,midpoint,na,new,number,overlapping,papilla,papillose,plant,prickle,ray,reddish-brown,reproduction,seed,spacing,specimen,texture,tuberculation,width,winging	0.5-1,0.5-1.2,0.5-1.5,0.5-2,0.8-1,1-1.5,1-5,1.4-2.1,2-2.5,2-3,2/3,3-12,acute,anthesi,apically,attenuate,base,berry,broadly,campanulate,capitate,closely,cm,conical,dark,deflexed,dendritic,drying,ellipsoid,elliptic,filiform,flattened,glabrate,glabrous,globose,green,incrassate,internodal,lobed,margin,minutely,mm,mustard,narrowly,obovate,often,pitted,pointed,poricidal,pubescent,reniform,shaped,shrub,shrublet,simple,small,soon,spaced,sparsely,tear-drop,tip,trichome,way,white,woody,x,yellow	5-8,na,overlapping,papillose,reddish-brown
93	wfo-0001026905	success	199	141	86	103	96	38	83	3	.5,0-10,0.2-0.5,0.4-1,0.5-0.7,0.5-1.5,0.6-0.7,0.75-1.1,1-2.5,1-20,1-3.7,1-4,1-6,1.9-2.5,1/2-3/4,1/3,2.5-2.9,3-5,3-8,acute,anther,apart,apex,apically,articulated,attenuate,bark,base,berry,calyx,cell,cm,connivent,cream,curved,dark,deltate,densely,diameter,erect,filament,flattened-reniform,flower,fruit,green,inflorescence,lateral,leaf,length,lobe,lobed,long,marking,maturity,mauve,midpoint,mm,moderately,orange,orange-brown,outline,pale,pedicel,petiole,pit,poricidal,porrect,prickle,prickly,raised,ray,red,rounded,scar,sessile,shrub,small,smooth,sometimes,spherical,stalked,stellate,stellate-pubescent,stem,straight,style,subentire,surface,tapering,terete,tip,trichome,tube,unarmed,upper,usually,variously,way,weakly,white,wide,yellow,young	-4,.2,0-2,0-20,0-25,0-3,0.1,0.15,0.2-0.3,0.3-0.4,0.4-0.9,0.4-1.5,0.7-1.4,0.9-1.3,1-2,1/4-2/3,1/5-1/3,2-3,2.5-3.5,2/3-3/,5-6,5-merous,6-8,7-8,abaxially,acuminat,alyx,ame,apar,apparently,blade,branched,brow,c.,chartaceous,difoliate,discolorous,distance,drying,dull,eaf,eed,elongating,equal,extending,eye,free,fruiting,geminat,glabrous,gray-green,infructescence,longer,lower,margin,mature,midvein,naked,oblong,older,one,open,orolla,oung,ovate,pair,peduncle,pendulous,per,perfec,pericarp,portion,prickl,primary,reduced,ruit,shallowly,shorter,side,slender,somewhat,spaced,sparsely,spreading,stalk,tamen,tertiary,time,unit,vary,vein,venation,visible,woody,yellow-green,ympodial	acuminate,anthesi,arrangement,brown,bud,coat,colour,connation,corolla,decurrency,dry,embryo,feature,form,growth,height,history,life,minor,na,new,number,ovary,papilla,plant,pore,reproduction,seed,shape,size,spacing,specimen,stigma,texture,tuberculation,type,width,winging	.5,0-10,0.2-0.5,0.4-1,0.5-0.7,0.5-1.5,0.6-0.7,0.75-1.1,1-2.5,1-20,1-3.7,1-4,1-6,1.9-2.5,1/2-3/4,1/3,2.5-2.9,3-5,3-8,acute,apart,apically,articulated,attenuate,base,berry,cell,cm,connivent,cream,curved,dark,deltate,densely,diameter,erect,flattened-reniform,green,lateral,lobed,long,marking,maturity,mauve,mm,moderately,orange,orange-brown,outline,pale,pit,poricidal,porrect,prickle,prickly,raised,red,rounded,sessile,shrub,small,smooth,sometimes,spherical,stalked,stellate,stellate-pubescent,straight,subentire,tapering,terete,tip,trichome,unarmed,upper,usually,variously,way,weakly,white,wide,yellow,young	acuminate,brown,na
94	wfo-0001026923	success	177	134	79	93	84	41	76	3	.5,0-5,0.25-0.5,0.5-1,0.8-1,1-3,1-4,1-7,1.5-2,2,2-2.5,2-6,20-50,3-4,3-5,4-18,5-10,5-15,5-9,abaxially,acuminate,adaxially,anther,apart,apex,base,black,branched,calyx,chartaceous,cm,connivent,cuneate,densely,directed,distally,erect,filament,flattened,flower,forked,fruit,glabrous,globose,green,hair,intermediate,lanceolate,large,leaf,leaf-opposed,like,lobe,long,longitudinal,midpoint,mm,nearly,oblong,opening,pedicel,peltate,petiole,pore,possibly,pubescent,purple,ray,red,ripening,rounded,rugulose,scale,sessile,shrub,simple,slit,small,sparsely,stellate,stem,stigma,strongly,style,surface,tip,tree,trichome,tube,usually,white,x,yellowish	-5,.1-0.3,0.5,0.6-0.8,1,1-1.5,1.5-4,10,2-3,4-5-,5-6,absent,accrescent,acute,adaxiall,ag,apparently,articulated,axe,ba,blade,brown,capitat,center,covering,curved,cylindrical,deltate,denser,diameter,eaf,eed,eglandular,elliptic,elliptic-ovate,entire,equal,frui,fruiting,fused,geminate,glabrescent,gland-tippe,glandular,held,lateral,light,lower,many-foliate,margin,midvein,moderately,much,multangulate,nflorescence,orange,orolla,paired,peduncle,perfect,pubescence,rachi,relatively,ruit,short,slightly,smaller,sometimes,somewhat,spaced,ste,straight,subtending,tal,tamen,tem,time,unit,uprigh,vary,whitish,wide,yellow,ympodial	age,anthesi,arrangement,bud,capitate,coat,colour,connation,corolla,decurrency,dry,embryo,feature,form,growth,height,history,inflorescence,length,life,minor,na,new,number,ovary,papilla,plant,prickle,reproduction,scar,seed,shape,size,spacing,specimen,texture,tuberculation,type,width,winging,young	.5,0-5,0.25-0.5,0.5-1,0.8-1,1-3,1-4,1-7,1.5-2,2,2-2.5,2-6,20-50,3-4,3-5,4-18,5-10,5-15,5-9,abaxially,acuminate,adaxially,apart,black,branched,chartaceous,cm,connivent,cuneate,densely,directed,distally,erect,flattened,flower,forked,fruit,glabrous,globose,green,hair,intermediate,lanceolate,large,leaf-opposed,like,long,longitudinal,mm,nearly,oblong,opening,peltate,possibly,pubescent,purple,red,ripening,rounded,rugulose,scale,sessile,shrub,simple,slit,small,sparsely,stellate,stem,strongly,tree,trichome,usually,white,x,yellowish	age,capitate,na
95	wfo-0001026925	success	215	106	53	73	142	33	51	2	.5,0.1-0.2,0.5-1.5,0.9-1.8,1-1.3,1-1.4,1-3.5,1.5-4.5,1/3,2-5,2.4-2.6,3-20,3-7,4-10,4-14,5-8,6-17,acute,anther,apart,apex,apparently,attenuate,base,berry,broad-deltate,calyx,cm,connivent,deltate,erect,filament,flattened,flattened-reniform,flower,fruit,glabrescent,lateral,leaf,length,lobe,lobed,maturity,mauve,midpoint,mm,moderately,narrow-deltate,pale,pedicel,pendent,petiole,plant,poricidal,prickle,prickly,ray,scar,shrub,spherical,stellate-pubescent,stem,style,surface,tapering,terminal,tip,tube,upper,white,yellow,yellow-orange,young	/6,0,0-10,0-2,0-20,0-5,0-7,0.1,0.1-0.3,0.2,0.5-4,0.7-1.8,00-200,1-25,1-3,1-4,1.5-2,1.5-2.5,1.8-2,1.8-2.5,1/3-1/2,1/4-2/3,1/6-1/3,2-4,2.4-3,2.5-6,2/,4-5,4-7,5-6,5-merous,5.5-10,6-10,6-8,7-12,abaxially,acuminat,alyx,ame,andromonoecious,apar,apically,articulated,bark,blade,branched,brow,c.,chartaceous,concolorous,cream,curved,dark,diameter,distal,distance,drying,eaf,eed,elliptic,elongating,equal,extending,free,fruiting,gently,glabrous,green,green-brown,hair,hermaphrodite,heterostylous,infructescence,lobing,long,long-styled,longer,lower,lowermost,margin,marking,mature,membranous,midvein,minute,nflorescence,oblong,older,one,open,orange-brown,orolla,oung,ovate,pair,peduncle,pendulous,per,pericarp,plurifoliat,porrect,portion,prickl,primary,rarely,red-brown,reduced,reflexed,rounded,ruit,secondary,sessile,short-styled,side,simple,smooth,sometimes,spaced,sparsely,spreading,stalk,stalked,staminat,stellate,stout,straight,tamen,terete,tertiary,time,translucent,trichome,unarmed,unit,vary,vein,venation,visible,way,wide,woody,ympodial	anthesi,arrangement,bud,coat,colour,connation,corolla,decurrency,dry,embryo,feature,form,growth,height,inflorescence,minor,na,number,ovary,papilla,plurifoliate,pore,seed,shape,size,spacing,specimen,stigma,texture,tuberculation,type,width,winging	.5,0.1-0.2,0.5-1.5,0.9-1.8,1-1.3,1-1.4,1-3.5,1.5-4.5,1/3,2-5,2.4-2.6,3-20,3-7,4-10,4-14,5-8,6-17,acute,apart,apparently,attenuate,berry,broad-deltate,cm,connivent,deltate,erect,flattened,flattened-reniform,glabrescent,lateral,lobed,maturity,mauve,mm,moderately,narrow-deltate,pale,pendent,poricidal,prickly,shrub,spherical,stellate-pubescent,tapering,terminal,tip,upper,white,yellow,yellow-orange	na,plurifoliate
96	wfo-0001026946	success	205	127	82	99	106	28	79	3	0.5-2,0.9-4.3,1-10,1-2,1-4,1.5-2,1.6-3.7,10-39,12-23,2,2-15,2.5-10.5,3-20,3-5,3.5-10,4-7,4.1-9.4,6-24,8-15,8-25,acute,anther,apparently,attenuate,axillary,blade,borne,bud,chartaceous,clavate,cm,connivent,corolla,creamy,deeply,densely,diameter,digestion,elliptic,end,enzyme,filament,flower,forked,fruit,glabrous,globose,green,hair,herb,honeycomb-shaped,lanceolate,lateral,leaflet,like,lobe,long,membranous,mm,mottled,odd-pinnate,ovate,ovoid,pair,pedicel,peduncle,pentagonal,perfect,petiole,plant,poricidal,pubescent,pure,purple,removed,ripe,seed,short,short-pubescent,singly,size,slightly,stellate,stem,stigma,streak,style,subtending,terminal,tip,tube,tuber,typically,unwinged,wall,white,wing,x,yellow-white	0-20,0-5,0.9-3.5,1,2-5,2.7-9,3-6,5-7,5-merou,abaxially,acumen,acuminate,adaxially,ag,along,alyx,apart,apex,articulation,axe,base,berry,broadly,brownish,capitat,cell,ciliate,condition,covering,distal,dorsally,dot,drying,eaf,edge,eed,erec,especially,exceeding,except,extremely,flat,folded,fresh,geminat,generally,glabrou,greatly,green-white,greenish,hair-like,half,homostylous,interjected,lengthening,living,lower,make,margin,midrib,minutely,mucilaginous,narrowly,nflorescence,oblique,often,orbicular,orolla,petiolulate,petiolule,plurifoliate,pore,proximal,puberulent,pubescen,reduced,rounded,ruit,scattered,sessile,seudostipule,slit,spaced,specimen,stamen,ste,stolo,straight,subequal,tall,tamen,tem,testal,thick,thir,throughout,tri-,truncate,unit,usually,variable,vary,wet,whitish,yellow,ympodial	arrangement,calyx,capitate,coat,colour,connation,feature,form,growth,height,history,inflorescence,leaf,length,life,na,number,ovary,presence,pseudostipule,reproduction,shape,spacing,stolon,surface,texture,tuberculation,type	0.5-2,0.9-4.3,1-10,1-2,1-4,1.5-2,1.6-3.7,10-39,12-23,2,2-15,2.5-10.5,3-20,3-5,3.5-10,4-7,4.1-9.4,6-24,8-15,8-25,acute,apparently,attenuate,axillary,borne,bud,chartaceous,clavate,cm,connivent,creamy,deeply,densely,digestion,elliptic,end,enzyme,forked,glabrous,globose,green,hair,herb,honeycomb-shaped,lanceolate,lateral,like,long,membranous,mm,mottled,odd-pinnate,ovate,ovoid,pentagonal,perfect,poricidal,pubescent,pure,purple,removed,ripe,short,short-pubescent,singly,slightly,stellate,stem,streak,subtending,terminal,tip,typically,unwinged,wall,white,wing,x,yellow-white	capitate,na,stolon
97	wfo-0001026962	success	205	126	77	92	113	34	72	5	.05,0.3-0.7,0.5,0.8-1,1,1-2,1-6,1.5-17,1.5-3,1.5-5,10-12,10-20,2-2.5,2-6,3-3.5,6-7,abrupt,acute,anther,apex,bark,base,bud,calyx,cm,connivent,corolla,differing,difoliate,filament,flattened-reniform,flower,fruit,glabrous,globose,green,inflorescence,internodal,leaf,lobe,lobed,longitudinal,major,minor,minutely,mm,obconic,oblong,occasionally,one,opening,opposite,outline,ovate-lanceolate,pale,pedicel,petiole,pitted,pore,pubescent,purplish,rounder,sagittate,shaped,shrub,simple,size,slender,slightly,slit,small,sometimes,somewhat,stellate,stem,stigma,style,surface,tapering,tear-drop,tinged,tip,tree,trichome,tube,unbranched,unifoliate,uniseriate,white,x,yellowish,young	.5,0,0.5-0.8,0.5-1,0.5-1.5,1-1.2,1-1.5,1-3,1-4.5,1.5-2,15-22,2-5,2/3-3/4,3-6,4-5,9-12,9-17,abaxially,abruptly,accrescent,adaxially,ag,alyx,anthesi,apparently,appearing,arising,articulated,axe,basebud,becoming,beneath,blade,brittle,broadly,capitat,cell,chartaceous,closely,composed,constricted,cucullat,cylindrical,darker,deflexed,deltate,densely,denser,diameter,dimorphic,dry,eaf,eed,elliptic,elongate,entire,evenly,except,exerted,free,fruiting,geminat,glabrate,glabrou,ilament,incrassate,later,lateral,like,long,main,margin,material,narrowly,nflorescence,obovoid,often,older,orolla,oung,overlapping,packed,pair,papillose,paten,peduncle,pendent,perfect,portion,prominent,pubescen,rachi,raised,reflexed,remaining,rest,rounded,ruit,soon,straight,tal,tooth,triangular,trunk,unarmed,unit,vary,vein,way,whit,woody,yellow,ympodial	age,arrangement,berry,capitate,coat,colour,connation,decurrency,embryo,feature,form,geminate,growth,height,history,length,life,na,new,number,ovary,papilla,plant,prickle,reproduction,scar,seed,shape,spacing,texture,tuberculation,type,width,winging	.05,0.3-0.7,0.5,0.8-1,1,1-2,1-6,1.5-17,1.5-3,1.5-5,10-12,10-20,2-2.5,2-6,3-3.5,6-7,abrupt,acute,base,calyx,cm,connivent,differing,difoliate,flattened-reniform,glabrous,globose,green,internodal,leaf,lobed,longitudinal,major,minutely,mm,obconic,oblong,occasionally,one,opening,opposite,outline,ovate-lanceolate,pale,pitted,pubescent,purplish,rounder,sagittate,shaped,shrub,simple,size,slender,slightly,slit,small,sometimes,somewhat,stellate,tapering,tear-drop,tinged,tree,trichome,tube,unbranched,unifoliate,uniseriate,white,x,yellowish	age,berry,capitate,geminate,na
98	wfo-0001026964	success	128	124	71	76	52	48	62	9	.2,.5,0,0.5-1,1-2.5,10-30,2-2.5,3-5,3.5-7,?,acuminate,acute,along,anther,anthesi,apex,attenuate,axillary,base,berry,calyx,cm,conical,corolla,distinct,elliptic,filament,filiform,fleshy,flower,free,glabrous,globose,green,greenish,herb,horizontal,lightly,line,lobe,lobed,long,margin,minutely,mm,nearly,obovate,often,one,open,ovary,papillate,pedicel,petiole,pinnate,poricidal,portion,pubescent,purple,reflexed,shape,side,simple,size,sparsely,stigma,style,surface,time,tip,trichome,tube,uniseriate,winged,x,yellow	0.5,1-1.2,10,2-4,4.5-8.5,7-8,basal,beak,bearing,capitat,conspicuously,diameter,differentiated,eaf,edicel,equal,erec,exserted,fruiting,glabrou,immature,known,lateral,leaflet,lenticellate,long-attenuate,lower,nflorescence,noddin,onto,ot,pair,petiolule,primary,purpli,rachi,rugose,ruit,scar,slender,small,smooth,somewhat,tal,tem,terminal,tub,ud,unifoliat,unit,vein,ympodial	abaxial,adaxial,arrangement,bud,capitate,coat,colour,connation,dry,embryo,erect,feature,form,fruit,greyish,growth,hair,height,history,inflorescence,leaf,length,life,midpoint,minor,na,nodding,number,papilla,perennial,plant,pore,prickle,purplish,ray,reproduction,seed,spacing,specimen,stem,texture,tuberculation,type,unifoliate,white,width,winging,young	.2,.5,0,0.5-1,1-2.5,10-30,2-2.5,3-5,3.5-7,?,acuminate,acute,along,anthesi,attenuate,axillary,base,berry,cm,conical,distinct,elliptic,filament,filiform,fleshy,flower,free,glabrous,globose,green,greenish,herb,horizontal,lightly,line,lobed,long,margin,minutely,mm,nearly,obovate,often,one,open,papillate,pinnate,poricidal,portion,pubescent,purple,reflexed,side,simple,sparsely,time,tip,trichome,uniseriate,winged,x,yellow	capitate,erect,greyish,na,nodding,perennial,purplish,unifoliate,white
99	wfo-0001026981	success	249	115	56	77	172	38	54	2	-2.5,0.1-0.3,0.2,0.2-0.4,0.25-0.4,0.3.6-0.8,0.6-1.4,0.6-2,1-2,1.5-2.0,1.5-8.5,1/3,11,2-3-branched,2-locular,3.5-14,4,6-10,7.5,anther,anthesi,apex,articulated,asymmetric,base,calyx,capitate,cm,conical,cordate,corolla,deltate,diameter,distal,filament,flower,fruit,glandular,globose,green,hair-like,herb,imparipinnate,interrupted,leaf,linear,lobe,minutely,mm,narrowly,obovate,orange,orbicular,outgrowth,ovary,ovate,pedicel,pentagonal,perennial,petiole,plant,pubescent,rounded,sessile,simple,sometimes,specimen,stem,stigma,style,surface,tube,type,upto,variously,villous,yellow	-0.4,-14,-4,-8,.2,.2-0.2,0-5,0.05-0.1,0.1-0.2,0.15-0.2,0.2-2,0.3-0.5,0.4-0.5,0.4-0.7,0.4-2,0.45-1.3,0.5,0.5-0.3,0.5-30-35,0.7-0.8,0.8-1.2,0.8-6,0.9-1.4,0.9-1.5,1,1-2-cellular,1-3,1-3-celled,1-3.3,1-4,1.5-5,1.8-2.8,196.,2-3,3-foliate,4-8,4-celled,<,abaxially,absen,absent,abundant,academy,accrescent,acute,adaxially,adpressed,along,amongst,angled,apical,appearance,appendage,appressed,articulation,axi,basiscopically,bay,beak,becoming,bract,bracteole-like,brown,cell,citrus-like,coastal,column,composed,cone,d,dark,densely,eaf,ebracteate,edicel,eed,entire,erect,exserted,fruiting,giving,glabrescent,gree,half,halfway,head,included,initially,interjected,internode,irregularly,jointles,larger,later,lateral,leaflet,less,like,lime,lobed,lon,long,lower,mainly,margin,maturity,mixed,much,multicellular,nflorescence,occasionally,pair,pale,patent,peduncle,per,petiolule,population,present,primary,procumbent,pronounced,proximal,pseudostipule,pubescence,rachi,reflexed,rick,robust,ruit,scen,secondary,see,several,shaggy,shaped,short,shorter,silky,slender,smaller,sparsely,sparser,spreadin,staminal,sterile,straight,strong,tangled,tem,terminal,tertiary,testa,thick,tightly,transparent,trichome,tub,uni-,unicellular,uniseriate,unit,usually,velvety,viny,wall,wide,winged,without,ympodial,â,â	0.2-0.2,arrangement,bud,coat,colour,connation,decurrency,dry,embryo,feature,form,growth,height,history,inflorescence,length,life,midpoint,minor,na,new,number,papilla,pore,prickle,ray,reproduction,scar,seed,shape,size,spacing,texture,tip,tuberculation,width,winging,young	-2.5,0.1-0.3,0.2,0.2-0.4,0.25-0.4,0.3.6-0.8,0.6-1.4,0.6-2,1-2,1.5-2.0,1.5-8.5,1/3,11,2-3-branched,2-locular,3.5-14,4,6-10,7.5,articulated,asymmetric,capitate,cm,conical,cordate,deltate,distal,glandular,globose,green,hair-like,herb,imparipinnate,interrupted,linear,minutely,mm,narrowly,obovate,orange,orbicular,outgrowth,ovate,pentagonal,perennial,pubescent,rounded,sessile,simple,sometimes,upto,variously,villous,yellow	0.2-0.2,na
100	wfo-0001026992	success	243	127	84	105	138	22	81	3	0.2-0.5,0.25-0.45,0.6-1.5,1-4,1.2-1.4,1.4-1.6,1.4-1.9,1.5-3.4,1.7-2.4,1.7-4.3,12-33,2-10,2.3-3.3,3-4,3.3-5.6,5-15,5.3-12.1,6-10,8-14,abruptly,acuminate,acute,adaxially,anther,anthesi,apart,apex,attenuate,bark,base,berry,blunt-tipped,branched,broadly,brown,calyx,chartaceous,cm,corolla,deltoid,directed,distally,echinoid,elliptic,entire,filament,fleshy,flower,fruit,globose,granular-tomentose,greenish,lance-ovate,lanceolate,leaf,length,lobe,many,margin,mm,moderately,multangulate,oblong,ovate,ovate-lanceolate,pedicel,peduncle,petiole,plant,pore,poricidal,pubescent,rachi,reniform,reticulate-punctate,ripe,short,shrub,simple,size,small,sometimes,somewhat,sparingly,stellate,stem,stigma,style,subcampanulate,subglobose,surface,terminal,time,tip,tomentose,tree,tube,unarmed,violet,white,whitish,x,yellow,yellowish,young	-2.5,/7,0.5-1.2,0.8-3.4,00-170,1.2-1.7,1.3-2.6,1.3-4.3,1.7-1.9,1/2,10-12,2-5.6,2.6-4.6,2.8-4.6,2.8-4.7,3.3-5.5,4-8,5-merou,8,8-11,abaxial,abaxially,accrescent,adaxiall,ag,along,alyx,angled,apparently,appressed,approximately,around,articulated,axe,axillary,ba,blade,branch,capitat,completely,coriaceous,covering,crown,cylindrical,dark,densely,diameter,drying,eaf,echinoi,edge,eed,enveloping,equal,evident,exserted,farinose,flat-topped,forming,free,fruiting,geminate,glabrescen,glabrous,grooved,hair,high,homostylous,immature,inserted,lacking,lateral,lengthening,less,line,lobed,long,long-stalked,longitudinal,longitudinally,lower,m.,main,mature,maturity,midrib,minute,mostly,nearly,nflorescence,obtuse,occasional,occasionally,often,older,orange-tan,orolla,overlapping,perfect,plurifoliate,porrect-stellate,pubescence,rare,rather,ruit,runk,scabridulous-,semi-ovate,sessile,short-,short-stalked,shorter,side,slit,spaced,split,spreading,stalked,stamen,stout-stalked,suture,tamen,tan,terete,thin-textured,ud,unarme,unequal,unit,usually,vary,vein,velutinous,way,weakly,wide,ympodial,Â½	100-170,arrangement,bud,capitate,colour,feature,form,growth,height,history,inflorescence,life,na,number,ovary,reproduction,seed,shape,spacing,texture,type,width	0.2-0.5,0.25-0.45,0.6-1.5,1-4,1.2-1.4,1.4-1.6,1.4-1.9,1.5-3.4,1.7-2.4,1.7-4.3,12-33,2-10,2.3-3.3,3-4,3.3-5.6,5-15,5.3-12.1,6-10,8-14,abruptly,acuminate,acute,adaxially,anthesi,apart,attenuate,berry,blunt-tipped,branched,broadly,brown,chartaceous,cm,deltoid,directed,distally,echinoid,elliptic,entire,fleshy,flower,fruit,globose,granular-tomentose,greenish,lance-ovate,lanceolate,many,mm,moderately,multangulate,oblong,ovate,ovate-lanceolate,poricidal,pubescent,reniform,reticulate-punctate,ripe,short,shrub,simple,small,sometimes,somewhat,sparingly,stellate,subcampanulate,subglobose,terminal,time,tip,tomentose,tree,unarmed,violet,white,whitish,x,yellow,yellowish	100-170,capitate,na
101	wfo-0001026994	success	260	123	71	88	172	35	66	5	0.4-0.5-0.7,0.5,0.5-0.6-0.7,0.5-2,1,1-1.4,1-1.5,1-1.6,2.2-3.2,4,5-7-13-20,6-20-30,8-12,acuminate,acute,anther,apex,base,basiscopically,beneath,berry,bifurcate,branched,bright,broadly,calyx,capitate,cell,cm,conical,corolla,densely,diameter,eglandular,filament,flower,fruit,glabrous,globose,grayish,green,greenish,hair-like,herb,imparipinnate,inflorescence,interrupted,lanceolate,lateral,leaf,less,lobe,locule,margin,minutely,mm,obovate,outgrowth,ovary,paler,pedicel,perennial,petiole,puberulent,pubescent,purple,rachi,regularly,ripe,rotate-stellate,simple,size,stem,stigma,stripe,style,surface,testa,tip,trichome,tube,uniseriate,usually,velvety,wall,white,yellow,young	-foliate,.2,.5,0.05-0.1,0.05-0.2,0.1,0.1-0.2,0.1-0.3,0.15-0.2,0.2-0.4,0.2-0.5,0.25,0.3-0.4,0.4-1.2,0.5-0.6,0.5-0.7,0.5-0.8,0.5-0.9,0.5-1.2,0.5-1.3,0.7-2.5,0.9-1.2,0.9-1.3,1-1.2,1-2,1.2-1.6,1.2-3.5,1.4-2.1,10-20,12-20-50,2,2-2.5-6.5-10,2-2.6,2-4,2-5-locular,3,3-branched,4-15,4-celled,5,5-7,8,abaxially,absent,abundant,acroscopically,additional,adpressed,along,also,amongst,andscattered,anthesi,apical,apically,appearance,appendage,articulate,articulation,basal,basally,becoming,bent,bifurcation,bract,bracteate,broader,brown,celled,column,crenat,crenate,crowded,dark,darker,decreasing,decumbent,decurrent,deeply,developed,distal,eaf,ebracteate,edicel,eed,elliptic,erect,especially,essentially,exserted,fewer,fruiting,giving,glandular,gree,habitat,hal,half,halfway,head,interjected,internode,investing,irregularly,lamina,large,larger,largest,leaflet,leave,like,lobed,lon,long,loosely,lower,markedly,medial,midvein,moderately,much,narrower,narrowing,narrowly,nearly,nflorescence,node,oblique,occasionally,often,pair,papillate,peduncle,petiolule,present,primary,pseudostipule,rarely,reflexed,robust,rocky,secondary,sessile,set,shaggy,short,silky,sinus,slightly,sometimes,sparsely,specimen,spreadin,spreading,staminal,sterile,straight,tall,tem,terminal,tertiary,thick,toward,ud,unicellular,unit,weak-walled,well,wide,winged,woody,ympodial	2.5-6.5-10,20-50,abaxial,adaxial,alternate,arrangement,bark,bud,colour,connation,decurren,decurrency,feature,form,growth,height,history,length,life,minor,na,new,number,papilla,plant,pore,reproduction,scar,seed,shape,spacing,texture,type,width,winging	0.4-0.5-0.7,0.5,0.5-0.6-0.7,0.5-2,1,1-1.4,1-1.5,1-1.6,2.2-3.2,4,5-7-13-20,6-20-30,8-12,acuminate,acute,apex,basiscopically,beneath,berry,bifurcate,branched,bright,broadly,capitate,cell,cm,conical,densely,eglandular,glabrous,globose,grayish,green,greenish,hair-like,herb,imparipinnate,interrupted,lanceolate,lateral,less,locule,margin,minutely,mm,obovate,outgrowth,paler,perennial,puberulent,pubescent,purple,rachi,regularly,ripe,rotate-stellate,simple,stripe,testa,trichome,uniseriate,usually,velvety,wall,white,yellow	2.5-6.5-10,20-50,alternate,decurren,na
102	wfo-0001026996	invalid_json	188	125	NA	96	92	29	NA	NA	0-6,0.6-1,0.9-2.7,1-2,1-3,1.2-1.8,1.3-7.7,1.8-4.4,14-33,15-28,3-10,3-5,3-7,3.3-6,3.8-14.1,4-4.4,4-8,4.5-10.5,6-8,6.9-10.9,8.7-18.6,acumen,anther,axillary,blade,blue,brownish,bud,cell,clavate,cm,condition,connivent,coriaceous,corolla,covering,dark,deep,diameter,drying,flower,fresh,fruit,glabrous,globose,green,green-white,greenish,hair-like,herb,interjected,lanceolate,lateral,leaf,leaflet,lilac,lobe,long,make,medium,mm,moniliform,mottled,mucilaginous,odd-pinnate,ovate,ovoid,pedicel,peduncle,pentagonal,petiole,plant,poricidal,purple,ripe,rotate,seed,size,stigma,straight,stripe,style,subtending,terminal,testal,thick,throughout,tip,tube,tuber,unwinged,wall,wet,white,whitish,x	1-4,1-5,2-3,5-8,5-merou,abaxiall,abaxially,acuminate,acute,adaxially,ag,along,alyx,apart,apex,apparently,arranged,articulated,asymmetric,attenuate,axe,base,basiscopic,bead,berry,capitat,considerably,decreasing,digestion,distal,dorsally,eaf,edge,eed,elliptic,enzyme,erec,exceeding,filament,flat,folded,forked,geminat,generally,glabrou,half,homostylous,honeycomb-shaped,larger,lengthening,like,linear,living,lower,middl,multiple,necklace,nflorescence,orbicular,orolla,pair,perfect,petiolulate,plurifoliate,pore,removed,rounded,ruit,sessile,seudostipule,side,slightly,slit,sometimes,spaced,specimen,stamen,stolon,subglabrou,symmetric,tall,tamen,tem,tissue,toward,tri-,typically,unit,usually,vary,yellow,ympodial	abaxial,adaxial,arrangement,calyx,capitate,characteristic,colour,connation,feature,form,growth,height,history,inflorescence,length,life,number,ovary,perennial,pseudostipule,reproduction,shape,spacing,stem,subglabrous,surface,texture,type,value	NA	NA
103	wfo-0001027010	success	198	114	76	87	111	27	72	4	0-2.5,0.4-5.1,0.5-1.5,1-10,1-2,1.2-1.7,1.2-1.9,10-60,14-46,2.1-4.3,2.2-12.9,3-10,3-5,3-8,4-12,5-13,acute,anther,axillary,bud,cell,clavate,cm,connivent,coriaceous,corolla,covering,deep,diameter,elliptic,filament,flower,fruit,glabrescent,glabrous,green,green-white,hair,hair-like,herb,homostylous,lanceolate,lateral,leaf,light,long,make,mm,moniliform,mucilaginous,narrow,odd-pinnate,ovate,ovoid,pedicel,peduncle,pentagonal,petiole,plant,poricidal,purple,ripe,rotate,scabrous,seed,short,size,sometimes,spot,stigma,stripe,style,subtending,terminal,testal,thick,throughout,tip,tuber,usually,wall,wet,white,wide,wing,winged,yellow	0-2,0-3,1-4,1-7,1.4-6.9,2-6,2-9.4,2.1-15.3,3-6,3.5-13.6,4-8,4.4-29,4.9-31,5-14,5-merou,abaxially,acumen,acuminate,adaxiall,adaxially,ag,along,alyx,apart,apex,apparently,arranged,articulated,asymmetric,attenuate,axe,base,basiscopic,bead,blade,brownish,capitat,coloration,condition,decreasing,digestion,distal,dorsally,drying,eaf,edge,eed,enzyme,erec,exceeding,flat,folded,forked,fresh,geminat,generally,glabrescen,glabrou,greenish,hal,half,high,honeycomb-shaped,interjected,larger,leaflet,lengthening,like,living,lobe,lower,multiple,necklace,nflorescence,occasionally,orbicular,orolla,pair,perfect,petiolulate,plurifoliate,pore,present,removed,rounded,ruit,scabrou,sessile,seudostipule,side,slightly,slit,spaced,specimen,stamen,stolon,straight,subequal,tall,tamen,tem,tissue,toward,tri-,tube,typically,unit,vary,whitish,x,ympodial	5-merous,abaxial,adaxial,arrangement,calyx,capitate,colour,feature,form,growth,height,history,inflorescence,length,life,na,number,ovary,perennial,pseudostipule,reproduction,shape,spacing,staman,stem,surface,texture	0-2.5,0.4-5.1,0.5-1.5,1-10,1-2,1.2-1.7,1.2-1.9,10-60,14-46,2.1-4.3,2.2-12.9,3-10,3-5,3-8,4-12,5-13,acute,axillary,bud,cell,clavate,cm,connivent,coriaceous,covering,deep,elliptic,glabrescent,glabrous,green,green-white,hair,hair-like,herb,homostylous,lanceolate,lateral,light,long,make,mm,moniliform,mucilaginous,narrow,odd-pinnate,ovate,ovoid,pentagonal,poricidal,purple,ripe,rotate,scabrous,seed,short,sometimes,spot,stripe,subtending,terminal,testal,thick,throughout,tip,usually,wall,wet,white,wide,wing,winged,yellow	5-merous,capitate,na,perennial
104	wfo-0001027019	success	142	119	65	81	61	38	60	5	0-0.5,0.5-1,1-1.5,1-2,1.5-3,12-30,2-3,2-5,2-8,4-8.5,7-14,acute,anther,anthesi,apex,attenuate,bark,base,berry,branched,calyx,capitate,cm,corolla,cyathiform,deflexed,deltoid,densely,ellipsoid,elliptic,erect,filament,flattened,fleshy,glabrate,globose,golden,green,inflorescence,later,leaf,lobe,minor,minutely,mm,obovate,onto,opposite,ovary,overlapping,ovoid-reniform,papillose,pedicel,petiole,pitted,plant,pore,poricidal,pubescent,scar,shaped,shrub,small,somewhat,spaced,stem,stigma,straight,style,surface,tear-drop,tip,tree,trichome,tube,waxy,white,winged,woody,x,young	.5,/4,1.5-2,1/2,10,10-40-flowered,4-5,abaxial,abaxially,abruptly,adaxially,along,apparent,ba,bright,constriction,dia,difoliate,distal,eaf,edicel,eed,even,exserted,free,fruiting,geminat,glabrous,inflorescenc,largely,like,live,lobed,lon,long,lower,major,midrib,narrowed,nflorescence,older,pale,papillo,planar,portion,reddish-brow,rest,ruit,sparsely,strongly,tall,tan,tapering,third,tub,ud,unit,way,widest,wing,ympodial	0.5,10-40,alternate,arrangement,bud,coat,colour,connation,decurrency,dry,feature,flower,form,fruit,growth,height,history,length,life,midpoint,na,new,number,papilla,prickle,ray,reddish-brown,reproduction,seed,shape,size,spacing,specimen,texture,tuberculation,type,width,winging	0-0.5,0.5-1,1-1.5,1-2,1.5-3,12-30,2-3,2-5,2-8,4-8.5,7-14,acute,attenuate,berry,branched,capitate,cm,cyathiform,deflexed,deltoid,densely,ellipsoid,elliptic,erect,flattened,fleshy,glabrate,globose,golden,green,later,leaf,minutely,mm,obovate,onto,opposite,overlapping,ovoid-reniform,papillose,petiole,pitted,poricidal,pubescent,shaped,shrub,small,somewhat,spaced,straight,tear-drop,tip,tree,trichome,waxy,white,winged,woody,x,young	0.5,10-40,alternate,na,reddish-brown
105	wfo-0001027030	success	228	141	92	112	116	29	89	3	-15,.5,0.2,0.3-0.5,0.4-0.5,0.5,0.7-1,0.8-0.9,1,1-1.3,1-3,2-6,2-7,2-locular,2.2-3.2,5-12,abaxial,abundant,acuminate,acute,anther,apex,articulated,base,basiscopically,branched,bright,calyx,capitate,cell,cm,conical,corolla,crenate,dark,decurrent,deeply,densely,denser,diameter,distal,due,elliptic,entire,evenly,extremely,filament,flower,fruit,globose,grayish,green,hair-like,half,herb,imparipinnate,inflorescence,interrupted,lamina,lanceolate,larger,lateral,leaflet,like,lobe,long,margin,minutely,mm,narrowly,node,oblique,obovate,often,outgrowth,ovary,pale,paler,papillate,pedicel,perennial,petiole,present,primary,pseudostipule,pubescence,pubescent,rotate-stellate,simple,size,slender,soft,sometimes,sparsely,spread,stem,stigma,stripe,style,surface,terminal,testa,trichome,truncate,tube,uniseriate,vein,velvety,wall,weak,yellow,young	.2,0-4,0.05-0.1,0.1-0.7,0.1-0.9,0.15-0.2,0.2-0.3,0.2-1,0.3-0.4-1.5,0.3-0.7,0.4-0.8,0.5-0.6-1.8,0.5-0.7,0.5-0.8,0.5-1,0.5-1-3.4,0.6-0.7,0.6-0.8,0.8-1,0.9-1.1,1-1.2,1-2-4-11,1.2-1.6,1.5-2-4.8,1.6-2,2-3,2-3-9,2-foliate,3-4-celled,3-8,4-celled,8-celled,abaxially,absent,adaxially,adpressed,angled,anthesi,apical,appearance,appendage,articulation,axi,basal,beneath,berry,beyond,bract,brown,column,crenat,crenation,darker,deeper,diamete,eaf,edicel,eed,eglandular,exserted,fruiting,giving,gland,glandular,gree,growt,hal,halfway,interjected,internode,interspersed,investing,irregularly,less,lon,longer,loosely,lower,multicellular,near,nflorescence,occasionally,pair,peduncle,petiolule,reflexed,robust,ruit,secondary,sessile,silky,similar,slightly,small,smaller,somewhat,spreadin,spreading,staminal,sterile,straight,tall,tem,tertiary,thick,tiny,trailing,ud,unicellular,unit,usually,white,wide,winged,woody,ympodial	2-9,adaxial,alternate,arrangement,bud,colour,connation,feature,form,growth,hair,height,history,leaf,length,life,na,new,number,papilla,plant,pore,reproduction,seed,shape,texture,tip,type,width	-15,.5,0.2,0.3-0.5,0.4-0.5,0.5,0.7-1,0.8-0.9,1,1-1.3,1-3,2-6,2-7,2-locular,2.2-3.2,5-12,abundant,acuminate,acute,apex,articulated,base,basiscopically,branched,bright,capitate,cell,cm,conical,crenate,dark,decurrent,deeply,densely,denser,distal,due,elliptic,entire,evenly,extremely,globose,grayish,green,hair-like,half,herb,imparipinnate,interrupted,lamina,lanceolate,larger,lateral,like,long,minutely,mm,narrowly,node,oblique,obovate,often,outgrowth,pale,paler,papillate,perennial,present,pubescence,pubescent,rotate-stellate,simple,size,slender,soft,sometimes,sparsely,spread,stem,stripe,testa,trichome,truncate,uniseriate,vein,velvety,wall,weak,yellow	2-9,alternate,na
106	wfo-0001027035	success	199	110	68	84	115	26	65	3	0.1-0.9,0.3-2.3,0.4-12.8,0.5-7,0.9-3.1,1-2,1-3.4,1-8,10-80,2-38,3-10,3-5,4-18,4-18.5,anther,axillary,blue,bud,cell,clavate,cm,coloration,completely,connivent,corolla,covering,deep,diameter,elliptic,filament,flower,fruit,glabrescent,glabrous,globose,green,hair,hair-like,herb,homostylous,lanceolate,lateral,leaf,light,lilac,lobe,long,make,medium,mm,moniliform,mucilaginous,odd-pinnate,ovate,ovoid,pedicel,peduncle,pentagonal,petiole,plant,pore,poricidal,purple,ripe,rotate,seed,shape,short,size,sometimes,stigma,stripe,style,subtending,terminal,testal,thick,tip,tube,tuber,usually,wall,wet,white	0-36,0-7,0.5-3.4,0.5-5,0.8-3,0.8-4.2,1-3,1.5-5.9,1.7-8,1.8-5.2,2-7,2.8-10.3,4.9-23.5,5-merou,abaxially,acumen,acuminate,acute,adaxiall,adaxially,ag,along,alyx,apart,apex,apparently,arranged,articulated,asymmetric,attenuate,axe,base,basiscopic,bead,blade,brownish,capitat,condition,decreasing,digestion,distal,dorsally,drying,eaf,edge,eed,enzyme,erec,exceeding,flat,folded,forked,fresh,geminat,generally,glabrescen,glabrou,green-white,greenish,hal,half,high,honeycomb,interjected,larger,leaflet,lengthening,like,living,lower,multiple,necklace,nflorescence,orbicular,orolla,pair,perfect,petiolulate,plurifoliate,present,removed,rounded,ruit,second,sessile,seudostipule,shaped,side,slightly,slit,smaller,spaced,specimen,stamen,stolon,straight,subequal,subglabrous,tall,tamen,tem,throughout,tissue,toward,tri-,typically,unit,unwinged,variable,vary,whitish,wide,x,yellow,ympodial	5-merous,abaxial,adaxial,arrangement,calyx,capitate,colour,connation,feature,form,growth,height,history,inflorescence,length,life,na,number,ovary,pseudostipule,reproduction,spacing,stem,surface,texture,width	0.1-0.9,0.3-2.3,0.4-12.8,0.5-7,0.9-3.1,1-2,1-3.4,1-8,10-80,2-38,3-10,3-5,4-18,4-18.5,axillary,blue,bud,cell,clavate,cm,coloration,completely,connivent,covering,deep,elliptic,glabrescent,glabrous,globose,green,hair,hair-like,herb,homostylous,lanceolate,lateral,light,lilac,long,make,medium,mm,moniliform,mucilaginous,odd-pinnate,ovate,ovoid,pentagonal,poricidal,purple,ripe,rotate,seed,short,sometimes,stripe,subtending,terminal,testal,thick,tip,usually,wall,wet,white	5-merous,capitate,na
107	wfo-0001027050	success	244	134	77	100	144	34	74	3	-12,-9,/3,0.3-1.5,1-1.5,1-2,1.5-6,10-13.5,15-50+,2-2.5,2-5,2-8,4-20,5,5-6,8-26,acuminate,acute,anther,apex,bark,base,berry,branched,brown,calyx,capitate,closely,cm,connivent,cordate,cuneate,deeply,densely,directed,distally,entire,erect,ferruginous,filament,flattened-reniform,flower,fruit,glabrous,glandular-puberulent,green,growth,inflorescence,lanceolate,lateral,leaf,leaf-opposed,length,lobe,lobed,midpoint,minute,minutely,mm,moderately,narrowly,obtuse,ovate-lanceolate,pedicel,petiole,plant,pore,poricidal,prickle,pubescent,ray,ripe,rounded,scar,several,short-stalked,shrub,small,somewhat,spaced,spherical,stellate,stem,stigma,style,surface,time,tip,touching,tree,triangular,trichome,truncate,tube,unbranched,way,white,woody,yellowish-green,young	.2,.5,0-0.2,0-3,0.1-0.3,0.1-3,0.2-0.5,0.2-1,0.5-3,0.8,0.9-2.1,1,1.5-2,12-15,2-3,2-4,2.5-3,3-5,4-8,5-10,5-7,5-9,5-merous,50,6-8,7-30+,abaxial,abaxially,absen,absent,abundant,adaxial,adaxiall,adult,alyx,andromonoeciou,apar,arme,articulated,axe,basal,blade,branch,broad,broad-based,broadly,brow,chartaceous,coarsely,conical,curved,diameter,difoliate,distal,distall,drying,eaf,eed,eglandular,elliptic,equal,erec,except,flattened,free,fruiting,geminat,hair,half,heterostylous,infructescence,inside,interpetalar,juicy,juvenile,larger,least,less,like,long,long-styled,longer,lower,margin,markedly,mature,mid-way,midrib,midvein,moist,mucilaginous,multiseriate,near,nflorescence,numerous,oblique,occasionally,often,older,orolla,oung,ovate,pale,papillat,peduncle,per,pericarp,porrect,portion,present,pricklier,prickly,rest,ruit,scattered,secondary,sessile,shallowly,shiny,short-styled,shorter,side,slightly,sparsely,stalk,stalked,stellate-pubescent,straight,tall,tamen,terete,thicker,tissue,toothed,unarmed,unit,usually,vary,weakly,whitish,wide,yellow,ympodial,younger	anthesi,apart,arrangement,bud,coat,colour,connation,corolla,decurrency,dry,embryo,feature,form,height,history,life,minor,na,new,number,ovary,papilla,papillate,reproduction,seed,shape,size,spacing,specimen,texture,tuberculation,type,width,winging	-12,-9,/3,0.3-1.5,1-1.5,1-2,1.5-6,10-13.5,15-50+,2-2.5,2-5,2-8,4-20,5,5-6,8-26,acuminate,acute,base,berry,branched,brown,capitate,closely,cm,connivent,cordate,cuneate,deeply,densely,directed,distally,entire,erect,ferruginous,flattened-reniform,glabrous,glandular-puberulent,green,lanceolate,lateral,leaf-opposed,lobed,minute,minutely,mm,moderately,narrowly,obtuse,ovate-lanceolate,poricidal,pubescent,ripe,rounded,several,short-stalked,shrub,small,somewhat,spaced,spherical,stellate,time,tip,touching,tree,triangular,trichome,truncate,unbranched,way,white,woody,yellowish-green	apart,na,papillate
108	wfo-0001027050	success	234	157	107	122	112	35	105	2	0-0.2,0.1-3,0.5-1,0.8,1-1.5,1-2,1.5-6,10-13.5,15-50+,2-10,2-2.5,2-3,2-3-locular,2-5,2-6,2-8,2.5-3,3-15,3-5,4-40,5-10,5-6,6-8,8-40+,abaxially,absent,acuminate,acute,adaxially,anther,apex,base,branched,broadly,brown,calyx,chartaceous,cm,connivent,cordate,cuneate,densely,diameter,directed,distally,drying,eglandular,elliptic,except,extra-axillary,ferruginous,filament,flattened,flower,forked,fruit,glabrous,glandular-puberulent,globose,green,growth,hair,inflorescence,interpetalar,lanceolate,lateral,leaf,leaf-opposed,length,like,lobe,long,longer,midpoint,minute,minutely,mm,moderately,multiseriate,narrowly,oblique,obtuse,often,ovate,ovate-lanceolate,pedicel,petiole,pitted,plant,pore,porrect,present,prickle,ray,rounded,shrub,simple,small,somewhat,sparsely,stalk,stellae,stellate,stellate-pubescent,stem,stigma,style,surface,tip,tissue,tree,triangular,truncate,tube,unarmed,unbranched,usually,white,whitish,x,yellow,yellowish-green	.2,0-0.5,0-1,0-3,0.2-0.6,0.2-1,0.3-0.6,0.4-1,0.5-0.8,0.5-3,1-5,1.5-2,10-30,11-21,12-15,14-20,16-40,2-4,2-foliate,23-40+,4-19,4-8,5,5-7,5-9,5-merous,7-30+,8-26,absen,abundant,accrescent,across,adaxiall,adult,andromonoecious,anvil-shape,apart,armed,articulated,axe,ba,blade,branche,broad-based,capitat,coarsely,contiguous,cross-section,curved,cylindrical,deeply,distall,distributed,eaf,eed,entire,erect,exocarp,fruiting,functional,geminat,half,held,juicy,juvenile,less,lobed,lower,margin,markedly,mature,mesocarp,midvein,moist,mucilaginous,nearly,nflorescence,orolla,pair,pale,peduncle,per,pinnatifid,placenta,rachi,ruit,scattered,sessile,shallowly,shorter,side,slightly,spaced,stalked,straight,tal,tamen,tem,thick,thicker,throughout,time,toothed,unarme,unit,upper,upright,vary,weakly,wide,ympodial,younger	anthesi,arrangement,bark,bud,capitate,coat,colour,connation,corolla,decurrency,dry,feature,form,height,history,life,minor,na,new,number,ovary,papilla,reproduction,scar,seed,shape,size,spacing,specimen,texture,tuberculation,type,width,winging,young	0-0.2,0.1-3,0.5-1,0.8,1-1.5,1-2,1.5-6,10-13.5,15-50+,2-10,2-2.5,2-3,2-3-locular,2-5,2-6,2-8,2.5-3,3-15,3-5,4-40,5-10,5-6,6-8,8-40+,abaxially,absent,acuminate,acute,adaxially,branched,broadly,brown,chartaceous,cm,connivent,cordate,cuneate,densely,diameter,directed,distally,drying,eglandular,elliptic,except,extra-axillary,ferruginous,flattened,forked,glabrous,glandular-puberulent,globose,green,hair,interpetalar,lanceolate,lateral,leaf-opposed,like,lobe,long,longer,midpoint,minute,minutely,mm,moderately,multiseriate,narrowly,oblique,obtuse,often,ovate,ovate-lanceolate,pitted,pore,porrect,present,ray,rounded,shrub,simple,small,somewhat,sparsely,stalk,stellae,stellate,stellate-pubescent,stem,surface,tip,tissue,tree,triangular,truncate,tube,unarmed,unbranched,usually,white,whitish,x,yellow,yellowish-green	capitate,na
109	wfo-0001027091	success	142	123	72	76	66	47	69	3	.3,0.7,1-1.6,1.8-2.6,1/2-2/3,2.3-2.9,3-8,3-9,4-10,5-11,8.5-11.5,9-13,acute-tipped,annual,anther,arcuate,base,berry,blade,blue,bristly,broadly,calyx,capitate-glandular,cauline,cm,deltoid,densely,dia,dm,glabrous,green,hair,herb,internodal,lenticular,linear-lanceolate,lobe,long,longer,low,mm,mostly,narrowly,near,obtuse,occasionally,oriented,ovate,pedicel,petiole,pinnatifid,pinnatisect,prickly,radially,reticulately,ridge,rounded,simple,sparsely,spherical,stellate-pentagonal,stem,suffused,surface,tapering,terete,terminally,tube,twice,undulate,uniseriate,usually,vestiture,violet,wrinkled	0.8,1.1-1.6,2.5-3.5,30-60,6-10,6-10-flowere,accrescent,across,along,alyx,anthesi,armed,beneath,branched,brown,campanulate,dark,developing,difoliate,divided,dry,eaf,eed,enveloped,extended,few-rayed,fully,geminat,gland,glandular,high,invested,lon,main,maturity,nflorescence,orolla,per,ruit,scattered,sessile,short,short-stipitate,slende,sometimes,somewhat,splitting,spreadingly,ste,stellae,strait,tamen,taprooted,tightly,tigma,tub,tyle,unexpande,unit,variously,vary,vein,wholly,yello,ympodial,younger	6-10-flowered,apex,arrangement,bud,colour,connation,corolla,decurrency,embryo,feature,filament,flower,form,fruit,growth,height,history,inflorescence,leaf,length,life,midpoint,minor,na,new,number,ovary,papilla,plant,pore,prickle,ray,reproduction,scar,seed,shape,size,spacing,stigma,style,texture,tip,type,unexpanded,width,winging,young	.3,0.7,1-1.6,1.8-2.6,1/2-2/3,2.3-2.9,3-8,3-9,4-10,5-11,8.5-11.5,9-13,acute-tipped,annual,arcuate,base,berry,blade,blue,bristly,broadly,capitate-glandular,cauline,cm,deltoid,densely,dia,dm,glabrous,green,hair,herb,internodal,lenticular,linear-lanceolate,lobe,long,longer,low,mm,mostly,narrowly,near,obtuse,occasionally,oriented,ovate,pinnatifid,pinnatisect,prickly,radially,reticulately,ridge,rounded,simple,sparsely,spherical,stellate-pentagonal,suffused,tapering,terete,terminally,twice,undulate,uniseriate,usually,vestiture,violet,wrinkled	6-10-flowered,na,unexpanded
110	wfo-0001027102	success	167	128	73	87	80	41	69	4	.5,0.5,0.5-1,0.5-2,0.5-3,1-1.5,1-2,1-2.5,1-6,10-20,15-35,2-2.5,3,3-12,3-4,4-5,absent,acuman,acuminate,acute,adaxially,almost,anther,apart,apex,base,broad,broadly,calyx,chartaceous,cm,connivent,cuneate,curved,deltate,densely,directed,distally,filament,flattened,flower,forked,fruit,glabrous,globose,hair,leaf,leaf-opposed,lobe,long-tapered,longitudinal,minor,mm,narrowly,oblong,often,opening,orange,ovate,pedicel,petiole,pore,pubescent,rarely,ripe,rugulose,shrub,simple,size,slender,slit,small,somewhat,sparsely,stellate,stem,stigma,style,surface,tip,triangular,truncate,tube,unbranched,white,x,young	.5-6,0.2-2,1-3,1-4,1.5-2,15,2-3,3-5,4-7,5-12,<,abaxially,absen,accrescent,adaxial,adaxiall,ag,aggregate,alyx,appearance,articulated,axe,ba,blade,cell,channe,ciliate,congested,corky,cylindrical,diameter,differing,difoliate,dimorphic,eaf,eed,elliptic,entire,few-,free,fruiting,geminat,giving,ilament,lanceolate,long,m.,major,margin,moderately,multiseriate,nflorescence,obtuse,one,orolla,peduncle,per,perfect,portion,rachi,roughened,ruit,short,spaced,stone,straight,subcoriaceous,tal,tem,time,tomentose,truncat,unarme,unit,usually,vary,wide,yellow,yellow-brown,ympodial	age,alternate,anthesi,arrangement,berry,bud,coat,colour,connation,corolla,decurrency,dry,embryo,feature,form,growth,height,history,inflorescence,length,life,midpoint,na,new,number,ovary,papilla,plant,prickle,ray,reproduction,scar,seed,shape,spacing,specimen,texture,tuberculation,type,width,winging	.5,0.5,0.5-1,0.5-2,0.5-3,1-1.5,1-2,1-2.5,1-6,10-20,15-35,2-2.5,3,3-12,3-4,4-5,absent,acuman,acuminate,acute,adaxially,almost,apart,broad,broadly,chartaceous,cm,connivent,cuneate,curved,deltate,densely,directed,distally,flattened,flower,forked,fruit,glabrous,globose,hair,leaf-opposed,long-tapered,longitudinal,mm,narrowly,oblong,often,opening,orange,ovate,pubescent,rarely,ripe,rugulose,shrub,simple,slender,slit,small,somewhat,sparsely,stellate,tip,triangular,truncate,unbranched,white,x	age,alternate,berry,na
111	wfo-0001027104	success	141	94	60	69	72	25	58	2	0.15-0.35,1-3,1-4,2-3,4-15,6-7.5,acuminate,acute,apex,apical,apically,attenuate,base,branched,calyx,cell,cm,connate,cordate,corolla,covering,cyme,dehiscent,diameter,dichasial,dichasially,filament,finely,flower,forked,globose,green,hair-like,herbaceous,introrse,lateral,lobe,long,make,maturing,mm,monochasial,mucilaginous,mucronate,odd-pinnate,often,ovate,ovoid,perennial,petiole,plant,poricidally,pubescent,seed,short,slit,stellate,stigma,style,testal,thick,throughout,tone,truncate,tuber-bearing,wall,white,yellow,yellow-green	0.5-0.8,1-1.5,1.2-6,1.5-2.3,1.5-4.2,10-15,2-6,2.2-5,3-5.5,3-6-foliat,5-15,abaxially,acumen,adaxially,articulate,condition,digestion,distal,dorsally,eaf,ebracteate,edge,eed,emoval,enzyme,epiphyti,epiphytic-like,exceeding,flat,folded,generally,globo,green-white,growing,half,honeycomb,linear,living,lon,lower,mos,narrowly,nflorescence,nther,orolla,ovat,pattern,pedicel,peduncle,perfect,plan,proximal,rarely,reveal,ruit,seudostipule,simple,specimen,stamen,straight,tall,tem,terrestrial,throughou,typically,unit,vary,viole,wide,without,ympodial,Â¼	anther,arrangement,colour,dehiscence,feature,form,fruit,growth,height,history,inflorescence,leaf,length,life,number,ovary,reproduction,shape,size,stem,surface,texture,type,violet,wet	0.15-0.35,1-3,1-4,2-3,4-15,6-7.5,acuminate,acute,apical,apically,attenuate,branched,cell,cm,connate,cordate,covering,cyme,dehiscent,dichasial,dichasially,finely,forked,globose,green,hair-like,herbaceous,introrse,lateral,lobe,long,make,maturing,mm,monochasial,mucilaginous,mucronate,odd-pinnate,often,ovate,ovoid,perennial,poricidally,pubescent,seed,short,slit,stellate,testal,thick,throughout,tone,truncate,tuber-bearing,wall,white,yellow,yellow-green	violet,wet
112	wfo-0001027114	success	152	113	57	74	78	39	52	5	-17,.5,0.5-1,1-1.2,1-1.5,1-2,1/2,13-21-30,2-2.5,2-3,20-40,3-4,3-7,6-8,6-9,7-10,acute,anther,anthesi,apex,appearing,bark,base,berry,bushy,calyx,capitate,cm,conical,corolla,deltate,dendritic,elliptic,erect,filament,flattened-reniform,glabrous,globose,green,inflorescence,leaf,lobe,lobed,long,margin,minor,minutely,mm,opposite,ovary,pedicel,petiole,pitted,pore,poricidal,reddish,scar,shoot-terminal,shrub,size,stem,stigma,style,surface,tapering,thickened,tip,trichome,tube,way,white,wide,woody,young	1-1.1-2,1.5-1.7,1.5-2,5,7-9,abaxial,abaxially,adaxially,along,alternating,apar,axillary,ba,branched,closely,commonly,dark,densely,dia,differing,difoliate,drying,due,eaf,edicel,eed,exserted,flowered,free,fruiting,geminate,glabrou,growt,halfway,inflorescenc,investing,lamina,lateral,like,lon,lower,main,major,many,minute,nflorescence,occasionally,older,opening,pair,papillo,planar,plurifoliate,portion,projection,pubescent,rapid,reddish-brown,rest,ruit,scattered,several,shoot,simple,slit,soft,spaced,tall,time,triangular,tub,ud,unevenly,uniseriate,unit,vein,yellowish,ympodial	0.5,alternate,apart,arrangement,bud,coat,colour,connation,decurrency,dry,embryo,feature,flower,form,fruit,growth,height,history,length,life,midpoint,na,new,number,papilla,papillose,plant,prickle,ray,reproduction,seed,shape,spacing,specimen,texture,tuberculation,type,width,winging	-17,.5,0.5-1,1-1.2,1-1.5,1-2,1/2,13-21-30,2-2.5,2-3,20-40,3-4,3-7,6-8,6-9,7-10,acute,appearing,base,berry,bushy,capitate,cm,conical,deltate,dendritic,elliptic,erect,flattened-reniform,glabrous,globose,green,leaf,lobed,long,margin,minutely,mm,opposite,pitted,poricidal,reddish,shoot-terminal,shrub,tapering,thickened,tip,trichome,way,white,wide,woody	0.5,alternate,apart,na,papillose
113	wfo-0001027117	success	229	85	53	65	164	20	51	2	.5,0.1-0.7,0.6-0.9,0.7-1.3,0.7-1.5,0.8-1.5-6.5,1-2,1.5-5-14,1.7-2.5,2-3,2.3-2.8,3-15,acute,anther,apex,bark,berry,calyx,cell,cm,connivent,dark,densely,evenly,fine,flattened-reniform,flower,fruit,glabrescent,glabrous,green,herb,lateral,leaf,length,lobed,long,maturity,mauve,mm,moderately,narrow-deltate,oblong,outline,pale,pedicel,petiole,pit,prickly,raised,red-brown,rounded,small,smooth,spherical,spreading,stellate-pubescent,stem,style,surface,tapering,tube,wide,yellow,young	-11,-12,-2.8,/3,0-10,0-15,0-20,0-25,0-40,0-5,0.1,0.1-0.2-0.45,0.15-0.25,0.15-0.35,0.2,0.5,0.5-1.5,0.7-0.9-1.5,1-4,1-6,1.2,1.5-2.3,1.8-2.5,1/,1/3,1/4-3/4,1/8-1/2,10-20,2-6,2-8,25-100,3-10,3-6,4-6.5,4-7,4-8,4.5-6.5,4.5-8,5-11,5-merous,6-10,6-9,7-8,abaxially,accrescent,acicular,almost,alyx,ame,apar,apart,apically,apparently,articulated,attenuate,base,beyond,black,blade,branched,brittle,brown,c.,chartaceous,concolorous,cordate,curved,deltate,diameter,discolorous,distance,drying,eaf,eed,elongating,enclosing,erect,extending,fifth,filament,four,free,fruiting,gently,gra,herbarium,infructescence,irregularly,less,lobe,lon,long-acuminat,longer,lower,margin,mature,membranous,midpoint,midvein,narrow-elliptic,narrow-lanceolate,nflorescence,obovate,older,one,open,orolla,oung,ovate,pair,peduncle,pendulous,per,perfec,pericarp,perpendicular,plurifoliat,poricidal,porrect,portion,prickl,prickle,primary,ray,reduced,reflexed,ruit,scar,sessile,shallowly,shiny,shorter,side,sometimes,spaced,sparsely,specimen,stalk,stalked,staman,stellate,straight,tamen,tearing,terete,tertiary,time,tip,tissue,translucent,trichome,unequal,unit,upper,variously,vary,vein,venation,visible,way,weakly,woody,yellow-green,ympodial	arrangement,colour,connation,corolla,feature,form,gray,growth,height,inflorescence,number,ovary,plant,plurifoliate,seed,shape,size,texture,type,width	.5,0.1-0.7,0.6-0.9,0.7-1.3,0.7-1.5,0.8-1.5-6.5,1-2,1.5-5-14,1.7-2.5,2-3,2.3-2.8,3-15,acute,berry,cell,cm,connivent,dark,densely,evenly,fine,flattened-reniform,glabrescent,glabrous,green,herb,lateral,lobed,long,maturity,mauve,mm,moderately,narrow-deltate,oblong,outline,pale,pit,prickly,raised,red-brown,rounded,small,smooth,spherical,spreading,stellate-pubescent,tapering,wide,yellow,young	gray,plurifoliate
114	wfo-0001027123	success	180	116	59	78	102	38	57	2	-10,0.5,0.5-0.8,0.7-3.5,0.8-1.3,1,1-1.2,1-1.5,2-lobed,2.5-10.4,2.5-4,2.5-6,3-15-20,3-4,4-5,acute,anther,anthesi,apex,attenuate,base,branched,bright,broadly,calyx,clavate,cm,commonly,corolla,cup-shaped,dark,deltate,elliptic,erect,exerted,filament,flattened,flower,glabrous,globose,green,inflorescence,leaf,less,lobe,mauve-purple,minute,minutely,mm,narrowly,ovary,pedicel,petiole,pitted,reniform,revolute,scar,shining,shiny,simple,soon,spaced,stellate,stem,stigma,stoutish,strongly,style,subshrub,surface,terminal,tip,tube,violet,warty,widely,x,young	.3,.5,0.3-1.6cm,0.9-1.3,1.5-2,2-2.2,2-2.5,2-2.6,2-3,2-5.5,4-6,5-10,5-6,abaxial,adaxial,adaxially,along,appearing,axe,axi,bark,brown,campanulate,cell,completely,conical,constricted,coriaceous,darker,dendritic,densely,denser,diameter,drying,eaf,edge,eed,enlarged,fide,free,fruiting,glandular,inserted,lamina,lax,lewi,like,lobed,lon,long,loose,loosely,lower,margin,midvein,monopodia,nflorescence,nodding,older,outline,pair,papillae,papillate,peduncle,perfect,perhaps,petal,planar,plurifoliate,portion,primary,prominent,pubescent,reddish,scatted,scattered,shin,shinin,short,sinuate,sleeve,slightly,sometimes,sparsely,straight,testal,thick,time,trailing,trichome,tub,turned,ud,unit,upper,usually,vein,way,white,wood,ympodial,Â¾	0.3-1.6,arrangement,bud,coat,colour,connation,decurrency,dry,embryo,feature,form,fruit,growth,height,history,length,life,midpoint,minor,na,new,number,papilla,plant,pore,prickle,ray,reproduction,seed,shape,size,spacing,specimen,texture,tuberculation,type,width,winging	-10,0.5,0.5-0.8,0.7-3.5,0.8-1.3,1,1-1.2,1-1.5,2-lobed,2.5-10.4,2.5-4,2.5-6,3-15-20,3-4,4-5,acute,attenuate,branched,bright,broadly,clavate,cm,commonly,cup-shaped,dark,deltate,elliptic,erect,exerted,flattened,glabrous,globose,green,less,mauve-purple,minute,minutely,mm,narrowly,pitted,reniform,revolute,shining,shiny,simple,soon,spaced,stellate,stoutish,strongly,subshrub,terminal,violet,warty,widely,x,young	0.3-1.6,na
115	wfo-0001027146	success	213	135	93	109	104	26	90	3	0-11,0.3-2.2,0.7-2.4,0.8,0.8-5.8,1-10,1-2,1-2.5,1-9.5,10,13-36,2-12.2,2-13,2-4.2,2-5,3.3-6.1,3.5-22,4-11,4-12.5,4-38,6-10,6-17.5,6.5-52,abaxially,adaxially,anther,apart,attenuate,axillary,berry,bud,cell,chartaceous,clavate,cm,coarsely,conical,connivent,corolla,covering,dark,deep,diameter,elliptic,finely,flower,forked,fruit,glabrous,green,hair,hair-like,herb,interjected,lanceolate,lateral,leaf,leaflet,like,long,make,medium,membranous,minute,mm,moniliform,mottled,mucilaginous,odd-pinnate,ovate,ovoid,pair,pedicel,peduncle,pentagonal,petiole,plant,pore,poricidal,puberulent,pubescent,purple,ripe,rotate,seed,simple,size,stem,stigma,style,subglabrous,subtending,terminal,testal,thick,throughout,tinged,tip,tube,tuber,unwinged,violet,wall,wet,white,whitish,wide,wing,x	0.5-3.2,0.6-3.3,0.8-3.1,1.9-10,4-8,5-merou,6,acumen,acuminate,ag,along,alyx,apex,apparently,arranged,articulated,asymmetrical,axe,base,basiscopic,bead,blade,brownish,capitat,ciliate,commonly,condition,darker,decreasing,digestion,distal,dorsally,drying,eaf,edge,eed,enzyme,erec,especially,exceeding,filament,flat,folded,fourt,fourth,fresh,geminat,generally,glabrou,gradually,green-white,greenish,half,homostylous,honeycomb-shaped,lengthening,living,lobe,lower,margin,midrib,minutely,multiple,necklace,nflorescence,orbicular,orolla,perfect,petiolule,plurifoliate,proximal,rarely,ray,removed,ruit,secondary,semierect,sessile,seudostipule,side,slit,sometimes,spaced,specimen,stamen,ste,stolon,straight,subequal,subglabrou,subsessile,symmetrical,tall,tamen,tem,tissue,toward,tri-,typically,unit,usually,vary,yellow,ympodial	arrangement,calyx,capitate,coat,colour,connation,feature,form,growth,height,history,inflorescence,length,life,na,number,ovary,perennial,pseudostipule,reproduction,shape,spacing,surface,texture,tuberculation,type	0-11,0.3-2.2,0.7-2.4,0.8,0.8-5.8,1-10,1-2,1-2.5,1-9.5,10,13-36,2-12.2,2-13,2-4.2,2-5,3.3-6.1,3.5-22,4-11,4-12.5,4-38,6-10,6-17.5,6.5-52,abaxially,adaxially,apart,attenuate,axillary,berry,bud,cell,chartaceous,clavate,cm,coarsely,conical,connivent,covering,dark,deep,elliptic,finely,forked,glabrous,green,hair,hair-like,herb,lanceolate,lateral,like,long,make,medium,membranous,minute,mm,moniliform,mottled,mucilaginous,odd-pinnate,ovate,ovoid,pentagonal,poricidal,puberulent,pubescent,purple,ripe,rotate,seed,simple,stem,subglabrous,subtending,terminal,testal,thick,throughout,tinged,tip,unwinged,violet,wall,wet,white,whitish,wide,wing,x	capitate,na,perennial
116	wfo-0001027157	success	207	129	76	90	117	39	70	6	0.15-0.3,0.7-2,0.9-2.8,1-10,1-2,1-3,1-3.8,1-6,10-30,2,2-15,2-2.5,2.5-3,3-12,3.3-7.8,6.5-14.5,9-12,acuminate,acute,anther,apart,apex,articulated,attenuate,axillary,base,berry,broadly,bud,cell,chartaceous,clavate,cm,conical,connivent,cordate,corolla,covering,deeply,densely,diameter,filament,flower,fruit,glabrous,green,hair-like,herb,lanceolate,lateral,leaf,lengthening,lobe,long,membranous,mm,narrowly,oblique,odd-pinnate,ovate,ovoid,pedicel,petiole,plant,pore,poricidal,puberulent,pubescent,ripe,rounded,seed,size,slit,sometimes,stellate,stem,stigma,style,subtending,terminal,testal,thick,tinged,tip,tube,unwinged,violet,wall,white,x	0-3,1,1.5-6.5,2-3,2-5,2.3-4,3-7,3.8-8.3,4-5,5-merou,abaxially,absent,acumen,adaxially,ag,along,alyx,among,apparently,axe,blade,brownish,capitat,ciliate,condition,cuneate,decreasing,decurrent,digestion,distal,dorsally,drying,eaf,edge,eed,elliptic,end,enzyme,erec,especially,exceeding,flat,folded,forked,fresh,geminat,generally,glabrou,grassland,greatly,green-white,greenish,hair,half,homostylous,honeycomb-shaped,interjected,leaflet,like,living,low-growing,lower,make,margin,markedly,middl,midrib,minutely,mucilaginous,nflorescence,obtuse,one,orbicular,orolla,pair,peduncle,perfect,petiolulate,petiolule,placed,plurifoliate,rarely,removed,ruit,semi-rosette,sessile,seudostipule,shady,short,situation,slightly,spaced,specimen,stamen,ste,stolo,straight,subsessile,sunny,tall,tamen,tem,throughout,toward,tri-,tuber,typically,unequal,unit,usually,vary,wet,whitish,wide,woodland,yellow,ympodial	abaxial,adaxial,age,arrangement,calyx,capitate,coat,colour,connation,embryo,feature,form,geminate,growth,height,history,inflorescence,length,life,middle,minor,na,new,number,ovary,papilla,perennial,prickle,reproduction,scar,shape,spacing,surface,texture,tuberculation,type,width,winging,young	0.15-0.3,0.7-2,0.9-2.8,1-10,1-2,1-3,1-3.8,1-6,10-30,2,2-15,2-2.5,2.5-3,3-12,3.3-7.8,6.5-14.5,9-12,acuminate,acute,apart,articulated,attenuate,axillary,berry,broadly,bud,cell,chartaceous,clavate,cm,conical,connivent,cordate,covering,deeply,densely,glabrous,green,hair-like,herb,lanceolate,lateral,lengthening,long,membranous,mm,narrowly,oblique,odd-pinnate,ovate,ovoid,poricidal,puberulent,pubescent,ripe,rounded,slit,sometimes,stellate,subtending,terminal,testal,thick,tinged,tip,unwinged,violet,wall,white,x	age,capitate,geminate,middle,na,perennial
117	wfo-0001027184	success	218	134	92	103	115	31	87	5	.3,.5,0.2-0.4,0.4â0.9,0.8â1.6,0â3,1-2,1.5-5,1.8â3.5,13â18,19,1â2.5,1â4,2,3â4-celled,4,4â12,absent,acute,anther,apart,apex,articulated,axillary,base,blue,borne,broad,calyx,chartaceous,cm,connivent,covered,diameter,directed,elliptic,entire,epidermal,extension,filament,flattened,flower,fruit,glabrous,globose,hair,hairlike,herbaceous,imparipinnate,introrsely,lanceolate,leaf,leafy,least,lobe,long,longitudinal,meter,mm,mostly,narrowly,nearly,oblong,obtuse,often,opening,orange,ovate,pedicel,petiole,pore,pubescent,red,revolute,ripe,several,shape,shoot,short,simple,size,slit,small,soft-woody,somewhat,sparsely,stellate,stem,stigma,style,sulcate,surface,tip,truncate,tube,unbranched,unequal,vine,wall,weak,white,x,young	.7,.8,0-0.2,0-0.5-2,0.4-2,0.8,1.5,1â2,2.8â4.1,2â4-celled,3-4-,3-foliolate,3.5â8,3â,5,5-7,7,9,abaxially,accrescent,adaxiall,adaxially,adventitious,ag,along,always,alyx,appressed,axe,axi,ba,basal,blade,bract-like,branch,broadly,brown,cell,clavat,cluster,cordat,cylindrical,densely,eaf,eed,especially,fasciculate,fleshy,foliaceous,free,fruiting,geminat,generally,glabrescent,glabrou,grading,half,ilament,larger,largest,lateral,leaflet,less,light,like,lower,m.,margin,membranous,midrib,minutely,much,nflorescence,node,older,opposite,orolla,ower,peduncle,per,petiolule,pilose,plurifoliate,portion,prominent,prominently,pseudostipule,puberulent,rachi,raised,rarely,reticulate,root,ruit,scarcely,secondary,slightly,spaced,straight,subopposite,terminal,tertiary,tightly,tree,trunk,unarme,uniform,unit,usually,vary,vein,visible,yellow,ympodial,â9	0.5-2,age,arrangement,berry,clavate,colour,connation,corolla,decurrency,feature,form,growth,height,history,inflorescence,length,life,minor,na,number,ovary,papilla,plant,reproduction,scar,seed,spacing,texture,type,width,winging	.3,.5,0.2-0.4,0.4â0.9,0.8â1.6,0â3,1-2,1.5-5,1.8â3.5,13â18,19,1â2.5,1â4,2,3â4-celled,4,4â12,absent,acute,apart,apex,articulated,axillary,base,blue,borne,broad,chartaceous,cm,connivent,covered,diameter,directed,elliptic,entire,epidermal,extension,flattened,flower,fruit,glabrous,globose,hair,hairlike,herbaceous,imparipinnate,introrsely,lanceolate,leafy,least,long,longitudinal,meter,mm,mostly,narrowly,nearly,oblong,obtuse,often,opening,orange,ovate,pubescent,red,revolute,ripe,several,shoot,short,simple,slit,small,soft-woody,somewhat,sparsely,stellate,sulcate,surface,truncate,unbranched,unequal,vine,wall,weak,white,x	0.5-2,age,berry,clavate,na
118	wfo-0001027186	success	168	119	62	83	85	36	59	3	0.5-1,1-1.5,1-2.5,1.4-1.6,1.5,1.6-5,2-lobed,30-40,4-15,4-9,5-10,6-7,?,acute,age,anther,anthesi,apart,apex,attenuate,base,berry,broadly,calyx,clavate,cm,conical,corolla,deltate,dendritic,densely,dry,ellipsoid,elliptic,filament,filiform,flower,fruit,glabrous,globose,golden,green,growth,immature,lengthening,less,lobe,lobed,loose,maturity,minutely,mm,narrowly,new,ovary,ovoid,pale,papillate,pedicel,pendent,petiole,pitted,pore,poridical,pubescent,reniform,scar,seed,simple,slit,sparsely,stem,stigma,style,surface,terminal,tip,tree,trichome,tube,uniseriate,white,x	-6,.4,.5,1.5-2,1.5-2.5,15,2-6,2.5-3,3-4,3.5-4,9-10,abaxial,abaxially,adaxially,always,apparently,axil,bark,branch,branched,brown,dark,dbh,deflexed,denditic,denser,diameter,eaf,enlarging,entire,exerted,free,fruiting,glabrescent,incrassat,irregularly,keeled,lamina,like,longer,lower,m.,margin,midrib,much,nflorescence,occasionally,pair,papillat,peduncle,perfect,pericarp,planar,plane,plurifoliat,pointed,portion,primary,pubescen,rachi,reddish,rough,ruit,scattered,shiny,short,slightly,small,soon,spaced,spreading,stalk,straight,strongly,time,treelet,tub,ud,unit,variably,vein,way,woody,yellow,ympodial	0.5,arrangement,bud,coat,colour,connation,decurrency,embryo,feature,form,height,history,inflorescence,leaf,length,life,midpoint,minor,na,number,papilla,perennial,plant,prickle,ray,reproduction,shape,size,spacing,specimen,texture,tuberculation,type,width,winging,young	0.5-1,1-1.5,1-2.5,1.4-1.6,1.5,1.6-5,2-lobed,30-40,4-15,4-9,5-10,6-7,?,acute,age,apart,attenuate,berry,broadly,clavate,cm,conical,deltate,dendritic,densely,ellipsoid,elliptic,filiform,glabrous,globose,golden,green,immature,lengthening,less,lobed,loose,maturity,minutely,mm,narrowly,ovoid,pale,papillate,pendent,pitted,poridical,pubescent,reniform,simple,slit,sparsely,terminal,tip,tree,trichome,uniseriate,white,x	0.5,na,perennial
119	wfo-0001027198	success	191	119	65	82	109	37	57	8	0.5-0.75,0.5-1,0.7-1,1-1.5,1-10,1.5-10,1.5-2,11-20,2-5.5,4-9,5-6,7.5-9,acuminate,acute,anther,anthesi,apart,apex,attenuate,base,berry,calyx,clavate,cm,corky,corolla,cyathiform,deltoid,dendritic,densely,dry,elliptic,filament,flower,glabrate,globose,golden,green,inflorescence,leaf,lobe,lobed,minor,minutely,mm,obovate,opposite,ovary,ovoid,ovoid-reniform,papillose,pedicel,petiole,pitted,plant,pore,puberulent,pubescent,rather,rounded,scar,shaped,shrub,simple,size,slender,slightly,speciman,specimen,stem,stigma,style,surface,tear-drop,tip,trichome,tube,type,white,woody,x,young	.4,.5,0.05-1.0,0.8-1,1-5,10-11,3/4,5-120-flowered,abruptly,always,axil,ba,beginning,beneath,broadening,bushy,caly,channeled,closely,complex,constriction,corresponding,decurrent,dia,differing,difoliate,eaf,edge,edicel,eed,entire,erect,evenly,exserted,extremely,eye,female,found,free,fruiting,furcate,geminat,glabrous,impressed,inflorescenc,invisible,large,lateral,like,live,lon,long,lower,main,major,male,many,margin,medium,meet,middle,minute,naked,nearly,nflorescence,often,older,overlapping,pale,paler,papillo,pendan,planar,poricidal,portion,pubescence,reddi,reflexed,rest,ruit,sessile,set,shining,short,small,soon,spaced,straight,strong,styled,tall,tannish-yellow,testae,thickened,thin,time,top,tree,two,ud,undersurface,uniseriate,unit,usually,vein,way,widest,yellowish,ympodial	0.4,2.5,3.5,5-120,alternate,arrangement,bark,bud,coat,colour,connation,decurrency,embryo,feature,form,fruit,growth,height,history,length,life,midpoint,na,number,papilla,perennial,prickle,ray,reddish,reproduction,seed,shape,spacing,texture,tuberculation,width,winging	0.5-0.75,0.5-1,0.7-1,1-1.5,1-10,1.5-10,1.5-2,11-20,2-5.5,4-9,5-6,7.5-9,acuminate,acute,apart,attenuate,berry,clavate,cm,corky,cyathiform,deltoid,dendritic,densely,elliptic,glabrate,globose,golden,green,leaf,lobed,minutely,mm,obovate,opposite,ovoid,ovoid-reniform,papillose,pitted,puberulent,pubescent,rather,rounded,shaped,shrub,simple,slender,slightly,speciman,stem,tear-drop,trichome,type,white,woody,x,young	0.4,2.5,3.5,5-120,alternate,na,perennial,reddish
120	wfo-0001027200	success	139	118	64	83	56	35	63	1	0.05-0.25,0.25-0.5,0.5-1,0.6-1,0.7-2.5,1-1.5,1.2-1.5,1.5-2,1.5-5,1.6-6,2-3,2.5-3,3.5-6,6-8,8-15,acute,anther,anthesi,apex,bark,base,berry,broadly,calyx,capitate,cm,conical,corolla,decurrent,deeply,deltoid,elliptic,filament,glabrous,globose,golden,green,grey-brown,inflorescence,leaf,lightly,lobe,lobed,long,minor,minute,minutely,mm,nearly,onto,ovary,ovoid-reniform,papillose,pedicel,petiole,pitted,pore,poricidal,puberulent,shaped,shrub,size,slightly,small,sparsely,stem,stigma,style,surface,tear-drop,tip,tree,trichome,tube,unicellular,unifoliate,uniseriate,white,widened,winged,woody,x,young	0.5-0.75,1-1.4,3-3.5,9-11,across,aspec,ba,beneath,branch,branche,brown,converging,dark,deflexed,densely,dia,differing,eaf,eed,except,flattened,free,fruiting,geminate,giving,horizontally,impressed,lateral,like,lon,lower,main,major,margin,middle,near,node,non-reproductive,occasionally,older,papillo,planar,portion,prominent,reflexed,rest,ruit,sparse,spreading,straight,tall,unit,vein,widest,yellowish,ympodial	arrangement,bud,coat,colour,connation,decurrency,dry,embryo,feature,flower,form,fruit,growth,height,history,length,life,midpoint,na,number,papilla,plant,prickle,ray,reproduction,scar,seed,shape,spacing,specimen,texture,tuberculation,type,width,winging	0.05-0.25,0.25-0.5,0.5-1,0.6-1,0.7-2.5,1-1.5,1.2-1.5,1.5-2,1.5-5,1.6-6,2-3,2.5-3,3.5-6,6-8,8-15,acute,apex,base,berry,broadly,capitate,cm,conical,decurrent,deeply,deltoid,elliptic,glabrous,globose,golden,green,grey-brown,leaf,lightly,lobed,long,minute,minutely,mm,nearly,onto,ovoid-reniform,papillose,petiole,pitted,poricidal,puberulent,shaped,shrub,slightly,small,sparsely,tear-drop,tree,trichome,unicellular,unifoliate,uniseriate,white,widened,winged,woody,x	na
121	wfo-0001027213	success	227	129	78	93	134	36	75	3	0-2.5-3.3,1-2,1-5,1.1-1.7,1.2-1.6,1.2-1.7,1.3-2.2,1.8-2.8,10-24,2-5,2.5-5.1,2.9-4.8,3.5-8,4-9.5,5.7-6.2,8-24,acute,anther,apart,apex,attenuate,base,blunt-tipped,branched,broadly,brown,calyx,cm,corolla,cuneate,dark,deltoid,elliptic,eventually,filament,flower,free,fruit,glabrescent,globose,granular,grayish-brown,green,hair,lanceolate,leaf,length,lobe,long-stalked,many,mm,multangulate,oblanceolate,obovate,orbicular,ovate,ovate-lanceolate,pale,pedicel,petiole,pore,poricidal,porrect-stellate,pseudo-terminal,pubescent,reniform,reticulate-punctate,scabrous,short-,short-attenuate,shrub,simple,stellate,stem,stigma,style,subcampanulate,surface,terete,time,tip,tomentose,tomentose-pubescent,tree,tube,unarmed,unwinged,whitish,whitish-green,x,yellow-green,yellowish,young	/10,0-160-230,0.2-0.4,0.2-0.5,0.7-2.3-4.5,0.8-1.8,1.2-2.5,1.7-3.6,1.7-3.9,1.8-3.2,1/2-2/3,12.3-16.3-19,2.4-4.7,2.9-3.8,2/3,3.5-5,4.2-5.9,5-7.5,5-8,5-merou,8.2-10.5,9-13,abaxially,accrescent,acuminate,adaxially,ag,along,alyx,anthesi,apparently,ark,around,articulated,axe,axillary,ba,basal,blade,branch,capitat,cell,completely,conical,covering,cylindrical,decurrent,diameter,directed,distally,drying,eaf,early,edge,eed,entire,enveloping,epidermal,exserted,farinose,few-rayed,fruiting,glabrescen,glabrous,group,high,homostylous,immature,inserted,lackin,lateral,lengthening,lobed,long,long-,longitudinal,lower,m.,main,margin,midrib,mixed,moderately,mostly,multangulat,nearly,nflorescence,obscured,obtuse,often,older,orolla,partly,peduncle,perfect,plurifoliate,porrect-stellat,prominent,pubescence,rachi,rather,relatively,ruit,sessile,short,short-stalked,side,slit,sometimes,somewhat,spaced,sparsely,stamen,suture,tamen,thick,thick-stalked,thin-stalked,ti,tomentu,touching,ud,unarme,unit,vary,vein,vestigial-rayed,violet,way,white,wide,yellow,yellow-tan,ympodial	90-160-230,abaxial,adaxial,arrangement,bark,bud,capitate,colour,connation,embryo,feature,form,growth,height,history,inflorescence,life,midpoint,minor,na,number,ovary,papilla,plant,prickle,ray,reproduction,scar,seed,shape,size,spacing,texture,type,width,winging	0-2.5-3.3,1-2,1-5,1.1-1.7,1.2-1.6,1.2-1.7,1.3-2.2,1.8-2.8,10-24,2-5,2.5-5.1,2.9-4.8,3.5-8,4-9.5,5.7-6.2,8-24,acute,apart,attenuate,blunt-tipped,branched,broadly,brown,cm,cuneate,dark,deltoid,elliptic,eventually,flower,free,fruit,glabrescent,globose,granular,grayish-brown,green,hair,lanceolate,long-stalked,many,mm,multangulate,oblanceolate,obovate,orbicular,ovate,ovate-lanceolate,pale,poricidal,porrect-stellate,pseudo-terminal,pubescent,reniform,reticulate-punctate,scabrous,short-,short-attenuate,shrub,simple,stellate,subcampanulate,terete,time,tip,tomentose,tomentose-pubescent,tree,unarmed,unwinged,whitish,whitish-green,x,yellow-green,yellowish	90-160-230,capitate,na
122	wfo-0001027214	success	175	122	79	91	84	31	68	11	0.25,0.5-0.8,0.5-1,0.7-2,0.7-2.5,0.8-1,1-1.5,1-2.8,1.2-3,1.5,1.5-1.8,1.5-6,10-13,2,2-9,3-6,6-12,7-12,adaxially,anther,anticlinal,basal,base,calyx,cm,conical,corolla,densely,diameter,elliptic,filament,finely,flattened-round,flower,fruit,fruiting,glabrous,globose,greenish,grown,height,herb,inflorescence,irregular,lanceolate,lateral,leaflet,length,less,like,lobed,long,long-conical,minutely,mm,narrowly,nearly,nodding,obovate,occasionally,once-branched,ovary,pedicel,petiole,pinnate,pointed,poricidal,projection,pubescent,rachi,rest,rugose,rugosity,seed,sharply,simple,sinuous,stigma,style,surface,terminal,thickening,tip,trichome,tube,uniseriate,white,white-lenticellate,whitish,without,x	..,.25,.5,0,0-16,0.3-1.5,0.3-1.7,10-15-25-38,3-4-5-9,5-6,6-12-17-20,8-9,abaxially,absent,acuminate,acute,along,anthesi,apex,apical,berry,broadly,capitat,cell,climbing,composed,conspicuously,decurrent,deltate,dr.,drying,eaf,edicel,eed,epidermal,erect,exserted,extending,free,green,groove,horizontal,inflorescenc,lamina,lobe,lon,long-acuminate,lower,margin,markedly,midrib,nflorescence,noddin,oblique,often,onto,open,opposite,pair,paired,papilla,papillate,per,perfectly,petiolule,portion,reflexed,ruit,scar,scattered,scrambling,smaller,somewhat,tem,time,triangular,truncate,tub,ud,unevenly,unifoliat,unit,vein,ympodial	0.5,1,10-38,2.0,5,6-20,arrangement,bud,capitate,coat,colour,dry,feature,form,growth,history,leaf,life,na,number,papillae,plant,reproduction,shape,size,stem,texture,tuberculation,type,unifoliate,width	0.25,0.5-0.8,0.5-1,0.7-2,0.7-2.5,0.8-1,1-1.5,1-2.8,1.2-3,1.5,1.5-1.8,1.5-6,10-13,2,2-9,3-6,6-12,7-12,adaxially,anticlinal,base,cm,conical,densely,elliptic,finely,flattened-round,glabrous,globose,greenish,grown,herb,inflorescence,irregular,lanceolate,less,like,lobed,long,long-conical,minutely,mm,narrowly,nearly,nodding,obovate,occasionally,once-branched,pinnate,pointed,poricidal,projection,pubescent,rest,rugose,rugosity,sharply,simple,sinuous,thickening,tip,trichome,uniseriate,white,white-lenticellate,whitish,without,x	0.5,1,10-38,2.0,5,6-20,capitate,dry,na,papillae,unifoliate
123	wfo-0001027219	success	143	123	66	84	59	39	63	3	0.4-0.6,0.5,0.5-0.8,1,1-15,1-2,1-3,1.5-2.5,2,2-3.5,2-4,3-5,3-6,6-8,absent,acuminate,acute,age,anther,anthesi,apex,bark,base,berry,bright,broadly,brown,calyx,capitate,closely,cm,conical,corolla,cup-shaped,deltate,edge,elliptic,filament,flower,glabrescent,glabrous,globose,green,greyish,growth,leaf-opposed,lengthening,less,lobe,lobed,long-styled,minutely,mm,new,ovary,pale,pedicel,pendent,petiole,pore,poricidal,pubescent,purple,scar,short-styled,shrub,simple,slightly,slit,spaced,stem,stigma,stout,style,surface,thickened,tip,trichome,tube,uniseriate,violet,white,woody,x	.5,/4,0.3,1.5-2,2-2.5,2-3,7-8,axillary,berr,c.,completely,densely,diameter,drying,eaf,eed,entire,erect,exerte,exfoliatin,free,fruiting,glabrou,hard,heterostylous,known,long-conical,lower,margin,maturity,nflorescence,overlappin,pair,papillo,papillose-pubescent,peduncle,pericarp,planar,plurifoliat,pointed,portion,primary,ruit,sharply,shoot,short,sometimes,somewhat,soon,terminal,tuft,ud,unit,vein,way,weight,yellowish,ympodial,â1/3	arrangement,bud,coat,colour,connation,decurrency,dry,embryo,exfoliating,feature,form,fruit,height,history,inflorescence,leaf,length,life,midpoint,minor,na,number,papilla,papillose,plant,prickle,ray,reproduction,seed,shape,size,spacing,specimen,texture,tuberculation,type,width,winging,young	0.4-0.6,0.5,0.5-0.8,1,1-15,1-2,1-3,1.5-2.5,2,2-3.5,2-4,3-5,3-6,6-8,absent,acuminate,acute,age,berry,bright,broadly,brown,capitate,closely,cm,conical,cup-shaped,deltate,edge,elliptic,flower,glabrescent,glabrous,globose,green,greyish,leaf-opposed,lengthening,less,lobed,long-styled,minutely,mm,pale,pendent,poricidal,pubescent,purple,short-styled,shrub,simple,slightly,slit,spaced,stout,thickened,tip,trichome,uniseriate,violet,white,woody,x	exfoliating,na,papillose
124	wfo-0001027223	success	189	111	62	77	112	34	58	4	.5,0.19-0.75,0.3-1.2,1-2,1.8-3.5,16-41,3-10,3-5,3.5-4,5.9-12.2,9-15,9-22,9-35,anther,apart,apex,axillary,base,berry,bud,cell,clavate,cm,conical,connivent,corolla,covering,deep,densely,diameter,dot,filament,flower,forked,fruit,glabrous,green,hair,hair-like,herb,hyaline,lanceolate,lateral,leaf,lengthening,light,lobe,long,mm,odd-pinnate,ovoid,pedicel,pentagonal,petiole,plant,pore,poricidal,pubescent,purple,ripe,rotate,seed,size,slit,sometimes,stigma,stripe,style,subtending,terminal,testal,thick,tip,tube,unwinged,wall,white	1-3,1.3-2,1.5-3.5,2-4,2-7,3-11,3-5.2,3.5-6,3.5-7,3.7-9.3,4-6,5-10,5-21,5-8,5-merou,abaxially,acumen,acuminate,adaxiall,adaxially,ag,alyx,apparently,articulated,asymmetric,attenuate,axe,basiscopic,blade,brownish,capitat,condition,decreasing,digestion,distal,dorsally,drying,eaf,edge,eed,elliptic,end,enzyme,erec,exceeding,flat,folded,fresh,geminat,generally,glabrou,green-white,greenish,hal,half,homostylous,honeycomb-shaped,interjected,larger,leaflet,like,living,lower,make,middle,mucilaginous,nflorescence,one,orbicular,orolla,ovate,pair,peduncle,perfect,petiolulate,placed,plurifoliate,present,removed,rounded,ruit,sessile,seudostipule,short,shortly,side,slightly,spaced,specimen,stamen,ste,stolo,straight,subequal,tall,tamen,tem,throughout,tissue,toward,tri-,tuber,typically,unit,usually,vary,wet,whitish,wide,x,yellow,ympodial	abaxial,adaxial,age,arrangement,calyx,capitate,colour,connation,feature,form,geminate,growth,height,history,inflorescence,length,life,minor,na,new,number,ovary,papilla,reproduction,scar,shape,spacing,stem,surface,texture,type,width,winging,young	.5,0.19-0.75,0.3-1.2,1-2,1.8-3.5,16-41,3-10,3-5,3.5-4,5.9-12.2,9-15,9-22,9-35,apart,axillary,berry,bud,cell,clavate,cm,conical,connivent,covering,deep,densely,dot,forked,glabrous,green,hair,hair-like,herb,hyaline,lanceolate,lateral,lengthening,light,long,mm,odd-pinnate,ovoid,pentagonal,poricidal,pubescent,purple,ripe,rotate,slit,sometimes,stripe,subtending,terminal,testal,thick,tip,unwinged,wall,white	age,capitate,geminate,na
125	wfo-0001027237	success	122	92	55	70	52	22	53	2	.5,/4,1-1.2,1.5-2,2-3,3-3.5,3-4,30-100-flowered,6-11,6-8,8,anther,apart,apiculate,bark,base,berry,black,branched,calyx,clavate,cm,completely,corolla,cup-shaped,deflexed,drying,ellipsoid,filament,flattened,fruiting,glabrous,globose,green,greenish-white,inflorescence,internodal,later,lobe,lobed,many,minutely,mm,ovary,papillose,pedicel,pitted,poricidal,regularly,reniform,scar,shaped,shining,shrub,small,stem,stigma,style,surface,tall,tapering,tear-drop,time,tip,tree,tube,way,white,x,young	0.5-1,1.5-2.5,5,anthesi,apiculae,appearing,ba,blac,branc,broadly,brown,cucullate,dark,deltoid,dia,difoliate,edicel,eed,erect,exsertion,free,geminate,greyi,leaf,long,lower,margin,nflorescence,occasionally,older,paler,papillate,papillo,part,plurifoliat,pore,portion,reflexed,regulary,ruit,slender,spaced,straight,terminal,ud,unit,upper,usually,widely,woody,x.,ympodial	arrangement,bud,colour,connation,feature,flower,form,fruit,greyish,growth,height,length,na,number,plant,seed,shape,size,spacing,texture,type,width	.5,/4,1-1.2,1.5-2,2-3,3-3.5,3-4,30-100-flowered,6-11,6-8,8,apart,apiculate,base,berry,black,branched,clavate,cm,completely,cup-shaped,deflexed,drying,ellipsoid,flattened,glabrous,globose,green,greenish-white,internodal,later,lobed,many,minutely,mm,papillose,pitted,poricidal,regularly,reniform,shaped,shining,shrub,small,tall,tapering,tear-drop,time,tip,tree,way,white,x	greyish,na
126	wfo-0001027238	success	203	123	73	89	114	34	70	3	.3,.5,0-1,0-1.5,0.3-1,0.3-5,0.5-1,0.5-16,0.5-2,1-2,1.5-4,10,15-30,2-4,3-4,3-6,5-15,6-15-25,acuminate,acute,anther,apex,base,berry,black,calyx,cm,connivent,cuneate,deltate,densely,elliptic,elliptic-ovate,extra-axillary,filament,fleshy,flower,fruit,glabrous,globose,hair,lavender,leaf,lobe,long,longitudinal,midpoint,minor,minutely,mm,multangulate,narrowly,new,oblique,oblong,outline,pale,pedicel,petiole,pitted,pore,porrect-stellate,pubescent,purple,ray,reniform,ripe,rounded,shiny,shrub,simple,slit,small,sometimes,stellate,stellate-pubescent,stem,stigma,style,surface,tip,tree,triangular,tube,unbranched,white,whitish,x,yellowish	-5,0-0.7,0.3-0.5,0.3-0.8,1-1.5,1.5-3,1.5-7,2-3,3-5,4-,4-10,4-16,4-5,4-8,5-7,5-merou,6-8,abaxially,accrescent,adaxiall,adaxially,ag,alyx,apparently,articulated,axe,ba,blade,branch,brown,capitat,chartaceous,contiguous,covering,cylindrical,dark,diameter,differentiated,directed,discolorous,distally,eaf,eed,entire,equal,flattened,foliaceous,fork,free,frui,fruiting,geminate,glabrescent,gland,gland-tipped,green,greenish,growt,homostylous,interpetalar,introrsely,juic,large,light,lighter,like,lower,major,margin,membranaceous,mixed,near,nearly,nflorescence,obtuse,often,one,opening,orolla,paired,part,peduncle,perfect,pericarp,plurifoliate,rachi,ruit,scandent,sessile,short-stalked,side,similar,somewhat,sparse,sparsely,sprawling,ste,straight,strongly,subtending,tamen,tem,time,tissue,toward,unarme,unequal,unit,vary,vein,wide,without,yellow,ympodial	age,arrangement,bud,capitate,colour,connation,corolla,decurrency,embryo,feature,form,growth,height,history,inflorescence,length,life,na,number,ovary,papilla,plant,prickle,reproduction,scar,seed,shape,size,spacing,texture,type,width,winging,young	.3,.5,0-1,0-1.5,0.3-1,0.3-5,0.5-1,0.5-16,0.5-2,1-2,1.5-4,10,15-30,2-4,3-4,3-6,5-15,6-15-25,acuminate,acute,apex,berry,black,cm,connivent,cuneate,deltate,densely,elliptic,elliptic-ovate,extra-axillary,fleshy,flower,fruit,glabrous,globose,hair,lavender,long,longitudinal,minutely,mm,multangulate,narrowly,oblique,oblong,outline,pale,pitted,porrect-stellate,pubescent,purple,reniform,ripe,rounded,shiny,shrub,simple,slit,small,sometimes,stellate,stellate-pubescent,tree,triangular,unbranched,white,whitish,x,yellowish	age,capitate,na
127	wfo-0001027244	success	285	151	111	124	161	27	108	3	-2,0.05,0.2-1,0.3-0.8,0.45-0.6,0.5,0.5-0.8,0.7-1.5,0.9-1.3,1,1-celled,1.1-1.3,1.2-1.6,1.5-2,1.5-6.5,1.7-3.0,2-locular,4-12,4-celled,5-9-celled,adpressed,anther,apex,appearance,articulated,base,berry,bifurcate,bracteate,branched,broadly,brown,calyx,capitate,cell,cm,conical,corolla,curved,dark,deltate,densely,diameter,distal,eglandular,either,elliptic,filament,flower,flushed,forming,fruit,giving,glabrous,gland,glandular,globose,green,greenish,hair-like,half,head,herb,imparipinnate,inflorescence,interrupted,lanceolate,largest,lateral,length,like,lobe,long,middle,minute,mixture,mm,multicellular,narrowly,obovate,occasionally,often,orbicular,outgrowth,ovary,patent,pedicel,perennial,petiole,pubescent,purple,ripe,rotate-stellate,shaggy,silky,simple,size,slender,sometimes,stem,stigma,stout,stripe,strongly,style,surface,testa,thick,tiny,tip,tipped,trichome,tube,unicellular,uniseriate,united,usually,velvety,vivid,wall,white,wide,woody,yellow	-12,.5,0-5-10,0.02-0.1-0.3,0.04-0.1-0.3,0.05-1,0.07-0.15,0.1-0.5,0.1-0.6,0.1-0.7-2,0.15-0.2,0.2,0.2-0.7-3,0.25-0.4,0.3,0.3-0.4,0.3-0.5,0.3-0.6,0.4-0.6,0.4-1,0.4-1-3.5,0.5-1,0.6-0.9-1.2,0.6-09,0.7-1,0.8-1.2,0.9-1.7,1-2-celled,1-2.5,1.5-2.1,1.5-2.4-3.2,1/2,2-3.5-13,2-4,2-4-celled,2-9,2-foliate,2.1-8,3-5,3/4,5-8-16,7-12,8-celled,abaxially,absent,abundance,abundant,acroscopically,acuminate,acute,adaxially,alfway,along,also,always,amongst,angled,anthesi,apical,apparently,appendage,arequipa,around,articulatio,articulation,axi,basal,berr,bract,c.,cage,column,common,cordate,crenate,deciduous,decumbent,decurrent,deeper,dense,density,dentate,developed,diamete,eaf,edicel,eed,elliptical,erect,exserted,extremely,fruiting,general,glabrescent,gree,halfway,hyaline,interjected,internode,investing,irregularly,lamina,larger,leaflet,leave,lobed,lobing,lon,longer,lower,margin,midvein,mixed,near,node,oblique,onto,pair,papillate-pubescent,peduncle,petiolule,population,present,primary,pseudostipule,rachi,reflexed,rest,rounded,ruit,scattered,secondary,sessile,short,shorter,sinus,small,somewhat,sparse,sparsely,sparser,spreading,staminal,sterile,straight,tall,tem,terminal,tertiary,toward,truncate,two,ud,undulate,unit,upper,variable,variety,vein,winged,ympodial	0.6-0.9,3.5-13,5-16,abaxial,adaxial,arrangement,bud,colour,feature,form,growth,hair,height,history,leaf,life,number,papilla,plant,pore,reproduction,seed,shape,texture,type,width,young	-2,0.05,0.2-1,0.3-0.8,0.45-0.6,0.5,0.5-0.8,0.7-1.5,0.9-1.3,1,1-celled,1.1-1.3,1.2-1.6,1.5-2,1.5-6.5,1.7-3.0,2-locular,4-12,4-celled,5-9-celled,adpressed,apex,appearance,articulated,base,berry,bifurcate,bracteate,branched,broadly,brown,capitate,cell,cm,conical,curved,dark,deltate,densely,diameter,distal,eglandular,either,elliptic,flushed,forming,giving,glabrous,gland,glandular,globose,green,greenish,hair-like,half,head,herb,imparipinnate,interrupted,lanceolate,largest,lateral,like,long,middle,minute,mixture,mm,multicellular,narrowly,obovate,occasionally,often,orbicular,outgrowth,patent,perennial,pubescent,purple,ripe,rotate-stellate,shaggy,silky,simple,slender,sometimes,stem,stout,stripe,strongly,surface,testa,thick,tiny,tipped,trichome,tube,unicellular,uniseriate,united,usually,velvety,vivid,wall,white,wide,woody,yellow	0.6-0.9,3.5-13,5-16
128	wfo-0001027248	success	158	119	66	86	72	33	63	3	.5,0.5-1,0.5-2.5,0.7-1.2,1-1.5,1-2,1-5,2-4.5,3-7,3.5-4,4-8,5-5.5,6-13,6.5-8,acute,anther,anthesi,apex,arachnoid,arachnoid-pubescent,area,bark,base,beige,berry,broadened,broadly,calyx,closely,cm,conical,corolla,deflexed,densely,dirty,elliptic,filament,fruit,glabrescent,glabrous,globose,green,leaf,lightly,lobe,lobed,long,merely,minor,minutely,mm,nearly,opposite,ovary,ovoid-reniform,pale,papillose,pedicel,petiole,pitted,poricidal,pubescent,scar,shaped,shrub,simple,size,small,spaced,specimen,stem,stigma,style,surface,tear-drop,thick,tip,tree,trichome,tube,unifoliate,white,wide,winged,woody,young	0,1-3,2-2.5,3-4,3-7-flowered,7-9,abaxial,abaxially,adaxially,along,ape,appearing,arachnoid-pubescen,beneath,brown,brownish,brownish-gra,dark,deltate,denser,dia,differing,difoliate,eaf,edicel,eed,ellipsoid,erect,exserted,felty,fleshy,free,fruiting,geminate,grayish-green,impressed,lamina,later,lateral,lower,main,major,margin,nflorescence,node,occasionally,older,overlappin,pair,papillo,patch,per,planar,pore,portion,present,pubescence,ruit,scattered,shoot,somewhat,soon,sparsely,strongly,tall,top,tub,ud,unit,vein,wid,ympodial	arrangement,brownish-gray,bud,coat,colour,connation,dry,embryo,feature,flower,form,growth,height,history,inflorescence,length,life,midpoint,na,number,overlapping,papilla,plant,prickle,ray,reproduction,seed,shape,spacing,texture,tuberculation,type,width	.5,0.5-1,0.5-2.5,0.7-1.2,1-1.5,1-2,1-5,2-4.5,3-7,3.5-4,4-8,5-5.5,6-13,6.5-8,acute,arachnoid,arachnoid-pubescent,area,base,beige,berry,broadened,broadly,closely,cm,conical,deflexed,densely,dirty,elliptic,glabrescent,glabrous,globose,green,leaf,lightly,lobed,long,merely,minutely,mm,nearly,opposite,ovoid-reniform,pale,papillose,pitted,poricidal,pubescent,shaped,shrub,simple,small,spaced,tear-drop,thick,tree,trichome,unifoliate,white,wide,winged,woody	brownish-gray,na,overlapping
129	wfo-0001027258	success	178	116	76	93	85	23	75	1	.25,.5,/4,0.6-2,0.9-1.3,1-2.3,1-4,2-2.5,2.5-8,3-6,3.5-4,4-5,5-10-flowered,6-8,7-13,abruptly,acuminate,acute,age,anther,anthesi,apex,attenuate,bark,base,berry,broadly,calyx,capitate,cm,corolla,deflexed,densely,dia,ellipsoid,elliptic,filament,flattened-reniform,fruit,glabrous,globose,green,greenish-yellow,internodal,large,leaf,length,lengthening,lenticel,lobe,lobed,margin,minor,minutely,mm,occasionally,opposite,ovary,ovate,pale,papillose,pedicel,petiole,pitted,planar,poricidal,pubescent,red-papillose,reddish,shrub,simple,size,slender,slit,small,sparsely,stem,stigma,style,surface,swollen,tip,treelet,trichome,tube,uniseriate,urceolate,way,white,widening,woody,x,young	0.25-0.5,0.5-1,1-1.5,1.2-2,1.5-1.6,3-4,4.5-5,7-9,abaxially,adaxially,along,apar,apical,apiculae,axil,ba,beneath,crystal,darker,decurrent,deltate,dense,deposit,differing,difoliate,dissecting,drying,eaf,edicel,eed,enlarge,entire,evenly,exserted,extending,fide,fragrant,free,fruiting,geminat,glabrou,incrassate,lamina,lateral,long,lower,main,major,microscope,middle,minute,nee,nflorescence,often,older,onto,pair,papillo,pore,portion,projection,prominent,ruit,sand,scar,scattered,slightly,spaced,speck,straight,strongly,sweetly,tall,tiny,tub,tuft,ud,unit,vein,visible,widest,winged,yellowish,yellowish-tan,ympodial	abaxial,adaxial,alternate,arrangement,bud,colour,connation,dry,feature,flower,form,growth,height,inflorescence,number,papilla,plant,seed,shape,specimen,texture,type,width	.25,.5,/4,0.6-2,0.9-1.3,1-2.3,1-4,2-2.5,2.5-8,3-6,3.5-4,4-5,5-10-flowered,6-8,7-13,abruptly,acuminate,acute,age,anthesi,attenuate,base,berry,broadly,calyx,capitate,cm,deflexed,densely,dia,ellipsoid,elliptic,flattened-reniform,glabrous,globose,green,greenish-yellow,internodal,large,leaf,lengthening,lenticel,lobe,lobed,margin,minutely,mm,occasionally,opposite,ovate,pale,papillose,pitted,planar,poricidal,pubescent,red-papillose,reddish,shrub,simple,slender,slit,small,sparsely,swollen,tip,treelet,trichome,uniseriate,urceolate,way,white,widening,woody,x	alternate
130	wfo-0001027260	success	170	131	88	99	71	32	86	2	-2,-7,0.25-1,0.5-3,0.5-6.5,0.75-1,0.8-2,1-2.5-14,1-3,1-3-10-17,1-4,1-4.5-14,1-7,1.5-13,15-30,2-18,2-2.5,2.5-3.5,3-6,3.5-25,4-25,4-32,5-10-25,acuminate,acute-,age,also,apart,apex,basal,base,berry,branched,chartaceous,clavate,cm,connivent,cordate,darker,densely,diameter,directed,distally,eglandular,ellipsoidal,elliptic,elliptic-ovate,entire,fading,flattened,flower,fruit,glabrate,glabrous,globose,greenish,hair,lanceolate,lavender,lobe,long,longitudinal,margin,membranaceous,mm,moderately,obtuse,often,ovate,pedicel,peduncle,petiole,pilose,pink,pore,puberulent,puberulent-pubescent,pubescent,pubescent-pilose,purple,rachi,shrub,simple,small,sparsely,stellate,stigma,stripe,style,tree,triangular,truncate,tube,unbranched,white,x,yellow,yellow-green,yellowish	0.5-1,1-2,1-6,1.5-2,2-10,2-6-20,3-11,3-4-6,3-4.5,4-5-foliat,5-25,5-40-60,5-merous,abaxially,absent,acute,adaxially,aggregate,alyx,ape,articulated,axe,beyond,blade,cell,connective,cylindrical,diamete,eaf,eed,equal,exceeding,exserted,leaving,lon,lower,narrowly,nearly,nflorescence,nther,orolla,pedicellar,perfec,perfect,pilo,presen,puberulent-pubescen,radiu,remnant,ruit,shorter,slightly,spaced,stamen,stone,strongly,subcoriaceous,tal,tapered,tem,thecae,time,tomento,ud,unit,usually,vary,vein,wide,yellow-orang,ympodial	15-40-60,2-20,abaxial,adaxial,anther,arrangement,bud,calyx,colour,connation,corolla,feature,filament,form,growth,height,inflorescence,leaf,length,number,ovary,plant,seed,shape,size,spacing,stem,surface,texture,tip,type,width	-2,-7,0.25-1,0.5-3,0.5-6.5,0.75-1,0.8-2,1-2.5-14,1-3,1-3-10-17,1-4,1-4.5-14,1-7,1.5-13,15-30,2-18,2-2.5,2.5-3.5,3-6,3.5-25,4-25,4-32,5-10-25,acuminate,acute-,age,also,apart,basal,berry,branched,chartaceous,clavate,cm,connivent,cordate,darker,densely,diameter,directed,distally,eglandular,ellipsoidal,elliptic,elliptic-ovate,entire,fading,flattened,glabrate,glabrous,globose,greenish,hair,lanceolate,lavender,lobe,long,longitudinal,membranaceous,mm,moderately,obtuse,often,ovate,pilose,pink,puberulent,puberulent-pubescent,pubescent,pubescent-pilose,purple,shrub,simple,small,sparsely,stellate,stripe,tree,triangular,truncate,unbranched,white,x,yellow,yellow-green,yellowish	15-40-60,2-20
131	wfo-0001027265	success	158	128	86	89	69	39	74	12	.2,.3,0.2-0.4,0.5,0.5-1,1-2.5,1-3,1.2-1.3,1.2-2,2,2-3,2-4,2/3,20-30,3-lobed,4-5,abaxially,acute,adaxially,anther,apart,apex,articulated,base,broad,calyx,cm,connivent,cylindrical,diameter,entire,extra-axillary,filament,flattened-reniform,flower,fruit,glabrous,globose,hair,herb,hermaphroditic,larger,leaf-opposed,lobe,long,long-attenuate,lower,margin,minutely,mm,near,nearly,oblong,orange,ovate-lanceolate,paired,partially,pedicel,peduncle,petiole,pitted,pore,present,prominent,puberulent,pubescent,rachi,rarely,recurved,red,ripe,rotate-stellate,seed,simple,slightly,somewhat,sparsely,stigma,style,surface,tip,triangular,tube,usually,weak,white-puberulent,winged,x,yellow	-2.5,.5,0.1â2,0.5â0.6,1-1.3,1.2â1.4,1.5-2.5,1.5â1.8,1.5â2,1.5â4,2-3-,2â2.5,2â3,30â50,4.5â8,4â6,4â7-branched,5-merou,58409,accrescent,adaxiall,alyx,apparently,axe,ba,berry,blade,capitat,chartaceous,ciliate,covering,croat,dehiscent,eaf,eed,erect,foliate,frui,fruiting,geminat,granule,juic,light,lon,longitudinall,low,mesocarp,nflorescence,node,numerous,obtuse,orolla,purple,rooting,ruit,scarcely,sclerotic,sometimes,spaced,subcoriaceous,tall,tamen,tem,time,unit,vary,white,wide,ympodial	0.1-2,1.2-1.4,1.5-1.8,1.5-2,1.5-4,2-2.5,30-50,4-6,4.5-8,arrangement,articulation,capitate,coat,colour,connation,corolla,dehiscence,feature,form,growth,height,history,inflorescence,leaf,length,life,longitudinally,number,ovary,perennial,plant,reproduction,shape,size,spacing,stem,texture,tuberculation,width	.2,.3,0.2-0.4,0.5,0.5-1,1-2.5,1-3,1.2-1.3,1.2-2,2,2-3,2-4,2/3,20-30,3-lobed,4-5,abaxially,acute,adaxially,apart,apex,articulated,base,broad,cm,connivent,cylindrical,entire,extra-axillary,flattened-reniform,glabrous,globose,hair,herb,hermaphroditic,larger,leaf-opposed,lobe,long,long-attenuate,lower,minutely,mm,near,nearly,oblong,orange,ovate-lanceolate,paired,partially,pitted,pore,present,prominent,puberulent,pubescent,rarely,recurved,red,ripe,rotate-stellate,seed,simple,slightly,somewhat,sparsely,tip,triangular,usually,weak,white-puberulent,winged,x,yellow	0.1-2,1.2-1.4,1.5-1.8,1.5-2,1.5-4,2-2.5,30-50,4-6,4.5-8,capitate,longitudinally,perennial
132	wfo-0001027265	success	155	125	84	91	64	34	78	6	.2,.3,0.1â2,0.2-0.4,0.5,0.5-1,1-2.5,1-3,1.2-1.3,1.2-2,1.2â1.4,1.5â1.8,1.5â2,2,2-3,2-4,2/3,20-30,2â2.5,2â3,4-5,4â6,4â7-branched,abaxially,acute,adaxially,anther,apart,apex,articulated,base,broad,calyx,cm,connivent,cylindrical,diameter,extra-axillary,filament,flattened-reniform,flower,fruit,glabrous,globose,hair,herb,hermaphroditic,larger,leaf-opposed,lobe,long,long-attenuate,lower,minutely,mm,near,nearly,oblong,orange,ovate-lanceolate,paired,partially,pedicel,peduncle,petiole,pitted,pore,prominent,puberulent,pubescent,rachi,recurved,red,ripe,rotate-stellate,seed,simple,sometimes,somewhat,sparsely,stigma,style,surface,tip,triangular,tube,weak,white-puberulent,winged,x,yellow	-2.5,.5,0.5â0.6,1-1.3,1.5-2.5,1.5â4,2-3-,3-lobed,30â50,4.5â8,5-merou,58409,accrescent,adaxiall,alyx,apparently,axe,ba,blade,capitat,chartaceous,ciliate,covering,croat,dehiscent,eaf,eed,entire,erect,foliate,frui,fruiting,geminat,granule,juic,light,lon,longitudinall,low,margin,mesocarp,nflorescence,node,numerous,obtuse,orolla,purple,rarely,rooting,ruit,scarcely,sclerotic,slightly,spaced,subcoriaceous,tall,tamen,tem,time,unit,vary,white,wide,ympodial	1.5-4,30-50,4.5-8,arrangement,articulation,capitate,coat,colour,connation,corolla,dehiscence,feature,form,growth,height,history,inflorescence,leaf,length,life,longitudinally,number,ovary,perennial,plant,reproduction,shape,size,spacing,stem,texture,tuberculation,type,width	.2,.3,0.1â2,0.2-0.4,0.5,0.5-1,1-2.5,1-3,1.2-1.3,1.2-2,1.2â1.4,1.5â1.8,1.5â2,2,2-3,2-4,2/3,20-30,2â2.5,2â3,4-5,4â6,4â7-branched,abaxially,acute,adaxially,apart,apex,articulated,base,broad,cm,connivent,cylindrical,diameter,extra-axillary,flattened-reniform,glabrous,globose,hair,herb,hermaphroditic,larger,leaf-opposed,lobe,long,long-attenuate,lower,minutely,mm,near,nearly,oblong,orange,ovate-lanceolate,paired,partially,pitted,pore,prominent,puberulent,pubescent,recurved,red,ripe,rotate-stellate,seed,simple,sometimes,somewhat,sparsely,tip,triangular,weak,white-puberulent,winged,x,yellow	1.5-4,30-50,4.5-8,capitate,longitudinally,perennial
133	wfo-0001027284	success	172	122	67	78	94	44	62	5	.3,0.7â0.9,0.7â1,1.5â2.5,1.5â8,1.8â2,1â1.5,1â3,2.5â3,2.5â3.5,2â16,2â2.2,3.5â14,4,4â12,4â6,9â18,acuminate,acute,anther,anthesi,apex,base,berry,branched,brownish,calyx,cm,cordate,deltoid,elliptic,filament,flattened-reniform,flower,fruit,glabrous,globose,green,herbaceous,inflorescence,lobe,long,maturity,minutely,mm,nearly,oblique,orangish,ovate,ovoid,pale,pedicel,petiole,pubescent,reticulate-rugulose,rounded,scandent,scar,shortly,shrub,simple,size,sometimes,soon,sparsely,stellate,stigma,style,surface,tip,truncate,tube,unbranched,vine,weakly,white,woody,x	0.1â0.5,0.1â2,0.2â,1.2â1.5,1.5â2,1.5â5.5,1â2,3â4,5-merous,5â7,5â8,abaxially,accrescent,adaxially,alyx,axe,axillary,blade,branch,c.,capitat,ciliat,climbing,conspicuous,contiguousl,cylindrical,deflected,densely,diameter,distally,eaf,eed,enlarged,entire,extra-axillary,fine,flattened,fleshy,fruiting,glabrescen,glabrou,gradually,immature,leafy,lower,m.,margin,midvein,near,nflorescence,nternode,one,orolla,pair,peduncle,pendulou,perfec,pink,pinnate,planar,plurifoliate,pointed,prominent,pubescence,rachi,rarely,reduced,ruit,sand-punctat,sand-punctate,secondary,seen,side,slightly,somewhat,spaced,spreading,stem-terminal,tamen,tan,tem,thickened,thickly,time,toward,tree,understory,unifoliat,unit,vary,vein,venation,wide,ympodial	0.2â1.5,arrangement,bud,capitate,coat,colour,connation,contiguously,corolla,decurrency,dry,embryo,feature,form,glabrescent,growth,height,history,leaf,length,life,midpoint,minor,na,new,number,ovary,papilla,plant,pore,prickle,ray,reproduction,seed,shape,spacing,specimen,stem,texture,tuberculation,type,width,winging,young	.3,0.7â0.9,0.7â1,1.5â2.5,1.5â8,1.8â2,1â1.5,1â3,2.5â3,2.5â3.5,2â16,2â2.2,3.5â14,4,4â12,4â6,9â18,acuminate,acute,berry,branched,brownish,cm,cordate,deltoid,elliptic,flattened-reniform,flower,fruit,glabrous,globose,green,herbaceous,long,maturity,minutely,mm,nearly,oblique,orangish,ovate,ovoid,pale,pubescent,reticulate-rugulose,rounded,scandent,shortly,shrub,simple,sometimes,soon,sparsely,stellate,tip,truncate,unbranched,vine,weakly,white,woody,x	0.2â1.5,capitate,contiguously,glabrescent,na
134	wfo-0001027302	success	188	121	73	92	96	29	70	3	0.4-5,0.5,0.5-1,0.6-1,0.8-1,1-1.3,1-1.5,1-3,1.5-2,10,10-20,2,2-3,2-6,2.2,2.7-7.5,7,acuminate,acute,age,anther,apex,appearing,bark,base,berry,bright,brownish-yellow,calyx,capitate,clavate,cm,conical,cordate,corolla,deltoid,dendritic,densely,elliptic,filament,fine,flattened,flower,free,glabrous,globose,growth,later,lateral,leaf,length,lenticular,less,lobe,lobed,long-triangular,minutely,mm,narrowly,ovary,ovate,pale,petiole,pitted,plant,plurifoliate,pore,poridical,pubescent,red,scar,shrub,simple,slit-like,small,somewhat,sparsely,stem,stigma,style,surface,tapering,terminal,tiny,tip,tree,trichome,truncate,tube,violet,x,young	.5,1,1-2,1.2-1.6,1.2-2.5,3.5-5,3/4,5-7,6-12,7/8,abaxial,abaxially,adaxial,adaxially,along,anthesi,apical,ba,basal,becoming,blade,branching,broader,crispate,cultivation,decurrent,deflexed,denser,diameter,dichasia,discussion,eaf,edicel,eed,entire,especially,ew,exserted,flat-topped,fruiting,growing,inserted,juvenile,larger,lax,like,lon,long,lower,m.,main,margin,monochasial,nflorescence,nodding,occasionally,older,otherwise,overtopping,pair,papillo,pedicle,per,pericarp,planar,portion,prominent,puberulent,pyramidal,reddish-brown,reflexed,ruit,scattered,scrambling,secondary,see,shade,shin,shoot,sleeve,stamen,strongly,tall,thin,time,tub,ud,undulate,unit,usually,vein,way,wide,winged,woody,ympodial	arrangement,bud,colour,connation,decurrency,feature,form,fruit,height,history,inflorescence,life,minor,na,new,number,papilla,papillose,pedicel,reproduction,seed,shape,shiny,size,spacing,texture,type,width,winging	0.4-5,0.5,0.5-1,0.6-1,0.8-1,1-1.3,1-1.5,1-3,1.5-2,10,10-20,2,2-3,2-6,2.2,2.7-7.5,7,acuminate,acute,age,appearing,berry,bright,brownish-yellow,capitate,clavate,cm,conical,cordate,deltoid,dendritic,densely,elliptic,fine,flattened,free,glabrous,globose,later,lateral,lenticular,less,lobed,long-triangular,minutely,mm,narrowly,ovate,pale,pitted,plurifoliate,poridical,pubescent,red,shrub,simple,slit-like,small,somewhat,sparsely,tapering,terminal,tiny,tip,tree,trichome,truncate,violet,x,young	na,papillose,shiny
135	wfo-0001027310	success	213	157	107	120	93	37	105	2	/3,0.05,0.1,0.6-1,0.7-2,0.9-0.17-2.2,1-1.2,1-1.7,1-6,1.1-1.5,1.5-5,1/3-1/2,11-16,2-10,2-4,2.2-2.5,2.8-3,2/3,3-15,4-10,4-9,4.5-7,5-20,5-7,6-8,acute,anther,apart,apex,apically,apparently,articulated,bark,base,berry,calyx,cm,connivent,cuneate,dark,deltate,diameter,entire,erect,evenly,filament,flattened,flattened-reniform,flower,fruit,fused,glabrescent,gray,green,hair,lanceolate,lateral,leaf,length,less,lobe,lobed,long,long-styled,longer,lower,maturity,mauve,midpoint,minutely,mm,moderately,pale,pedicel,pendulous,petiole,pitted,plant,poricidal,porrect-lepidote,prickle,prickly,pubescent,purple,ray,red,reflexed,rounded,scar,sessile,shallowly,shorter,shrub,simple,sometimes,sparse,sparsely,spherical,spreading,stellate,stellate-pubescent,stem,straight,style,surface,tapering,terete,terminal,time,tip,toward,tree,trichome,truncate,tube,unarmed,way,wide,yellow,young	.8,0,0-20,0-5,0.05-0.15,0.1-0.2,0.15-0.3,1.5-2.2,1/10-1/6,1/3-3/4,2-3.1,2-5,20-60,22-30,4.5-5.5,5-10,5-merous,7-10,8-10,9-13-20,abaxial,abaxially,acut,adaxial,alyx,andromonoecious,apar,blade,branched,branching,broadly,chartaceous,curved,densely,discolorous,distal,drying,eaf,eed,elongating,equal,faint,foliaceous,free,fruiting,gently,glabrou,glabrous,glaucous,green-brown,hermaphrodite,heterostylous,inflated,infructescence,lowermost,margin,mature,nflorescence,older,one,open,orange-brown,orolla,oung,pair,peduncle,per,pericarp,plurifoliat,porrect,portion,primary,reddi,ruit,secondary,short-styled,smooth,spaced,stalk,stalked,staminat,stout,strongly,tamen,tertiary,unarme,unit,vary,vein,venation,visible,woody,ympodial	anthesi,arrangement,bud,coat,colour,connation,corolla,decurrency,dry,embryo,feature,form,growth,height,history,inflorescence,life,minor,na,new,number,ovary,papilla,pore,reddish,reproduction,seed,shape,size,spacing,specimen,stigma,texture,tuberculation,type,width,winging	/3,0.05,0.1,0.6-1,0.7-2,0.9-0.17-2.2,1-1.2,1-1.7,1-6,1.1-1.5,1.5-5,1/3-1/2,11-16,2-10,2-4,2.2-2.5,2.8-3,2/3,3-15,4-10,4-9,4.5-7,5-20,5-7,6-8,acute,apart,apex,apically,apparently,articulated,base,berry,cm,connivent,cuneate,dark,deltate,diameter,entire,erect,evenly,flattened,flattened-reniform,flower,fused,glabrescent,gray,green,hair,lanceolate,lateral,length,less,lobe,lobed,long,long-styled,longer,lower,maturity,mauve,midpoint,minutely,mm,moderately,pale,pendulous,pitted,poricidal,porrect-lepidote,prickly,pubescent,purple,ray,red,reflexed,rounded,sessile,shallowly,shorter,shrub,simple,sometimes,sparse,sparsely,spherical,spreading,stellate,stellate-pubescent,straight,tapering,terete,terminal,time,tip,toward,tree,trichome,truncate,unarmed,way,wide,yellow,young	na,reddish
136	wfo-0001027317	success	144	122	66	81	63	41	59	7	0.3-1,0.4-1.5,0.5-1,0.5-3,0.8-3.5,1,1-1.5,1-2,1-5,1.4-1.6,2-9,4.5-5,?,abaxial,acuminate,acute,anther,anthesi,apex,apically,bark,base,berry,bilobed,broadly,calyx,closely,cm,conical,corolla,deltoid,difoliate,ellipsoid,elliptic,erect,expanded,filament,filiform,fruit,glabrous,globose,golden,green,leaf,lobe,lobed,minor,minutely,mm,nearly,offset,opposite,ovary,pale,papillose,pedicel,petiole,pointed,pore,poricidal,pubescent,scar,shaped,shrub,simple,size,slightly,spaced,stem,stigma,style,surface,tear-drop,tip,trichome,tube,uniseriate,white,woody,x,young	.25,.5,0.1-0.2,1.5-2,2-3-flowered,3-3.5,7-9,adaxially,along,apical,arch,ba,beneath,cucullate,deciduous,deflexed,densely,dia,differing,drying,eaf,edicel,eed,elongated,free,fruiting,geminat,greyish-whit,immature,inflorescenc,joined,known,lateral,like,lon,long,long-exserted,lower,main,major,margin,mature,minute,nflorescence,older,overlappin,pair,papillo,portion,projection,prominent,reflexed,rest,ruit,series,soon,sparsely,strongly,tall,tub,ud,vein,ympodia	0.25,2-3,adaxial,arrangement,bud,coat,colour,connation,dry,embryo,feature,flower,form,geminate,greyish-white,growth,hair,height,history,inflorescence,length,life,midpoint,na,new,number,overlapping,papilla,plant,prickle,ray,reproduction,seed,shape,spacing,specimen,sympodia,texture,tuberculation,type,width	0.3-1,0.4-1.5,0.5-1,0.5-3,0.8-3.5,1,1-1.5,1-2,1-5,1.4-1.6,2-9,4.5-5,?,acuminate,acute,apex,apically,base,berry,bilobed,broadly,closely,cm,conical,deltoid,difoliate,ellipsoid,elliptic,erect,expanded,filiform,glabrous,globose,golden,green,leaf,lobed,minutely,mm,nearly,offset,opposite,pale,papillose,pointed,poricidal,pubescent,shaped,shrub,simple,slightly,spaced,tear-drop,tip,trichome,uniseriate,white,woody,x	0.25,2-3,geminate,greyish-white,na,overlapping,sympodia
137	wfo-0001027323	success	175	123	64	86	89	37	56	8	0.5-1,1-1.5,1.2-1.5,10-15,14-21,2-6,2.5-3,20-45,3-5,5-7,6-11,acute,adaxial,anther,anthesi,apex,area,asymmetric,attenuate,bark,base,berry,broadened,bud,calyx,campanulate,closely,cm,corolla,deflexed,dry,elliptic,erect,filament,fleshy,flower,fruit,furcate,glabrate,glabrous,globose,grey,leaf,lobe,lobed,long-triangular-deltoid,minor,minutely,mm,older,opposite,ovary,overlapping,ovoid,ovoid-reniform,papillose,partially,pedicel,persistent,petiole,pinkish-grey,pitted,plant,pore,poricidal,red-papillose,reddish-grey,scar,shaped,size,slightly,spaced,specimen,stem,stigma,style,surface,tear-drop,tiny,tip,treelet,tube,white,winged,woody,x	.75,/3,1-2,2-3,5-20-flowered,7-9,along,apparent,appearing,arising,ba,character,closed,cork,decurrent,densely,dia,differing,difoliate,dried,eaf,edicel,eed,elongate,entire,erose,exserted,five-pointed,flopping,free,fruiting,geminat,growing,held,higher,hood,hooded,immature,interpetalar,lateral,like,live,lon,long,lower,main,major,margin,matte,mature,measured,middle,nflorescence,occasionally,one,onto,pair,papillae,papillo,planar,portion,prominent,proximal,rather,rest,ridge,ruit,secondary,seen,sinus,small,smoot,soon,straight,tall,tan,thickened,thin,trunk,two,ud,unit,upper,vein,visible,way,widest,ympodial,young	3,5-20,7,abaxial,alternate,arrangement,coat,colour,connation,embryo,feature,form,green,growth,hair,height,hirsute,history,inflorescence,length,life,midpoint,na,number,papilla,prickle,ray,reproduction,seed,shape,smooth,spacing,texture,tuberculation,type,width,winging	0.5-1,1-1.5,1.2-1.5,10-15,14-21,2-6,2.5-3,20-45,3-5,5-7,6-11,acute,area,asymmetric,attenuate,berry,broadened,campanulate,closely,cm,deflexed,elliptic,erect,fleshy,furcate,glabrate,glabrous,globose,grey,leaf,lobed,long-triangular-deltoid,minutely,mm,opposite,overlapping,ovoid,ovoid-reniform,papillose,partially,persistent,pinkish-grey,pitted,poricidal,red-papillose,reddish-grey,shaped,slightly,spaced,tear-drop,tiny,treelet,white,winged,woody,x	3,5-20,7,alternate,green,hirsute,na,smooth
138	wfo-0001027340	success	189	121	85	94	95	27	81	4	0.5-0.9,1-10,1-2,1-3,10-16,16-22,2-3,2-4,3.5-5,3.5-9,4-7.5,5-11,6-8.5,7-18,7-8,8-14,8-9.5,abruptly,absent,acumen,anther,apex,auriculate,axillary,bud,cell,chartaceous,cm,connivent,corolla,covering,dark,diameter,elliptic,filament,flower,fruit,glabrous,globose,green,green-white,hair,hair-like,herb,homostylous,lanceolate,lateral,lengthening,like,lilac-purple,lobe,long,make,membranous,minute,mm,mucilaginous,narrow,narrowed,odd-pinnate,ovate,ovoid,pedicel,peduncle,petiole,plant,pointed,pore,poricidal,pubescent,purple,ripe,rotate,seed,short,size,slit,sparsely,splotched,stem,stigma,style,subtending,terminal,testal,thick,throughout,tinged,tip,tube,wall,wet,wing,x	1.5-2.7,2-3.5,2.5-4.5,2.7-4.5,3-4,4-6,5-6,5-merou,abaxially,acuminate,adaxially,ag,along,alyx,apart,apparently,articulated,articulation,axe,base,berry,blade,brownish,capitat,ciliate,condition,cordate,decreasing,developing,digestion,distal,distinct,dorsally,drying,eaf,edge,eed,enzyme,especially,exceeding,flat,folded,forked,fresh,geminat,generally,glabrou,greenish,hal,half,high,honeycomb-shaped,indistinct,interjected,leaflet,living,lower,margin,midrib,minutely,nflorescence,orolla,pair,papillose,perfect,petiolulate,plurifoliate,puberulent,purpl,removed,rounded,ruit,semi-erec,semi-rosette,sessile,seudostipule,shortly,slightly,spaced,specimen,stamen,ste,straight,tall,tamen,tem,tri-,truncate,unit,usually,vary,whitish,yellow,ympodial,young	5-merous,abaxial,adaxial,age,arrangement,calyx,capitate,colour,connation,feature,form,growth,height,history,inflorescence,leaf,length,life,na,number,ovary,pseudostipule,reproduction,shape,spacing,surface,texture	0.5-0.9,1-10,1-2,1-3,10-16,16-22,2-3,2-4,3.5-5,3.5-9,4-7.5,5-11,6-8.5,7-18,7-8,8-14,8-9.5,abruptly,absent,acumen,apex,auriculate,axillary,bud,cell,chartaceous,cm,connivent,covering,dark,diameter,elliptic,glabrous,globose,green,green-white,hair,hair-like,herb,homostylous,lanceolate,lateral,lengthening,like,lilac-purple,lobe,long,make,membranous,minute,mm,mucilaginous,narrow,narrowed,odd-pinnate,ovate,ovoid,pointed,pore,poricidal,pubescent,purple,ripe,rotate,seed,short,slit,sparsely,splotched,stem,subtending,terminal,testal,thick,throughout,tinged,tip,wall,wet,wing,x	5-merous,age,capitate,na
139	wfo-0001027354	success	166	126	70	93	73	33	68	2	0.5-2,0.7-1.3,1,1-1.5,1-7,1.5-2,1.7-5,10-20,2.5-3.5,3-4,4-10,5-7,6.5-13,absent,acute,age,anther,anthesi,apex,appearing,bark,base,berry,bi-lobed,branch,branching,calyx,cm,conical,corolla,dark,deltoid,dendritic,densely,elliptic,erect,filament,flattened,flower,fork,free,fruit,glabrous,globose,golden,growth,later,lateral,leaf,length,lenticular,less,lobe,lobed,loosely,minutely,mm,narrowly,nodding,occasionally,ovary,pedicel,petiole,pitted,plurifoliate,pore,poricidal,pubescent,purplish-black,pyramidal,reddish-brown,scar,shrub,slit-like,small,sparsely,stem,stigma,style,surface,tapering,terminal,tip,tree,tree-like,trichome,tube,type,violet,white,woody,x,young	.5,0,0.5,1-1.2,1.5-1.8,10,3.4-4,3/4,8-12,abaxial,abaxially,adaxial,along,apical,ba,basal,becoming,belo,blade,covered,denser,diameter,dichasia,drying,eaf,edicel,eed,entire,ew,exserted,fruiting,glabrate,inserted,like,long,loose,lower,m.,monochasial,mostly,near,nflorescence,older,pair,papillo,per,pericarp,planar,portion,pubescen,raised,ruit,secondary,side,simple,sleeve,slightly,somewhat,stamen,strongly,tall,thecalyx,thin,time,tiny,tub,ud,unit,vein,way,wide,winged,ympodial	arrangement,bud,coat,colour,connation,decurrency,dry,feature,form,height,history,inflorescence,life,midpoint,minor,na,new,number,papilla,papillose,plant,prickle,ray,reproduction,seed,shape,size,spacing,specimen,texture,tuberculation,width,winging	0.5-2,0.7-1.3,1,1-1.5,1-7,1.5-2,1.7-5,10-20,2.5-3.5,3-4,4-10,5-7,6.5-13,absent,acute,age,apex,appearing,berry,bi-lobed,branch,branching,cm,conical,dark,deltoid,dendritic,densely,elliptic,erect,flattened,fork,free,glabrous,globose,golden,later,lateral,lenticular,less,lobed,loosely,minutely,mm,narrowly,nodding,occasionally,pitted,plurifoliate,poricidal,pubescent,purplish-black,pyramidal,reddish-brown,shrub,slit-like,small,sparsely,tapering,terminal,tip,tree,tree-like,trichome,violet,white,woody,x	na,papillose
140	wfo-0001027359	success	220	127	78	92	128	35	76	2	-4,.5,/3,0.3-1.2,0.5-2,0.6-1,1-1.2,1-5,1.5-2.5,1.8-3.2,2-3,2.5-3.5,2.5-5.5,3-10,6-8,acute,anther,apart,apex,base,berry,bright,calyx,cell,cm,cream,cuneate,dark,diameter,dull,entire,filament,filiform,flattened-reniform,flower,fruit,glabrous,green,lateral,leaf,length,lobe,lobed,long,marking,maturity,minutely,mm,moderately,narrow-deltate,narrow-ovate,obtuse,occasional,orange-brown,outline,ovoid,pale,pedicel,petiole,pit,poricidal,prickle,prickly,purple,raised,red,reticulate,scar,shrub,small,smooth,sometimes,spherical,spreading,stellate,stellate-pubescent,stem,style,surface,tapering,terminal,tip,trichome,tube,unarmed,way,weakly,white,wide,yellow,yellow-brown,young	-20,-3,-7,.1,.2,/4,0-2,0-3,0-5,0-9,0.1,0.1-0.2,0.1-0.2-0.25,0.1-1.5,0.3-0.5,0.5,0.5-1,0.6-0.8,1-2,1-3,1-4,1.2-1.5-2,1.2-2,1.5-2,1/5-1/4,2-10,2-4,4-5,4-5-6.5,5-6-8-9,5-merous,7-8,abaxially,acut,alyx,apar,apically,apparently,articulated,ba,bark,blade,branched,brow,chartaceous,concolorous,coroll,curved,deltate,densely,difoliate,distinctive,drying,eaf,eed,elongate,elongating,equal,erect,eye,flattened,free,fruiting,geminat,glabrescent,gray,herbaceous,infructescence,less,like,longer,lower,margin,mature,membranous,midpoint,naked,near,nflorescence,often,older,one,open,orolla,oung,ovate,pair,peduncle,per,perfec,pericarp,porrect,portion,primary,rachi,rarely,ray,reflexed,ruit,scandent,sessile,shallowly,shorter,simple,slender,slightly,spaced,sparsely,stalk,stalked,stump,tamen,terete,tertiary,time,tinge,ud,unarme,undulate,unit,usually,variously,vary,vein,venation,visible,woody,ympodial	arrangement,bud,coat,colour,connation,corolla,decurrency,embryo,feature,form,growth,height,history,inflorescence,life,minor,new,number,ovary,papilla,perennial,plant,pore,reproduction,seed,shape,size,spacing,stigma,texture,tuberculation,type,unknown,width,winging	-4,.5,/3,0.3-1.2,0.5-2,0.6-1,1-1.2,1-5,1.5-2.5,1.8-3.2,2-3,2.5-3.5,2.5-5.5,3-10,6-8,acute,apart,base,berry,bright,cell,cm,cream,cuneate,dark,diameter,dull,entire,filiform,flattened-reniform,glabrous,green,lateral,lobed,long,marking,maturity,minutely,mm,moderately,narrow-deltate,narrow-ovate,obtuse,occasional,orange-brown,outline,ovoid,pale,pit,poricidal,prickly,purple,raised,red,reticulate,shrub,small,smooth,sometimes,spherical,spreading,stellate,stellate-pubescent,surface,tapering,terminal,tip,trichome,unarmed,way,weakly,white,wide,yellow,yellow-brown,young	perennial,unknown
141	wfo-0001027366	success	136	110	53	68	68	42	48	5	0.25-0.5,0.5-1,1-1.5,1-2,1-3,11-21,4-4.5,4-5,5-7,6-19,acute,anther,anthesi,apex,bark,base,berry,bright,broadly,calyx,capitate,closely,cm,conical,corolla,deltate,elliptic,erect,filament,glabrous,globose,green,greenish-white,internodal,leaf,lobe,lobed,long-triangular,minutely,mm,opposite,orbicular,ovary,ovoid,ovoid-reniform,packed,pale,papillose,pedicel,petiole,pitted,pore,poridical,rounded,scar,shaped,shrub,simple,sometimes,stem,stigma,style,surface,tear-drop,tip,tube,woody,young	.5,/2,/4,0.7-1,1.5-2,2-2.5,3-10-flowered,3-9,603,abaxially,adaxially,ape,axe,ba,brown,conspicuously,dark,deflexed,dia,drying,eaf,edicel,eed,et,except,exserted,fide,free,fruiting,golden,lamina,lateral,less,lon,long,lower,main,margin,middle,nflorescence,older,overlappin,pair,papillo,parallel,planar,pointed,portion,ramo,reddish,ruit,secondary,shining,somewhat,straight,tall,trichome,tub,ud,unifoliat,unit,vein,venation,way,wide,widest,yellowish-gre,ympodial	3-10,arrangement,bud,coat,colour,connation,decurrency,dry,embryo,feature,flower,form,fruit,growth,height,history,inflorescence,length,life,midpoint,minor,na,new,number,overlapping,papilla,plant,prickle,ray,reproduction,seed,shape,size,spacing,specimen,texture,tuberculation,type,unifoliate,width,winging,yellowish-grey	0.25-0.5,0.5-1,1-1.5,1-2,1-3,11-21,4-4.5,4-5,5-7,6-19,acute,berry,bright,broadly,capitate,closely,cm,conical,deltate,elliptic,erect,glabrous,globose,green,greenish-white,internodal,leaf,lobed,long-triangular,minutely,mm,opposite,orbicular,ovoid,ovoid-reniform,packed,pale,papillose,pitted,poridical,rounded,shaped,shrub,simple,sometimes,tear-drop,tip,woody	3-10,na,overlapping,unifoliate,yellowish-grey
142	wfo-0001027368	success	143	116	67	73	70	43	63	4	0.3-2.5,0.5-3.5,0.5-5,0.8-2,1-2,1.5-2.5,2,2-2.5,2-3,2-4,3-12.5,5-15-20,5-6,abruptly,acuminate,acute,also,apex,base,branched,calyx,cm,connivent,cuneate,decurrent,deltate,dendritically,densely,distally,ellipsiodal,forked,glabrous,gland,globose,hair,lanceolate,lenticular,lobe,margin,mm,narrowed,narrowly,nearly,oblong,occasionally,often,otherwise,ovoid-fusiform,pedicel,petiole,pore,puberulent,pubescent,purple,shrub,simple,small,sometimes,sparsely,stalked,stellate,stigma,style,subhastate,tip,triangular,truncate,tube,unbranched,unknown,usually,white,x	-10,-15,-2-5,.5,1-15-flower,1-6,1.5-2,2-9,3,4-6,4-many-foliat,5-10,8-13,abaxially,absen,adaxiall,adaxially,aggregate,apart,articulated,axe,ba,blade,cell,chartaceous,color,contiguous,cylindrical,darker,denser,diameter,directed,eaf,eed,elliptic,elliptic-ovate,entire,except,lighter,long,long-stalked,lower,midvein,moderately,nflorescence,nther,obtuse,orolla,peduncle,pubescen,rachi,radiu,ray,ruit,spaced,star,stone,subcapitat,subcoriaceous,tal,tem,terminal,three,time,unit,vary,vein,wide,yellow,ympodial	-5,1-15,anther,arrangement,bud,coat,colour,connation,corolla,decurrency,embryo,feature,filament,flower,form,fruit,growth,height,inflorescence,leaf,length,minor,na,new,number,ovary,papilla,plant,prickle,scar,seed,shape,size,spacing,stem,subcapitate,surface,texture,tuberculation,type,width,winging,young	0.3-2.5,0.5-3.5,0.5-5,0.8-2,1-2,1.5-2.5,2,2-2.5,2-3,2-4,3-12.5,5-15-20,5-6,abruptly,acuminate,acute,also,branched,cm,connivent,cuneate,decurrent,deltate,dendritically,densely,distally,ellipsiodal,forked,glabrous,gland,globose,hair,lanceolate,lenticular,lobe,margin,mm,narrowed,narrowly,nearly,oblong,occasionally,often,otherwise,ovoid-fusiform,puberulent,pubescent,purple,shrub,simple,small,sometimes,sparsely,stalked,stellate,subhastate,triangular,truncate,unbranched,unknown,usually,white,x	-5,1-15,na,subcapitate
143	wfo-0001027369	success	188	128	73	87	101	41	69	4	-10,.5,.7,/4,0-5,0.2-0.5-1,0.25-0.4,0.3-1.5,0.5,0.5-0.8,0.6-0.8,1-2.5,1.2-2.5,1.2-3,1.5-2,2-5,3-10,4-8,almost,anther,apart,apex,apically,articulated,bark,base,berry,calyx,cm,cordate,deltate,densely,diameter,erect,filament,filiform,flower,fruit,glabrous,herbaceous,lanceolate,lateral,leaf,length,less,lobe,lobed,long,mauve,midpoint,mm,moderately,multangulate,narrowly,pale,pedicel,pendulous,perpendicular,petiole,poricidal,prickle,prickly,ray,reflexed,rounded,scandent,scar,sessile,shrub,simple,slightly,spherical,spreading,stellate-pubescent,stem,straight,style,surface,tapering,terminal,tip,trichome,tube,way,wide,winged,yellow	-11,.1,.4,0-1,0-15,0-2,0-3,0-6,0.05-0.15,0.1,0.1-0.2,0.1-0.3,0.5-1.5,1-2,1-2-4,1-3,1-4,1/3,2-3,3,3-4,4-5,5,5-merous,7-15,abaxially,acut,alyx,ame,apar,apparently,blade,branched,broad-deltate,c.,color,concolorous,curved,difoliate,distance,drying,eaf,eed,elongating,equal,extending,eye,free,fruiting,geminat,glabrou,glaucous,gra,green,hair,infructescence,know,known,lon,lower,margin,mature,membranous,midvein,naked,nflorescence,older,one,open,orbicular,orolla,oung,peduncle,per,perfec,pericarp,porrect,portion,prickl,reniform,ruit,side,slender,smooth,spaced,sparsely,stalk,stalked,stellate,strongly,tamen,terete,time,unarmed,unequal,unit,vary,venation,visible,wider,ympodial	2-4,acute,anthesi,arrangement,bud,coat,colour,connation,corolla,decurrency,dry,embryo,feature,form,gray,growth,height,history,inflorescence,life,minor,na,new,number,ovary,papilla,plant,pore,reproduction,seed,shape,size,spacing,specimen,stigma,texture,tuberculation,type,width,winging,young	-10,.5,.7,/4,0-5,0.2-0.5-1,0.25-0.4,0.3-1.5,0.5,0.5-0.8,0.6-0.8,1-2.5,1.2-2.5,1.2-3,1.5-2,2-5,3-10,4-8,almost,apart,apically,articulated,base,berry,cm,cordate,deltate,densely,diameter,erect,filiform,glabrous,herbaceous,lanceolate,lateral,less,lobed,long,mauve,mm,moderately,multangulate,narrowly,pale,pendulous,perpendicular,poricidal,prickle,prickly,reflexed,rounded,scandent,sessile,shrub,simple,slightly,spherical,spreading,stellate-pubescent,stem,straight,tapering,terminal,tip,trichome,way,wide,winged,yellow	2-4,acute,gray,na
144	wfo-0001027378	success	149	118	69	84	65	34	66	3	.2,0.5â1,0.7â1,1.2â1.8,1.5â1.8,1.5â8,15â35,2.3â5,2â11,2â2.5,3â4.5,3â5,3â6,4â6,4â9,5-8,5â13,6â7,acuminate,acute,adaxial,anther,apex,base,berry,blue,broadly,calyx,chartaceous,cm,cordate,deeply,deltoid,extra-axillary,filament,fleshy,flower,fruit,glabrous,hair,hair-tipped,half,herbaceous,lanceolate,leaf,light,lobe,long,lower,margin,minutely,mm,narrowly,obscure,often,ovoid,papillose,pedicel,pentagonal,petiole,pubescent,revolute,rotate-stellate,rounded,sand-punctate,simple,slender,small,somewhat,spaced,sparsely,stem,stigma,style,tip,tooth,trichome,tube,unbranched,unknown,vine,white,widely,x	0.8â2.5,1.2â1.5,1â1.5,1â3,2.5â7,2â2.2,5-merous,5â10,5â7,6â10,abaxially,adaxially,alyx,apar,apicall,axe,blade,c.,capitat,ciliate,clavate,climbin,color,cylindrical,densely,diameter,eaf,eed,flattened,fruiting,glabrou,like,lon,longer,m.,markedly,membranous,moderately,nflorescence,nternode,orolla,ovate,palmate,peduncle,perfec,plurifoliat,pointed,primary,rachi,ruit,sand-punctat,scattered,short,side,slightly,tamen,tem,terrestrial,unit,unknow,vary,vein,venation,wide,ympodial	abaxial,apart,arrangement,capitate,coat,colour,connation,corolla,embryo,feature,form,growth,history,inflorescence,length,life,na,new,number,ovary,papilla,pore,prickle,reproduction,seed,shape,size,spacing,surface,texture,tuberculation,type,width,young	.2,0.5â1,0.7â1,1.2â1.8,1.5â1.8,1.5â8,15â35,2.3â5,2â11,2â2.5,3â4.5,3â5,3â6,4â6,4â9,5-8,5â13,6â7,acuminate,acute,berry,blue,broadly,chartaceous,cm,cordate,deeply,deltoid,extra-axillary,fleshy,glabrous,hair-tipped,half,herbaceous,lanceolate,light,long,lower,minutely,mm,narrowly,obscure,often,ovoid,papillose,pentagonal,pubescent,revolute,rotate-stellate,rounded,sand-punctate,simple,slender,small,somewhat,spaced,sparsely,tip,tooth,trichome,unbranched,unknown,vine,white,widely,x	apart,capitate,na
145	wfo-0001027378	success	141	115	65	78	63	37	61	4	0.7-1,1.5-8,15-35,2-11,2.3-5,3-5,3-6,4-6,4-9,5-13,5-8,acuminate,anther,apart,apex,basally,base,blue,broadly,calyx,chartaceous,cm,connivent,cordate,deeply,deltoid,directed,distally,extra-axillary,filament,fleshy,flower,fruit,glabrous,hair,hair-tipped,herb,lanceolate,large,leaf,light,lobe,longitudinal,margin,minutely,mm,multicellular,oblong,obscure,often,opening,ovate,pedicel,petiole,pore,pubescent,revolute,rotate-pentagonal,rounded,simple,slender,slit,small,somewhat,spaced,sparsely,stigma,style,tip,tooth,trailing,tube,unbranched,unknown,weakly,white,widely,yellow	.2,0.8-2.5,1-1.5,1-3,1.2-1.5,1.5-1.8,2-2.2,2-4,2.5-7,3-4.5,5-merou,6-10,6-7,abaxially,acute,adaxially,ag,alyx,apicall,apparently,articulated,axe,ba,blade,capitat,ciliate,clavate,climbing,cylindrical,densely,diameter,eaf,eed,equal,fruiting,geminat,long,longer,lower,moderately,narrowly,nflorescence,node,orolla,peduncle,perfect,plurifoliate,pubescen,rachi,rooting,scattered,short,slightly,tamen,tem,terrestrial,unit,unknow,vary,vein,wide,x,ympodial	abaxial,adaxial,age,arrangement,bud,capitate,coat,colour,connation,corolla,embryo,feature,form,greyish,growth,height,inflorescence,length,na,new,number,ovary,papilla,plant,prickle,reproduction,seed,shape,size,spacing,stem,surface,texture,tuberculation,type,width,young	0.7-1,1.5-8,15-35,2-11,2.3-5,3-5,3-6,4-6,4-9,5-13,5-8,acuminate,apart,basally,blue,broadly,chartaceous,cm,connivent,cordate,deeply,deltoid,directed,distally,extra-axillary,fleshy,glabrous,hair,hair-tipped,herb,lanceolate,large,light,longitudinal,minutely,mm,multicellular,oblong,obscure,often,opening,ovate,pubescent,revolute,rotate-pentagonal,rounded,simple,slender,slit,small,somewhat,spaced,sparsely,tooth,trailing,unbranched,unknown,weakly,white,widely,yellow	age,capitate,greyish,na
146	wfo-0001027384	success	155	128	77	91	64	37	74	3	.5,/3,0.4-1.1,0.5-1,0.9-1,1-1.3,1-3,1-4,1.5-2,2.5-6.5,3-3.5,3-4,3/4,7-14,7.5-8,acute,anther,anthesi,apart,apex,bark,base,beginning,berry,breaking,broadly,bud,calyx,capitate,clavate,cm,corolla,cuneate,deep,ellipsoid,erect,filament,flattened-reniform,glabrous,globose,green,herbarium,later,leaf,lobe,lobed,long-exserted,minutely,mm,mustard,narrowly,obovate,opposite,ovary,papillose,pedicel,peeling,petiole,pitted,pore,poricidal,pseudo-terminal,reddish-purple,rounded,scar,section,shaped,shining,shrub,simple,slender,small,specimen,stem,stigma,style,sulcate,surface,tapering,tear-drop,tip,transverse,tree,triangular,tube,way,white,woody,x,yellow,young	.25,.75,1-1.5,4-7,5-15-flowered,5-5.5,abov,anothe,ba,beneath,brown,closely,dia,difoliate,distal,drying,eaf,edicel,eed,equal,free,fruiting,geminate,hard,incrassate,inflorescenc,lateral,long,lower,main,margin,member,middle,nflorescence,occasionally,older,overlapping,pair,pale,paler,papillo,planar,portion,prominent,rarely,ruit,siz,spaced,straight,subcoriaceous-fleshy,tall,thick,trichome,tub,tuft,ud,uniseriate,unit,vein,widely,widest,without,yellowish,ympodial	5-15,arrangement,coat,colour,connation,decurrency,dry,embryo,feature,flower,form,fruit,growth,height,history,inflorescence,length,life,midpoint,minor,na,new,number,papilla,plant,prickle,ray,reproduction,seed,shape,size,spacing,texture,tuberculation,type,width,winging	.5,/3,0.4-1.1,0.5-1,0.9-1,1-1.3,1-3,1-4,1.5-2,2.5-6.5,3-3.5,3-4,3/4,7-14,7.5-8,acute,apart,base,beginning,berry,breaking,broadly,calyx,capitate,clavate,cm,cuneate,deep,ellipsoid,erect,flattened-reniform,glabrous,globose,green,herbarium,later,leaf,lobed,long-exserted,minutely,mm,mustard,narrowly,obovate,opposite,papillose,peeling,pitted,poricidal,pseudo-terminal,reddish-purple,rounded,section,shaped,shining,shrub,simple,slender,small,specimen,sulcate,tapering,tear-drop,tip,transverse,tree,triangular,tube,way,white,woody,x,yellow,young	5-15,inflorescence,na
147	wfo-0001027389	success	154	115	62	79	75	36	58	4	.1,.5,0.25-0.3,0.25-0.5,0.5-1.5,0.6-1,1-1.5,1-2,11-14,2-2.5,3-3.5,3-4.5,acuminate,acute,anther,anthesi,apart,apex,bark,base,berry,broadening,broadly,bud,calyx,cm,conical,corolla,decurrent,deltoid,dry,elliptic,erect,filament,filiform,glabrous,globose,green,hispidulous,inflorescence,leaf,lobe,lobed,minutely,mm,nearly,opposite,ovary,ovate,ovoid-reniform,papillose,pedicel,petiole,pitted,pore,poricidal,puberulent,reddish-golden,scar,shaped,shrub,simple,slight,stem,stigma,style,surface,tear-drop,tip,top,trichome,truncate,tube,uniseriate,white,winged,woody,x,young	.25,0.5-0.75,1,1.8-1.9,4-5-flowered,5-7,7-8,along,ba,beneath,brown,dark,deflexed,dia,eaf,edicel,eed,ellipsoid,evenly,except,expanded,exserted,foetid,foliage,free,fruiting,geminate,lateral,like,lon,long,lower,main,making,margin,material,middle,nflorescence,node,non-reproductive,obovoi,occasionally,often,older,one,pair,paler,papillo,portion,prominent,prominently,proximal,raise,raised,reflexed,rest,ruit,shin,side,slender,slightly,soon,spaced,sparsely,straight,tall,tapering,thread-like,ud,unifoliat,unit,vein,widest,yellowish,ympodial	4-5,arrangement,coat,colour,connation,feature,flower,form,fruit,growth,height,history,length,life,midpoint,minor,na,new,number,papilla,plant,prickle,ray,reproduction,seed,shape,shiny,size,spacing,specimen,texture,tuberculation,type,unifoliate,width,winging	.1,.5,0.25-0.3,0.25-0.5,0.5-1.5,0.6-1,1-1.5,1-2,11-14,2-2.5,3-3.5,3-4.5,acuminate,acute,apart,base,berry,broadening,broadly,cm,conical,decurrent,deltoid,elliptic,erect,filiform,glabrous,globose,green,hispidulous,leaf,lobed,minutely,mm,nearly,opposite,ovate,ovoid-reniform,papillose,pitted,poricidal,puberulent,reddish-golden,shaped,shrub,simple,slight,style,tear-drop,top,trichome,truncate,uniseriate,white,winged,woody,x,young	4-5,na,shiny,unifoliate
148	wfo-0001027395	success	153	130	79	97	56	33	75	4	.25,.5,0.25-0.5,0.6-1.1,1-1.5,1-2,1-5,1.1-1.5,1.5-1.9,1.5-2.5,1.6-2.9,10-20-flowered,12.5-17.3,2-3,2.2-7,5-6.5,8,acute,anther,anthesi,apex,apically,apiculate,attenuate,bark,base,berry,black,calyx,capitate,closely,cm,conical,constricted,corolla,deflexed,deltoid,densely,dia,drying,erect,exfoliating,filament,fleshy,fruit,glabrous,globose,green,large,leaf,lobe,long,minor,minutely,mm,narrowly,obovate,occasionally,once-furcate,opposite,ovary,overlapping,ovoid,papillose,pedicel,petiole,piece,pointed,pore,poricidal,pubescent,robust,rusty-papillate,scar,shaped,shining,shiny,shrub,simple,size,small,somewhat,spaced,stem,stigma,style,tear-drop,thick,tip,transverse,trichome,tube,uniseriate,white,woody,x,young	0.75-1,11-15,3.5-4,4-6,becoming,beginning,beneath,caly,cucullate,decurrent,depressed,differing,difoliate,eaf,edicel,eed,enlarging,exserted,free,fruiting,geminat,immature,imperceptibly,inflorescenc,known,lateral,lobed,lon,lower,main,major,margin,midrib,nearly,nflorescence,older,pair,papillo,partially,planar,portion,primary,raised,restricted,ruit,secondary,straight,tall,tapering,thickened,ud,unit,vein,within,without,ympodial	abaxial,adaxial,alternate,arrangement,bud,coat,colour,connation,dry,feature,flower,form,growth,hair,height,inflorescence,length,midpoint,na,number,papilla,plant,prickle,ray,seed,shape,spacing,specimen,surface,texture,tuberculation,type,width	.25,.5,0.25-0.5,0.6-1.1,1-1.5,1-2,1-5,1.1-1.5,1.5-1.9,1.6-2.9,10-20-flowered,12.5-17.3,2-3,2.2-7,5-6.5,8,acute,apically,apiculate,attenuate,berry,black,capitate,closely,cm,conical,constricted,deflexed,deltoid,densely,dia,drying,erect,exfoliating,fleshy,glabrous,globose,green,large,leaf,long,minutely,mm,narrowly,obovate,occasionally,once-furcate,opposite,overlapping,ovoid,papillose,piece,pointed,pore,poricidal,pubescent,robust,rusty-papillate,shaped,shining,shiny,shrub,simple,small,somewhat,spaced,tear-drop,thick,tip,transverse,trichome,uniseriate,white,woody,x	.5-2.5,alternate,di,na
149	wfo-0001027396	success	241	137	107	119	122	18	105	2	0-30,0-4,0-5,0.1-0.5,0.4-0.7,0.5-1,0.5-2,0.5-2.5,0.7-2.5,0.8,0.8-1.3,1,1/3,1/4-1/3,10-15,10-35,2-3,2-3.5,2.5-4,2.8-4.5,20-100,4-5,4-7,5-10,5-30,6-20,abaxial,acute,adaxial,almost,ame,anther,apex,apparently,articulated,attenuate,bark,base,berry,broad,bulbous,c.,calyx,cm,connivent,cream,cuneate,dark,densely,diameter,elliptic,elongate,erect,fewer,flattened-reniform,flower,fruit,glabrescent,glandular,green,hair,herb,lateral,leaf,length,lignified,lobed,long,long-styled,longer,marking,maturity,mauve,midpoint,mm,obtuse,often,pale,pedicel,petiole,plant,poricidal,porrect,prickle,prickly,pubescent,purple,ray,rotate,short-styled,shrub,simple,sometimes,somewhat,sparsely,spherical,stalk,stalked,stellate-pubescent,stem,style,surface,tapering,tearing,terete,tip,trichome,tube,unarmed,unbranched,upper,variously,visible,way,white,wide,yellow,yellowish,young	/3,0-100,0-3,0.1-1,0.5-1.5,1-2,1-4,1.2-2,1.5-3,1.5-3.5,1.8-3,1/2-2/3,1/6,10-25,10-30,12-25,15-40,2-7,3-4-5-6,3-9,3.5-6,4-6,5-20,5-50,5-8,5-merous,5.5-7.5,6.5-7.5,7-10,7-15,8-20,abaxially,alyx,andromonoecious,apar,apart,apically,ba,black,blade,broad-deltate,brown,chartaceous,concolorous,curved,decurrent,deltate,difoliate,discolorous,distal,distance,drying,eaf,eed,elongating,equal,extending,extensive,filament,flattened,free,fruiting,fully,geminat,glabrous,gray-brow,hermaphrodite,heterostylous,infructescence,less,lobe,lobing,lon,long-acuminat,lower,lowermost,margin,mature,midvein,moderately,near,nflorescence,older,one,open,opening,orange,orolla,oung,pair,peduncle,pendulous,per,pericarp,perpendicular,portion,prickl,primary,red-brown,reflexed,ruit,scar,secondary,sessile,side,smooth,spaced,spreading,staminat,stout,straight,tamen,tertiary,time,unit,usually,vary,vein,venation,woody,yellow-green,ympodial	arrangement,colour,corolla,feature,form,gray-brown,growth,height,inflorescence,na,number,ovary,seed,shape,size,texture,type,width	0-30,0-4,0-5,0.1-0.5,0.4-0.7,0.5-1,0.5-2,0.5-2.5,0.7-2.5,0.8,0.8-1.3,1,1/3,1/4-1/3,10-15,10-35,2-3,2-3.5,2.5-4,2.8-4.5,20-100,4-5,4-7,5-10,5-30,6-20,acute,almost,ame,apparently,articulated,attenuate,base,berry,broad,bulbous,c.,cm,connivent,cream,cuneate,dark,densely,diameter,elliptic,elongate,erect,fewer,flattened-reniform,flower,glabrescent,glandular,green,hair,herb,lateral,length,lignified,lobed,long,long-styled,longer,marking,maturity,mauve,midpoint,mm,obtuse,often,pale,poricidal,porrect,prickle,prickly,pubescent,purple,ray,rotate,short-styled,shrub,simple,sometimes,somewhat,sparsely,spherical,stalk,stalked,stellate-pubescent,surface,tapering,tearing,terete,tip,trichome,unarmed,unbranched,upper,variously,visible,way,white,wide,yellow,yellowish,young	gray-brown,na
150	wfo-0001027449	success	160	115	61	82	78	33	58	3	.4,.75,/3,0.5-1,0.5-1.5,0.8-1.5,0.9-1.1,1.2-1.5,2-3,2-4,3,5-6,acuminate,acute,anther,anthesi,apex,area,bark,base,berry,bud,calyx,closely,cm,corolla,deflexed,dry,elliptic,erect,filament,fruit,glabrate,glabrous,globose,green,inflorescence,leaf,lobe,lobed,long,long-triangular,minor,minutely,mm,narrowly,often,opposite,ovary,overlapping,ovoid-reniform,packed,pale,papillose,pedicel,petiole,pitted,pointed,pore,poricidal,red-papillose,scar,shaped,shrub,simple,size,small,stem,stigma,style,surface,tear-drop,tip,tree,trichome,tube,uniseriate,way,white,woody,x,young	.5,1.4-1.5,1.5-2.5,10-15-flowered,3-3.5,3-7,4-6,8-15,appearing,arising,around,axil,becoming,beginning,beneath,brown,cup,dark,deciduous,dense,densely,density,dia,differing,difoliate,eaf,edicel,eed,ellipsoid,exserted,extreme,forming,free,frui,fruiting,geminat,inflorescenc,lamina,later,lateral,like,lon,long-acuminate,lower,main,major,material,nflorescence,obconic,oblique,older,one,orangish,pair,persistent,portion,prominent,pubescent,raised,reddish-brow,reflexed,rest,ruit,slender,soon,sparse,sparsely,straight,styl,tall,tapering,trunk,tuft,ud,unit,varying,vein,ympodial	10-15,arrangement,coat,colour,connation,decurrency,feature,flower,form,growth,height,history,length,life,midpoint,na,new,number,papilla,plant,prickle,ray,reddish-brown,reproduction,seed,shape,spacing,specimen,texture,tuberculation,type,width,winging	.4,.75,/3,0.5-1,0.5-1.5,0.8-1.5,0.9-1.1,1.2-1.5,2-3,2-4,3,5-6,acuminate,acute,area,base,berry,closely,cm,deflexed,elliptic,erect,glabrate,glabrous,globose,green,leaf,lobed,long,long-triangular,minutely,mm,narrowly,often,opposite,overlapping,ovoid-reniform,packed,pale,papillose,pitted,pointed,poricidal,red-papillose,shaped,shrub,simple,small,style,tear-drop,tip,tree,trichome,uniseriate,way,white,woody,x	10-15,na,reddish-brown
151	wfo-0001027452	success	152	115	82	88	64	27	78	4	.5,0.5-1,0.5-1.5,0.5-2,0.5-2.5,1,1-2,1-3,1-4.5,1-5,1.5,10-20,2-foliate,3-6,3-9,4,4-6,5-12,5-20,abundant,acute,anther,apex,base,brown,calyx,cell,celled,center,cm,connected,decurrent,densely,dm,drying,elliptic,elliptic-ovoid,filament,flower,fruit,glabrous,hair,herb,immature,interpetalar,large,lobe,long,margin,maturing,mm,moderately,new,oblong,obtuse,often,one-,outer,parallel,pedicel,per,perpendicular,petiole,pubescent,raised,ridge,rotate,rounded,running,seed,semitransparent,smaller,smoother,sparsely,stigma,straight,style,swollen,tissue,triangular,tube,two-celled,unbranched,usually,wall,white,x,yellow	1.5-3,2-4,2-6,abaxially,absent,adaxiall,adaxially,along,axe,berry,beyond,blade,branched,chartaceous,ciliate,cordate,dehiscing,denser,diameter,eaf,eed,emarginat,entire,equal,explosively,exserted,flat,frui,geminat,globose,growt,held,linear-lanceolate,lower,lying,maturit,membranaceous,mesocarp,nearly,nfloresence,notched,orolla,peduncle,placenta,pressure,pubescen,rachi,ruit,short,significantly,single,slightly,sometimes,stamen,tal,tamen,tem,unit,vary,vein,watery,wid,woody,ympodial	arrangement,colour,connation,corolla,emarginate,feature,form,geminate,growth,inflorescence,leaf,length,na,number,ovary,papilla,pore,shape,size,stem,surface,texture,tip,type,wide,width,young	.5,0.5-1,0.5-1.5,0.5-2,0.5-2.5,1,1-2,1-3,1-4.5,1-5,1.5,10-20,2-foliate,3-6,3-9,4,4-6,5-12,5-20,abundant,acute,apex,brown,cell,celled,center,cm,connected,decurrent,densely,dm,drying,elliptic,elliptic-ovoid,flower,fruit,glabrous,hair,herb,immature,interpetalar,large,long,margin,maturing,mm,moderately,oblong,obtuse,often,one-,outer,parallel,per,perpendicular,petiole,pubescent,raised,ridge,rotate,rounded,running,seed,semitransparent,smaller,smoother,sparsely,straight,swollen,tissue,triangular,two-celled,unbranched,usually,wall,white,x,yellow	emarginate,geminate,na,wide
152	wfo-0001027471	success	165	112	73	90	75	22	71	2	/4,0.2-0.4,0.2-0.5,0.4-1,0.5-0.6,0.5-1.5,1-1.2,1-1.5,1.4-3,1.5-2,2-3,3-4,3-7,4-5,acute,age,anther,anthesi,apex,base,berry,branched,calyx,closely,cm,corolla,deltate,dendritic,densely,flattened,flower,glabrous,globose,growth,herb,inflorescence,internodal,leaf,leaf-opposed,lengthening,lobe,lobed,major,maturity,minor,minutely,mixture,mm,new,nodding,open-conical,orbicular,ovary,overlapping,pale,pedicel,petiole,pitted,planar,pore,poridical,pubescent,red-orange,reflexed,reniform,scar,shape,shrub,similar,simple,size,slightly,slit,small,somewhat,spaced,sparsely,stem,straight,style,subshrub,surface,tip,trichome,tube,usually,way,white,x,yellowish	.5,0.1-0.2,0.5,0.5-0.7,0.7-0.9,0.9-1,1-1.6,2-2.5,2-lobed,6-7,abaxially,adaxially,along,appressed,ascending,bark,bifid,brittle,c.,conical,desnsely,diameter,differing,difoliate,distant,drying,eaf,eed,elliptic,entire,erec,erect,especially,filament,free,fruiting,furcate-dendritic,geminate,included,lamina,less,like,long-triangular,lower,margin,midvein,nflorescence,node,occasionally,ovate,pair,papillat,peduncle,perfect,pericarp,petal,plane,portion,primary,pubscent,rachi,ruit,scattered,slender,stigma,tan,thickened,thin,trifoliat,ud,uniseriate,unit,vein,woody,ympodial	abaxial,adaxial,alternate,arrangement,bud,colour,feature,form,fruit,hair,height,length,na,number,plant,seed,spacing,texture,type,width,winging,young	/4,0.2-0.4,0.2-0.5,0.4-1,0.5-0.6,0.5-1.5,1-1.2,1-1.5,1.4-3,1.5-2,2-3,3-4,3-7,4-5,acute,age,anthesi,base,berry,branched,closely,cm,deltate,dendritic,densely,flattened,glabrous,globose,herb,inflorescence,internodal,leaf-opposed,lengthening,lobed,major,maturity,minutely,mixture,mm,nodding,open-conical,orbicular,overlapping,pale,pitted,planar,pore,poridical,pubescent,red-orange,reflexed,reniform,shrub,similar,simple,slightly,slit,small,somewhat,spaced,sparsely,straight,style,subshrub,tip,trichome,usually,way,white,x,yellowish	alternate,na
153	wfo-0001027473	success	138	125	69	85	53	40	65	4	.25,/2,0.25-0.5,0.5-1,0.8-1,1-1.5,1-2,1.5-2,1.8-2,2-2.5,2.5-3,4.5-13,8.5-37,?,acute,anther,anthesi,apex,apparently,bark,base,berry,calyx,clavate,cm,conical,corolla,decurrent,deflexed,dendritic,densely,di-,dia,empty,erect,filament,flattened-reniform,glabrous,globose,green,incrassate,leaf,lobe,lobed,long,long-triangular,margin,minor,minutely,mm,near,obovate,occasionally,ovary,pale,pedicel,petiole,pitted,pointed,pore,pubescent,sessile,shape,shaped,shrub,somewhat,stem,sterile,stigma,strongly,style,subshrub,surface,tear-drop,thick,tip,trichome,trifoliate,tube,way,white,wide,winged,woody,young	1.3-2,1/3,3.5-5,5,6-9,abaxially,absen,adaxially,along,ape,brown,deccurent,deep,denser,differing,drying,eaf,eed,free,fruiting,geminat,giving,later,lateral,less,like,lower,main,major,middle,minute,older,overall,pair,papillo,planar,poricidal,portion,pubesent,rootstock,ruit,rusty,sac,sparsely,tall,unit,usually,vein,widest,wing,yellowish,yellowish-brow,ympodial	absent,arrangement,bud,coat,colour,connation,decurrency,dry,embryo,feature,flower,form,fruit,growth,height,history,inflorescence,length,life,midpoint,na,new,number,papilla,papillose,plant,prickle,ray,reproduction,scar,seed,size,spacing,specimen,texture,tuberculation,type,width,winging,yellowish-brown	.25,/2,0.25-0.5,0.5-1,0.8-1,1-1.5,1-2,1.5-2,1.8-2,2-2.5,2.5-3,4.5-13,8.5-37,?,acute,apex,apparently,base,berry,clavate,cm,conical,decurrent,deflexed,dendritic,densely,di-,dia,empty,erect,flattened-reniform,glabrous,globose,green,incrassate,lobed,long,long-triangular,margin,minutely,mm,near,obovate,occasionally,pale,pitted,pointed,pubescent,sessile,shaped,shrub,somewhat,stem,sterile,strongly,subshrub,tear-drop,thick,trichome,trifoliate,way,white,wide,winged,woody	absent,na,papillose,yellowish-brown
154	wfo-0001027483	success	164	113	76	86	78	27	73	3	0.2-1.9,0.6,1-2.5,1.2-2.5,1.5-10,1.5-2.6,1.5-3,2-3,2-4,2-4.5,3-15,3-6,3.5-20,4.5-8,5-10,5-6,abaxially,adaxially,apical,apically,branched,calyx,cell,cm,coarsely,connate,corolla,covering,cyme,dehiscent,diameter,dichasial,dichasially,dot,ebracteate,finely,flower,forked,globose,green,hair-like,herbaceous,interpetiolar,introrse,lateral,leaf,leaflet,light,lighter,long,make,maturing,medium,mm,monochasial,mucilaginous,odd-pinnate,often,ovoid,pedicel,peduncle,perennial,petiole,plant,poricidally,pubescent,purple,ray,rotate,seed,short,size,slit,smooth,sometimes,stigma,style,terminal,testal,thick,uniform,violet,violet-purple,wall,white,wide	0-1.,1,1-2,1-4,1-5,2,3-6-foliat,acumen,acute,apex,articulate,basal,base,cuneate,decurrent,digestion,diminishing,distal,dorsally,eaf,edge,eed,elliptical,emoval,enzyme,erec,exceeding,filament,flat,folded,generally,globo,gradually,green-white,half,honeycomb,interjected,living,lobe,lon,lower,lunat,minute,nflorescence,nther,obtuse,orolla,ovate,pair,pattern,perfect,petiolule,plan,proximal,rachi,reveal,rosette,rounded,ruit,sessile,seudostipule,specimen,stamen,straight,subsessile,tall,tem,throughout,tissu,toward,tuber-bearing,typically,unit,vary,varying,yellow,ympodial,Â¼	abaxial,adaxial,anther,arrangement,colour,connation,dehiscence,feature,form,fruit,growth,height,history,inflorescence,length,life,na,number,ovary,reproduction,shape,stem,surface,texture,tissue,wet,width	0.2-1.9,0.6,1-2.5,1.2-2.5,1.5-10,1.5-2.6,1.5-3,2-3,2-4,2-4.5,3-15,3-6,3.5-20,4.5-8,5-10,5-6,abaxially,adaxially,apical,apically,branched,cell,cm,coarsely,connate,covering,cyme,dehiscent,diameter,dichasial,dichasially,dot,ebracteate,finely,forked,globose,green,hair-like,herbaceous,interpetiolar,introrse,lateral,light,lighter,long,make,maturing,medium,mm,monochasial,mucilaginous,odd-pinnate,often,ovoid,perennial,poricidally,pubescent,purple,ray,rotate,seed,short,slit,smooth,sometimes,testal,thick,uniform,violet,violet-purple,wall,white,wide	na,tissue,wet
155	wfo-0001027506	success	213	151	96	116	97	35	95	1	-7,-7.5,.2,.5,/6,0-1,0.2-0.3,0.5-1.5,0.5-6,0.7-1.3,0.8-1.5,1-4,1.2-1.5,1.8,1/3,10-40,2.2-3.5,2.5-5,2.5-8,3-10,3-5,3-6,5-10,acuminate,acute,anther,apart,apex,apically,articulated,bark,base,becoming,berry,brown,calyx,cell,cm,connivent,cordate,cream,cuneate,curved,dark,densely,dry,erect,filament,fine,flattened,flattened-reniform,flower,fruit,glabrescent,green,lateral,leaf,length,lobe,lobed,long,lower,marking,maturity,mauve,midpoint,mm,moderately,multangulate,narrow-deltate,orange,outline,ovate,pale,pedicel,pendulous,petiole,pit,plant,poricidal,porrect,prickle,prickly,purple,raised,ray,reddish,scar,shrub,simple,small,smooth,sometimes,spherical,spreading,stalked,stellate,stellate-pubescent,stem,style,surface,tapering,terete,terminal,tip,tree,trichome,truncate,tube,upper,variously,way,wide,woody,yellow,young	-20,-3,/2,0-10,0-2,0-6,0-60,0.1-0.2-0.3-0.35,0.1-0.3,0.2,0.25,1-2,1-3,1.5-2.2,1/6-1/4,2-3.2,3.5-5,5-7,5-merous,6-13,6.5-10,7-8,7-9,8-10,9-13,abaxially,acuminat,alyx,ame,andromonoecious,apar,apparently,blade,branched,brow,c.,chartaceous,concolorous,diameter,distal,drying,eaf,eed,elongating,entire,equal,free,fruiting,glabrous,hard,hermaphrodite,heterostylous,infructescence,lengt,long-styled,longer,lowermost,margin,mature,nflorescence,occasionally,older,one,open,orange-brown,orolla,oung,pair,peduncle,per,pericarp,plurifoliat,portion,prickl,primary,reduced,reflexed,ruit,sessile,short-styled,spaced,stalk,staminat,stout,subentire,tamen,tertiary,time,twice,unarmed,unit,vary,vein,venation,visible,yellow-green,ympodial	anthesi,arrangement,bud,coat,colour,connation,corolla,decurrency,embryo,feature,form,growth,height,history,inflorescence,life,minor,na,new,number,ovary,papilla,pore,reproduction,seed,shape,size,spacing,specimen,stigma,texture,tuberculation,type,width,winging	-7,-7.5,.2,.5,/6,0-1,0.2-0.3,0.5-1.5,0.5-6,0.7-1.3,0.8-1.5,1-4,1.2-1.5,1.8,1/3,10-40,2.2-3.5,2.5-5,2.5-8,3-10,3-5,3-6,5-10,acuminate,acute,apart,apically,articulated,base,becoming,berry,brown,cell,cm,connivent,cordate,cream,cuneate,curved,dark,densely,erect,fine,flattened,flattened-reniform,glabrescent,green,lateral,lobed,long,lower,marking,maturity,mauve,mm,moderately,multangulate,narrow-deltate,orange,outline,ovate,pale,pendulous,pit,poricidal,porrect,prickle,prickly,purple,raised,reddish,shrub,simple,small,smooth,sometimes,spherical,spreading,stalked,stellate,stellate-pubescent,tapering,terete,terminal,tip,tree,trichome,truncate,upper,variously,way,wide,woody,yellow,young	na
156	wfo-0001027548	success	216	126	76	92	124	34	70	6	-11.5,0.5-2,1-1.5,1-10,1-2.5,1-3.5,10-50,3-7,4-6,4-8,4.5,6-9,acuminate,acute,almost,anther,anthesi,apart,apex,attenuate,base,berry,black,calyx,capitate,cm,conical,connivent,corolla,deltate,dendritic,densely,depressed-elliptic,diameter,ellipsoid,elliptic,elongate,filament,flattened-reniform,flower,glabrous,globose,green,growth,immature,inflorescence,leaf,lengthening,lilac,lobe,lobed,loose,loosely,margin,minute,minutely,mm,narrowly,new,pedicel,petiole,pitted,pore,poricidal,prominent,pubescent,ripe,scar,simple,size,slender,slit,somewhat,sparsely,specimen,stellate,stem,stigma,style,surface,terminal,thickened,tinged,tip,trichome,tube,type,vine,warty,white,woody,x	.3,0.2,0.3-1.2,0.5,1,1.2,1.5,1.5-2,1.5-2.5,10-12,5-merou,7-10,8-9,abaxiall,adaxially,ag,along,also,although,alyx,apical,apparently,appearing,area,ark,articulated,articulation,axi,basal,beneath,bent,branch,branched,branching,brown,bu,c.,cell,dark,darker,deflexe,denser,drying,dull,eaf,early,eed,em,entire,exserted,extending,flexuous,free,fruiting,geminat,glabrescen,glandular,half,herbarium,ilament,irregularly,lamina,leaving,less,like,lon,long,long-styled,lower,many,matte,membranous,mixed,near,nflorescence,occasionally,older,orolla,outline,pair,pale,papillae,papillate,papillo,peduncle,per,perfect,pericarp,planar,plurifoliate,point,portion,primary,puberulent,rachi,rectangular,reddish,revolute,ruit,scattered,small,sometimes,spaced,sparse,spreading,strongly,swollen,tapering,testal,thin,time,tiny,transparent,twinin,ud,uniseriate,unit,upper,usually,vary,vein,way,yellow,ympodial	5,8,age,arrangement,bud,coat,colour,connation,decurrency,deflexed,dry,feature,form,fruit,height,length,midpoint,minor,na,number,ovary,papilla,papillose,plant,prickle,ray,seed,shape,spacing,texture,tuberculation,width,winging,young	-11.5,0.5-2,1-1.5,1-10,1-2.5,1-3.5,10-50,3-7,4-6,4-8,4.5,6-9,acuminate,acute,almost,apart,apex,attenuate,berry,black,capitate,cm,conical,connivent,deltate,dendritic,densely,depressed-elliptic,diameter,ellipsoid,elliptic,elongate,flattened-reniform,glabrous,globose,green,immature,leaf,lengthening,lilac,lobed,loose,loosely,margin,minute,minutely,mm,narrowly,pitted,poricidal,prominent,pubescent,ripe,scar,simple,slender,slit,somewhat,sparsely,stellate,terminal,thickened,tinged,tip,trichome,vine,warty,white,woody,x	5,8,age,deflexed,na,papillose
157	wfo-0001027581	success	200	126	71	76	124	50	54	17	100+,acute,anther,anthesi,apex,base,berry,branched,broadly,brown,c.,calyx,clavate,cm,connivent,corolla,cup-shaped,dark,densely,echinoid,ellipsoidal,elliptic,filament,flattened-reniform,flower,globose,gradually,green,greyish,growth,inflorescence,leaf,length,lengthening,lobe,lobed,loosely,many,minute,minutely,mm,multangulate,multiseriate,narrowing,new,nodding,pedicel,petiole,pitted,pore,poricidal,pubescent,purple,ray,reddish,ripe,scar,shrub,simple,size,slit,small,stalk,stellate,stem,stigma,stout,style,surface,terminal,time,tip,tree,trichome,tube,way	0.2â0.3,0.3,0.3â1,0.5â1,0.5â1.5,1,1.2â1.5,1.3â1.5,1.5,1.5â2,1.5â3,10,10â16,12,12â30,15â20,1â1.5,1â3-rayed,2.5â3,200,3.5â4.5,3â3.5,4.5â16,4â8,5-merou,6â7,7â10,7â9,8,8â10,9â11,9â9.5,>,abaxial,abaxially,adaxial,ag,along,alyx,apar,ark,articulated,axe,beneath,branching,brow,bulbous,clearly,closely,deltate,diameter,dichasia,discolorous,distally,drying,eaf,eed,entire,erec,evenly,exserted,free,fruiting,glabrescent,glabrous,golden,ilament,lamina,largest,less,like,long,longest,lower,margin,midvei,mixed,moderately,near,nflorescence,older,orolla,pair,papillo,part,peduncle,per,perfect,pericarp,plane,plurifoliate,porrect-stellate,portion,primary,reflexed,rhachi,ruit,scarcely,sessile,shiny,short-stalked,smaller,spaced,sparsely,spreading,tall,tem,thin,ud,undersurface,unevenly,unit,upper,vary,varying,vein,visible,weak,whit,wide,woody,yellow,yellowish,ympodial	1-1.5,1.5-2,1.5-3,12-30,15-20,2.5-3,3-3.5,3.5-4.5,4-8,4.5-16,7-9,9-9.5,age,apart,arrangement,bark,bud,coat,colour,connation,decurrency,dry,embryo,feature,form,fruit,height,history,life,midpoint,minor,na,number,ovary,papilla,papillose,plant,prickle,reproduction,seed,shape,spacing,specimen,texture,tuberculation,type,white,width,winging,young	100+,acute,anthesi,base,berry,branched,broadly,brown,c.,clavate,cm,connivent,cup-shaped,dark,densely,echinoid,ellipsoidal,elliptic,flattened-reniform,globose,gradually,green,greyish,lengthening,lobed,loosely,many,minute,minutely,mm,multangulate,multiseriate,narrowing,nodding,pedicel,pitted,poricidal,pubescent,purple,reddish,ripe,shrub,simple,slit,small,stalk,stellate,stout,terminal,time,tip,tree,trichome,way	1-1.5,1.5-2,1.5-3,12-30,15-20,2.5-3,3-3.5,3.5-4.5,4-8,4.5-16,7-9,9-9.5,age,apart,na,papillose,white
158	wfo-0001027584	success	142	105	52	67	75	38	46	6	0.5-1.5-2,0.9-1,0.9-2.5,1-1.2,1.6-1.9,11.5-45,2,2-10,3,3-.,4-6,4-7,4.5-20,8-9,abruptly,absent,acuminate,anther,anthesi,apex,attenuate,bark,base,branched,calyx,cm,conical,corolla,cucullate,darker,dry,ellipsoid,elliptic,filament,flattened,flower,four,fruit,glabrous,green,herb,lobe,lobed,minutely,mm,narrowly,nearly,ovary,ovate,papillate,pedicel,petiole,reddish,reniform,scar,smooth,stem,stigma,stripe,style,suffruticose,surface,time,tip,triangular,tube,white	..,.5,0.5-1,1.2-1.4,1.5-2,1.5-8,10-15,100,2.5-3,7-10-16,apical,becoming,beginning,beneath,branch,brittle,broadly,brow,c.,capitat,cell,deflexe,deltate,densely,diameter,eaf,edicel,eed,erec,fruiting,irregular,lamina,long,lower,margin,markedly,nflorescence,open,outer,outline,pair,pale,peduncle,per,pericarp,planar,plurifoliat,pointed,present,primary,regularly,ruit,scattered,shrub,single,single-stemmed,sinuate,small,sparse,sparsely,striate,tan,testal,thickening,thin,trichome,tuft,ud,uniseriate,unit,vein,wall,without,x,ympdoial	1,arrangement,brown,bud,capitate,coat,colour,connation,embryo,erect,feature,form,growth,height,history,inflorescence,leaf,length,life,midpoint,na,number,papilla,plant,plurifoliate,pore,prickle,ray,reproduction,seed,shape,size,spacing,specimen,texture,tuberculation,type,width	0.5-1.5-2,0.9-1,0.9-2.5,1-1.2,1.6-1.9,11.5-45,2,2-10,3,3-.,4-6,4-7,4.5-20,8-9,abruptly,absent,acuminate,attenuate,base,branched,cm,conical,cucullate,darker,ellipsoid,elliptic,flattened,four,glabrous,green,herb,lobed,minutely,mm,narrowly,nearly,ovate,papillate,reddish,reniform,smooth,stripe,suffruticose,time,triangular,white	1,brown,capitate,erect,na,plurifoliate
159	wfo-0001027600	success	183	113	78	85	98	28	75	3	-10,0.5-1.5,1,1-14,1-4,10-15-25,10-20,2-18,2-3,2-4,2-4.5,2-5,2-6,2.5-21,2.5-6,20-30,3-15,3-5-lobed,abaxially,acuminate,acute,adpressed,apart,apex,apical,apiculate,basal,base,calyx,campanulate,cm,concave,cordate,cuneate,deltate,densely,diameter,directed,ellipsoidal,fading,flattened,flower,forked,fruit,glabrous,gland,greenish-white,laterally,leaf,lobe,mature,minutely,mm,moderately,oblong,obtuse,occasionally,orange,ovoid,pedicel,petiole,pilose,pinnately,pore,puberulent,purple,purplish,rarely,rounded,simple,stigma,style,surface,tip,tree,triangular,truncate,tube,two,unbranched,unlobed,white,x,yellow,yellow-green	0.5-1,1-2,1-5,1.5-2,1.5-2.5-3,1/2-3/4,2-11,2-3.5,3-5,3-6,4-6,4-foliat,5-13,8-17,abruptly,absen,absent,adaxial,adaxially,aggregate,along,ape,articulated,axe,beyond,blade,brow,cell,channe,collection,connective,coriaceous,cream,dilated,distally,divided,eaf,eed,elliptic,entire,especially,exceeding,except,exserted,fleshy,glabrescent,glandular-puberulent,leaving,lobed,lon,long,lower,main,margin,midrib,narrowed,nflorescence,nther,obconical,older,orolla,ovate,papillose,pedicellar,peduncle,perfect,pilo,puberulen,puberulence,pubescent,rachi,radiu,remnant,ruit,shorter,sinus,slightly,small,somewhat,spaced,sparsely,stamen,stone,strongly,subcoriaceous,tal,tem,thecae,time,tomento,ud,unit,vary,vein,wide,yellowish,ympodial,young	anther,arrangement,berry,bud,colour,corolla,feature,form,growth,height,history,inflorescence,length,life,na,number,ovary,perennial,plant,reproduction,seed,shape,size,spacing,stem,texture,type,width	-10,0.5-1.5,1,1-14,1-4,10-15-25,10-20,2-18,2-3,2-4,2-4.5,2-5,2-6,2.5-21,2.5-6,20-30,3-15,3-5-lobed,abaxially,acuminate,acute,adpressed,apart,apex,apical,apiculate,basal,base,campanulate,cm,concave,cordate,cuneate,deltate,densely,diameter,directed,ellipsoidal,fading,flattened,forked,glabrous,gland,greenish-white,laterally,lobe,mature,minutely,mm,moderately,oblong,obtuse,occasionally,orange,ovoid,pilose,pinnately,puberulent,purple,purplish,rarely,rounded,simple,style,tip,tree,triangular,truncate,two,unbranched,unlobed,white,x,yellow,yellow-green	berry,na,perennial
160	wfo-0001027607	success	167	122	76	87	80	35	73	3	.1,.5,0.5-1,1-4,1.5-3,2-2.5,2-3,2-4,2.5-3,3-3.5,3/4,4-10-flowered,5-10,8-9,acuminate,acute,age,anther,anthesi,apex,area,bark,base,becoming,berry,calyx,cm,corolla,curling,decurrent,deltoid,densely,dry,ellipsoid,elliptic,elongate,filiform,glabrate,glabrous,globose,golden,green,leaf,like,lobe,lobed,long,minute,minutely,mm,narrowly,obovoid,opposite,ovary,ovoid-reniform,papillose,pedicel,petiole,pitted,plant,pore,poricidal,pubescent,reddish-brown,scar,shaped,shrub,simple,slightly,stem,stigma,style,surface,tear-drop,tip,treelet,trichome,tube,unifoliate,uniseriate,way,white,widened,winged,woody,x,young	.25,0.25-0.5,0.5,0.8-1,1,1.2-1.5,5-7,apar,arching,aspect,ba,basal,branch,branche,brown,corky,dark,deflexed,dia,eaf,edicel,eed,erect,evenly,except,exserted,f,filament,flattened,free,fruiting,geminate,gently,giving,lamina,lateral,lenticellat,less,lon,lower,m.,main,material,middle,midrib,narrow,nflorescence,non-reproductive,occasionally,older,pagoda-like,pair,portion,present,prominent,raised,rarely,reflexed,ruit,short,slender,slight,small,soon,spaced,straight,strongly,styl,tall,tan,tapering,tub,ud,unit,vein,widening,widest,yellowish,ympodial,zig-zag	apart,arrangement,bud,coat,colour,connation,feature,flower,form,fruit,growth,height,history,inflorescence,length,lenticellate,life,midpoint,minor,na,number,papilla,prickle,ray,reproduction,seed,shape,size,spacing,specimen,texture,tuberculation,type,width,winging	.1,.5,0.5-1,1-4,1.5-3,2-2.5,2-3,2-4,2.5-3,3-3.5,3/4,4-10-flowered,5-10,8-9,acuminate,acute,age,area,base,becoming,berry,calyx,cm,curling,decurrent,deltoid,densely,ellipsoid,elliptic,elongate,filiform,glabrate,glabrous,globose,golden,green,leaf,like,lobed,long,minute,minutely,mm,narrowly,obovoid,opposite,ovoid-reniform,papillose,petiole,pitted,pore,poricidal,pubescent,reddish-brown,shaped,shrub,simple,slightly,stem,style,tear-drop,tip,treelet,trichome,tube,unifoliate,uniseriate,way,white,widened,winged,woody,x	apart,lenticellate,na
161	wfo-0001027618	success	201	156	111	129	72	27	108	3	-10,-pubescent,0-10,0.5,0.5-1,0.5-6,1,1-1.5,1-13,1-14,1-23,1-3,1-5,1-9,1.4-4,1.5-8.5,11-16,11-22,11-pinnate,15-35,2-11,2-12,2-27,2-5,2-9,2.5-6,3-30,3-7,3-7-pinnate,4,4-8,5-18,5-20,5-30,5-7.5,5-merous,5.5-12,6-25,6-40,8-35,abaxially,adaxially,also,apex,basal,base,blade,branched,bud,campanulate,capitate,chartaceous,cm,compound,connective,cordate,cuneate,deltate,densely,diameter,directed,ellipsoidal,elliptic,elliptic-ovate,entire,fleshy,flower,fruit,fusiform,glabrous,globose,greenish,laterally,leaf,leaflet,length,less,lobe,long,margin,membranaceous,minutely,mm,moderately,oblong,obovate,obtuse,orange,ovate,papillose,pedicel,peduncle,per,perfect,petiolule,pilose,pinnately,pore,puberulent,puberulent-pubescent,pubescent,pubescent-pilose,purple,rachi,radiu,remnant,reticulate,ripe,shallowly,shrub,simple,sometimes,sparsely,stigma,style,sympodial,tomentose,tree,triangular,truncate,tube,unbranched,unit,urceolate,white,wide,width,x,yellow	1-2-8.5,1.5-13,1.5-3,1.5-7,12-27,15-30,2-11.5,3-18,3-5,3.5-6,7-25,8-16,acuminat,acut,acute,aggregate,alyx,apart,ape,articulated,ascending,axe,beyond,cell,cylindrical,darker,dia,diamete,dilated,distally,eaf,eed,exceeding,exserted,lateral,leaving,lon,longitudinal,lower,mesocarp,near,nflorescence,nther,obtu,often,orolla,pedicellar,perfec,petiole,pilo,presen,puberulent-pilo,ranch,ratio,rown,ruit,runk,shorter,slightly,small,somewhat,spaced,spreading,stamen,stone,stripe,tal,terminal,thecae,uni,vary,without	2-8.5,abaxial,acuminate,adaxial,anther,arrangement,branch,calyx,colour,corolla,crown,feature,form,growth,height,inflorescence,na,number,ovary,plant,seed,shape,size,spacing,surface,texture,trunk	-10,-pubescent,0-10,0.5,0.5-1,0.5-6,1,1-1.5,1-13,1-14,1-23,1-3,1-5,1-9,1.4-4,1.5-8.5,11-16,11-22,11-pinnate,15-35,2-11,2-12,2-27,2-5,2-9,2.5-6,3-30,3-7,3-7-pinnate,4,4-8,5-18,5-20,5-30,5-7.5,5-merous,5.5-12,6-25,6-40,8-35,abaxially,adaxially,also,apex,basal,branched,campanulate,capitate,chartaceous,cm,compound,cordate,cuneate,deltate,densely,diameter,directed,ellipsoidal,elliptic,elliptic-ovate,entire,fleshy,fusiform,glabrous,globose,greenish,laterally,less,lobe,long,membranaceous,minutely,mm,moderately,oblong,obovate,obtuse,orange,ovate,papillose,per,perfect,pilose,pinnately,puberulent,puberulent-pubescent,pubescent,pubescent-pilose,purple,reticulate,ripe,shallowly,shrub,simple,sometimes,sparsely,sympodial,tomentose,tree,triangular,truncate,unbranched,unit,urceolate,white,wide,x,yellow	2-8.5,acuminate,na
162	wfo-0001027622	success	203	138	104	114	89	24	100	4	.5,0-14,0-16,0.3-10,1,1-10,1-2,1.5-3.5,1.5-4.2,1.6-4.5,12-23,2-25,2-6,2.5-3.5,3-4.5,3.5-11,4-9.5,5-11,6-17,6-7,8-16,8-20,abaxially,acuminate,adaxially,anther,axillary,berry,blue,blue-purple,brownish,bud,cell,chartaceous,clavate,cm,condition,connivent,corolla,covering,diameter,distal,drying,flower,forked,fresh,fruit,generally,glabrescent,glabrous,globose,green,green-white,greenish,hair,hair-like,half,herb,homostylous,interjected,lanceolate,lateral,leaflet,light,like,lobe,long,make,membranous,middle,mm,mottled,mucilaginous,odd-pinnate,ovate-lanceolate,ovoid,pale,pedicel,peduncle,pentagonal,petal,petiole,plant,poricidal,pubescent,purple,seed,shortly,size,slightly,star,stellate,stem,stigma,straight,striped,style,subglabrous,subtending,terminal,testal,thick,throughout,tip,tube,unwinged,usually,wall,wet,whitish,wide,wing,x,yellow	1/,2-3,3-16,3-4,4-5,5-merou,acumen,acute,ag,along,alyx,apart,apex,apparently,articulated,axe,base,blade,borne,broadly,capitat,ciliate,decumben,different,digestion,dorsally,eaf,edge,eed,elliptic,elliptical,end,enzyme,erect,especially,exceeding,except,filament,flat,folded,geminat,glabrou,greatly,honeycomb-shaped,lengthening,living,lower,margin,midrib,minutely,narrowly,nflorescence,oblique,often,orolla,ovate,pair,perfect,petiolule,plurifoliate,population,pore,proximal,puberulent,reduced,removed,rounded,ruit,seudostipule,singly,slit,sometimes,spaced,specimen,stamen,ste,stolo,subequal,tall,tamen,tem,tri-,truncate,tuber,typically,unit,vary,varying,ympodial	5-merous,calyx,capitate,colour,feature,form,growth,height,history,inflorescence,leaf,length,life,na,number,ovary,perennial,pseudostipule,reproduction,shape,spacing,surface,texture,type	.5,0-14,0-16,0.3-10,1,1-10,1-2,1.5-3.5,1.5-4.2,1.6-4.5,12-23,2-25,2-6,2.5-3.5,3-4.5,3.5-11,4-9.5,5-11,6-17,6-7,8-16,8-20,abaxially,acuminate,adaxially,axillary,berry,blue,blue-purple,brownish,bud,cell,chartaceous,clavate,cm,condition,connivent,covering,diameter,distal,drying,forked,fresh,generally,glabrescent,glabrous,globose,green,green-white,greenish,hair,hair-like,half,herb,homostylous,lanceolate,lateral,light,like,long,make,membranous,middle,mm,mottled,mucilaginous,odd-pinnate,ovate-lanceolate,ovoid,pale,pentagonal,petal,plant,poricidal,pubescent,purple,seed,shortly,slightly,star,stellate,stem,straight,striped,subglabrous,subtending,terminal,testal,thick,throughout,tip,unwinged,usually,wall,wet,whitish,wide,wing,x,yellow	5-merous,capitate,na,perennial
163	wfo-0001027624	success	189	118	79	95	94	23	77	2	0-7,0.1-0.9,0.3-1,0.5-1.5,1-2,1-3,1.1-8.4,1.2-2.6,1.3-2.9,1.5-6.6,2-20,2.4-4.8,2.9-12,3-10,3-5,4-15.2,4-7,5-9,9-41,abaxially,adaxially,anther,apart,axillary,base,blade,bud,cell,clavate,cm,connivent,corolla,covering,decreasing,deep,densely,diameter,entirely,flower,forked,fruit,globose,green,hair,hair-like,herb,interjected,lanceolate,lateral,leaf,leaflet,light,like,lobe,long,make,mm,moniliform,mottled,mucilaginous,odd-pinnate,orbicular,ovate,ovoid,pedicel,peduncle,pentagonal,petiole,plant,pore,poricidal,pubescent,purple,rotate,seed,sessile,short,size,sometimes,stigma,style,subtending,terminal,testal,thick,tip,toward,tube,tuber,usually,wall,wet,white,wide,x	0-3,0.4-3,0.8-5.6,1-5,2-5,2-7,3-11,3-4,4-8,5-merou,6-18.5,acuman,acumen,acuminate,acute,ag,along,alyx,apex,apparently,arranged,articulated,axe,bead,berry,brownish,capitat,condition,considerably,cuneate,decumben,decurrent,digestion,distal,dorsally,drying,eaf,edge,eed,elliptic,enzyme,erect,exceeding,filament,flat,folded,fresh,geminat,glabrou,glabrous,green-white,greenish,half,homostylous,honeycomb-shaped,larger,leave,lengthening,living,lower,middl,multiple,necklace,nflorescence,onto,orolla,pair,perfect,plurifoliate,present,rachi,removed,ruit,seudostipule,slightly,slit,spaced,specimen,stamen,stolon,straight,tall,tamen,tem,throughout,tri-,typically,unit,unwinged,vary,whitish,widely,yellow,ympodial	arrangement,calyx,capitate,colour,connation,feature,form,growth,height,history,inflorescence,length,life,na,number,pseudostipule,reproduction,shape,spacing,stem,surface,texture,type	0-7,0.1-0.9,0.3-1,0.5-1.5,1-2,1-3,1.1-8.4,1.2-2.6,1.3-2.9,1.5-6.6,2-20,2.4-4.8,2.9-12,3-10,3-5,4-15.2,4-7,5-9,9-41,abaxially,adaxially,apart,axillary,base,bud,cell,clavate,cm,connivent,covering,decreasing,deep,densely,entirely,forked,globose,green,hair,hair-like,herb,lanceolate,lateral,leaf,light,like,long,make,mm,moniliform,mottled,mucilaginous,odd-pinnate,orbicular,ovate,ovoid,pentagonal,poricidal,pubescent,purple,rotate,seed,sessile,short,size,sometimes,subtending,terminal,testal,thick,tip,toward,usually,wall,wet,white,wide,x	capitate,na
164	wfo-0001027626	success	152	114	74	86	66	28	70	4	.3,.5,0.1â0.2,0.2â0.6,0.5-1,0.7â1,0.7â2.8,1,1.3â4.5,1.5â2,1.5â8,13â14,2â49,2â5,3â4,3â5,3â55,4.4â11,4â6,5â6,8,9â18,acuminate,acute,adaxially,along,anther,apex,arrangement,base,calyx,chartaceous,clavate,cm,cordate,coriaceous,diameter,distichous,distinct,entire,extra-axillary,filament,fleshy,flower,frequently,fruit,glabrous,greenish-white,lanceolate,leaf-opposed,liana,line,lobe,long,margin,membranous,minutely,mm,moderately,nearly,oblique,pedicel,peduncle,petiole,pinnate,possibly,pubescent,rachi,sand-punctate,shrub,simple,somewhat,sparsely,spindle-shaped,stellate,stigma,style,terminal,tip,trichome,unbranched,unknown,venation,white,wiry-woody,x	0.5â1,14â116,2â3,3â4.5,5-merous,abaxially,accrescen,alyx,apar,axe,berry,blade,broadly,c.,capitat,center,ciliat,climbing,color,densely,distant,eaf,eed,elliptical,fruiting,glabrou,immature,lamina,lower,m.,maturity,midvein,mor,nflorescence,nternode,orolla,ovate,pair,perfec,petal,plurifoliat,pointed,reflexed,rounded,ruit,sand-punctat,scandent,scar,secondary,seen,shortly,side,slender,spaced,ste,tamen,tem,time,truncate,tube,two,unit,vary,vein,wide,ympodial	abaxial,adaxial,apart,capitate,colour,corolla,feature,form,growth,height,inflorescence,internode,leaf,length,ovary,perfect,plant,reproduction,seed,shape,size,spacing,staman,stem,surface,texture,type,width	.3,.5,0.1â0.2,0.2â0.6,0.5-1,0.7â1,0.7â2.8,1,1.3â4.5,1.5â2,1.5â8,13â14,2â49,2â5,3â4,3â5,3â55,4.4â11,4â6,5â6,8,9â18,acuminate,acute,adaxially,along,chartaceous,clavate,cm,cordate,coriaceous,distichous,distinct,entire,extra-axillary,fleshy,flower,frequently,fruit,glabrous,greenish-white,lanceolate,leaf-opposed,liana,line,long,membranous,minutely,mm,moderately,nearly,oblique,pinnate,possibly,pubescent,sand-punctate,shrub,simple,somewhat,sparsely,spindle-shaped,stellate,terminal,tip,trichome,unbranched,unknown,white,wiry-woody,x	apart,capitate,perfect,stem
165	wfo-0001027630	invalid_json	149	116	NA	72	77	44	NA	NA	.1,0.5-1,0.5-1.2,0.5-2,1-5,1.4-1.7,3/4,4-6,5.5-11.2,acute,anther,anthesi,apart,apex,bark,base,berry,calyx,climbing,cm,corolla,decurrent,deflexed,densely,extreme,filament,fruit,glabrate,glabrous,globose,golden,green,hirsute,internodal,lanceolate,leaf,linear,lobe,lobed,long,long-acuminate,minutely,mm,occasionally,opposite,ovary,paler,papillose,partially,pedicel,petiole,pore,poricidal,reflexed,scar,shaped,shrub,simple,sparsely,stem,stigma,style,tapering,tear-drop,tip,trichome,tube,uniseriate,way,white,winged,young	.2,.5,0.05-0.1,1-1.5,1.5-2,2-3,2-6-flowered,6-10,8-9,also,arising,beginning,blunt,branchlet,broadly,ciliate,de,deltoid,dia,distinguishable,eaf,edicel,eed,elongat,erose,except,free,fruiting,globo,immature,indistinct,inflorescenc,irregularly,knob-like,known,lateral,lon,lower,main,margin,middle,midrib,near,nflorescence,novo,older,pair,portion,prominent,proximal,puberulent,pubescent,raised,rest,rounded,ruit,seen,slender,spaced,straight,strongly,swollen,tall,terminal,thickened,ti,ud,ultimate,unifoliat,unit,vein,wide,widest,wing,x,yellowish,ympodial	2-6,arrangement,bud,characteristic,coat,colour,connation,decument,decurrency,dry,embryo,feature,flower,form,growth,height,history,inflorescence,length,life,midpoint,minor,na,new,number,papilla,perennial,plant,prickle,ray,reproduction,seed,shape,size,spacing,specimen,surface,texture,tuberculation,type,unifoliate,value,width,winging	NA	NA
166	wfo-0001027661	success	220	135	84	102	118	33	80	4	+,-10,0.5,0.5-2,0.6-1.1,0.6-1.5,1-1.5,1-5,1.2-6,1.5,2.5-3,2.5-7,40,5-9,6-12,8-10,acuminate,acute,anther,anthesi,apart,apex,base,berry,branch,bright,broadly,calyx,capitate,cm,conical,connivent,cordate,corolla,deeply,dendritic,ellipsoid,filament,flattened,flower,glabrous,globose,green,growth,herbaceous,lateral,leaf,leaf-opposed,lobe,lobed,long,minute,minutely,mixture,mm,moderately,new,often,pedicel,petiole,pinnatifid,pitted,pore,poricidal,pubescent,purple,purplish,red,reniform,ripe,scar,shape,short,simple,size,slender,stellate,stem,stigma,style,surface,tangled,terminal,ternately,tightly,tip,triangular,trichome,truncate,tube,turbinate,two,type,uniseriate,usually,vine,violet,way,white,wide,woody,Â¾	0.5-1-7,1-4-15,1.3,1.5-2,2,30,4-8-celled,4.5-6,5-merou,6-8,6-9,<,>,abaxially,adaxiall,ag,along,alyx,ark,articulate,axi,basal,branched,cell,column,commonly,creeping,densely,denser,density,diameter,eaf,eed,elliptic,entire,even,extremely,free,fruiting,fused,gre,grey,ground,hue,ilament,irregularly,lamina,leaving,lengthening,like,long-exserted,lower,many,margin,markedly,membraneous,narrowing,near,nflorescence,occasionally,older,open,orolla,outline,ovate,pair,pale,papillat,papillate,papillo,peduncle,peg,pentagonal,per,perfect,pericarp,plurifoliat,pointed,portion,primary,prominent,pubescen,pubescence,rachi,rarely,reflexed,ruit,shiny,single,sinus,sleeve,slit,small,spaced,sparsely,spot,spreadin,spreading,strongly,swollen,tan,tem,testa,thin,time,trailing,ud,underground,unieriate,unit,upper,variable,vary,vein,yellow,yellowish,ympodial,zig-za	4-15,arrangement,bud,coat,colour,connation,decurrency,dry,feature,form,fruit,height,inflorescence,length,midpoint,na,number,ovary,papilla,papillose,plant,plurifoliate,prickle,ray,reproduction,seed,spacing,specimen,texture,tuberculation,width,winging,young	+,-10,0.5,0.5-2,0.6-1.1,0.6-1.5,1-1.5,1-5,1.2-6,1.5,2.5-3,2.5-7,40,5-9,6-12,8-10,acuminate,acute,apart,base,berry,branch,bright,broadly,capitate,cm,conical,connivent,cordate,deeply,dendritic,ellipsoid,flattened,glabrous,globose,green,herbaceous,lateral,leaf-opposed,lobed,long,minute,minutely,mixture,mm,moderately,often,pinnatifid,pitted,poricidal,pubescent,purple,purplish,red,reniform,ripe,short,simple,slender,stellate,tangled,terminal,ternately,tightly,tip,triangular,trichome,truncate,turbinate,two,type,uniseriate,usually,vine,violet,way,white,wide,woody,Â¾	4-15,na,papillose,plurifoliate
167	wfo-0001027714	success	248	110	75	93	155	17	73	2	+,.5,/3,1-1.5,1-1.6,14-16,2-2.5,4-5,5,5-10,5-6,7-20,80,abaxial,adaxial,almost,anther,apex,base,berry,branched,bright,brown,calyx,capitate,cm,conical,corky,corolla,deep,densely,diameter,ellipsoid,elliptic,flattened,flower,fruit,glabrate,glabrous,globose,growth,hairy,immature,inflated,inflorescence,irregularly,juicy,lateral,leaf,lobed,many,mature,minutely,mm,new,obovate,occasionally,ovary,pedicel,petiole,pinnatifid,pitted,poricidal,pubescent,purple,red,reniform,ripe,scar,seed,shiny,simple,slender,small,somewhat,spaced,sparsely,stellate-rotate,stem,stigma,style,surface,terminal,time,tip,tube,usually,vine,violet,way,woody,x,yellowish	0,0.4,0.5,0.5-0.7,0.6-0.7,0.9-1.5,1,1-2,1-2-8,1.5-2,1.5-2.5,1.5-3,1.5-5,2-2.5-4,2.5-4-10,2373.,3-3.5,4.5-5,5-merou,6-7,<,abaxially,acuminate,acute,adaxially,age,aid,along,alyx,angle,anthesi,apar,apice,appearance,ark,around,articulated,axi,basal,canop,cell,channelled,climbin,confined,connected,connivent,cordate,creating,cucullate,cupped,deflexed,dendritic,denser,drying,eaf,eed,elongate,enlarged,entire,especially,exserted,fide,filament,fleshy,free,fruiting,furcate,giving,glabrou,groove,hanging,ilament,individual,lamina,large,leaving,lengthening,like,lobe,lon,long,longer,loosely,lower,margin,marginal,mere,minute,mpodial,nee,nflorescence,nodding,often,older,orolla,otherwise,outline,pair,pale,papillate,papillo,peduncle,peg,per,perfect,pericarp,petal,petiolule,plat,plurifoliat,pore,portion,primary,prominent,pubescence,reaching,rectangular,reddish,rim,ruit,showy,similar,sleeve,slightly,slit,spreading,strongly,tangled,tem,testa,testal,thecae,thick,thickened,thin,third,tiny,tooth,trichome,truncate,twining,ud,uniformly,uniseriate,unit,upper,vein,visible,wall,weak,weight,widest,wing,yellow,younger	2.5-10,apart,arrangement,bark,bud,colour,feature,form,length,number,shape,size,spacing,texture,type,width,young	+,.5,/3,1-1.5,1-1.6,14-16,2-2.5,4-5,5,5-10,5-6,7-20,80,almost,apex,base,berry,branched,bright,brown,capitate,cm,conical,corky,deep,densely,diameter,ellipsoid,elliptic,flattened,fruit,glabrate,glabrous,globose,hairy,immature,inflated,irregularly,juicy,lateral,lobed,many,mature,minutely,mm,obovate,occasionally,pinnatifid,pitted,poricidal,pubescent,purple,red,reniform,ripe,shiny,simple,slender,small,somewhat,spaced,sparsely,stellate-rotate,terminal,time,tip,usually,vine,violet,way,woody,x,yellowish	2.5-10,apart
168	wfo-0001027720	success	184	116	63	76	108	40	59	4	0.25-0.35,0.3-5,0.8-1,1-1.5,1-2,1-3.5,1-locular,1.5-2,13-35,15-25,2-3,2-4,2-branched,4-7,4.3-15,7-8,8-16,absent,anther,apex,calyx,cm,confined,connivent,deltate,densely,diameter,directed,distally,elliptic,extra-axillary,filament,flattened,flower,fruit,glabrous,globose,green,hair,incomplete,inflorescence,lanceolate,leaf,length,lilac,lobe,loosely,midpoint,midrib,minute,mm,narrowly,notched,ovate,pedicel,perennial,petiole,pore,prickle,pubescent,ray,red,rhizomatous,septum,shrub,simple,slightly,sparsely,stellate,stellate-pubescent,stigma,style,subreniform,surface,triangular,tube	%,.25-0.3,0,0-15,0.15-0.25,0.4-0.7,0.4-0.8,0.5-0.8,0.5-1,0.6-1.2,13-23,2-7,2-foliate,2.8-3.1,23-35,3-13,4-,4-5.5,4.3-7.5,5-merous,6,7-10,7-9,8-11,9-15,abaxially,absen,acute,adaxiall,adaxially,adult,alyx,apparently,articulated,axe,ba,base,berry,blade,brown,capitat,chartaceous,cuneate,cylindrical,distall,eaf,eed,eglandular,entire,erect,finger,fruiting,geminat,gland-tipped,half,hig,homostylous,intepetalar,juicy,juvenile,lamina,lateral,less,long,lower,margin,markedly,mature,mesocarp,mid-point,nflorescence,oblique,orolla,pale,part,peduncle,per,perfec,perfect,porrect,present,rachi,ruit,scarce,sessile,short,stellae,straight,succulen,tamen,tem,thick,thicker,time,tissue,toward,unarme,unarmed,unit,upper,vary,white,wide,without,x,yellow,yellowi,ympodial	1,abaxial,adaxial,anthesi,arrangement,capitate,coat,colour,connation,corolla,dry,embryo,feature,form,growth,height,history,life,na,new,number,ovary,papilla,plant,reproduction,scar,seed,shape,size,spacing,specimen,stem,texture,tip,tuberculation,type,width,winging,yellowish,young	0.25-0.35,0.3-5,0.8-1,1-1.5,1-2,1-3.5,1-locular,1.5-2,13-35,15-25,2-3,2-4,2-branched,4-7,4.3-15,7-8,8-16,absent,apex,cm,confined,connivent,deltate,densely,diameter,directed,distally,elliptic,extra-axillary,flattened,flower,fruit,glabrous,globose,green,hair,incomplete,lanceolate,lilac,loosely,midrib,minute,mm,narrowly,notched,ovate,perennial,pubescent,red,rhizomatous,septum,shrub,simple,slightly,sparsely,stellate,stellate-pubescent,subreniform,triangular	1,capitate,na,yellowish
169	wfo-0001027720	success	272	149	105	104	168	45	89	16	0,1/2,1/3,10.0,2.0,acuminate,acute,aequilateral,anther,apex,apical,apiculate,attachment,attenuate,base,berry,bilobed,bud,calyx,cancellate,capitate,cm,conical,connivent,corolla,cream,developed,diameter,distally,elliptic,especially,extra-axillary,filament,flattened-irregular,flattened-orbicular,flattened-reniform,flower,fruit,glabrous,glandular,globose,gradually,growth,hair,increasing,internode,interpetalar,juvenile,large,lateral,lavender,leaf,lobe,long,major,mature,minor,minute,mm,nearly,notched,oblique,oblong,orange,ovate,part,pedicel,per,petiole,point,poorly,pore,porrect,prickle,red,scattered,sessile,short,shrub,simple,slightly,small,stellae,stellate,stem,stigma,straight,style,subacute,surface,tip,tissue,tree,truncate,tube,twice-branched,upper,violet,white,yellow,young,youngest,Â±equal,Ã	.0,.04,.2,.3,.5,.9,0.1â0.6,0.2â0.4,0.3â0.4,0.7â0.9,0.7â1.1,0.7â1.2,0.8â1.3,0.8â1.9,0.8â2.0,0.9,1.4â1.9,1.5â1.7,1.5â2.0,1.5â2.5,1.5â3.3,1.5â9.0,1.7â1.8,1.7â2.0,1.7â2.5,1.8â2.0,1.9â2.2,1/3â1/2,10.8â18.2,12â16,13.0,19.7â30.0,2.5,2.5â2.8,2.5â2.9,2â3,3.2,3.6,3.7â5.7,3.9,4.0â12.6,4.0â18.0,4â5-merou,5.1â18.6,6.5â9.5,6â8,8.0,8.0â11.9,8.2â10.5,8.5â9.4,9.5â16.0,abaxially,adaxially,adnate,alyx,anthesi,apparently,appearing,armed,articulated,axe,ba,becoming,blade,branch,broad,broad-based,brochidodromous,channel,channeled,colore,concave,congested,crisped,curved,deciduous,dehiscence,densely,dentate,difoliate,dorsally,dry,eaf,eed,either,emerging,endocarp,entire,erect,exocarp,fertile,filiform,free,geminat,glossy,heavily,homostylous,hooked,inclined,intersepalar,juic,lamina,least,like,line,lon,longer,lower,m.,margin,midpoint,midrib,midvein,moderately,narrowly,nflorescence,occasionally,often,orolla,peduncle,perforate,porrect-stellate,portion,potentially,presumably,proximal,pubescent,raised,ray,reflexed,rigid,rip,row,ruit,shorter,side,sinus,soon,sparsely,splitting,spread,stamen,stellate-pubescen,stellate-pubescent,subcoriaceous,suture,tall,tamen,tem,thin,time,toward,translucent,triangular,two,ud,unarmed,vary,vein,wavy,way,weakly,wide,yellow-ferruginou,yellow-ferruginous,yellow-tan,ympodia,â4	0.8-1.9,1.4-1.9,1.5-3.3,1.5-9.0,1.7-2.5,19.7-30.0,2-3,2.5-2.8,2.5-2.9,4,5.1-18.6,6.5-9.5,8.0-11.9,9.5-16.0,arrangement,coat,colored,colour,connation,decurrency,embryo,feature,form,height,history,inflorescence,length,life,na,new,number,ovary,papilla,plant,reproduction,scar,seed,shape,size,spacing,texture,tuberculation,type,width,winging	0,1/2,1/3,10.0,2.0,acuminate,acute,aequilateral,apical,apiculate,attachment,attenuate,base,berry,bilobed,cancellate,capitate,cm,conical,connivent,cream,developed,diameter,distally,elliptic,especially,extra-axillary,flattened-irregular,flattened-orbicular,flattened-reniform,flower,fruit,glabrous,glandular,globose,gradually,growth,hair,increasing,internode,interpetalar,juvenile,large,lateral,lavender,leaf,lobe,long,major,mature,minute,mm,nearly,notched,oblique,oblong,orange,ovate,part,per,point,poorly,pore,porrect,red,scattered,sessile,short,shrub,simple,slightly,small,stellae,stellate,straight,subacute,tip,tissue,tree,truncate,twice-branched,upper,violet,white,yellow,young,youngest,Â±equal,Ã	0.8-1.9,1.4-1.9,1.5-3.3,1.5-9.0,1.7-2.5,19.7-30.0,2-3,2.5-2.8,2.5-2.9,4,5.1-18.6,6.5-9.5,8.0-11.9,9.5-16.0,colored,na
170	wfo-0001027757	success	186	131	81	78	108	53	63	18	0.5,0.6,2,2.5,abaxially,acute,adaxially,anther,anthesi,apart,apex,base,blue,branching,brown,calyx,campanulate,clavate,cm,colour,connivent,decurrent,deeply,densely,directed,distally,elliptic,erect,filament,flattened,flower,fruit,glabrous,globose,hair,lanceolate,leaf,lilac,lobe,long,longitudinal,mm,multicellular,narrowly,oblong,obtuse,opening,ovate,pale,pedicel,perennial,petiole,pitted,pore,poricidal,pubescent,rotate,shrub,simple,slit,sparsely,stigma,stone,style,surface,tip,tube,unbranched,unicellular,uniseriate,unknown,violet,white,woody,x,â19,â2.7,â5.5	0.2,0.2â0.3,0.3â2.0,0.6â1.0,0.7,0â1.4,1.0â1.1,1.0â2.5,1.2â4.0,1.5â1.6,1.5â2.5,1.6â2.4,1.9â2.7,12,1â1.5,1â11,1â2,1â3,2.5â4,2.5â5.5,2.5â7,2â,2â10,3â12,3â5,4â9,5,5â,60â100,6â9,7â8,8â16,absen,accrescent,adaxiall,ag,along,apical,arising,articulated,axe,axillary,ba,basal,blade,borne,cell,chartaceous,concave,convex,cylindrical,dark,diameter,eaf,eed,entire,equal,erose,fleshy,geminat,glabrescen,glabrou,irregularly,leafy,lobed,lon,lower,m.,margin,moderately,nflorescence,occasionally,often,opposed,orolla,pair,peduncle,perfect,plurifoliate,primary,probably,regularly,rootstock,ruit,secondary,serrate,shoot,side,smaller,sometimes,spaced,straight,tall,tamen,tem,thic,thickened,time,toward,unit,vary,wide,yellow,ympodial,â3.2,â4.0,â6,â9	0-1.4,0.2-0.3,0.3-2.0,0.6-1.0,1-11,1.0-1.1,1.2-4.0,1.5-1.6,1.6-2.4,2-10,3-12,4-9,6-9,60-100,8-16,age,arrangement,bud,coat,connation,corolla,decurrency,embryo,feature,form,glabrescent,growth,height,history,inflorescence,length,life,minor,na,new,number,ovary,papilla,plant,prickle,reproduction,scar,seed,shape,size,spacing,stem,texture,tuberculation,type,width,winging,young	0.5,0.6,2,2.5,abaxially,acute,adaxially,anthesi,apart,blue,branching,brown,campanulate,clavate,cm,connivent,decurrent,deeply,densely,directed,distally,elliptic,erect,flattened,fruit,glabrous,globose,hair,lanceolate,lilac,long,longitudinal,mm,multicellular,narrowly,oblong,obtuse,opening,ovate,pale,perennial,pitted,pore,poricidal,pubescent,rotate,shrub,simple,slit,sparsely,stone,tip,unbranched,unicellular,uniseriate,unknown,violet,white,woody,x,â19,â2.7,â5.5	0-1.4,0.2-0.3,0.3-2.0,0.6-1.0,1-11,1.0-1.1,1.2-4.0,1.5-1.6,1.6-2.4,2-10,3-12,4-9,6-9,60-100,8-16,age,glabrescent,na
171	wfo-0001027765	success	163	112	75	85	78	27	71	4	0.8,1,1-10,1-11.5,1-4,1-5,1.5-6,10-13,2-2.5,2-3,2-4,2.5-4.2,20-30-44,3-12,3-20,5-6,5-8,abaxial,apical,apically,branched,calyx,cell,cm,connate,corolla,covering,cyme,dehiscent,diameter,dichasial,dichasially,distal,ebracteate,filament,flower,forked,generally,globose,green,hair-like,half,herbaceous,interjected,introrse,lateral,leaf,leaflet,light,lobe,long,make,maturing,mm,monochasial,mucilaginous,odd-pinnate,often,ovoid,pedicel,peduncle,perennial,petiole,pilose,plant,poricidally,seed,short,side,size,slit,stellate,stigma,style,terminal,testal,thick,throughout,tip,tone,violet,wall,white,wide,yellow	0-.,1-2,1-2-3-4,2.5-4,3-5-15-30,3-6-foliat,5,7-20,abaxially,abruptly,acumen,acuminate,acute,apex,apiculate,articulate,base,cordate,cuneate,digestion,diminishing,dorsally,eaf,edge,eed,elliptic,elliptic-lanceolate,emoval,enzyme,exceeding,flat,folded,glandular,globo,green-white,hair,honeycomb,living,lon,lower,lunat,nflorescence,nther,oblique,obtuse,orolla,ovate,ovate-elliptic,ovate-lanceolate,pair,pattern,perfect,petiolate,petiolule,plan,proximal,reveal,rounded,ruit,sessile,seudostipule,simple,slightly,specimen,stamen,straight,tal,tem,throughou,toward,truncate,tuber-bearing,typically,unit,vary,without,ympodial,Â¼	0-2,3-15-30,adaxial,anther,arrangement,colour,connation,dehiscence,feature,form,fruit,growth,height,history,inflorescence,length,life,na,number,ovary,reproduction,shape,stem,surface,texture,wet,width	0.8,1,1-10,1-11.5,1-4,1-5,1.5-6,10-13,2-2.5,2-3,2-4,2.5-4.2,20-30-44,3-12,3-20,5-6,5-8,abaxial,apical,apically,branched,cell,cm,connate,covering,cyme,dehiscent,diameter,dichasial,dichasially,distal,ebracteate,forked,generally,globose,green,hair-like,half,herbaceous,introrse,lateral,light,lobe,long,make,maturing,mm,monochasial,mucilaginous,odd-pinnate,often,ovoid,perennial,pilose,plant,poricidally,seed,short,side,slit,stellate,testal,thick,throughout,tip,tone,violet,wall,white,wide,yellow	0-2,3-15-30,na,wet
172	wfo-0001027807	success	116	84	51	64	52	20	50	1	0-0.2,0.1-1,0.2-0.3,0.2-0.9,0.3-0.4,0.9-1,0.9-2.5,15-30,2-6,3.5-9,acuminate,acute,apex,attenuate,bark,base,berry,bud,closely,cm,elliptic,flattened,flower,glabrous,globose,gray,grayish,green,growth,internodal,lanceolate,leaf,leaf-opposed,minutely,mm,narrowly,new,occasionally,older,overlapping,pair,pale,papillae,papillate,pedicel,petiole,pitted,primary,reddish,reniform,scar,shrub,simple,slightly,small,spaced,sparsely,stem,surface,tree,vein,white,winged,x	.5,1-1.5,2-5,abaxially,adaxially,almost,barely,brittle,brown,decurrent,deflexe,deflexed,diameter,difoliate,dry,drying,eaf,eed,ellipti,fruiting,geminat,know,known,margin,material,maturity,midrib,nflorescence,ot,paler,parallel,peduncle,plane,prominent,rachi,reddi,reproductive,revolute,ruit,seemingly,shoot,slender,somewhat,thickened,ud,unifoliate,unit,usually,visible,yellowish,ympodial,young	arrangement,coat,colour,embryo,feature,form,fruit,inflorescence,length,na,number,seed,shape,size,spacing,texture,tuberculation,type,width,winging	0-0.2,0.1-1,0.2-0.3,0.2-0.9,0.3-0.4,0.9-1,0.9-2.5,15-30,2-6,3.5-9,acuminate,acute,attenuate,berry,closely,cm,elliptic,flattened,glabrous,globose,gray,grayish,green,internodal,lanceolate,leaf-opposed,minutely,mm,narrowly,occasionally,older,overlapping,pair,pale,papillae,papillate,pitted,reddish,reniform,shrub,simple,slightly,small,spaced,sparsely,stem,tree,white,winged,x	na
173	wfo-0001027816	success	187	119	67	86	101	33	63	4	.5,0.5-1,0.5-2,0.6-0.8,1-1.5,1-4,1.8-6,2-2.5,2-4,3-3.5,3.5-4,4-5,5-30,acuminate,acute,anther,anthesi,apex,attenuate,base,becoming,berry,bluish,branched,calyx,capitate,cm,conical,connivent,corolla,dark,densely,ellipsoid,filament,filiform,flattened,flower,glabrous,globose,growth,inflorescence,lanceolate,lateral,leaf,lengthening,less,linear,lobe,lobed,loosely,minute,minutely,mm,new,orange,pedicel,petiole,pitted,plant,pore,poricidal,pubescent,purple,reniform,ripe,scar,several,shrub,simple,slightly,slit,stellate,stem,stigma,style,surface,terminal,time,tip,triangular,trichome,tube,uniformly,uniseriate,variable,x	..,0.2,0.5,0.7-1,1,1-1,1-3,1.2-2,1.5-2,12-14,2/3,5-merou,6-9,<,ag,almost,along,alyx,apar,ark,articulated,axi,brown,cell,confined,cupped,dense,diameter,drying,eaf,eed,em,entire,erect,exserted,fleshy,free,fruiting,gland-tipped,glandular,half,ilament,irregularly,leaving,like,lower,m.,margin,markedly,nflorescence,nodding,occasionally,often,older,orolla,pair,papillo,patent,peduncle,peg,per,perfect,perhaps,pericarp,plurifoliat,portion,primary,prominen,pubescen,rectangular,red,reddish,rounded,ruit,shiny,sleeve,small,sometimes,somewhat,spaced,sparse,sparsely,spreadin,spreading,square,testal,thin,twinin,ud,ultimate,unit,upper,usually,vary,vein,viscous,way,woody,yellowish,ympodial,Â½	abaxial,adaxial,age,apart,arrangement,bud,coat,colour,connation,dry,feature,form,fruit,height,length,midpoint,na,number,ovary,papilla,papillose,prickle,ray,seed,shape,size,spacing,specimen,texture,tuberculation,type,width,young	.5,0.5-1,0.5-2,0.6-0.8,1-1.5,1-4,1.8-6,2-2.5,2-4,3-3.5,3.5-4,4-5,5-30,acuminate,acute,attenuate,becoming,berry,bluish,branched,capitate,cm,conical,connivent,dark,densely,ellipsoid,filiform,flattened,glabrous,globose,lanceolate,lateral,lengthening,less,linear,lobed,loosely,minute,minutely,mm,orange,pitted,poricidal,pubescent,purple,reniform,ripe,several,shrub,simple,slightly,slit,stellate,terminal,time,tip,triangular,trichome,uniformly,uniseriate,variable,x	age,apart,na,papillose
174	wfo-0001027819	success	198	139	95	108	90	31	91	4	0.5-1,1-2,1-4-10,1-5,10-20,10-50,12-21,2-15,2-3,2-3-5-lobed,20-35,20-40-100,22-35,25-35,3-40,3-5,4,4-10,4-15,4-25,4-5,5,5-6,9-12,abaxially,acute,adaxially,apart,apex,apical,basal,base,branched,cm,concave,connective,cordate,cuneate,deeply,densely,diameter,directed,distally,eglandular,ellipsoidal,entire,especially,fading,finely,fleshy,flower,forked,fruit,glabrous,globose,green,hair,leaf,length,lobe,long,margin,mm,moderately,narrowly,oblique,oblong,obtuse,occasionally,often,pedicel,peduncle,per,petiole,pilose,pinnately,pore,probably,protuberance,puberulent,purple,rachi,radiu,rarely,rugose,simple,sometimes,sparsely,stellate,stigma,style,sympodial,tree,triangular,truncate,tube,two,umbrella-shaped,unbranched,unit,unknown,unlobed,villous,whitish,width,without,x,yellow	1,1.5-2,15-22,16-25,2,20-25,20-40,5-merous,8-10,aggregate,also,alyx,ape,apiculat,articulated,axe,ba,beyond,blade,cell,ciliate,color,cylindrical,denser,dia,diamete,dilated,divided,eaf,eed,eglandular-pilose,elliptic,elliptic-ovate,equal,exceeding,except,exserted,halfway,leaving,lobed,lon,lower,main,mesocarp,midrib,narrow,near,nflorescence,nther,obtu,orolla,ovate,pedicellar,perfec,perfect,present,prominent,puberulen,puberulence,purplish,ranch,ratio,remnant,ripe,rounded,rown,ruit,runk,shallowly,short-acuminat,shorter,sinus,slightly,small,spaced,stamen,stone,strongly,subcoriaceous,swelling,tal,thecae,toward,ud,uni,usually,vary,vein,wide,young	abaxial,adaxial,anther,apiculate,arrangement,bud,calyx,colour,corolla,crown,feature,form,growth,height,hermaphroditic,history,inflorescence,life,number,ovary,perennial,plant,reproduction,seed,shape,short-acuminate,spacing,surface,texture,tip,trunk	0.5-1,1-2,1-4-10,1-5,10-20,10-50,12-21,2-15,2-3,2-3-5-lobed,20-35,20-40-100,22-35,25-35,3-40,3-5,4,4-10,4-15,4-25,4-5,5,5-6,9-12,abaxially,acute,adaxially,apart,apex,apical,basal,branched,cm,concave,cordate,cuneate,deeply,densely,directed,distally,eglandular,ellipsoidal,entire,especially,fading,finely,fleshy,forked,glabrous,globose,green,hair,lobe,long,margin,mm,moderately,narrowly,oblique,oblong,obtuse,occasionally,often,per,pilose,pinnately,probably,protuberance,puberulent,purple,rarely,rugose,simple,sometimes,sparsely,stellate,sympodial,tree,triangular,truncate,two,umbrella-shaped,unbranched,unit,unknown,unlobed,villous,whitish,without,x,yellow	apiculate,hermaphroditic,perennial,short-acuminate
175	wfo-0001027834	success	235	120	64	78	157	42	55	9	0.2-0.3,0.2-0.6,0.9-1.8,1-1.9,1-10,1-2.5,1.1-1.6,1.4-2,1.6-2.7,10-25,2-8,2.9-4.2,3-15,3-4.3,4-5.2-6.1,5-20,5.1-8,acuminate,acute,anther,anthesi,apex,articulated,attenuate,bark,base,berry,blunt-tipped,brown,bud,calyx,cm,connivent,corolla,deltoid,ellipsoid,filament,flower,fruit,globose,granular-tomentose,gray,leaf,lenticular,lobe,mm,obtuse,ovate,ovate-lanceolate,pedicel,petiole,pore,poricidal,ray,reticulate-punctate,ripe,rounded,scar,short,shrub,simple,small,stellate,stem,stigma,style,subcampanulate,surface,tip,tree,tube,white,whitish,x,yellow,yellowish,yellowish-tomentose,young	.5-3,0-110,0.2-0.4,0.4-1.1,0.5-2,1-1.6,1.1-1.8,1.8-4.9,1/2,2-3.8,2.2-4.3,2.3-3.4,2.4-6.2,2.7-7.3,25,4-6,4.8-6.9,5-merous,6.9-18.1,9-11.9,9-13,abaxial,abaxially,absent,accrescent,adaxial,adaxially,ag,alyx,angled,apar,apical,around,axillary,ba,becoming,blade,branch,branched,branching,capitat,closely,completely,concentrated,coriaceous,covering,crown,cylindrical,dendritic-echinoi,dendritic-echinoid,densely,diameter,dichasia,directed,discolorous,distally,drying,eaf,echinoi,echinoid,edge,eed,enclosing,entire,enveloping,equal,erec,exserted,farinose,finely,flat-topped,fleshy,forming,fruiting,glabrescent,glabrous,grooved,hair,high,included,inserted,lengthening,less,light,lobed,long,long-stalked,longitudinal,longitudinally,lower,many,margin,mostly,multangulat,multangulate,near,nflorescence,numerous,obovate,obscured,older,orbicular,orolla,ovate-elliptic,pair,peduncle,perfec,persistent,plurifoliate,porrect-stellate,primary,pseudo-terminal,pubescence,pubescent,rachi,rarely,ruit,runk,scabridulous,semi-ovate,semi-spherical,sessile,short-stalked,slit,soft,sometimes,somewhat,spaced,sparsely,spreading,stalked,stamen,stellate-pubescent,subcoriaceous,suture,tamen,though,time,tomentose,tomentu,tomentum,toward,trichome,turbinoid,ud,unarme,unit,usually,vary,vein,velutinous-tomentose,villous,way,whitish-tomentose,wide,yellowish-tan,ympodial	70-110,apart,arrangement,capitate,coat,colour,connation,decurrency,dry,embryo,erect,feature,form,growth,height,history,inflorescence,length,life,midpoint,minor,number,ovary,papilla,perennial,plant,prickle,reproduction,seed,shape,size,spacing,specimen,texture,tomontose,tuberculation,turbanoid,type,unarmed,unknown,width,winging	0.2-0.3,0.2-0.6,0.9-1.8,1-1.9,1-10,1-2.5,1.1-1.6,1.4-2,1.6-2.7,10-25,2-8,2.9-4.2,3-15,3-4.3,4-5.2-6.1,5-20,5.1-8,acuminate,acute,articulated,attenuate,base,berry,blunt-tipped,brown,cm,connivent,deltoid,ellipsoid,globose,granular-tomentose,gray,lenticular,mm,obtuse,ovate,ovate-lanceolate,poricidal,reticulate-punctate,ripe,rounded,short,shrub,simple,small,stellate,subcampanulate,tip,tree,white,whitish,x,yellow,yellowish,yellowish-tomentose	70-110,apart,capitate,erect,perennial,tomontose,turbanoid,unarmed,unknown
176	wfo-0001027843	success	154	120	65	80	74	40	58	7	0.5-0.75,0.5-1,0.8-3.5,1-1.2,1-1.5,1.2-1.5,1.2-2.5,2-4,3-6,5-6,6-13,6-9,acute,anther,anthesi,apart,apex,apiculate,bark,base,berry,broadly,calyx,clavate,cm,conical,corolla,deflexed,deltoid,ellipsoid,filament,flower,glabrate,glabrous,globose,green,later,leaf,lobe,lobed,long,long-acuminate,minor,minutely,mm,nearly,occasionally,opposite,orbicular,ovary,ovate,papillose,pedicel,petiole,pore,poricidal,pubescent,rounded,scar,shape,shaped,shrub,simple,size,slender,slightly,stem,stigma,style,surface,tapering,tear-drop,tip,trichome,tube,uniseriate,white,woody,x,young	.5,.75,/3,1-1.3,2-2.5,3-15-flowered,along,ba,bearing,becoming,beginning,beneath,coroll,curly,densely,denser,dia,differing,difoliate,distally,eaf,edicel,eed,erose,exsertion,free,fruiting,geminat,hairy,impressed,irregularly,known,lamina,larger,lateral,like,lon,lower,main,major,margin,middle,near,nflorescence,older,one,pair,papillo,pleated,portion,prominent,proximal,reddish-gre,reflexed,ruit,sinus,somewhat,spaced,sparsely,sparser,stiff,straight,strongly,tall,time,tipped,two,ud,unit,vein,way,widest,winged,ympodial	1,3-15,alternate,arrangement,bud,coat,colour,connation,decurrency,dry,embryo,feature,form,fruit,growth,height,history,inflorescence,length,life,midpoint,na,new,number,papilla,perennial,plant,prickle,ray,reddish-grey,reproduction,seed,spacing,specimen,texture,tuberculation,type,unknown,width,winging	0.5-0.75,0.5-1,0.8-3.5,1-1.2,1-1.5,1.2-1.5,1.2-2.5,2-4,3-6,5-6,6-13,6-9,acute,apart,apiculate,base,berry,broadly,clavate,cm,conical,deflexed,deltoid,ellipsoid,glabrate,glabrous,globose,green,later,leaf,lobed,long,long-acuminate,minutely,mm,nearly,occasionally,opposite,orbicular,ovate,papillose,poricidal,pubescent,rounded,shaped,shrub,simple,slender,slightly,tapering,tear-drop,tip,trichome,uniseriate,white,woody,x,young	1,3-15,alternate,na,perennial,reddish-grey,unknown
177	wfo-0001027847	success	215	134	81	100	115	34	80	1	-2.5,-5,-6,.7,/3,0-2,0.15-0.2,0.4-1,0.8-0.9,0.8-1.2,1-2,1-2.5-4,1.5-2,1.5-5,1.9-2.3,1/4,2-4,2-5,2.2-3,2.5-3.5,3-15,3.5-6,acute,almost,anther,apart,apex,articulated,base,berry,calyx,cm,connivent,cordate,curved,deltate,diameter,elliptic,erect,evenly,filament,finely,flattened,flattened-reniform,flower,fruit,gray,green,lateral,leaf,length,lobe,lobed,long,maturity,mauve,middle,midpoint,minor,mm,narrow-deltate,orange,ovate,pedicel,perpendicular,petiole,pitted,poricidal,prickle,prickly,purple,ray,red,red-brown,retrorse,rounded,scar,seed,shrub,simple,size,smooth,sometimes,spherical,spreading,stellate,stellate-pubescent,stem,straight,style,surface,tapering,terminal,tip,tube,upper,way,white,wide,young	-3,.35,/2,0-7,0.1-0.4,0.2,0.5,0.5-0.8,0.5-1,0.8,1.5-2.5,1/2,1/6-1/3,2-2.8,2-3,2/,3-5,3-6,4-5-merous,5-25,5-6,5.5-8,6-11,6-8,7-10,abaxially,alyx,ame,apar,apically,apparently,bark,blade,branched,broadly,brow,c.,chartaceous,densely,dimorphic,discolorous,distance,drying,dull,eaf,edge,eed,elongating,equal,extending,faint,filiform,filiform-acuminat,free,fruiting,geminate,glabrescent,glabrous,increasing,infructescence,lon,longer,lower,margin,mature,midvein,moderately,nflorescence,older,one,open,orange-brown,orbicular,orolla,oung,pair,peduncle,pendulous,per,perfec,pericarp,pit,plurifoliat,porrect,portion,prickl,primary,reddish,ruit,scandent,sessile,side,slender,spaced,sparsely,stalk,stalked,strongly,tamen,terete,tertiary,time,toward,trichome,unarmed,unit,usually,variously,vary,vein,venation,visible,weakly,yellow,ympodial	anthesi,arrangement,bud,coat,colour,connation,corolla,decurrency,dry,embryo,feature,form,growth,height,history,inflorescence,life,na,new,number,ovary,papilla,plant,pore,reproduction,shape,spacing,specimen,stigma,texture,tuberculation,type,width,winging	-2.5,-5,-6,.7,/3,0-2,0.15-0.2,0.4-1,0.8-0.9,0.8-1.2,1-2,1-2.5-4,1.5-2,1.5-5,1.9-2.3,1/4,2-4,2-5,2.2-3,2.5-3.5,3-15,3.5-6,acute,almost,apart,articulated,base,berry,cm,connivent,cordate,curved,deltate,diameter,elliptic,erect,evenly,finely,flattened,flattened-reniform,gray,green,lateral,lobed,long,maturity,mauve,middle,mm,narrow-deltate,orange,ovate,perpendicular,pitted,poricidal,prickly,purple,red,red-brown,retrorse,rounded,seed,shrub,simple,smooth,sometimes,spherical,spreading,stellate,stellate-pubescent,stem,straight,tapering,terminal,tip,upper,way,white,wide,young	na
178	wfo-0001027872	success	190	152	105	109	81	43	100	5	1,1-4,1-8,1.0-1.3,10,12-35,15,2,2-3,35,5-lobed,6-20,8-11,acuminate,acute,apex,apical,apically,apiculate,articulate,b,base,branched,ca,calyx,caudate,cell,celled,cm,connate,cordate,covering,cuneate,cyme,deep,dehiscent,densely,dichasial,dichasially,distal,ebracteate,elliptic,filament,flower,forked,four-celled,generally,gland,glandular,globose,gray-green,green,hair-like,half,herbaceous,homogeneously,introrse,lanceolate,lateral,light,lobe,long,longer,make,maturing,middle,mm,monochasial,mottled,mucilaginous,narrowly,obliquely,oblong,odd-pinnate,often,ovate,ovoid,pedicel,perennial,petiolate,plant,poricidally,puberulent,pubescent,purple,rarely,rhizomatous,rotate,rounded,seed,shape,short,single,size,slightly,slit,sometimes,stigma,style,symmetrically,testal,thick,tinged,tip,type,usually,wall,wide,yellowish-green	0.5,1-1.2,1.5-4,2.2-3.5,2.8,20,3-6-foliat,4-6,5-10,5-7,5-8,abaxially,acumen,adaxially,angular,ba,basal,becoming,clasping,commonly,decreasing,diameter,digestion,eaf,eed,emoval,enzyme,erect,exceeding,externally,glabrescent,glandular-pubescent,globo,green-white,honeycomb,interjected,leaflet,living,lon,lower,moderately,nearly,nflorescence,nther,orolla,pair,pattern,peduncle,pentagonal,perfect,petiolulate,petiolule,purpl,reduced,reveal,rhizome,rotate-,ruit,semi-lunate,sessile,seudostipule,somewhat,specimen,stamen,ste,straight,subequal,tem,terete,terminal,trailing,typically,unbranched,uniformly,unit,vary,viole,wid,wider,yellow,ympodial	anther,arrangement,berry,coat,colour,connation,corolla,embryo,feature,form,fruit,growth,height,history,inflorescence,leaf,length,life,midpoint,minor,na,new,number,ovary,papilla,petiole,pore,prickle,ray,reproduction,rotate-pentagonal,scar,spacing,stem,surface,texture,tube,tuberculation,violet,wet,width,winging,young	1,1-4,1-8,1.0-1.3,10,12-35,15,2,2-3,35,5-lobed,6-20,8-11,acuminate,acute,apical,apically,apiculate,articulate,b,base,branched,ca,caudate,cell,celled,cm,connate,cordate,covering,cuneate,cyme,deep,dehiscent,densely,dichasial,dichasially,distal,ebracteate,elliptic,forked,four-celled,generally,gland,glandular,globose,gray-green,green,hair-like,half,herbaceous,homogeneously,introrse,lanceolate,lateral,light,lobe,long,longer,make,maturing,middle,mm,monochasial,mottled,mucilaginous,narrowly,obliquely,oblong,odd-pinnate,often,ovate,ovoid,perennial,petiolate,plant,poricidally,puberulent,pubescent,purple,rarely,rhizomatous,rotate,rounded,seed,short,single,slightly,slit,sometimes,symmetrically,testal,thick,tinged,tip,type,usually,wall,wide,yellowish-green	berry,na,rotate-pentagonal,violet,wet
179	wfo-0001027880	success	185	131	76	89	96	42	72	4	.25,0.3-3,0.5-5,0.6-1,0.6-1.5,0.8-1.5,1-15,1-2.5,1.5-2,10-15,2-80,4-10,4-6,8,acute,anther,apart,apex,apiculate,base,calyx,clavate,cm,conical,connivent,contiguously,cordate,curled,deltate,densely,diameter,distichous,epiphytic,extra-axillary,filament,flattened,flower,fruit,glabrous,globose,green,greenish,hair,inflorescence,leaf,leaf-opposed,lobe,longitudinal,lower,minutely,mm,multicellular,nearly,oblique,oblong,oblong-ovate,often,ovate,ovoid,papillose,pedicel,petiole,pink,pore,pubescent,purple,red-brown,ripe,rounded,rugulose,scar,shrub,simple,size,slightly,slit,somewhat,stellate,stigma,style,surface,tip,truncate,tube,unbranched,uniseriate,vine,white,x	-3,0.5-1.5,0.5-1.5-3.5,1-14,1-2,1-3,1.5-3,2-3,2/,3-4,5-11,5-8,5-merou,abaxially,absen,accrescen,acuminate,adaxially,ag,aggregate,along,alyx,apparently,articulated,axe,ba,blade,branch,branching,cell,chartaceous,ciliat,coriaceous,cylindrical,dense,diminishing,directed,discolorous,distally,distinct,distinctly,eaf,eed,entire,equal,fruiting,geminat,growing,increasing,internode,line,long,longer,margin,midvein,nflorescence,node,occasionally,opening,orolla,pair,pale,peduncle,perfect,plurifoliate,point,pubescen,rachi,reddish,revolute,rooting,ruit,secondary,slender,sometimes,spaced,sparsely,ste,stone,tamen,tan,tem,thickened,time,trailing,tree,trunk,typically,undulate,unit,usually,vary,vein,wide,yellow,ympodial	2/3,age,anthesi,arrangement,bud,coat,colour,connation,corolla,decurrency,dry,embryo,feature,form,growth,height,history,length,life,midpoint,minor,na,new,number,ovary,papilla,plant,prickle,ray,reproduction,seed,shape,spacing,specimen,stem,texture,tuberculation,type,unknown,width,winging,young	.25,0.3-3,0.5-5,0.6-1,0.6-1.5,0.8-1.5,1-15,1-2.5,1.5-2,10-15,2-80,4-10,4-6,8,acute,apart,apiculate,clavate,cm,conical,connivent,contiguously,cordate,curled,deltate,densely,diameter,distichous,epiphytic,extra-axillary,flattened,flower,fruit,glabrous,globose,green,greenish,hair,leaf-opposed,longitudinal,lower,minutely,mm,multicellular,nearly,oblique,oblong,oblong-ovate,often,ovate,ovoid,papillose,pink,pubescent,purple,red-brown,ripe,rounded,rugulose,shrub,simple,slightly,slit,somewhat,stellate,tip,truncate,unbranched,uniseriate,vine,white,x	2/3,age,na,unknown
180	wfo-0001027880	success	170	112	82	77	93	35	64	18	.25,0.2-0.5,0.5,8,absent,acuminate,acute,adaxially,along,anther,apex,apiculate,arrangement,base,bluish-purple,calyx,chartaceous,clavate,cm,conical,contiguously,cordate,coriaceous,cylindrical,densely,diameter,distichous,distinct,distinctly,entire,extra-axillary,flattened,flower,fruit,glabrous,globose,greenish,hair,leaf,leaf-opposed,line,longer,margin,membranous,midvein,mm,nearly,oblique,occasionally,often,ovoid,pedicel,peduncle,petiole,pink,pubescent,rachi,revolute,rounded,rugulose,shrubby,simple,slightly,sometimes,somewhat,sparsely,stellate,stigma,style,surface,trichome,truncate,typically,undulate,vine,white,x	0.3â3,0.5â1.5,0.5â5,0.6â1,0.6â1.5,0.8â1.5,1.5â2,1.5â3,10â15,1â14,1â15,1â2,1â2.5,1â3,2-80,2/3,2â3,3â4,4â10,4â6,5-merous,5â11,5â8,abaxially,accrescen,alyx,apar,axe,berry,blade,c.,capitat,ciliat,climbing,curled,deltate,dense,discolored,eaf,eed,filament,fruiting,green,lanceolate,lobe,long,lower,m.,minutely,mottled,nflorescence,nternode,oblong-ovate,orolla,ovate,pair,pale,papillose,perfec,pinnate,plurifoliat,red,reddish,reddish-brown,rip,ruit,sand-punctat,sand-punctate,scar,secondary,slender,spaced,ste,tamen,tan,tem,thickened,time,tip,tree,trunk,tube,unbranched,uniseriate,unit,vary,vegetatio,vein,venation,wide,woody,ympodial,â3.5	0.3-3,0.5-5,0.6-1,0.6-1.5,0.8-1.5,1-14,1-15,1-2,1.5-2,1.5-3,10-15,2-3,4-10,4-6,5-8,abaxial,adaxial,apart,capitate,colour,corolla,feature,form,growth,inflorescence,length,ovary,seed,shape,size,spacing,staman,stem,texture,width	.25,0.2-0.5,0.5,8,absent,acuminate,acute,adaxially,along,apex,apiculate,bluish-purple,chartaceous,clavate,cm,conical,contiguously,cordate,coriaceous,cylindrical,densely,distichous,distinct,distinctly,entire,extra-axillary,flattened,flower,fruit,glabrous,globose,greenish,hair,leaf-opposed,line,longer,margin,membranous,midvein,mm,nearly,oblique,occasionally,often,ovoid,pink,pubescent,revolute,rounded,rugulose,shrubby,simple,slightly,sometimes,somewhat,sparsely,stellate,trichome,truncate,typically,undulate,vine,white,x	0.3-3,0.5-5,0.6-1,0.6-1.5,0.8-1.5,1-14,1-15,1-2,1.5-2,1.5-3,10-15,2-3,4-10,4-6,5-8,apart,capitate,stem
181	wfo-0001027881	success	214	113	77	74	140	39	59	18	abaxially,acute,almost,anther,apex,articulated,attenuate,base,berry,blackish,calyx,chartaceous,cm,connivent,contiguous,cordate,densely,diameter,drying,eglandular,erect,extra-axillary,filament,flattened,flower,fruit,giving,glabrous,glandular,globose,greenish,groove,hair,herb,immature,impression,introrsely,lateral,leaf,light-brown,margin,maturity,membranaceous,mm,moderately,multicelled,netlike,ovate-elliptic,parallel,pedicel,petiole,pore,projection,pubescent,raised,reniform,rotate,seed,sessile,short,simple,size,staman,stem,stigma,style,subapically,subopposite,surface,translucent,unbranched,white,yellow,Ã	.3â0.5,0.5â2.2,0.8â1.5,1-celled,1.3â2,1.8â2.9,10â25,1â2,1â2-celled,1â2.5-3,1â2.6,1â3,1â3-celled,1â4,2.5â3.6,20â40,2â4,2â6,2â7,4â6,4â9.5,5,5-merous,6â10,7â14,7â9,8,absent,abundant,accrescent,acuminate,adaxiall,adaxially,alyx,appressed,asymmetric,axe,ba,barely,blade,bulge,camptodromous,capitat,case,central,ciliate,closely,commonly,connected,cordiform,curved,cylindrical,decurrent,dehiscing,denser,difoliate,directed,dorsally,eaf,ed,emarginate,emerging,entire,equal,exceeding,exclusively,explosively,eye,few-,fewer,forming,frequent,geminate,half,held,hollow,interpetalar,larger,less,like,lobe,long,longer,longitudinal,lower,mainly,many-branched,maturit,mesocarp,mixed,much,multicellular,naked,near,nflorescence,normally,one,opening,orolla,other,pair,part,peduncle,per,perfec,placenta,pressure,primary,prominent,pubescence,rachi,ruit,secondary,side,similar,slightly,slit,small,smaller,solitary,sometimes,sparsely,stalk,stamen,tal,tamen,tem,tissue,triangular,tube,two,unit,vary,vein,venation,visible,watery,winged,woody,ympodial	.3-0.5,0.5-2.2,0.8-1.5,1-2,1-2-celled,1-2.5-3,1-3,1-4,1.8-2.9,2-7,2.5-3.6,20-40,4-9.5,6-10,7-14,7-9,abaxial,adaxial,arrangement,capitate,colour,corolla,feature,form,growth,height,history,inflorescence,length,life,ovary,perennial,plant,reproduction,shape,texture,type,width,young	abaxially,acute,almost,articulated,attenuate,base,berry,blackish,chartaceous,cm,connivent,contiguous,cordate,densely,diameter,drying,eglandular,erect,extra-axillary,flattened,flower,fruit,giving,glabrous,glandular,globose,greenish,groove,hair,herb,immature,impression,introrsely,lateral,light-brown,margin,maturity,membranaceous,mm,moderately,multicelled,netlike,ovate-elliptic,parallel,projection,pubescent,raised,reniform,rotate,sessile,short,simple,subapically,subopposite,translucent,unbranched,white,yellow,Ã	.3-0.5,0.5-2.2,0.8-1.5,1-2,1-2-celled,1-2.5-3,1-3,1-4,1.8-2.9,2-7,2.5-3.6,20-40,4-9.5,6-10,7-14,7-9,capitate,perennial
182	wfo-0001027882	success	183	138	84	102	81	36	81	3	.25,0.5-1,1-1.5,1-5,1.5-2.2,1.5-3-4,1.5-3.2-6,1.5-6,1.6-2.2,10-40,2-3,2-6,2-lobed,3.5-4,4-5,6-9,7-10-25,age,anther,anthesi,apart,apparently,appearing,axil,bark,base,berry,branch,broadly,brown,c.,calyx,clavate,cm,conical,corolla,dark,deltate,dry,elliptic,erect,filament,flattened,flower,fork,fusiform,glabrous,globose,green,growth,hairy,inflorescence,leaf-opposed,lengthening,less,lobe,lobed,maturity,minutely,mm,nodding,occasionally,ovary,ovoid,papillate,paulo,pedicel,petiole,pitted,pointed,population,pore,poricidal,reddish,reniform,scar,shiny,shrub,simple,slender,slit,small,sometimes,sparse,specimen,stem,stigma,strongly,structurally,style,surface,sÃ£o,tip,tree,trichome,tube,uniseriate,usually,way,white,woody,x	.5,0.1,06a,1,1.5-2,2.1-2.6,2.5-3,3-4,3.5-5,9-13,abaxially,absent,acuminate,adaxially,along,apex,attenuate,branched,branching,caly,completely,cucullate,dense,densely,diameter,difoliate,drying,eaf,eed,entire,et,exerted,fide,free,fruiting,geminat,glabrou,hollow,hooked,irregularly,junction,kallunki,lamina,lower,margin,markedly,midrib,new,nflorescence,pair,pale,papillat,peduncle,penden,perfect,planar,plane,portion,primary,pulp,rachi,rarely,red-papillat,ruit,shattering,spaced,sparsely,sticky,stout,straight,sweet-scented,swollen,thickened,time,tuft,ud,unit,vein,yellow,yellowish,ympodial	abaxial,adaxial,arrangement,bud,coat,colour,connation,embryo,feature,form,fruit,greyish,hair,height,history,leaf,length,life,midpoint,na,number,papilla,pendent,plant,prickle,ray,reproduction,seed,shape,size,spacing,texture,tuberculation,type,width,winging	.25,0.5-1,1-1.5,1-5,1.5-2.2,1.5-3-4,1.5-3.2-6,1.5-6,1.6-2.2,10-40,2-3,2-6,2-lobed,3.5-4,4-5,6-9,7-10-25,age,anthesi,apart,apparently,appearing,axil,base,berry,branch,broadly,brown,c.,clavate,cm,conical,dark,deltate,elliptic,erect,flattened,fork,fusiform,glabrous,globose,green,hairy,leaf-opposed,lengthening,less,lobed,maturity,minutely,mm,nodding,occasionally,ovoid,papillate,paulo,pitted,pointed,population,poricidal,reddish,reniform,shiny,shrub,simple,slender,slit,small,sometimes,sparse,strongly,structurally,sÃ£o,tip,tree,trichome,uniseriate,usually,way,white,woody,x	greyish,na,pendent
183	wfo-0001027889	success	151	129	90	102	49	27	87	3	-pubescent,.5,.5-2,0.5-1,0.5-11,0.7-2,1,1-10,1-3,1-3.5,1.5,10-12,10-20,10-30,2-20,2-3,3-4,3-8,3-9,5-10,abaxially,acuminate,acute,acute-acuminate,apart,apex,apiculate,basal,base,calyx,chartaceous,cm,connective,connivent,cylindrical,darker,deltate,densely,dilated,directed,distally,eglandular-puberulent,eglandular-pubescent,entire,equal,exceeding,finely,flower,fruit,glabrous,glandular-,green,greenish,immature,introrse,laterally,length,light,lobe,long,longitudinal,margin,mm,moderately,oblong,ovate,ovoid,pedicel,peduncle,petiole,pore,probably,puberulent,puberulent-pubescent,rachi,remnant,ripe,shrub,simple,slightly,somewhat,sparsely,stellate,stigma,stripe,style,subcordate,subcoriaceous,thecae,time,tip,tree,triangular,truncate,tube,unbranched,unknown,violet,white,wide,x,yellowish	-2.5,0,1.5-2,4-foliat,adaxially,aggregate,ape,articulated,axe,beyond,blade,capitat,cell,color,diameter,eaf,eed,elliptic,exserted,extending,leaving,lon,lower,narrow,nflorescence,nther,orolla,pedicellar,perfect,presen,present,puberulen,puberulent-pubescen,radiu,ruit,small,spaced,stamen,stone,swelling,tal,tem,tomento,tomentose,ud,unit,vary,yello,ympodial	1-2.5,abaxial,adaxial,anther,arrangement,bud,capitate,colour,corolla,feature,form,growth,height,inflorescence,leaf,number,ovary,plant,seed,shape,size,spacing,stem,surface,texture,width,yellow	-pubescent,.5,.5-2,0.5-1,0.5-11,0.7-2,1,1-10,1-3,1-3.5,1.5,10-12,10-20,10-30,2-20,2-3,3-4,3-8,3-9,5-10,abaxially,acuminate,acute,acute-acuminate,apart,apex,apiculate,basal,base,chartaceous,cm,connivent,cylindrical,darker,deltate,densely,dilated,directed,distally,eglandular-puberulent,eglandular-pubescent,entire,equal,exceeding,finely,glabrous,glandular-,green,greenish,immature,introrse,laterally,light,lobe,long,longitudinal,mm,moderately,oblong,ovate,ovoid,probably,puberulent,puberulent-pubescent,ripe,shrub,simple,slightly,somewhat,sparsely,stellate,stripe,subcordate,subcoriaceous,thecae,time,tip,tree,triangular,truncate,unbranched,unknown,violet,white,wide,x,yellowish	1-2.5,capitate,yellow
184	wfo-0001027901	success	156	112	56	78	78	34	52	4	.5,0.3-1.2,0.8-1,0.8-2,0.9-2.3,1-1.5,1-2,1-2.5,1.8-4.5,3-5,4-5,4.7-12,acuminate,acute,anther,anthesi,apex,area,attenuate,bark,base,berry,broadened,brown,calyx,closely,cm,conical,corolla,dark,dry,elliptic,filament,glabrous,globose,inflorescence,leaf,lobe,lobed,minor,minutely,mm,opposite,orbicular,ovary,ovoid-reniform,papillose,pedicel,petiole,pitted,pore,poricidal,pubescent,reddish,rounded,scar,shape,shaped,shrub,simple,size,slender,spaced,stem,stigma,style,surface,tear-drop,tip,translucent,triangular,trichome,tube,white,woody,x,yellow,young	.25,0.5-1,1.5-1.8,2.5-3,4-10-flowered,6-7,?,abaxial,abaxially,adaxially,ba,beneath,bright,brow,curled,deflexed,densely,dia,differing,difoliate,direction,drying,eaf,edicel,eed,ellipsoid,exserted,firm,fleshy,free,fresh,fruiting,geminat,green,imbedded,immature,keeled,later,lateral,like,lon,long,lower,main,major,material,matrix,middle,midrib,nearly,nflorescence,older,oriented,overlappin,pair,papillo,planar,portion,prominently,reflexed,rest,ripe,ruit,shiny,single,sparsely,straight,strongly,swollen,tall,tub,ud,uniseriate,unit,usually,vein,widest,ympodial	0.25,1,4-10,arrangement,bud,coat,colour,connation,embryo,feature,flower,form,fruit,growth,height,history,length,life,midpoint,na,new,number,papilla,plant,prickle,ray,reproduction,seed,spacing,specimen,texture,tuberculation,type,width	.5,0.3-1.2,0.8-1,0.8-2,0.9-2.3,1-1.5,1-2,1-2.5,1.8-4.5,3-5,4-5,4.7-12,acuminate,acute,area,attenuate,berry,broadened,brown,closely,cm,conical,dark,elliptic,glabrous,globose,leaf,lobed,minutely,mm,opposite,orbicular,ovoid-reniform,papillose,pitted,poricidal,pubescent,reddish,rounded,shaped,shrub,simple,slender,spaced,tear-drop,translucent,triangular,trichome,white,woody,x,yellow	0.25,1,4-10,na
185	wfo-0001027902	success	128	110	71	85	43	25	71	0	-2.5,0.5-1,1-1.5,1-2,1-6,10-20,15-30,2-12,2-15,2-8,2-9,20-50,3-4,3-5,4-25,4-5,5-20,6-37,7-9,abaxially,acuminate,acute,adaxially,angled,apart,apex,base,branched,calyx,chartaceous,cm,connivent,cordate,cylindrical,deeply,densely,diameter,directed,distally,eglandular,entire,flower,forked,fruit,glabrous,glandular,globose,hair,inflated,lobe,long,margin,mm,moderately,narrowly,nearly,pedicel,peduncle,petiole,pore,puberulent,pubescent,purplish,rachi,remnant,reticulate,shrub,simple,small,sparsely,stigma,style,time,tip,tree,triangular,truncate,tube,unbranched,unknown,usually,whitish,wide,x,yellow	1.5-3,10-15,2,2-3,3-foliat,8-13,absen,adaxiall,aggregate,articulated,axe,blade,cell,color,distall,eaf,eed,leaving,like,lon,lower,nflorescence,nther,obtuse,orolla,ovate,pedicellar,pubescen,purple,radiu,ripe,ruit,spaced,ste,stellate,stone,subcoriaceous,tal,tem,truncat,unit,vary,ympodial	abaxial,adaxial,anther,arrangement,colour,corolla,direction,feature,form,growth,height,inflorescence,leaf,length,number,ovary,plant,ratio,seed,shape,size,spacing,stem,surface,texture	-2.5,0.5-1,1-1.5,1-2,1-6,10-20,15-30,2-12,2-15,2-8,2-9,20-50,3-4,3-5,4-25,4-5,5-20,6-37,7-9,abaxially,acuminate,acute,adaxially,angled,apart,apex,branched,chartaceous,cm,connivent,cordate,cylindrical,deeply,densely,diameter,directed,distally,eglandular,entire,forked,glabrous,glandular,globose,hair,inflated,long,margin,mm,moderately,narrowly,nearly,puberulent,pubescent,purplish,reticulate,shrub,simple,small,sparsely,time,tip,tree,triangular,truncate,unbranched,unknown,usually,whitish,wide,x,yellow	
186	wfo-0001027929	success	193	129	72	84	109	45	68	4	1,1-4,1.0-1.3,10,2-3,20,3.5-5,35,4-30,5-lobed,6-15,acuminate,acute,apex,apical,apiculate,articulate,base,branched,calyx,caudate,cell,cm,coat,connate,cordate,corolla,covering,cuneate,cyme,deep,dehiscent,dichasial,dichasially,ebracteate,embryo,filament,flower,forked,glabrous,globose,green,hair-like,herbaceous,introrse,lanceolate,lateral,lobe,long,make,maturing,middle,mm,monochasial,mucilaginous,obliquely,oblong,odd-pinnate,often,ovoid,pedicel,perennial,plant,poricidally,puberulent,purple,rhizomatous,rotate,rounded,seed,shape,short,size,slit,specimen,stigma,style,symmetrically,testal,thick,tip,violet,violet-blue,wall	0.2-0.9,1-10,1-8,1.5-4,15,2,2.0-3.0,3-6-foliat,4-5,4-6,5-10,5-6,abaxially,acumen,adaxially,along,angular,apically,ba,basal,becoming,beyond,cente,center,clasping,color,dark,darker-violet-blue,decreasing,diameter,digestion,distal,eaf,eed,elliptic,emoval,enzyme,erect,exceeding,except,formed,generally,globo,green-white,hair,half,honeycomb,included,interjected,leaflet,light,living,lon,lower,mostly,narrowly,nearly,nflorescence,nther,occasional,orolla,ovate,pair,pattern,peduncle,pentagonal,perfect,petiolate,petiolulate,petiolule,purpl,radiating,rarely,reduced,reveal,rhizome,rotate-,ruit,semi-lunate,sessile,seudostipule,slightly,sometimes,somewhat,spot,stamen,star,ste,straight,subequal,tem,terete,terminal,tinged,trailing,typically,unbranched,unit,usually,vary,vein,visible,white,wid,wide,wider,without,yellow,ympodial	anther,anthesi,arrangement,bark,berry,bud,colour,connation,decurrency,dry,feature,form,fruit,growth,height,history,inflorescence,leaf,length,life,midpoint,minor,na,new,number,ovary,papilla,petiole,pore,prickle,ray,reproduction,rotate-pentagonal,scar,spacing,stem,surface,texture,tube,tuberculation,type,wet,width,winging,young	1,1-4,1.0-1.3,10,2-3,20,3.5-5,35,4-30,5-lobed,6-15,acuminate,acute,apical,apiculate,articulate,base,branched,caudate,cell,cm,connate,cordate,covering,cuneate,cyme,deep,dehiscent,dichasial,dichasially,ebracteate,forked,glabrous,globose,green,hair-like,herbaceous,introrse,lanceolate,lateral,long,make,maturing,middle,mm,monochasial,mucilaginous,obliquely,oblong,odd-pinnate,often,ovoid,perennial,poricidally,puberulent,purple,rhizomatous,rotate,rounded,seed,short,slit,symmetrically,testal,thick,violet,violet-blue,wall	berry,na,rotate-pentagonal,wet
187	wfo-0001027948	success	180	93	42	51	129	42	37	5	.5,0.5-2,1-2,1.5-4.5,10-14,5,7.5-10,anther,berry,calyx,campanulate,cm,corolla,edentate,ellipsoidal,elliptical,filament,glabrous,globose,herb,hollow,inconspicuous,leaf,length,light,lobe,longitudinal,longitudinally,mm,narrowly,ovate,petiole,pore,poricidal,pubescent,purple,reduced,ridged,seed,simple,slit,stem,stigma,style,sub-shrub,tip,triangular,tube,ventrifixed,violet,viscid-pubescent	0-,0.4,0.5-0.7,0.6,0.8-1.2-2.2,1-1.2,1.3-1.8,1.6,1/10,13-15,14,2-,2.2-3-8.2,2.5-3.2-5.2-6,3.5,3.7-4,5-,5-7-15-16,6-celled,7,8-celled,abaxially,abundant,accrescen,acuminate,adaxially,ag,aggregate,antrorse,ape,apex,articulate,attenuate,ature,basal,base,bicellular,branch,c.,cell,connectival,crushed,cuticle,dark,delicate,diamete,diameter,difoliate,directed,dorsally,eaf,erect,finely,flexuous,fragrance,free,fruiting,generally,glandular,head,herbaceous,hig,ill-smelling,inserted,lamina,long,long-stalked,longer,lower,many-,margin,midvein,narrow,near,non-glandular,occasionally,odorles,opening,orolla,ovoid,pair,papillate,patent,pericarp,portion,prolongation,pubescence,ree,ruit,saddle-shape,scarce,scarcely,secondary,seeded,seen,separated,serrulate,short-stalked,shorter,single-celled,sinus,slightly,small,smooth,solitary,spur-like,stalk,stone,straight,striat,striate,sub-opposite,tem,thecae,thickened,time,tooth,trichome,twice,unequal,unit,upward,vary,vein,verrucate,x,ympodial,Â¼,Â½	2.2-8.2,5-15,abaxial,adaxial,age,anthesi,arrangement,bud,coat,colour,connation,dry,embryo,feature,flower,form,fruit,growth,height,inflorescence,midpoint,na,new,number,ovary,papilla,pedicel,plant,prickle,ray,saddle-shaped,scar,shape,size,spacing,specimen,surface,texture,tuberculation,type,width,young	.5,0.5-2,1-2,1.5-4.5,10-14,5,7.5-10,berry,campanulate,cm,edentate,ellipsoidal,elliptical,glabrous,globose,herb,hollow,inconspicuous,light,longitudinal,longitudinally,mm,narrowly,ovate,poricidal,pubescent,purple,reduced,ridged,simple,slit,sub-shrub,tip,triangular,ventrifixed,violet,viscid-pubescent	2.2-8.2,5-15,age,na,saddle-shaped
188	wfo-0001027961	success	177	133	82	95	82	38	77	5	.5,0.25-0.5,0.5-1,0.9-1,1-1.5,1-3,1-4,1-5,1-9,10-50,2-2.5,2.5-9,3-3.5,5-8,8-10,?,acute,age,anther,anthesi,apex,asymmetric,base,berry,branched,broadly,c.,calyx,clavate,cm,conical,connivent,cordate,corolla,curling,deltate,densely,diameter,ellipsoid,elliptic,fading,filament,flower,fusiform,glabrous,globose,green,growth,immature,inflorescence,lateral,lengthening,lobe,lobed,long,loosely,many,minute,minutely,mm,new,occasionally,often,pedicel,perfect,petiole,pinnatifid,plurifoliate,pore,poricidal,pubescent,purple,rotate-stellate,scar,simple,slender,slightly,slit,stem,stigma,style,surface,terminal,time,tip,trichome,truncate,tube,twining,uniseriate,vine,violet,way,white,woody	0.25,1,2.3-2.5,4.5-5,5-merou,6-9,7-9,<,abaxially,adaxiall,adaxially,always,alyx,apar,ark,articulated,axil,brow,clear,distributed,eaf,early,eed,entire,equalling,exserted,free,fruiting,geminat,ilament,irregularly,lamina,lon,lower,margin,mature,maturity,membranous,midrib,nflorescence,obovate,observed,older,one,orolla,other,pair,papillo,peduncle,pendan,pericarp,pinched,planar,portion,present,primary,probably,pubescen,reddish,ruit,shiny,sleeve,small,spaced,sparsely,spreading,tem,thin,transition,triangular,tuft,twinin,ud,unequal,unit,upper,vary,vein,white-pubescent,x,yellow,ympodial	apart,arrangement,bud,coat,colour,connation,decurrency,dry,feature,form,fruit,geminate,height,leaf,length,midpoint,minor,na,number,ovary,papilla,papillose,pendant,plant,prickle,ray,reproduction,seed,shape,size,spacing,specimen,texture,tuberculation,type,width,winging,young	.5,0.25-0.5,0.5-1,0.9-1,1-1.5,1-3,1-4,1-5,1-9,10-50,2-2.5,2.5-9,3-3.5,5-8,8-10,?,acute,age,apex,asymmetric,base,berry,branched,broadly,c.,clavate,cm,conical,connivent,cordate,curling,deltate,densely,diameter,ellipsoid,elliptic,fading,fusiform,glabrous,globose,green,immature,lateral,lengthening,lobe,lobed,long,loosely,many,minute,minutely,mm,occasionally,often,perfect,pinnatifid,plurifoliate,poricidal,pubescent,purple,rotate-stellate,simple,slender,slightly,slit,terminal,time,tip,trichome,truncate,twining,uniseriate,vine,violet,way,white,woody	apart,geminate,na,papillose,pendant
189	wfo-0001027966	success	207	121	69	83	124	38	65	4	1-1.8,1-10,1-2,1-4.2,1.3-2.2,10-30,2.5-10.5,3-5,3-7,40-80,5-10,5-6,5-9.5,5.5-14,acuminate,anther,apart,apex,attenuate,axillary,base,berry,blue-violet,bud,cell,chartaceous,cm,conical,connivent,corolla,covering,densely,diameter,elliptic,filament,flower,forked,fruit,glabrous,green,hair,hair-like,herb,lanceolate,lateral,leaf,lengthening,light,lobe,long,medium,membranous,mm,mottled,odd-pinnate,ovate,ovoid,pedicel,pentagonal,petiole,plant,pore,poricidal,pubescent,purple,ripe,rotate,seed,sessile,shorter,size,slightly,slit,stem,stigma,subsessile,subtending,terminal,testal,thick,tip,tube,wall	0.4-0.5,0.7-3,0.8,0.8-2.5,1-3,1-5,1.2-4.5,1.5-3,1.5-5.2,10,2.2-2.9,2.8-9,3-4,4,5-merou,6-11,abaxially,absent,acumen,adaxially,ag,along,alyx,apparently,arranged,articulated,asymmetrical,axe,basiscopic,bead,blade,brownish,capitat,ciliate,commonly,condition,decreasing,digestion,distal,dorsally,drying,eaf,edge,eed,enzyme,erec,especially,exceeding,flat,folded,fresh,geminat,generally,glabrou,gradually,green-white,greenish,half,homostylous,honeycomb-shaped,interjected,larger,leaflet,less,like,living,lower,make,margin,middle,minute,moniliform,mucilaginous,multiple,narrow,necklace,nflorescence,orbicular,orolla,pair,pale,peduncle,perfect,petiolule,plurifoliate,proximal,rarely,ray,removed,ruit,secondary,semierect,seudostipule,side,somewhat,spaced,sparsely,specimen,stamen,ste,stolon,straight,subequal,symmetrical,tall,tamen,tem,throughout,tissue,tri-,tuber,tyle,typically,unit,usually,violet,wet,white,whitish,wide,wing,x,yellow,ympodial	abaxial,adaxial,age,arrangement,calyx,capitate,coat,colour,connation,embryo,feature,form,geminate,growth,height,history,inflorescence,length,life,minor,na,new,number,ovary,papilla,prickle,reproduction,scar,shape,spacing,style,surface,texture,tuberculation,type,width,winging,young	1-1.8,1-10,1-2,1-4.2,1.3-2.2,10-30,2.5-10.5,3-5,3-7,40-80,5-10,5-6,5-9.5,5.5-14,acuminate,apart,attenuate,axillary,berry,blue-violet,bud,cell,chartaceous,cm,conical,connivent,covering,densely,elliptic,forked,glabrous,green,hair,hair-like,herb,lanceolate,lateral,lengthening,light,long,medium,membranous,mm,mottled,odd-pinnate,ovate,ovoid,pentagonal,poricidal,pubescent,purple,ripe,rotate,sessile,shorter,slightly,slit,stem,subsessile,subtending,terminal,testal,thick,tip,wall	age,capitate,geminate,na
190	wfo-0001028014	success	218	139	82	98	120	41	77	5	-4,-6,.5,/5,0.1-0.2,0.2-1,0.2-1.6-2.5,0.5-1,0.5-1.5,0.5-3,0.6-0.9,0.7-1,0.9-1.2,1-10,1-3,1-4,1.5-2,1.8-3,2-6.5,2.5-4,3-10,anther,apart,apex,apically,articulated,bark,base,berry,brown,calyx,cell,cm,connivent,cordate,curved,decurrent,deltate,densely,erect,filament,flattened,flattened-reniform,flower,fruit,glabrous,gray,lateral,leaf,length,lobe,lobed,long,maturity,mauve,midpoint,mm,obtuse,occasionally,orange,outline,ovate,pale,pedicel,petiole,pit,poricidal,prickle,prickly,purple,raised,ray,red,reflexed,rough,rounded,scar,seed,shiny,shrub,simple,spherical,spreading,stellate-pubescent,stem,straight,strongly,style,surface,tapering,terminal,tip,tube,visibly,way,wide,winged,yellow	-15,0-10,0-3,0-5,0-6,0.15,0.15-0.3-0.5,0.2,0.2-0.4,0.2-0.4-1,0.25,0.3-0.4,0.5,0.5-2,0.7-1.6,1-2,1-2-20,1.3-2.4,1.5,1/4,1/4-1/2,1/4-2/3,2-3,2-4.5,4-10,4.5-7,5-merous,6-10,6-11,abaxially,acuminat,almost,alyx,ame,apar,apparently,around,black,blade,branched,broad-deltate,brown-green,c.,chartaceous,concolorous,diameter,difoliate,discolorous,distance,drying,eaf,edge,eed,elongating,equal,extending,eye,free,fruiting,geminat,glabrescent,glabrou,gland,globular,gray-green,herbaceous,infructescence,lon,longer,lower,margin,mature,membranous,midvein,moderately,naked,nflorescence,older,one,open,orange-gra,orolla,oung,outer,pair,peduncle,pendulous,per,perfec,pericarp,porrect,portion,prickl,primary,reduced,ruit,scandent,sessile,shorter,side,slender,smooth,sometimes,spaced,stalk,stalked,stellate,tamen,terete,tertiary,time,trichome,unit,vary,vein,venation,visible,weakly,yellow-green,ympodial	2-20,acuminate,anthesi,arrangement,bud,coat,colour,connation,corolla,decurrency,dry,embryo,feature,form,growth,height,history,inflorescence,life,minor,new,number,orange-gray,ovary,papilla,perennial,plant,pore,reproduction,shape,size,spacing,specimen,stigma,texture,tuberculation,type,unknown,width,winging,young	-4,-6,.5,/5,0.1-0.2,0.2-1,0.2-1.6-2.5,0.5-1,0.5-1.5,0.5-3,0.6-0.9,0.7-1,0.9-1.2,1-10,1-3,1-4,1.5-2,1.8-3,2-6.5,2.5-4,3-10,apart,apically,articulated,base,berry,brown,cell,cm,connivent,cordate,curved,decurrent,deltate,densely,erect,flattened,flattened-reniform,glabrous,gray,lateral,lobed,long,maturity,mauve,mm,obtuse,occasionally,orange,outline,ovate,pale,pit,poricidal,prickly,purple,raised,red,reflexed,rough,rounded,shiny,shrub,simple,spherical,spreading,stellate-pubescent,straight,strongly,tapering,terminal,tip,visibly,way,wide,winged,yellow	2-20,acuminate,orange-gray,perennial,unknown
191	wfo-0001028017	success	158	116	67	73	85	43	62	5	1-3,10-22,13-40,15-35,2-3,2-4,2.5-5,3,3-12,3-14,3-4,5-9,6-8,acute,apart,apex,apiculate,base,brown,calyx,clavate,cm,connivent,cuneate,densely,directed,distally,eglandular,eglandular-puberulent,ellipsoidal,flattened,flower,forked,fruit,fusiform,glabrous,glandular,glandular-,green,greenish,hair,immature,introrse,lanceolate,lobe,mm,moderately,narrowly,oblique,obtuse,ovoid,pedicel,petiole,pore,pubescent,rarely,ripe,short-acuminate,simple,sometimes,stellate,stellate-campanulate,stigma,style,tip,tree,triangular,truncate,tube,unbranched,white,x,yellow	-2.5,0.3-1,1,1-10,1-2,1.5-2,15-50-flower,2,3-foliat,40-50,5,5-7,6-7,9-11,abaxially,absen,absent,acuminate,adaxially,aggregate,ape,articulated,axe,basal,beyond,blade,cell,chartaceous,ciliat,connective,cream,cylindrical,diameter,eaf,eed,eglandular-pubescent,elliptic,entire,exceeding,exserted,fleshy,glandular-puberulent,leaving,lon,long,lower,margin,near,nflorescence,nther,orolla,ovate,pedicellar,peduncle,perfect,pointed,puberulen,purple,purplish,rachi,radiu,remnant,ruit,shorter,slightly,small,spaced,sparsely,stamen,stone,subcoriaceous,tal,tan,tem,thecae,time,tomentose,truncat,ud,unit,vary,vein,wide,without,ympodial	15-50,anther,arrangement,bud,colour,connation,corolla,decurrency,embryo,feature,filament,form,growth,height,hermaphroditic,history,inflorescence,leaf,length,life,midpoint,na,number,ovary,papilla,perennial,plant,prickle,puberulent,ray,reproduction,scar,seed,shape,size,spacing,stem,surface,texture,type,width,winging,young	1-3,10-22,13-40,15-35,2-3,2-4,2.5-5,3,3-12,3-14,3-4,5-9,6-8,acute,apart,apex,apiculate,brown,clavate,cm,connivent,cuneate,densely,directed,distally,eglandular,eglandular-puberulent,ellipsoidal,flattened,forked,fusiform,glabrous,glandular,glandular-,green,greenish,hair,immature,introrse,lanceolate,mm,moderately,narrowly,oblique,obtuse,ovoid,pubescent,rarely,ripe,short-acuminate,simple,sometimes,stellate,stellate-campanulate,tip,tree,triangular,truncate,unbranched,white,x,yellow	15-50,hermaphroditic,na,perennial,puberulent
192	wfo-0001028033	success	157	92	51	69	88	23	50	1	1â4,1â5,2â3,3â11,4â12,4â5,50,6â12,acuminate,acute,anther,apex,attenuate,base,brochidodromous,brown,calyx,cm,cyme,decurrent,deeply,densely,elliptic,emarginate,filament,flower,fruit,glabrous,greenish,growth,herb,hispid-pubescent,introrsely,lateral,length,like,lobe,lobed,membranaceous,mm,new,oblong,ovate-lanceolate,pedicel,petiole,pore,poricidal,pubescence,rhizomatous,sessile,shiny,shrub,simple,slightly,solitary,spreading,stellate,stem,stigma,style,surface,trichome,tube,unbranched,uniseriate,unknown,upright,venation,white	.6,1.4â1.8,1.5,2â4,2âfoliate,3,3â4,3â5,5-merou,5â7,abaxially,adaxiall,adaxially,along,alyx,anthesi,ark,ascending,becoming,blade,branch,capitat,cell,chartaceous,ciliate,connivent,contiguou,cordate,cylindrical,darker,denser,diameter,directed,discolorous,drying,eaf,eed,entire,equal,eye,few-branched,florescence,geminat,glabrescent,green,high,know,known,light,linear-lanceolate,long,longitudinal,lower,mainly,margin,midrib,naked,nearly,older,onto,opening,order,orolla,perfect,prominent,prostrat,pubescent,recurved,ruit,secondary,shin,shorter,slit,sparsely,straight,strongly,subapical,tamen,tem,unit,vary,vein,visible,wide,woody,yellow,ympodial,Ã	arrangement,capitate,colour,corolla,feature,form,height,history,inflorescence,leaf,life,number,ovary,plant,reproduction,seed,shape,size,texture,tip,type,width,young	1â4,1â5,2â3,3â11,4â12,4â5,50,6â12,acuminate,acute,attenuate,brochidodromous,brown,cm,cyme,decurrent,deeply,densely,elliptic,emarginate,glabrous,greenish,herb,hispid-pubescent,introrsely,lateral,like,lobed,membranaceous,mm,oblong,ovate-lanceolate,poricidal,pubescence,rhizomatous,sessile,shiny,shrub,simple,slightly,solitary,spreading,stellate,stem,trichome,unbranched,uniseriate,unknown,upright,white	capitate
193	wfo-0001028067	success	138	110	52	64	74	46	50	2	0.5-1.5,0.5-2,1-10-30,1-7,10-25,2,2-3,2.5-3,3-17,3-4,3-5,6-12,6-18,7-11-compound,7-20,7-9,acuminate,acute,apart,apex,base,calyx,cm,connivent,cuneate,dark,directed,elliptic-fusiform,flattened,flower,fruit,glabrous,hair,leaf,lobe,mm,moderately,narrowly,nearly,pedicel,petiole,pink,pinnately,pore,puberulent,purple,rarely,shrub,simple,sparsely,stellate,stigma,strongly,style,tip,tomentulose,triangular,triangular-deltate,truncate,tube,unbranched,usually,x,yellow	0.5-1,1,1-11,1-2,1-3,1.5-2.5,2-2.5,3-7,4-foliat,5-7,8-13,abaxially,adaxiall,adaxially,aggregate,along,articulated,axe,basiscopically,blade,cell,chartaceous,color,compound,cylindrical,decurrent,diameter,distall,eaf,eed,elliptic-ovate,entire,especially,glabrou,lateral,leaflet,leaving,lon,long,lower,margin,midrib,nflorescence,nther,obtuse,often,orolla,pedicellar,peduncle,per,puberulen,rachi,radiu,remnant,ripe,ruit,several,slightly,smal,spaced,stone,subcoriaceous,tal,tem,time,truncat,unequal,unit,unknown,upper,vary,wide,ympodial,zigzag	anther,anthesi,arrangement,bud,coat,colour,connation,corolla,decurrency,distally,dry,embryo,feature,filament,form,growth,height,history,inflorescence,length,life,midpoint,minor,na,new,number,ovary,papilla,plant,prickle,ray,reproduction,scar,seed,shape,size,spacing,specimen,stem,surface,texture,tuberculation,type,width,winging,young	0.5-1.5,0.5-2,1-10-30,1-7,10-25,2,2-3,2.5-3,3-17,3-4,3-5,6-12,6-18,7-11-compound,7-20,7-9,acuminate,acute,apart,cm,connivent,cuneate,dark,directed,elliptic-fusiform,flattened,glabrous,hair,mm,moderately,narrowly,nearly,pink,pinnately,puberulent,purple,rarely,shrub,simple,sparsely,stellate,strongly,tomentulose,triangular,triangular-deltate,truncate,unbranched,usually,x,yellow	distally,na
194	wfo-0001028069	success	249	124	66	84	165	40	63	3	0.1-0.3,0.1-0.5,0.3-0.45,0.3-0.7,0.4-0.8,0.5-0.7,0.5-1.8,0.6-1.1,1-2.7,1.5-2.0,10,12,2-17,2-3-branched,2-locular,3,5-25,acute,anther,anthesi,apex,articulated,axi,base,basioscopically,bilaterally,calyx,cm,conical,cordate,corolla,cuneate,curving,decurrent,deep,densely,filament,flower,fruit,glandular-villous,globose,green,hair-like,herb,imparipinnate,interrupted,leaf,length,linear,lobe,long,minute,minutely,mm,oblique,obovate,occasionally,orange,outgrowth,ovary,ovate,pale,pedicel,pentagonal,perennial,petiole,plant,pubescent,rounded,several,simple,size,somewhat,stem,stigma,straight,style,surface,symmetric,toward,trichome,tube,uniseriate,yellow	.1,.1-0.2,.2,.5,0.05-0.1,0.1-0.15,0.1-0.2,0.1-0.2-0.4,0.1-0.6,0.2-0.3,0.2-0.5,0.3,0.3-0.4,0.3-0.6,0.3-1,0.4,0.4-0.5,0.4-1,0.5,0.5-2,0.6-4,0.7-1,0.7-1.3,0.7-1.5,0.8-1.2,1-2-celled,1-3.5,1-4.5,1.4,1.5-3.5-6,1.6-3.2,10-12,2-4,2-7,3-5-22-30,3-foliate,4-celled,6-10-30,<,abaxially,absen,abundant,accrescent,adjacent,adpressed,along,alternate,always,among,apical,appearance,appendage,appressed,ba,basal,becoming,berry,bract,bracteole-like,bright,brown,cell,citru,column,composed,cone-shaped,deeply,dense,diameter,due,eaf,ebracteate,edicel,eed,eglandular,erect,exserted,forming,fruiting,fusion,giving,glabrescent,gland,gland-tippe,gland-tipped,glandular,gree,half,halfway,head,included,initially,interjected,internode,larger,later,lateral,leaflet,less,like,lime,lobed,lon,longer,longest,lower,margin,maturity,middl,midvein,multicellular,narrowly,nflorescence,often,one,pair,patent,peduncle,per,petiolule,population,present,primary,procumbent,pseudostipule,pubescence,quaternary,rarely,reflexed,robust,ruit,scarcely,scent,secondary,sessile,shaggy,short,shorter,silky,single-celled,slender,smaller,staminal,sterile,strong,subopposite,tangled,tem,terminal,tertiary,testa,thick,tightly,transparent,ud,unicellular,unit,usually,varying,viny,wall,weak,wide,winged,ympodial	0.2-0.6,arrangement,bark,bud,coat,colour,connation,decurrency,dry,embryo,feature,form,growth,height,history,inflorescence,life,middle,midpoint,minor,na,new,number,papilla,pore,prickle,ray,reproduction,scar,seed,shape,spacing,specimen,texture,tip,tuberculation,type,width,winging,young	0.1-0.3,0.1-0.5,0.3-0.45,0.3-0.7,0.4-0.8,0.5-0.7,0.5-1.8,0.6-1.1,1-2.7,1.5-2.0,10,12,2-17,2-3-branched,2-locular,3,5-25,acute,articulated,axi,basioscopically,bilaterally,cm,conical,cordate,cuneate,curving,decurrent,deep,densely,glandular-villous,globose,green,hair-like,herb,imparipinnate,interrupted,length,linear,long,minute,minutely,mm,oblique,obovate,occasionally,orange,outgrowth,ovate,pale,pentagonal,perennial,pubescent,rounded,several,simple,somewhat,straight,symmetric,toward,trichome,uniseriate,yellow	0.2-0.6,middle,na
195	wfo-0001028075	success	196	142	101	114	82	28	96	5	1-10,1-2,1-3,1.5-2.5,1.6-2.7,10-35,2-3,2-6,2.5-10,3-23.5,4-12,5-12,5-14,5-17,5-8,5-9,7-13,7-30,8-12,abaxially,acumen,adaxially,anther,apart,axillary,base,berry,blade,borne,broadly,brownish,bud,cell,chartaceous,ciliate,cm,condition,connivent,corolla,covering,dark,decreasing,diameter,distinctively,dot,drying,end,filament,flower,forked,fresh,fruit,glabrescent,glabrous,globose,green,green-white,greenish,hair-like,herb,homostylous,lanceolate,lateral,leaf,leaflet,light,ligulate,lobe,long,make,margin,membranous,mm,mucilaginous,narrow,obtuse,odd-pinnate,often,ovoid,pair,pale,pedicel,peduncle,pentagonal,petiolule,plant,poricidal,reflexed,rotate,rounded,scattered,seed,singly,size,stigma,style,subtending,terminal,testal,thick,throughout,tip,toward,tube,tuber,typically,wall,wet,white,whitish,wide,wing,x,yellow	.5,1-2.7,1.5-7,2-4.5,3-11,4-7,5-7,5-merou,absent,acuman,acuminate,acute,ag,along,alyx,apex,apparently,articulated,axe,capitat,cuneate,differentiated,digestion,distal,distally,dorsally,eaf,edge,eed,elliptic-lanceolate,enzyme,erec,especially,exceeding,flat,folded,geminat,generally,glabrescen,half,honeycomb-shaped,interjected,larger,lengthening,living,lower,middl,midrib,minutely,much,nflorescence,oblique,orolla,ovate,ovate-elliptic,perfect,petiole,plurifoliate,pore,puberulent,purple,removed,ruit,seudostipule,slightly,slit,sometimes,spaced,specimen,stamen,star,stolo,straight,subcordate,tall,tamen,tem,tri-,unit,usually,vary,ympodial	5-merous,arrangement,calyx,capitate,colour,feature,form,growth,height,history,inflorescence,length,life,na,number,ovary,perennial,presence,pseudostipule,reproduction,shape,spacing,staman,stem,stolon,surface,texture,type	1-10,1-2,1-3,1.5-2.5,1.6-2.7,10-35,2-3,2-6,2.5-10,3-23.5,4-12,5-12,5-14,5-17,5-8,5-9,7-13,7-30,8-12,abaxially,adaxially,apart,axillary,base,berry,blade,borne,broadly,brownish,bud,cell,chartaceous,ciliate,cm,condition,connivent,covering,dark,decreasing,distinctively,dot,drying,end,flower,forked,fresh,glabrescent,glabrous,globose,green,green-white,greenish,hair-like,herb,homostylous,lanceolate,lateral,leaf,light,ligulate,long,make,membranous,mm,mucilaginous,narrow,obtuse,odd-pinnate,often,ovoid,pale,pentagonal,poricidal,reflexed,rotate,rounded,scattered,seed,singly,size,subtending,terminal,testal,thick,throughout,tip,toward,typically,wall,wet,white,whitish,wide,wing,x,yellow	5-merous,capitate,na,perennial,stolon
196	wfo-0001028076	success	195	116	70	83	112	33	65	5	.5,0.5,1-1.3,1-10,1-2,1.8-2.2,12-22,13-14,2-12,2-5.4,2.2-2.6,2.5-4,4-5,5,5-20,5-6,5-6.5,7-8,anther,articulated,attenuate,axillary,berry,bud,chartaceous,cm,conical,connivent,corolla,densely,diameter,digestion,enzyme,filament,flower,forked,fruit,glabrous,green,hair,herb,honeycomb-shaped,lanceolate,lateral,leaf,less,light,like,lobe,long,medium,membranous,minute,mm,odd-pinnate,ovoid,pedicel,peduncle,pentagonal,petiole,plant,pore,poricidal,proximal,pubescent,purple,removed,ripe,rotate,seed,size,stem,stigma,straight,style,subtending,terminal,tip,tube,unwinged,wall,wide,wing	0.4-0.5,1-3,1.2-2.2,110,2-3,2.2-3.7,2.5-3,2.6-3.8,4.5-7,5-merou,?,abaxially,absent,acumen,acuminate,adaxially,ag,alyx,apart,apex,apparently,axe,base,blade,borne,brownish,capitat,cell,ciliate,condition,covering,decreasing,distal,dorsally,drying,eaf,edge,eed,elliptic,end,erec,especially,exceeding,flat,folded,fresh,geminat,generally,glabrou,gradually,green-white,greenish,hair-like,half,homostylous,interjected,larger,leaflet,lengthening,living,lower,make,margin,mucilaginous,nflorescence,obtuse,orolla,ovate,pair,perfect,petiolule,plurifoliate,pubescen,rarely,ray,round,ruit,secondary,semierect,sessile,seudostipule,singly,slightly,slit,spaced,specimen,stamen,ste,stolo,subequal,subsessile,symmetrical,tall,tamen,tem,testal,thick,thir,throughout,toward,tri-,tuber,typically,unit,usually,vary,wet,white,whitish,x,yellow,ympodial	abaxial,adaxial,arrangement,calyx,capitate,coat,colour,connation,feature,form,geminate,growth,height,history,inflorescence,length,life,na,number,ovary,papilla,perennial,pseudostipule,reproduction,shape,spacing,surface,texture,third,tuberculation,type,width,young	.5,0.5,1-1.3,1-10,1-2,1.8-2.2,12-22,13-14,2-12,2-5.4,2.2-2.6,2.5-4,4-5,5,5-20,5-6,5-6.5,7-8,articulated,attenuate,axillary,berry,bud,chartaceous,cm,conical,connivent,densely,digestion,enzyme,forked,glabrous,green,hair,herb,honeycomb-shaped,lanceolate,lateral,less,light,like,long,medium,membranous,minute,mm,odd-pinnate,ovoid,pentagonal,poricidal,proximal,pubescent,purple,removed,ripe,rotate,stem,straight,subtending,terminal,tip,unwinged,wall,wide,wing	capitate,geminate,na,perennial,third
197	wfo-0001028105	success	150	128	74	89	61	39	70	4	.1,.5,0.3-1.5,0.5-1,0.5-2,0.6-1,1-1.2,1-1.5,1-2.5,1.5-2,1.5-4.5,2,2-2.2,2-5,3-5-celled,3-6,9.5-15,acuminate,acute,anther,anthesi,apex,apical,attenuate,bark,base,berry,bilobed,calyx,clavate,cm,conical,corolla,deflexed,distinct,ellipsoid,elliptic,filament,filiform,flattened-reniform,glabrous,glandular,globose,green,incrassate,leaf,like,lobe,lobed,long,margin,minor,minutely,mm,nearly,opposite,ovary,pale,papillose,pedicel,petiole,pitted,pore,poricidal,projection,pubescent,quadrate,scar,shaped,shrub,simple,size,slightly,small,sparsely,stem,stigma,style,surface,tear-drop,tip,tree,trichome,tube,uniseriate,white,woody,x,young	.4,0.5,1.5,1.5-1.8,3.5-4,5-7-flowered,6-7,abaxially,adaxially,apar,axi,axil,ba,dark,dense,dia,differing,difoliate,drying,eaf,edicel,eed,erect,evenly,exserted,free,fruiting,geminat,greenish-yello,lamina,lateral,lon,lower,main,major,middle,nflorescence,occasionally,older,olive-green,pair,papillo,planar,portion,reddish-brown,reflexed,ruit,scattered,spaced,spreading,straight,strongly,tall,tub,tuft,ud,unit,vein,widest,yellowish,ympodial	5-7,apart,arrangement,bud,coat,colour,connation,decurrency,dry,embryo,feature,flower,form,fruit,greenish-yellow,growth,height,history,inflorescence,length,life,midpoint,na,new,number,papilla,plant,prickle,ray,reproduction,seed,shape,spacing,specimen,texture,tuberculation,type,width,winging	.1,.5,0.3-1.5,0.5-1,0.5-2,0.6-1,1-1.2,1-1.5,1-2.5,1.5-2,1.5-4.5,2,2-2.2,2-5,3-5-celled,3-6,9.5-15,acuminate,acute,apical,attenuate,base,berry,bilobed,clavate,cm,conical,deflexed,distinct,ellipsoid,elliptic,filiform,flattened-reniform,glabrous,glandular,globose,green,incrassate,leaf,like,lobed,long,margin,minutely,mm,nearly,opposite,pale,papillose,pitted,poricidal,projection,pubescent,quadrate,shaped,shrub,simple,slightly,small,sparsely,stem,tear-drop,tip,tree,trichome,uniseriate,white,woody,x,young	5-7,apart,greenish-yellow,na
198	wfo-0001028109	success	202	121	74	88	114	33	70	4	-7,0.4-0.8,0.4-1.5,0.45-0.65,0.6-0.8,1.5-10,1.5-2.5,1.5-5.5,12-40,2-4,2.3-2.9,2.5-5,2/3-3/4,30-150,5-13-20,acuminate,acute,almost,anther,apart,apex,apically,bark,base,berry,bright,calyx,cm,connivent,cuneate,deltate,densely,dull,elliptic,erect,evenly,filament,flattened-reniform,flower,fruit,glabrescent,glabrous,green,lateral,leaf,length,light,lobe,lobed,long,maturity,mauve,minor,mm,multangulate,obtuse,orange-brown,pedicel,petiole,poricidal,prickly,recurved,red,scar,shrub,simple,small,sometimes,spherical,stalked,stellate,stellate-pubescent,stem,style,surface,tapering,terete,terminal,tip,tree,trichome,tube,way,weakly,white,wide,yellow,young	.5,/3,0.05-0.15,0.05-0.2,0.1,0.1-0.2,0.3,0.5-1.2,0.5-2.5-4,0.7,0.8-1.5,0.8-1.6,1/8-1/4,10-25,10-30,15-100,2-15,2.5-3,20-60,3-4-13,3-7,3.5-6,3/4,4-5-merous,5-30,8-12,8-15,8-25,abaxial,abaxially,acut,adaxial,alyx,ame,apar,apparently,articulated,blade,branching,brow,c.,chartaceous,curved,diameter,dimorphic,discolorous,drying,eaf,eed,elongating,entire,equal,free,fruiting,fully,geminate,gently,glabrou,gray-green,green-brown,infructescence,long-styled,longer,lower,margin,mature,midpoint,moderately,nflorescence,occasionally,older,one,open,opening,orolla,oung,pair,peduncle,per,perfec,pericarp,perpendicular,plurifoliat,porrect,portion,prickl,prickle,primary,ray,red-brown,reflexed,ruit,secondary,sessile,slender,smooth,spaced,spreading,stalk,straight,strongly,tamen,tertiary,time,unarme,unarmed,unit,usually,vary,vein,venation,visible,woody,ympodial	3-13,arrangement,brown,bud,colour,connation,corolla,decurrency,feature,form,growth,height,history,inflorescence,life,na,new,number,ovary,papilla,plant,plurifoliate,pore,reproduction,seed,shape,size,spacing,stigma,texture,type,width,winging	-7,0.4-0.8,0.4-1.5,0.45-0.65,0.6-0.8,1.5-10,1.5-2.5,1.5-5.5,12-40,2-4,2.3-2.9,2.5-5,2/3-3/4,30-150,5-13-20,acuminate,acute,almost,apart,apically,base,berry,bright,cm,connivent,cuneate,deltate,densely,dull,elliptic,erect,evenly,flattened-reniform,glabrescent,glabrous,green,lateral,light,lobed,long,maturity,mauve,mm,multangulate,obtuse,orange-brown,poricidal,prickly,recurved,red,shrub,simple,small,sometimes,spherical,stalked,stellate,stellate-pubescent,tapering,terete,terminal,tip,tree,trichome,way,weakly,white,wide,yellow,young	3-13,brown,na,plurifoliate
199	wfo-0001028115	success	159	106	49	59	100	47	42	7	0.42,1-3,1.1-1.8,1.4-1.7,1.7-2.2,2-3.2,5-15,6-10,acute,annular,anther,apex,attenuate,base,berry,blue,calyx,campanulate,capitate,cm,coat,ellipsoidal,elliptical,embryo,filament,glabrescent,glabrous,globose,herb,length,light,linear,lobe,longitudinal,longitudinally,mm,moderately,narrowly,ovate,petiole,pore,poricidal,pubescent,ridged,seed,simple,slit,stem,stigma,style,tip,trans-ovoidal,triangular,tube,tuberculate,violet,width,winged,x	.2,.6,0.2-0.3,0.5,0.6-0.7,0.7-0.8-1.1,0.8-1-2.4,1.1-1.8-2.5,1.3-1.8,1.8-3.5,12-13.5,2-3-6.5,2.5-3-4.5-5.2,3-5,4.7-5-8.5,7-7.5,9-17,abaxially,abundant,accrescent,acuminat,adaxially,ag,alternate,amply,antrorse,articulate,basal,blade,connectival,curved,diameter,difoliat,dorsal,eaf,eed,entire,especially,evident,exceeding,fruiting,glandular,growing,half,herbaceous,hig,inflated,long,longer,lower,margin,mixed,much,multi-seeded,near,nerve,non-glandular,oblong,one,opening,opposite,orolla,pair,pale,papery-scarious,papillo,pinnatifid,pinnatipartite,pinnatisect,portion,prolongation,prostrate,rarely,ree,reticulate,ruit,scarce,segment,similar,slender,slightly,small,smooth,sometimes,strongly,styl,subsessil,tem,time,trichome,unequal,unifoliate,uniseriate,unit,vary,venation,wide,wider,yellow,ympodial	0.6,0.8-2.4,2-6.5,4.7-8.5,age,anthesi,arrangement,bud,colour,connation,corolla,decurrency,dry,feature,flower,form,fruit,growth,height,history,inflorescence,leaf,life,midpoint,minor,na,new,number,ovary,papilla,pedicel,perennial,plant,prickle,ray,reproduction,scar,shape,size,spacing,specimen,surface,texture,tuberculation,type,winging,young	0.42,1-3,1.1-1.8,1.4-1.7,1.7-2.2,2-3.2,5-15,6-10,acute,annular,attenuate,berry,blue,campanulate,capitate,cm,ellipsoidal,elliptical,glabrescent,glabrous,globose,herb,light,linear,longitudinal,longitudinally,mm,moderately,narrowly,ovate,poricidal,pubescent,ridged,simple,slit,tip,trans-ovoidal,triangular,tuberculate,violet,winged,x	0.6,0.8-2.4,2-6.5,4.7-8.5,age,na,perennial
200	wfo-0001028131	success	207	155	120	135	72	20	118	2	.5,/5,0-0.6-1.2,0-2,0-30,0.05-0.2,0.1-0.15,0.2-1.5,0.3-0.7,0.4-0.8,0.5-1.1,0.7-1.1,0.8-1,0.8-1.1,1-3,1-4,1-5,1.5-3,1.8-2,1.8-2.2,1/5,2-2.8,2-4,2-6.5,2/3,4-6,5-6.5,5-8,6-7,abaxial,absent,adaxial,anther,apart,apex,apically,apparently,articulated,attenuate,bark,base,berry,broad-deltate,calyx,cell,cm,connivent,cream,dark,deltate,densely,diameter,distance,dull,epidermi,erect,extending,flattened-reniform,flower,fruit,fruiting,glabrescent,glabrous,gland,green,herb,lanceolate,lateral,leaf,length,like,lobe,lobed,long,margin,marking,maturity,mauve,midpoint,midvein,mm,narrow-obovate,narrow-ovate,oblong,obtuse,often,orange,orange-brown,outline,pale,pale-brown,pedicel,per,petiole,pit,poricidal,porrect,prickle,prickly,purple,raised,ray,red,reduced,reflexed,rounded,scar,sessile,shiny,shorter,side,simple,small,smooth,sometimes,sparsely,spherical,spreading,stellate,stellate-pubescent,stem,strongly,style,sunk,surface,tapering,tip,trichome,tube,unarmed,upper,way,wide,yellow,young	.1,0-3,0-4,0.1-0.3,1-10,1.5-5,1/4-2/3,2-5,3-6,5-merous,7-8,abaxially,acuminat,alyx,apar,blade,branched,chartaceous,concolorous,curved,difoliate,drying,eaf,eed,elongating,equal,eye,filament,filiform,flattened,free,geminat,infructescence,lengt,longer,lower,mature,membranous,moderately,naked,nflorescence,older,one,open,orolla,oung,pair,pale-gra,peduncle,pendulous,perfec,pericarp,portion,prickl,primary,ruit,sessil,spaced,straight,tamen,terete,tertiary,time,unarme,unit,vary,vein,venation,visible,woody,yellow-green,ympodial	acuminate,arrangement,colour,corolla,feature,form,growth,height,inflorescence,number,ovary,pale-gray,plant,seed,shape,size,spacing,texture,type,width	.5,/5,0-0.6-1.2,0-2,0-30,0.05-0.2,0.1-0.15,0.2-1.5,0.3-0.7,0.4-0.8,0.5-1.1,0.7-1.1,0.8-1,0.8-1.1,1-3,1-4,1-5,1.5-3,1.8-2,1.8-2.2,1/5,2-2.8,2-4,2-6.5,2/3,4-6,5-6.5,5-8,6-7,absent,apart,apically,apparently,articulated,attenuate,base,berry,broad-deltate,cell,cm,connivent,cream,dark,deltate,densely,diameter,distance,dull,epidermi,erect,extending,flattened-reniform,glabrescent,glabrous,gland,green,herb,lanceolate,lateral,length,like,lobe,lobed,long,marking,maturity,mauve,midpoint,midvein,mm,narrow-obovate,narrow-ovate,oblong,obtuse,often,orange,orange-brown,outline,pale,pale-brown,per,pit,poricidal,porrect,prickle,prickly,purple,raised,ray,red,reduced,reflexed,rounded,sessile,shiny,shorter,side,simple,small,smooth,sometimes,sparsely,spherical,spreading,stellate,stellate-pubescent,stem,strongly,sunk,tapering,tip,trichome,unarmed,upper,way,wide,yellow,young	acuminate,pale-gray
201	wfo-0001028148	success	157	126	69	76	81	50	62	7	0.25-0.5,0.6-3.5,0.75-2,1-15,1.5,12-15,20-50,3.5-4,3.5-9,5-10,5-7,5-8,6-18,acute,angled,apart,apex,apiculate,base,blue-black,branched,broadly,calyx,cm,connivent,dark,decurrent,deltate,densely,directed,elliptic,flower,fruit,glaucous,globose,hair,less,light-colored,lobe,minute,mm,moderately,narrowly,often,ovate,pedicel,petiole,pink,plicate,pore,puberulent-pubescent,purple,rarely,ridge,ripe,rotate-stellate,scalloped,shrub,simple,slender,slightly,smooth,stigma,style,surface,tapered,tip,treelet,triangular,tube,unbranched,usually,violet,whitish,x,young	-6,.5-4,0.5-1.5,1-3.5,1.5-2.5,10-30,15,2,2-3,2-7,2.5-4,4-10,4.5-10,5,5-20,abaxially,absen,adaxially,aggregate,articulated,axe,ba,blade,cell,central,chartaceous,cylindrical,diameter,distal,distall,eaf,eed,entire,especially,except,fleshy,fresh,glabrous,highly,long,lower,many-foliat,margi,margin,material,mature,midrib,nflorescence,nther,obtuse,orange,orolla,part,peduncle,perfect,plicae,puberulence,puberulent,rachi,radiu,rhizomatous,ruit,smoot,sometimes,spaced,sparse,star,stone,succulent,tal,tem,thickened,time,truncat,unit,vary,white,wide,winge,yellow,ympodial	0.5-4,4-6,anther,anthesi,arrangement,bud,coat,colour,connation,corolla,decurrency,distally,dry,embryo,feature,filament,form,glaubrous,growth,height,history,inflorescence,leaf,length,life,midpoint,minor,na,new,number,ovary,papilla,plant,prickle,ray,reproduction,scar,seed,shape,size,spacing,specimen,stem,texture,truncate,tuberculation,type,width,winged,winging	0.25-0.5,0.6-3.5,0.75-2,1-15,1.5,12-15,20-50,3.5-4,3.5-9,5-10,5-7,5-8,6-18,acute,angled,apart,apex,apiculate,blue-black,branched,broadly,cm,connivent,dark,decurrent,deltate,densely,directed,elliptic,glaucous,globose,hair,less,light-colored,minute,mm,moderately,narrowly,often,ovate,pink,plicate,puberulent-pubescent,purple,rarely,ridge,ripe,rotate-stellate,scalloped,shrub,simple,slender,slightly,smooth,tapered,treelet,triangular,unbranched,usually,violet,whitish,x	0.5-4,4-6,distally,glaubrous,na,truncate,winged
202	wfo-0001028161	success	124	115	59	71	53	44	56	3	0.1-0.25,0.7-1.7,1-1.3,1-1.5,1-2,1-2.3,1.5-4.5,2-5-flowered,2-9,2.5-3,3-4,3-7,4-5,7.5-12,acuminate,acute,anthesi,apex,attenuate,bark,base,berry,branched,calyx,cell,closely,cm,corolla,deflexed,dendritic,densely,elliptic,globose,green,lanceolate,later,leaf,long,minor,minutely,mm,narrowly,obovoid,opposite,orbicular,outline,ovoid-reniform,pale,pedicel,petiole,pitted,pubescent,reddish-brown,rounded,scar,shape,shrub,simple,sinuate,size,somewhat,spaced,sparsely,stem,surface,tan,tapering,thin,trichome,x,young	.5,0.25-0.5,1/3,6-9,9-11,abaxially,adaxially,along,arising,ba,branch,brown,congested,consisting,denser,dia,differing,difoliate,distal,eaf,edicel,eed,exserted,fruiting,geminat,glabrescen,incrassate,inflorescenc,lateral,like,lon,main,major,margin,middle,nflorescence,often,older,overlappin,pair,probably,pubescence,rest,ruit,short,strongly,tall,tub,ud,unit,vein,widest,ympodial	anther,arrangement,bud,coat,colour,connation,dry,embryo,feature,filament,flower,form,fruit,glabrescent,growth,height,history,inflorescence,length,life,lobe,midpoint,na,new,number,ovary,overlapping,papilla,plant,pore,prickle,ray,reproduction,seed,spacing,specimen,stigma,style,texture,tip,tube,tuberculation,type,width	0.1-0.25,0.7-1.7,1-1.3,1-1.5,1-2,1-2.3,1.5-4.5,2-5-flowered,2-9,2.5-3,3-4,3-7,4-5,7.5-12,acuminate,acute,attenuate,berry,branched,cell,closely,cm,deflexed,dendritic,densely,elliptic,globose,green,lanceolate,later,leaf,long,minutely,mm,narrowly,obovoid,opposite,orbicular,outline,ovoid-reniform,pale,pitted,pubescent,reddish-brown,rounded,shrub,simple,sinuate,somewhat,spaced,sparsely,tan,tapering,thin,trichome,x	glabrescent,na,overlapping
203	wfo-0001028164	success	196	127	73	87	109	40	69	4	/4,0.4-0.8-1,0.5-0.8,0.5-1,0.7-1.1,1,1-1.5,1-4.5,1.5-2.5,1/3,2.5-4.5,2.8-4,3-7,3.6-4.8,8-15,8-17,acuminate,acute,anther,apex,apically,attenuate,base,berry,branched,bright,calyx,cm,connivent,deltate,densely,dull,elliptic,erect,evenly,filament,flattened-reniform,flower,fruit,glandular,gray,green,hair,lateral,leaf,length,less,lobe,lobed,long,maturity,mauve,midpoint,midvein,minute,mm,moderately,narrow-deltate,obtuse,orange-brown,pale,pedicel,petiole,poricidal,ray,recurved,red,scar,shrub,simple,sometimes,spherical,spreading,stellate-pubescent,stem,style,surface,tapering,terminal,tip,tube,upper,way,white,wide,yellow,young	-14,-8,0-20,0.05-0.2,0.05-1.5,0.1,0.3-0.8,0.8-1.5,0.9-1.6,1.8-2.5,1/6-1/4,12-20,2-2.5,2.5-4,2.5-4.5-6,3-17,4-13,4-5-merous,4-7,4-8,6-8,abaxial,abaxially,almost,alyx,ame,apar,apparently,articulated,bark,blade,c.,concolorous,curved,dark,diameter,difoliate,drying,eaf,eed,elongating,entire,equal,eye,filiform,free,fruiting,geminat,glabrescen,glabrescent,glabrou,glabrous,infructescence,long-acuminat,longer,lower,margin,mature,membranous,multangulate,naked,nflorescence,often,older,one,open,orolla,oung,pair,peduncle,per,perfec,pericarp,porrect,portion,primary,red-brown,reflexe,ruit,sessile,shallowly,shorte,shorter,side,smooth,spaced,sparsely,stalk,stalked,stellate,straight,tamen,terete,tertiary,time,trichome,unarme,unarmed,undulate,unit,variously,vary,vein,venation,visible,woody,yellow-gra,yellow-green,ympodial	anthesi,apart,arrangement,bud,coat,colour,connation,corolla,decurrency,dry,feature,form,growth,height,history,inflorescence,life,long-acuminate,minor,na,new,number,ovary,papilla,plant,pore,prickle,reproduction,seed,shape,size,spacing,specimen,stigma,texture,tuberculation,type,width,winging,yellow-gray	/4,0.4-0.8-1,0.5-0.8,0.5-1,0.7-1.1,1,1-1.5,1-4.5,1.5-2.5,1/3,2.5-4.5,2.8-4,3-7,3.6-4.8,8-15,8-17,acuminate,acute,apically,attenuate,base,berry,branched,bright,cm,connivent,deltate,densely,dull,elliptic,erect,evenly,flattened-reniform,glandular,gray,green,hair,lateral,less,lobed,long,maturity,mauve,midvein,minute,mm,moderately,narrow-deltate,obtuse,orange-brown,pale,poricidal,recurved,red,shrub,simple,sometimes,spherical,spreading,stellate-pubescent,tapering,terminal,tip,upper,way,white,wide,yellow,young	apart,long-acuminate,na,yellow-gray
204	wfo-0001028180	success	147	129	75	89	58	40	70	5	.05,.5,0.7-1,1-1.2,1-1.5,1-3,1.5-5,15-28,2-3,2.5-3,3-10,3-4,5-6,5-8,7,acute,anther,anthesi,apex,attenuate,bark,base,berry,calyx,capitate,closely,cm,conical,corolla,darker,deflexed,deltate,drying,elliptic,elongate,falcate,filament,fleshy,glabrous,globose,golden,green,irregularly,larger,leaf,lobe,lobed,long,minor,minutely,mm,nearly,onto,opposite,ovary,ovoid-reniform,papillose,pedicel,petiole,pinkish-white,pitted,pore,poricidal,puberulent,pubescent,scar,shaped,simple,size,small,somewhat,spaced,sparsely,stem,stigma,style,surface,tear-drop,tip,tree,trichome,tube,uniseriate,white,winged,woody,x,yellow-gray,young	/2,1-1.8,2-2.2,20-30-flowered,4.5-5,8-10,abaxially,adaxially,along,ba,beginning,c.,cucullate,dark,densely,dia,differing,difoliate,distinctly,eaf,eed,erect,four-angled,free,fruiting,geminat,glabrat,gold,know,lateral,leathery,lon,lower,main,major,margin,midrib,nflorescence,obscure,older,overlappin,pair,pale,planar,portion,ruit,shiny,straight,styl,tall,tan,thick,ud,underside,unit,vein,way,ympodial	20-30,arrangement,bud,coat,colour,connation,decurrency,dry,embryo,feature,flower,form,fruit,glabrate,growth,height,history,inflorescence,known,length,life,midpoint,na,new,number,overlapping,papilla,plant,prickle,ray,reproduction,seed,shape,spacing,specimen,texture,tuberculation,type,width,winging	.05,.5,0.7-1,1-1.2,1-1.5,1-3,1.5-5,15-28,2-3,2.5-3,3-10,3-4,5-6,5-8,7,acute,attenuate,base,berry,capitate,closely,cm,conical,darker,deflexed,deltate,drying,elliptic,elongate,falcate,fleshy,glabrous,globose,golden,green,irregularly,larger,leaf,lobed,long,minutely,mm,nearly,onto,opposite,ovoid-reniform,papillose,petiole,pinkish-white,pitted,poricidal,puberulent,pubescent,shaped,simple,small,somewhat,spaced,sparsely,style,tear-drop,tip,tree,trichome,uniseriate,white,winged,woody,x,yellow-gray	20-30,glabrate,known,na,overlapping
205	wfo-0001028182	success	150	111	56	74	76	37	52	4	0.1-0.2,0.5-0.6,0.5-1,0.9-1,1-1.5,2-2.5,2-6.5,3-5,6-9,anther,anthesi,apart,apex,apiculate,bark,base,calyx,capitate,ciliate,cm,conical,cordate,corolla,deltoid,dry,ellipsoid,filament,filiform,flower,glabrous,globose,hemiepiphyte,inflorescence,internodal,later,leaf,lobe,lobed,long,long-acuminate,minutely,mm,narrowly,nearly,obovoid,opposite,ovary,ovate,papillose,pedicel,petiole,pore,poricidal,pubescent,purplish,scar,shaped,shrub,simple,somewhat,sparsely,specimen,stem,stigma,style,surface,tear-drop,tip,trichome,truncate,tube,uniseriate,white,young	.5,0-90,0.5,0.8-1,2,3,4-6,5-15-flowered,5-ribbed,along,apiculae,arching,axi,bending,beneath,black,blade,branch,brown,deflexed,densely,dia,eaf,edicel,eed,evenly,except,extreme,free,gre,keeled,know,known,lateral,lax,less,like,lower,main,margin,material,midrib,minute,nflorescence,older,pair,papillo,planar,portion,present,prominent,proximal,reflexed,rib,rounded,ruit,sca,shiny,slender,slightly,spaced,sparser,spindly,still,strongly,tapering,third,time,ud,unifoliat,unit,vein,widest,x,ympodial,zig-zag	5-15,arrangement,bud,coat,colour,connation,decurrency,embryo,feature,form,fruit,grey,growth,height,history,length,life,midpoint,minor,na,new,number,papilla,plant,prickle,ray,reproduction,seed,shape,size,spacing,texture,tuberculation,type,unifoliate,width,winging	0.1-0.2,0.5-0.6,0.5-1,0.9-1,1-1.5,2-2.5,2-6.5,3-5,6-9,apart,apiculate,base,capitate,ciliate,cm,conical,cordate,deltoid,ellipsoid,filiform,glabrous,globose,hemiepiphyte,internodal,later,leaf,lobed,long,long-acuminate,minutely,mm,narrowly,nearly,obovoid,opposite,ovate,papillose,poricidal,pubescent,purplish,shaped,shrub,simple,somewhat,sparsely,tear-drop,tip,trichome,truncate,uniseriate,white,young	5-15,grey,na,unifoliate
206	wfo-0001028183	success	235	128	76	90	145	38	72	4	-10,0.5-2.5,0.7-1.2,0.7-2,1.2-1.4,1.3-1.4,1.3-1.7,1.6-2.3,1.7-2.7,11-30,2-4.2,2-5,2.6-4.4,4.5-9,5-8.5,5.2-6.2,50-400,7.5-23,along,anther,apart,apex,around,attenuate,axi,base,berry,blunt-tipped,bud,calyx,capitate,central,cm,corolla,cuneate,deltoid,dull,edge,elliptic,elongated,farinose,filament,flower,free,fruit,glabrescent,glabrous,globose,half,lanceolate,leaf,lobe,long-decurrent,mm,narrowly,nearly,oblong,obovoid,ovate-lanceolate,pedicel,petiole,pore,poricidal,porrect-stellate,pseudoterminal,pubescent,reticulate-punctate,ripe,scabrous,short-,shrub,simple,stellate,stem,stigma,style,sub-lenticular,subcampanulate,surface,tan,tip,tomentose,tree,tube,upper,white,x,yellowish,yellowish-tomentose,young	.5-3,0.1,0.1-0.2,0.1-0.4,0.1-0.9,0.2-0.3,0.2-0.4,0.2-0.5,0.5,0.6,0.8-1.4,0.8-3.1-5.3,1.1-1.8,1.4-2.8,1.5-3.4,1.9-3.7,1/3-1/2,10-15,2.2-5.7,2.5-4.1,2.8-4.2,3.2-4.6-6.4,3.5-6.6,5-8,6.6-20,8-9.1,9-13,abaxial,abaxially,accrescent,acute,adaxially,ag,alyx,anthesi,apparently,articulated,axillary,bark,blade,branch,branched,brown,cell,chartaceous,closely,cylindrical,dark,dendritic-multangulate,diameter,directed,distally,distantly,drying,eaf,earl,eed,entire,epidermal,especially,evident,except,exserted,few-rayed,fruiting,glabrescen,granular-punctate,group,hair,high,inserted,lackin,lateral,lengthening,lobed,lon,long,longitudinal,lower,m.,main,many,margin,midrib,multangulate,nflorescence,older,open,orangish-tan,orolla,overlapping,peduncle,perfec,plurifoliate,porrect-stellat,present,prominent,pubescence,purple,rachi,rarely,relatively,reportedly,ruit,runk,sessile,short,side,slit,small,somewhat,soon,spaced,sparingly,sparse,spherical,splitting,stage,stalk,stamen,stipitate-glandular,stout,streak,strongly,suture,tamen,terete,thick,thin,thin-textured,time,touching,translucent,ud,unarme,unit,usually,vary,vein,violet,way,whitish,wide,yellow,ympodial	3.2-6.4,arrangement,coat,colour,connation,decurrency,embryo,feature,form,growth,height,history,inflorescence,length,life,midpoint,minor,new,number,ovary,papilla,perennial,plant,prickle,ray,reproduction,scar,seed,shape,size,spacing,sparing,texture,tuberculation,type,unknown,width,winging	-10,0.5-2.5,0.7-1.2,0.7-2,1.2-1.4,1.3-1.4,1.3-1.7,1.6-2.3,1.7-2.7,11-30,2-4.2,2-5,2.6-4.4,4.5-9,5-8.5,5.2-6.2,50-400,7.5-23,along,apart,around,attenuate,axi,berry,blunt-tipped,capitate,central,cm,cuneate,deltoid,dull,edge,elliptic,elongated,farinose,flower,free,fruit,glabrescent,glabrous,globose,half,lanceolate,long-decurrent,mm,narrowly,nearly,oblong,obovoid,ovate-lanceolate,poricidal,porrect-stellate,pseudoterminal,pubescent,reticulate-punctate,ripe,scabrous,short-,shrub,simple,stellate,sub-lenticular,subcampanulate,tan,tip,tomentose,tree,upper,white,x,yellowish,yellowish-tomentose	3.2-6.4,perennial,sparing,unknown
207	wfo-0001028227	success	235	127	71	90	145	37	70	1	0-250,0.2-0.3,0.8-1.4,0.9-1.2,1-1.7,1-4.2-6.2,1.1-3.1,1.3-4,1.4,1.5-2.3,1.7-2.8,1.9-4.2,1/2,10-24,2-12,2.5-7.8,2.6-5.9,3.7-7,4-13,4.8-7.6,6-16,8.5-22,acuminate,acute,anther,anthesi,apart,apex,attenuate,base,berry,blunt-tipped,brownish,bud,calyx,cm,corolla,cuneate,decurrent,deltoid,dendritic-echinoid,echinoid,elliptic,elongate,filament,fleshy,flower,free,fruit,glabrescent,globose,granular-tomentose,leaf,less,lobe,long,mm,oblong,oblong-lanceolate,obtuse,orbicular,ovate-lanceolate,pale,pedicel,petiole,pore,poricidal,porrect-stellate,pseudoterminal,purple,reticulate-punctate,ripe,shrub,simple,stellate,stem,stigma,style,subcampanulate,sublenticular,surface,tip,tomentose,tree,tube,violet,x,yellow,yellowish,young	-2/3,.5-4,0.1,0.2,0.2-0.4,0.2-0.5,0.3,0.4,0.5,0.7-2.1,0.8,0.9,0.9-1.4,1,1-2.5,1.2-2,1.4-2.6,1.9,1.9-5.8,1/2-3/4,10,11-15,2-3.8,2.9-4.7,3-4.9,3.7-6.3,5-7.5,6.7-15,8.1-18,abaxial,abaxially,accrescent,adaxially,ag,age,along,alyx,apparently,appressed,around,articulated,axillary,bark,becoming,blade,blunt-tippe,branch,branched,brown,c.,closely,cylindrical,dark,diameter,directed,distally,drying,eaf,early,echinoi,edge,eed,ength,entire,exserted,farinose,fruiting,glabrous,gray,grayish,green,hair,high,inserted,lacking,lanceolate,lateral,lengthening,lobed,lon,longitudinal,lower,m.,main,many,margin,midrib,midvein,mostly,multangulate,nflorescence,obscured,occasionally,often,older,orangish-tan,orolla,ovate-orbicula,overlapping,peduncle,perfec,plurifoliate,present,prominent,pubescence,pubescent,quarter,rachi,relatively,rounded,ruit,runk,scabridulous,sessile,side,slightly,slit,somewhat,spaced,sparsely,stalk,stamen,stout,subspherical,sulcate,suture,tamen,thick,thicker,thin,time,tomentu,touching,ud,unarme,unit,upper,usually,vary,vein,velutinous,way,well,wide,ympodial	arrangement,coat,colour,connation,decurrency,dry,embryo,feature,form,growth,height,history,inflorescence,length,life,midpoint,minor,na,new,number,ovary,papilla,plant,prickle,ray,reproduction,scar,seed,shape,size,spacing,specimen,texture,tuberculation,type,width,winging	0-250,0.2-0.3,0.8-1.4,0.9-1.2,1-1.7,1-4.2-6.2,1.1-3.1,1.3-4,1.4,1.5-2.3,1.7-2.8,1.9-4.2,1/2,10-24,2-12,2.5-7.8,2.6-5.9,3.7-7,4-13,4.8-7.6,6-16,8.5-22,acuminate,acute,apart,attenuate,berry,blunt-tipped,brownish,cm,cuneate,decurrent,deltoid,dendritic-echinoid,echinoid,elliptic,elongate,fleshy,free,fruit,glabrescent,globose,granular-tomentose,less,long,mm,oblong,oblong-lanceolate,obtuse,orbicular,ovate-lanceolate,pale,poricidal,porrect-stellate,pseudoterminal,purple,reticulate-punctate,ripe,shrub,simple,stellate,subcampanulate,sublenticular,tip,tomentose,tree,violet,x,yellow,yellowish	na
208	wfo-0001028228	success	143	116	62	78	65	38	57	5	0.1-1.7,1-1.5,1.1-1.2,1.1-2.5,1.5-2,2,2-5,2-8,2.1-4.2,2.8-6.5,3/4,6-7,7.5-12.5,acute,age,anther,anthesi,apex,area,bark,base,berry,calyx,campanulate,closely,cm,corolla,deflexed,deltoid,dry,elliptic,erect,filament,glabrous,globose,green,greenish-yellow,leaf,lobe,lobed,minor,minute,minutely,mm,obovate,occasionally,opposite,ovary,overlapping,ovoid,ovoid-reniform,papillose,pedicel,petiole,pore,poricidal,reticulate,rounded,scar,shaped,shining,shrub,simple,small,spaced,stem,stigma,style,surface,tear-drop,tip,tree,tube,way,white,woody,x,young	.5,0.75,1.2-1.8,1.8-3.4,10-30-flowered,6-8,abruptly,ba,becoming,beginning,beneath,brown,caly,clavate,coriaceous,dark,dia,difoliate,distal,eaf,edicel,eed,exserted,fragrant,free,fruiting,geminat,impressed,inflorescenc,lateral,lon,long,lower,main,major,margin,material,middle,narrowing,nflorescence,older,pair,pale,planar,portion,prominent,ruit,shinin,slender,slightly,straight,styl,sweetly,tall,tapering,terminal,thick-margined,thickened,ud,unit,usually,vein,weight,widest,ympodial	0.5,1.5,10-30,alternate,arrangement,bud,coat,colour,connation,embryo,feature,flower,form,fruit,growth,height,history,inflorescence,length,life,midpoint,na,number,papilla,plant,prickle,ray,reproduction,seed,shape,size,spacing,specimen,texture,tuberculation,type,width,winging	0.1-1.7,1-1.5,1.1-1.2,1.1-2.5,1.5-2,2,2-5,2-8,2.1-4.2,2.8-6.5,3/4,6-7,7.5-12.5,acute,age,area,base,berry,campanulate,closely,cm,deflexed,deltoid,elliptic,erect,glabrous,globose,green,greenish-yellow,leaf,lobed,minute,minutely,mm,obovate,occasionally,opposite,overlapping,ovoid,ovoid-reniform,papillose,poricidal,reticulate,rounded,shaped,shining,shrub,simple,small,spaced,tear-drop,tree,way,white,woody,x,young	0.5,1.5,10-30,alternate,na
209	wfo-0001028263	success	156	93	52	66	90	27	48	4	0.25,1-3,1-4,11-13,11-23,14-44,2-3,2.6,3,3.4,3.5-4.2,4,4-5,5-7.5,6,8-14,9,abaxially,adaxially,branched,calyx,cm,conical,connate,corolla,cyme,darker,deep,diameter,dichasial,dichasially,ebracteate,filament,flower,forked,green,herbaceous,interjected,lateral,leaf,leaflet,light,long,medium,mm,monochasial,mucilaginous,odd-pinnate,ovoid,pair,pedicel,peduncle,perennial,petiole,plant,puberulent,pubescent,rotate,seed,size,strigose,style,terminal,throughout,violet,yellow	1-2,2,2-4,3-6-foliat,5-7,6-8,8-1.,abaxiall,acumen,acuminate,acute,apex,apical,apically,articulate,atenuate,base,broadly,cell,cordate,covering,cuneate,dehiscent,digestion,diminishing,distal,dorsally,eaf,edge,eed,elliptical,emoval,enzyme,equal,exceeding,first,flat,folded,generally,globo,gradually,green-white,hair-like,half,honeycomb,introrse,living,lobe,lon,lower,lunat,make,maturing,nflorescence,nther,oblique,often,orolla,ovate,pattern,perfect,plan,poricidally,proximal,reveal,ruit,sessile,seudostipule,short,slit,specimen,stamen,stigma,straight,tal,tem,testal,thick,throughou,toward,truncate,tuber-bearing,two,typically,unit,vary,wall,wide,ympodial,Â¼	8-19,abaxial,adaxial,anther,arrangement,colour,connation,feature,form,fruit,globose,growth,height,history,inflorescence,length,life,na,number,ovary,reproduction,shape,stem,surface,texture,wet,width	0.25,1-3,1-4,11-13,11-23,14-44,2-3,2.6,3,3.4,3.5-4.2,4,4-5,5-7.5,6,8-14,9,abaxially,adaxially,branched,cm,conical,connate,cyme,darker,deep,dichasial,dichasially,ebracteate,forked,green,herbaceous,light,long,medium,mm,monochasial,mucilaginous,odd-pinnate,ovoid,perennial,puberulent,pubescent,rotate,strigose,throughout,violet,yellow	8-19,globose,na,wet
210	wfo-0001028280	success	87	89	31	40	47	49	28	3	.5,0.7-1,1-2,1.5-2.7,2-3,6-9,acuminate,anthesi,apex,attenuate,bark,base,berry,closely,cm,dark,decurrent,elliptic,glabrous,globose,green,lanceolate,leaf,mm,narrowly,new,opposite,papillae,pedicel,petiole,present,scar,shrub,simple,spaced,stem,surface,tip,winged,young	1-2-flowered,2-2.5,7-8,almost,ape,arching,axil,branch,brow,ciliate,completely,dia,eaf,eed,flattened,fruiting,immature,know,known,lateral,lon,long,lower,main,margin,middle,minutely,nflorescence,older,onto,pair,pendant,rounded,ruit,sessil,small,somewhat,tall,ud,ultimate,unifoliat,unit,vein,widest,woody,x,ympodial	anther,arrangement,brown,bud,calyx,coat,colour,connation,corolla,decurrency,dry,embryo,feature,filament,flower,form,fruit,growth,height,history,inflorescence,length,life,lobe,midpoint,minor,na,number,ovary,papilla,plant,pore,prickle,ray,reproduction,seed,shape,size,spacing,specimen,stigma,style,texture,tube,tuberculation,type,unifoliate,width,winging	.5,0.7-1,1-2,1.5-2.7,2-3,6-9,acuminate,attenuate,berry,closely,cm,dark,decurrent,elliptic,glabrous,globose,green,lanceolate,leaf,mm,narrowly,opposite,papillae,present,shrub,simple,spaced,winged	brown,na,unifoliate
211	wfo-0001028281	success	258	173	125	156	102	17	123	2	-3,.4,0.05-0.4,0.1-0.15,0.15-0.2,0.2-0.3,0.2-0.5,0.2-0.5-1,0.2-0.7-0.9,0.3-0.5,0.3-1,0.5-0.6,0.5-0.7,0.5-1,0.5-1.1,0.5-1.2,0.7-1.2,0.7-2.5-7,0.75-1,1,1-1.5,1-3,1-5,1.0-1.6,1.1-1.4,1.1-2.4,1.2-1.6,1.4-4,1.7-2.5,10-30-45,2-4,2-4-celled,2-6.5-10,2.1-3.0,20-30,3-16-20,3-8.5,5-8-celled,6,7-30-36,acuminate,acute,almost,anther,apex,apical,appearance,appendage,appressed,arising,base,basiscopically,bract,branching,broadly,brown,calyx,capitate,cell,cm,column,composed,conical,corolla,dark,deep,densely,diameter,doubly,eglandular,either,elliptic,elongate,entire,extended,filament,flower,form,fragile,fruit,fruiting,giving,gland,glandular,globose,golden,green,hair-like,head,imparipinnate,inflorescence,interjected,interrupted,lateral,leaf,leaflet,less,like,lobe,long,margin,minute,mm,multi-celled,multi-cellular,multicellular,narrowly,oblique,obovate,occasionally,once-branched,outgrowth,ovary,ovate,patent,pedicel,peduncle,petiolule,primarily,primary,pseudostipule,pubescent,regularly,rotate,serrate,shorter,shrub,silky,size,small,sometimes,sparsely,staminal,stem,sterile,stiff,stigma,style,surface,terminal,testa,thick,thin,tip,trichome,tube,type,unicellular,uniseriate,usually,vine,wall,weak,weak-walled,wide,yellow	+,-5,-8,.2,.5,0.5-1.2-1.5,0.7-1-1.5,0.8-1,1-1.5-2,1-1.5-6,10-18,2-13,2-locular,2.5-6-15,3-5,3-foliate,abaxial,abaxially,absent,adaxial,alternate,anthesi,articulation,autogamous,axi,bent,berr,blade,bracteate,covering,darker,decreasing,decurrent,developed,distal,dry,eaf,edicel,eed,elongate-triangular,enclosing,exerted,exserted,free,generally,glabrous,gree,hal,half,halfway,included,internode,large,largest,lon,longest,lower,material,medial,midvein,mixture,nflorescence,node,opposite,orbicular,other,pair,pale,paler,petiole,point,population,portion,present,probably,proximal,rachi,rest,ruit,secondary,serrat,sessile,set,smaller,smooth,sparser,sprawling,straight,stripe,strongly,subopposite,tem,tertiary,three,toward,transparent,ud,unit,vein,well,winged,ympodial	1-2,2,2.5-15,3,4,arrangement,bud,colour,growth,height,length,number,plant,pubescence,seed,shape,width	-3,.4,0.05-0.4,0.1-0.15,0.15-0.2,0.2-0.3,0.2-0.5,0.2-0.5-1,0.2-0.7-0.9,0.3-0.5,0.3-1,0.5-0.6,0.5-0.7,0.5-1,0.5-1.1,0.5-1.2,0.7-1.2,0.7-2.5-7,0.75-1,1,1-1.5,1-3,1-5,1.0-1.6,1.1-1.4,1.1-2.4,1.2-1.6,1.4-4,1.7-2.5,10-30-45,2-4,2-4-celled,2-6.5-10,2.1-3.0,20-30,3-16-20,3-8.5,5-8-celled,6,7-30-36,acuminate,acute,almost,appearance,appressed,arising,base,basiscopically,broadly,brown,capitate,cell,cm,composed,conical,dark,deep,densely,diameter,doubly,eglandular,either,elliptic,elongate,entire,extended,form,fragile,giving,gland,glandular,globose,golden,green,hair-like,head,imparipinnate,interrupted,lateral,less,like,long,minute,mm,multi-celled,multi-cellular,multicellular,narrowly,oblique,obovate,occasionally,once-branched,outgrowth,ovate,patent,primarily,pubescent,regularly,rotate,serrate,shorter,shrub,silky,small,sometimes,sparsely,stem,stiff,surface,testa,thick,thin,tip,trichome,unicellular,uniseriate,usually,vine,wall,weak,weak-walled,wide,yellow	1-2,2.5-15
212	wfo-0001028317	success	204	110	75	88	116	22	73	2	/5,0.6-0.8,0.6-1.2,0.6-1.5,0.8-2.5,1-1.3,1-3,1-4,1.8-2.5,1/5,2-2.8,2.5-6.5,2.8-3.3,3-5,acute,anther,apart,apically,articulated,bark,base,berry,branched,bright,brown,calyx,cm,cream,curved,dark,deltate,densely,dull,erect,filiform,flattened-reniform,flower,fruit,glabrous,gray,green,herb,lanceolate,lateral,leaf,length,lobe,lobed,long,marking,maturity,mauve,mm,moderately,oblong,orange-brown,ovate,pale,pedicel,petiole,poricidal,prickly,purple,red,scar,shrub,simple,sometimes,sparsely,spherical,spreading,stellate-pubescent,stem,straight,style,surface,tapering,terminal,tip,toward,tube,upper,way,white,wide,yellow,yellow-green,young	-1.5,-5,0,0-1,0-5,0.1,0.1-0.25,0.1-0.3,0.1-0.4,0.3-0.4,0.3-1,0.5-3.5,0.8-1.1,1.1-1.9,1.4-2,1/,1/3-1/4,1/4-2/3,2-4,2-4.5,2/3,3-10,3-4,4-5-merous,4-6,4-8,5-8,6-10,abaxially,absent,acuminat,almost,alyx,apar,apex,apparently,blade,broad-deltate,brow,chartaceous,concolorous,cuneate,diameter,difoliate,distance,drying,eaf,eed,elongating,equal,extending,eye,filament,free,fruiting,geminat,hair,herbaceous,infructescence,longer,lower,margin,mature,midpoint,midvein,minute,naked,nflorescence,obtuse,older,one,open,orolla,oung,pair,peduncle,pendulous,per,perfec,pericarp,porrect,portion,prickl,prickle,primary,ray,reduced,reflexed,rounded,ruit,scandent,sessile,shorter,side,smooth,spaced,stalk,stalked,stellate,subsessile,tamen,terete,tertiary,time,translucent,trichome,truncate,unarme,unarmed,unit,variously,vary,vein,venation,visible,ympodial	abaxial,acuminate,adaxial,arrangement,colour,corolla,feature,form,growth,inflorescence,na,number,ovary,papilla,seed,shape,size,spacing,texture,type,width,winging	/5,0.6-0.8,0.6-1.2,0.6-1.5,0.8-2.5,1-1.3,1-3,1-4,1.8-2.5,1/5,2-2.8,2.5-6.5,2.8-3.3,3-5,acute,apart,apically,articulated,base,berry,branched,bright,brown,cm,cream,curved,dark,deltate,densely,dull,erect,filiform,flattened-reniform,glabrous,gray,green,herb,lanceolate,lateral,lobed,long,marking,maturity,mauve,mm,moderately,oblong,orange-brown,ovate,pale,poricidal,prickly,purple,red,shrub,simple,sometimes,sparsely,spherical,spreading,stellate-pubescent,straight,tapering,terminal,tip,toward,upper,way,white,wide,yellow,yellow-green,young	acuminate,na
213	wfo-0001028323	success	164	141	102	111	53	30	96	6	-2,0.2-1,0.4-1.3,0.5,0.6-1,0.9-1.2,1,1-1.2,1-2,3,3-6,7.5-9,acute,along,anther,anthesi,apart,apex,appressed,articulated,attenuate,bark,base,berry,blue-green,c.,calyx,cell,cm,conical,corolla,cup-shaped,dark,deltate,dendritic,densely,diameter,ellipsoid,elliptic,erect,fading,fleshy,flower,fruiting,glabrescent,glabrous,globose,grey,growth,inflorescence,internodal,leaf-opposed,lengthening,less,like,lobe,lobed,longer,main,maturity,minute,minutely,mm,new,occasionally,ovary,ovate,ovoid,pale,papillose,pedicel,peg,petiole,pitted,planar,pore,poricidal,proceed,pubescent,remaining,rounded,scar,scattered,shiny,shoot,short,shrub,simple,small,sometimes,somewhat,soon,sparsely,splitting,stem,stigma,straight,style,surface,testal,tip,trichome,tube,uniseriate,vein,violet,wall,way,white,woody,x	0.2-0.5,0.5-1,0.8,1-1.5,1.1-4.5,1.5,1.5-2.5,2-3,2-9,3-5,3.5-4,5-6,abaxially,abscissio,absent,apparently,ba,brown,capiatate,coriaceous,drying,eaf,eed,entire,filament,free,glabrescen,included,lanceolate,lower,margin,nflorescence,pair,papillat,peduncle,perfect,pericarp,plurifoliat,portion,primary,reddish,revolute,ruit,sinus,soft,sparely,tearing,thick,thin,tuft,ud,unit,ympodial	0.8-4.5,1.5-9,abaxial,abscission,adaxial,arrangement,bud,capitate,colour,feature,form,fruit,hair,height,history,leaf,length,life,na,number,papillate,plant,reproduction,seed,shape,size,spacing,texture,type,width	-2,0.2-1,0.4-1.3,0.5,0.6-1,0.9-1.2,1,1-1.2,1-2,3,3-6,7.5-9,acute,along,anthesi,apart,apex,appressed,articulated,attenuate,base,berry,blue-green,c.,cell,cm,conical,cup-shaped,dark,deltate,dendritic,densely,diameter,ellipsoid,elliptic,erect,fading,fleshy,glabrescent,glabrous,globose,grey,inflorescence,internodal,leaf-opposed,lengthening,less,like,lobe,lobed,longer,main,maturity,minute,minutely,mm,occasionally,ovate,ovoid,pale,papillose,peg,pitted,planar,pore,poricidal,proceed,pubescent,remaining,rounded,scattered,shiny,shoot,short,shrub,simple,small,sometimes,somewhat,soon,sparsely,splitting,stem,straight,surface,testal,tip,trichome,uniseriate,vein,violet,wall,way,white,woody,x	0.8-4.5,1.5-9,abscission,capitate,na,papillate
214	wfo-0001028329	success	215	134	98	108	107	26	95	3	.5-3,0.2-0.3,0.8-1.1,1-6,1.3-1.8,1.5-2.3,10-34,2-4,3-14,3-8,5-10,6-8,7-19,angled,anther,apart,apex,apical-lateral,articulated,asperous,bark,base,becoming,berry,blunt-tipped,brown,bud,calyx,chartaceous,closely,cm,conical,continued,corolla,dehiscing,deltoid,dendritic-echinoid,due,echinoid,finely,fleshy,flower,free,fruit,glabrous,granular,granular-tomentose,gray,green,grooved,growth,hair,honeycombed,introrse,large,lateral,leaf,length,longitudinally,minutely,mm,moderately,mostly,multangulate,obelliptic,oblong,obtuse,occasional,orbicular,pale,pedicel,petiole,plurifoliate,pore,porrect-stellate,pseudo-terminal,pubescent,reniform,reticulate-punctate,ripe,sessile,short-stalked,shrub,simple,slightly,small,spaced,stellate,stellate-rotate,stelliform,stem,stigma,style,subglobose,suborbicular,testa,tomentose,tree,tube,turning,unarmed,velutinous,white,whitish,x,yellow,yellowish,young	.75-2,.75-5.75,/10-3/10,0-100,0.8-1.4,0.9-1.3,1.0-1.4,1.1-2.5,1.3-2,1.5-2.75,1.5-3.5,1.5-8,12,2-3,2.2-3.9,2.6-5,2.75-4.5,3.75-7,3/4,4-15,4-5,6-11,6-9,abaxially,absen,acuminate,acute,adaxially,ag,anthesi,apparently,axe,axillary,ba,blade,branch,branched,cylindrical,dendritic-echinoi,diameter,dichotomously,distantly,distinct,eaf,eed,entire,filament,glabrescen,high,inserted,lengthening,lobe,lobed,long,long-attenuate,lower,main,margin,midvein,multangulat,nflorescence,obovate,obscured,older,orolla,ovate,ovate-elliptic,peduncle,perfect,present,rachi,rather,receptacle,relatively,ruit,runk,sessil,several,short-,side,slit,sometimes,sparse,sparsely,stalked,stellat,stellate-pubescent,subcapitat,suture,swollen,tamen,thick,thickened,thin,time,tomentu,touching,toward,unarme,unit,usually,vary,vein,vestigial,way,wide,ympodial	20-100,abaxial,adaxial,arrangement,colour,feature,form,height,history,inflorescence,life,na,number,ovary,papilla,plant,reproduction,seed,shape,size,subcapitate,surface,texture,tip,type,width	.5-3,0.2-0.3,0.8-1.1,1-6,1.3-1.8,1.5-2.3,10-34,2-4,3-14,3-8,5-10,6-8,7-19,angled,apart,apex,apical-lateral,articulated,asperous,base,becoming,berry,blunt-tipped,brown,chartaceous,closely,cm,conical,continued,dehiscing,deltoid,dendritic-echinoid,due,echinoid,finely,fleshy,flower,free,fruit,glabrous,granular,granular-tomentose,gray,green,grooved,growth,hair,honeycombed,introrse,large,lateral,longitudinally,minutely,mm,moderately,mostly,multangulate,obelliptic,oblong,obtuse,occasional,orbicular,pale,plurifoliate,pore,porrect-stellate,pseudo-terminal,pubescent,reniform,reticulate-punctate,ripe,sessile,short-stalked,shrub,simple,slightly,small,spaced,stellate,stellate-rotate,stelliform,stem,subglobose,suborbicular,testa,tomentose,tree,turning,unarmed,velutinous,white,whitish,x,yellow,yellowish	20-100,na,subcapitate
215	wfo-0001028337	success	192	134	79	97	95	37	77	2	-4,.5,.8,/3,0.05-1,0.3-0.5,0.4-0.7-2,0.4-0.8,0.7-0.9,0.7-1,1-2,1-3,1.5-3,1.5-4,1.8-2,15-50,2-2.2-2.5,2-4,5-8,anther,apart,apex,apically,articulated,bark,base,berry,calyx,cm,color,conical,connivent,cuneate,dark,deltate,erect,evenly,filament,flattened-reniform,flower,fruit,glabrescent,glabrous,gray,gray-brown,green,hair,inflorescence,juvenile,known,lateral,leaf,length,lobe,lobed,long,marking,mature,mauve,midpoint,minutely,mm,moderately,narrow-oblong,pale,pedicel,petiole,pitted,poricidal,prickle,prickly,ray,reddish,reflexed,rounded,scar,shallowly,shrub,simple,smooth,sparse,spherical,stellate-pubescent,stem,straight,style,surface,tapering,terminal,tip,toward,tube,unarmed,way,white,wide,young	0-6,0.05-0.15,0.1-0.3,1,1-1.8,1/2,1/3-2/3,1/4-1/3,1/8-1/4,11-16,3-4,4-5,5-25,5-6,5-merous,6-7,8-10,8-14,abaxial,abaxially,acut,adaxial,alyx,apar,ape,apparently,blade,branched,chartaceous,curved,densely,diameter,discolorous,drying,eaf,eed,elongating,entire,equal,eye,free,fruiting,fused,gently,glabrou,glaucous,green-brown,infructescence,juvenil,long-styled,longer,lower,margin,naked,nflorescence,occasionally,older,one,open,orange-brown,orolla,oung,peduncle,per,perfect,pericarp,plurifoliat,porrect,porrect-lepidote,portion,primary,ruit,sessile,shoot,short,short-styled,shorter,slender,small,spaced,staminate,stellate,stout,strongly,tamen,terete,time,trichome,unarme,unit,usually,vary,vein,visible,ympodial	acute,anthesi,arrangement,bud,coat,colour,connation,corolla,decurrency,dry,embryo,feature,form,growth,height,history,life,minor,na,new,number,ovary,papilla,plant,pore,reproduction,seed,shape,size,spacing,specimen,stigma,texture,tuberculation,type,width,winging	-4,.5,.8,/3,0.05-1,0.3-0.5,0.4-0.7-2,0.4-0.8,0.7-0.9,0.7-1,1-2,1-3,1.5-3,1.5-4,1.8-2,15-50,2-2.2-2.5,2-4,5-8,apart,apex,apically,articulated,base,berry,cm,color,conical,connivent,cuneate,dark,deltate,erect,evenly,flattened-reniform,glabrescent,glabrous,gray,gray-brown,green,hair,juvenile,known,lateral,lobed,long,marking,mature,mauve,minutely,mm,moderately,narrow-oblong,pale,pitted,poricidal,prickly,reddish,reflexed,rounded,shallowly,shrub,simple,smooth,sparse,spherical,stellate-pubescent,straight,tapering,terminal,tip,toward,unarmed,way,white,wide,young	acute,na
216	wfo-0001028339	success	195	131	82	101	94	30	78	4	.5,0.8-1.2,1-1.2,1-2,1-5,1.1-1.4,1.5,1.5-2,1.7-3.2,10.2-18.5,2.5-5,3.4-5.5,5-7,5.8-7.9,7-11,8182,acuminate,acute,anther,anthesi,apex,attenuate,bark,base,berry,blue,broadly,bud,calyx,capitate,closely,cm,connate,corolla,cuneate,cup-shaped,dried,dry,erect,evenly,filament,flattened,flower,glabrate,glabrous,globose,grainy,greyish-brown,growth,leaf,lobe,lobed,long-triangular,minor,minutely,mm,mustard,nearly,oblique,opposite,ovary,ovate,ovoid-reniform,papillate,pedicel,petiole,pitted,poricidal,red-brown,scar,schwarz,shaped,shining,shrub,simple,size,slightly,small,somewhat,spaced,specimen,stem,stigma,strongly,style,surface,tapering,tear-drop,texture,tightly,tip,tree,trichome,tube,urceolate,white,winged,woody,x,yellow,young	0.05-0.1,1-1.5,1.2-1.5,10-30-flowered,3.5-4,43191,5-angled,8-10,across,almost,appearance,appearing,appressed,becoming,beneath,brown,carinate,carpel,covered,crystalline,dark,decurrent,deflexed,densely,dia,differing,difoliate,distinctly,eaf,edicel,eed,enclosed,epidermi,exserted,fide,filiform,first,floccose,free,frui,fruiting,geminat,irregular,large-celled,later,lateral,leave,like,little,lon,long,lower,main,major,margin,middle,nee,nflorescence,obscure,occasionally,older,one,overlappin,ovoid,papery,papillose,planar,pore,portion,proximal,pulp,reflexed,ruit,secondary,septum,slender,sparsely,speckled,straight,strong,tall,tub,ud,uniseriate,unit,vein,venation,white-lenticellat,white-papillo,white-speckled,wide,widest,yellowish,ympodial	10-30,arrangement,coat,colour,connation,feature,form,fruit,height,history,inflorescence,length,life,midpoint,na,number,papilla,plant,prickle,ray,reproduction,seed,shape,spacing,tuberculation,type,white-lenticellate,white-papillose,width,winging	.5,0.8-1.2,1-1.2,1-2,1-5,1.1-1.4,1.5,1.5-2,1.7-3.2,10.2-18.5,2.5-5,3.4-5.5,5-7,5.8-7.9,7-11,8182,acuminate,acute,attenuate,base,berry,blue,broadly,bud,capitate,closely,cm,connate,cuneate,cup-shaped,dried,erect,evenly,flattened,flower,glabrate,glabrous,globose,grainy,greyish-brown,leaf,lobed,long-triangular,minutely,mm,mustard,nearly,oblique,opposite,ovate,ovoid-reniform,papillate,pitted,poricidal,red-brown,schwarz,shaped,shining,shrub,simple,slightly,small,somewhat,spaced,specimen,strongly,tapering,tear-drop,tightly,tree,trichome,urceolate,white,winged,woody,x,yellow,young	10-30,na,white-lenticellate,white-papillose
217	wfo-0001028351	success	175	137	96	109	66	28	93	3	.8,.8â1.0,0,0.2,0.5,1.0â1.6,10,2,2.0â2.5,2.0â5.0,2â4,3,3â4,4,40,5.0,5â7,6â12,8â15,absent,acute,annual,anther,anthesi,apart,apex,base,becoming,blue,branching,calyx,capitate,cell,chartaceous,clavate,cm,colour,connivent,cylindrical,densely,diameter,directed,distally,erect,filament,flattened,flower,fruit,glabrous,glandular,globose,green,hair,herb,lanceolate,leaf,lobe,lobed,long,longitudinal,margin,mm,multicellular,narrowly,number,oblong,occasionally,opening,opposed,ovate,pair,pedicel,pentagonal,perennial,petiole,pitted,pore,present,pubescent,regularly,shallowly,shaped,shiny,simple,slender,slit,smaller,stem,stigma,stone,straight,style,surface,tardily,teardrop,time,truncate,tube,unbranched,unicellular,uniseriate,unknown,wide,winged,woody,x,young,â,â3.0	.2,0.1,0.6,0â,1.0â,1.0â2.0,1.0â2.5,1.4â1.5,1.5â4.0,1.6â,2.1â3.5,2/3,2â2.5,3.4â5.0,5,5.0â5.5,5.5â10.5,6.5â8.5,abaxially,adaxiall,adaxially,ag,along,apical,articulated,axe,ba,basal,blade,brown,convex,eaf,eed,equal,fleshy,geminat,indumentum,lamin,like,lon,lower,m.,midvein,moderately,nfloresence,obtuse,orolla,pale,peduncle,perfect,plurifoliate,probably,ruit,serrate,side,spaced,sparsely,tal,tamen,tem,unit,vary,velutinous,white,wing,ympodial	0â1.0â2.5,age,arrangement,connation,corolla,feature,form,growth,height,history,inflorescence,length,life,na,ovary,papilla,plant,reproduction,scar,seed,shape,size,spacing,texture,tip,type,width,winging	.8,.8â1.0,0,0.2,0.5,1.0â1.6,10,2,2.0â2.5,2.0â5.0,2â4,3,3â4,4,40,5.0,5â7,6â12,8â15,absent,acute,annual,anthesi,apart,becoming,blue,branching,capitate,cell,chartaceous,clavate,cm,connivent,cylindrical,densely,diameter,directed,distally,erect,flattened,fruit,glabrous,glandular,globose,green,hair,herb,lanceolate,leaf,lobe,lobed,long,longitudinal,mm,multicellular,narrowly,number,oblong,occasionally,opening,opposed,ovate,pair,pentagonal,perennial,pitted,present,pubescent,regularly,shallowly,shaped,shiny,simple,slender,slit,smaller,stone,straight,surface,tardily,teardrop,time,truncate,unbranched,unicellular,uniseriate,unknown,wide,winged,woody,x,â,â3.0	0â1.0â2.5,age,na
218	wfo-0001028353	success	177	131	86	107	70	24	84	2	/3,0.2-0.4,0.5,0.9-1.2,1,1-4,1.4-2,1.5-5,2,2-3,2-4,3,6-8,7,acute,age,anther,anthesi,apex,base,beneath,berry,bluntly,bright,calyx,campanulate,capitate,cell,centre,ciliate,clasping,cm,coarsely,cordate,corolla,cup-shaped,dark,deep,deeply,densely,diameter,dry,ellipsoid,elliptic,erect,filament,fleshy,flower,glabrous,globose,green,greenish,herb,heteromorphic,hollow,honey-comb,internodal,leaf,lengthening,less,like,lobe,long,margin,midrib,minute,minutely,mm,nodding,open,ovary,ovoid,pale,papery,papillose,pedicel,petiole,pitted,plant,plump,pore,poricidal,pubescent,purple,ripe,sessile,simple,size,slender,slit,somewhat,sparsely,stem,stigma,style,surface,testal,tip,toothed,trichome,truncate,tube,uniseriate,vein,way,x,yellow	.5,0.5-1-2,1-2,1.5-2,3-5,4-7,8-10,abaxially,accrescent,along,apart,area,becoming,conical,curved,decreasing,decumben,difoliate,distally,drying,eaf,edicel,eed,emarginated,exerted,fracturing,free,frui,fruiting,geminat,gree,growing,horn,horned,inserted,lon,lower,m.,material,nflorescence,often,outline,pair,papillate,peduncle,pericarp,point,portion,primary,principal,reddish,rhomboid,ruit,scar,scattered,sessil,shallow,short,sleeve,slightly,straight,strongly,tan,thin,toward,ud,unit,wall,wrinkled,ympodial	0.5-1,abaxial,adaxial,alternate,arrangement,bud,colour,connation,feature,form,fruit,growth,height,inflorescence,length,number,papilla,seed,shape,specimen,texture,type,width,young	/3,0.2-0.4,0.5,0.9-1.2,1,1-4,1.4-2,1.5-5,2,2-3,2-4,3,6-8,7,acute,age,beneath,berry,bluntly,bright,campanulate,capitate,cell,centre,ciliate,clasping,cm,coarsely,cordate,cup-shaped,dark,deep,deeply,densely,diameter,ellipsoid,elliptic,erect,fleshy,glabrous,globose,green,greenish,herb,heteromorphic,hollow,honey-comb,internodal,lengthening,less,like,long,midrib,minute,minutely,mm,nodding,open,ovoid,pale,papery,papillose,pitted,plump,poricidal,pubescent,purple,ripe,sessile,simple,slender,slit,somewhat,sparsely,testal,tip,toothed,trichome,truncate,uniseriate,vein,way,x,yellow	0.5-1,alternate
219	wfo-0001028390	success	147	128	71	80	67	48	68	3	-10,0,0.5-1.5,1-2.5,1-5,1.5-2,1.5-3.5,1.5-5.5,10-15,2,2.5,3-4,4-11,4-5,7-8,acute,angled,apart,apex,apiculate,base,branched,calyx,chartaceous,cm,connivent,cuneate,deltate,dendritically,densely,divided,eglandular,elliptic,felty-pubescent,flower,forked,glabrous,gland,globose,hair,lanceolate,lobe,mixed,mm,moderately,narrowly,obtuse,occasionally,often,orange,ovate,pedicel,petiole,pore,pseudohair,pubescent,rarely,ripe,scar,short,shrub,simple,slightly,sparsely,stalked,stellate,stigma,style,subcordate,tip,triangular,truncate,tube,unbranched,unequally,usually,violet,white,x,yellow	.5-3.3,0.5,0.5-1,0.5-2.5,1,1-3,3-5,5-7,6-many-foliat,7,9,abaxially,absen,adaxiall,adaxially,aggregate,articulated,axe,blade,cell,curled,cylindrical,dendritically-branched,dense,diameter,directed,distall,eaf,eed,entire,leaving,less,like,lon,long,lower,margin,midvein,mostly,near,nflorescence,nther,orolla,peduncle,peg,perfect,presen,puberulent,pubescen,rachi,radiu,ruit,small,spaced,ste,stone,subcapitat,subclavate,subcoriaceous,tal,tem,time,unit,vary,white-pubescent,wide,ympodial	anther,anthesi,arrangement,bud,coat,colour,connation,corolla,decurrency,dry,embryo,feature,filament,form,fruit,growth,height,history,inflorescence,leaf,length,life,midpoint,minor,na,new,number,ovary,papilla,plant,present,prickle,ray,reproduction,seed,shape,size,spacing,specimen,stem,subcapitate,surface,texture,tuberculation,type,width,winging,young	-10,0,0.5-1.5,1-2.5,1-5,1.5-2,1.5-3.5,1.5-5.5,10-15,2,2.5,3-4,4-11,4-5,7-8,acute,angled,apart,apex,apiculate,branched,chartaceous,cm,connivent,cuneate,deltate,dendritically,densely,divided,eglandular,elliptic,felty-pubescent,forked,glabrous,gland,globose,hair,lanceolate,mixed,mm,moderately,narrowly,obtuse,occasionally,often,orange,ovate,pseudohair,pubescent,rarely,ripe,short,shrub,simple,slightly,sparsely,stalked,stellate,subcordate,triangular,truncate,unbranched,unequally,usually,violet,white,x,yellow	na,present,subcapitate
220	wfo-0001028405	success	149	80	38	52	97	28	34	4	0.4-0.5,0.5-3,1-4,1-9,1.5-6.5,10-11,2,2-2.5,2-3,3-20,3-4,3.5-10,4-11.5,4-6,6-7,7-14.5,8-15,branched,calyx,cm,conical,connate,corolla,cyme,diameter,dichasially,filament,flower,forked,herbaceous,interjected,lateral,leaf,leaflet,long,mm,mucilaginous,odd-pinnate,ovoid,pedicel,peduncle,perennial,petiole,plant,puberulent,seed,size,stellate,stigma,style,terminal,yellow	1.3-8,2-4,3-6-foliat,3.5-6.5,9-15,abaxially,absen,acumen,acute,adaxially,apex,apical,apically,apiculate,articulate,attenuate,base,cell,covering,decurrent,dehiscent,dichasial,digestion,diminishing,distal,dorsally,eaf,ebracteate,edge,eed,elliptic,elliptic-lanceolate,emoval,enzyme,exceeding,flat,folded,generally,globo,gradually,green,green-white,hair-like,half,honeycomb,introrse,lanceolate,living,lobe,lon,lower,lunat,make,maturing,monochasial,nflorescence,nther,oblique,oblong,often,orolla,ovate-elliptic,pair,pattern,perfect,plan,poricidally,proximal,rachi,reveal,ruit,seudostipule,short,short-acuminate,short-petiolate,slit,specimen,stamen,straight,subsessile,tal,tem,testal,thick,throughou,throughout,toward,tuber-bearing,typically,unit,vary,wall,whit,wide,without,ympodial,Â¼	abaxial,absent,adaxial,anther,arrangement,colour,connation,feature,form,fruit,globose,growth,height,history,inflorescence,length,life,na,number,ovary,reproduction,shape,stem,surface,texture,type,white,width	0.4-0.5,0.5-3,1-4,1-9,1.5-6.5,10-11,2,2-2.5,2-3,3-20,3-4,3.5-10,4-11.5,4-6,6-7,7-14.5,8-15,branched,cm,conical,connate,cyme,dichasially,forked,herbaceous,long,mm,mucilaginous,odd-pinnate,ovoid,perennial,puberulent,stellate,yellow	absent,globose,na,white
221	wfo-0001028429	success	162	125	85	98	64	27	82	3	0.2-0.4,0.9-2.3,1-2.5,1-4,1.5-3,10-11,10-27,10.5-21,2-3,2-4,2.5-12,2.5-4,2.5-7.5,2.7-3.6,3-6,5-12,6-18,6-28,abaxially,adaxially,apical,apically,branched,calyx,cell,cm,connate,corolla,covering,cyme,darker,dehiscent,diameter,dichasial,dichasially,distal,dorsally,ebracteate,edge,especially,filament,flat,flower,folded,forked,generally,glabrescent,glabrous,globose,green,greenish,hair,hair-like,half,herbaceous,interjected,introrse,lateral,leaf,leaflet,light,long,make,maturing,medium,mm,monochasial,mucilaginous,odd-pinnate,often,ovoid,pedicel,peduncle,pentagonal,perennial,petiole,plant,poricidally,rotate,scattered,seed,short,size,slightly,slit,spot,stigma,style,terminal,testal,thick,throughout,vein,violet,wall,white,wide,yellow	0.8-1.2,1.5-4,2-1.,2-8,3-6-foliat,4-14,7-7,abaxiall,acumen,acuminate,acute,apex,articulate,base,broadly,cordate,cuneate,digestion,diminishing,eaf,eed,elliptical,emoval,enzyme,exceeding,globo,gradually,green-white,honeycomb,living,lobe,lon,long-attenuate,lower,lunat,narrowly,nflorescence,nther,oblique,obovate,orolla,ovate,pair,pattern,perfect,petiolule,plan,proximal,reveal,ruit,seudostipule,specimen,stamen,straight,tal,tem,throughou,toward,tuber-bearing,typically,unit,vary,ympodial,Â¼	2-19,abaxial,adaxial,anther,arrangement,colour,connation,dehiscence,feature,form,fruit,growth,height,history,inflorescence,length,life,na,number,ovary,reproduction,shape,stem,surface,texture,wet,width	0.2-0.4,0.9-2.3,1-2.5,1-4,1.5-3,10-11,10-27,10.5-21,2-3,2-4,2.5-12,2.5-4,2.5-7.5,2.7-3.6,3-6,5-12,6-18,6-28,abaxially,adaxially,apical,apically,branched,cell,cm,connate,covering,cyme,darker,dehiscent,dichasial,dichasially,distal,dorsally,ebracteate,especially,flat,folded,forked,generally,glabrescent,glabrous,globose,green,greenish,hair,hair-like,half,herbaceous,introrse,lateral,light,long,make,maturing,medium,mm,monochasial,mucilaginous,odd-pinnate,often,ovoid,pentagonal,perennial,plant,poricidally,rotate,scattered,seed,short,slightly,slit,spot,testal,thick,throughout,vein,violet,wall,white,wide,yellow	2-19,na,wet
222	wfo-0001028436	success	150	124	69	77	73	47	65	4	0.2-0.4,0.5,0.5-1,0.8-1.5,1-3,1.5,1.5-2.5,10-20,1st,2-4,2.5-3,2nd,4,5-10,5-12,5-8,absent,abundant,acute,anther,apex,apically,base,berry,brown,calyx,cell,center,cm,decurrent,dm,dried,edge,elliptic,filament,fine,flower,fruit,geniculate,glabrous,globose,hair,interpetalar,leaf,linear,lobe,long,margin,mm,moderately,oblong,often,parallel,pedicel,petiole,pointing,pubescent,radiating,raised,ridge,rotate,running,shallow,shrub,sparsely,stem,stigma,style,surface,tissue,triangular,tube,two-celled,unbranched,unifoliate,white,x	.5,1-2,1-2-celled,1.5-2,2-3,5-15,7,8-12,abaxially,adaxiall,adaxially,along,appearance,appearing,axe,beyond,blade,chartaceous,ciliate,connected,cordat,deflated,dehiscent,diameter,difficult,due,eaf,eed,entire,evaluat,explosively,exserted,flat,frui,fruiting,glabrescen,lengt,like,linear-lancolate,lower,lying,membranaceous,much-branched,nearly,nflorescence,notch,older,orolla,oung,peduncle,per,placenta,presence,pubescen,rachi,reaching,rhizomatous,ruit,small,stamen,structure,swollen,tal,tamen,taproot,tear,thick,unit,vary,wid,woody,wrinkled,ympodial	2.5,anthesi,arrangement,bark,bud,coat,colour,connation,corolla,decument,decurrency,dry,embryo,feature,form,glabrescent,growth,height,history,inflorescence,length,life,midpoint,minor,na,new,number,ovary,papilla,plant,pore,prickle,ray,reproduction,scar,seed,shape,size,spacing,specimen,texture,tip,tuberculation,type,width,winging,young	0.2-0.4,0.5,0.5-1,0.8-1.5,1-3,1.5,1.5-2.5,10-20,1st,2-4,2.5-3,2nd,4,5-10,5-12,5-8,absent,abundant,acute,apex,apically,berry,brown,cell,center,cm,decurrent,dm,dried,edge,elliptic,fine,flower,fruit,geniculate,glabrous,globose,hair,interpetalar,linear,long,margin,mm,moderately,oblong,often,parallel,petiole,pointing,pubescent,radiating,raised,ridge,rotate,running,shallow,shrub,sparsely,tissue,triangular,two-celled,unbranched,unifoliate,white,x	2.5,decument,glabrescent,na
223	wfo-0001028465	success	159	93	51	66	93	27	47	4	0.75,1-4,1.2-2,1.5-2.9,10-24,11-23,2-3,2-6,2-9.3,2.4-2.8,3-4,3-5,4-8,4.5-5.5,5-7,7-15,8-10,9-19,branched,calyx,cm,connate,corolla,cyme,diameter,dichasial,dichasially,ebracteate,filament,flower,forked,globose,green,herbaceous,interjected,interpetalar,lateral,leaf,leaflet,long,medium,mm,monochasial,mucilaginous,odd-pinnate,ovoid,pair,pedicel,peduncle,perennial,petiole,plant,puberulent,pubescent,purple,rotate,seed,size,spot,stigma,strigose,style,terminal,throughout,white,yellow	1-2,10,2,2-4,2.5-4,3-6-foliat,3-8,3.8-7,4-1.,abaxially,acumen,acuminate,acute,adaxially,apex,apical,apically,articulate,attenuate,base,broadly,cell,covering,cuneate,decurrent,dehiscent,digestion,diminishing,distal,dorsally,eaf,edge,eed,elliptical,emoval,enzyme,equal,exceeding,first,flat,folded,generally,globo,gradually,green-white,hair-like,half,honeycomb,introrse,living,lobe,lon,lower,lunat,make,maturing,nflorescence,nther,oblique,often,orolla,pattern,perfect,petiolule,plan,poricidally,proximal,rachi,rarely,reveal,ruit,sessile,seudostipule,short,slit,specimen,stamen,straight,tal,tem,testal,thick,tissu,toward,tuber-bearing,two,typically,unit,vary,wall,wide,ympodial,Â¼	4-18,abaxial,adaxial,anther,arrangement,colour,connation,feature,form,fruit,growth,height,history,inflorescence,length,life,na,number,ovary,reproduction,shape,stem,surface,texture,tissue,wet,width	0.75,1-4,1.2-2,1.5-2.9,10-24,11-23,2-3,2-6,2-9.3,2.4-2.8,3-4,3-5,4-8,4.5-5.5,5-7,7-15,8-10,9-19,branched,cm,connate,cyme,dichasial,dichasially,ebracteate,forked,globose,green,herbaceous,interpetalar,long,medium,mm,monochasial,mucilaginous,odd-pinnate,ovoid,perennial,puberulent,pubescent,purple,rotate,spot,strigose,throughout,white,yellow	4-18,na,tissue,wet
224	wfo-0001028468	success	255	142	101	114	141	28	95	6	-10,-4,.3-0.4,0.2-0.3,0.4-4,0.5-2,0.5-3,0.5-8,0.7-2.5,0.8-3.5,1/3-1/2,16,2-9,2.2-3,2.8-4.1,20,5-21,5-9,6-9,acute,anther,apart,apex,attenuate,base,berry,blue,broad-based,brown,bud,calyx,campanulate,cm,compressed,corolla,dark,densely,directed,distally,ellipsoid,extra-axillary,filament,flattened,flower,foveate,fruit,glabrescent,glabrous,gray,green,greenish,hair,interpetalar,laterally,length,light,lobe,lobed,minutely,mixed,mm,moderately,narrowly,oblique,oblong-lanceolate,orange,ovate,ovoid,pale,pedicel,peduncle,per,petiole,pore,porrect-stellate,prickle,purple,rachi,recurved,reticulate,rhombic,rotate-stellate,sessile,short,short-stalked,shrub,simple,slightly,somewhat,sparsely,stellate-pubescent,stelliform,stem,stigma,straight,style,subcapitate,subcuneate,subelliptic,subglobose,sublenticular,subreniform,subshrub,surface,terete,testa,thicknes,tissue,tube,unbranched,way,x,yellowish,young	-1.3,-3,-5.5,-7,.1-0.2,.1-0.3,.1-0.4,.2,.2-0.4,.3,.5,.5-1.5,.5-1.6,.6-1,/10-1/5,/4-1/3,0.05,0.1,0.2-0.6,0.2-1.5,0.4-1,0.5-3.3,0.5-3.5,0.6-1.2,0.6-2,1,1.2-1.5,1.3-2,1.5-2.2,1.5-3.1,1.6,1/5-1/2,2,2.5-4,2/3-3/4,3-4,4-6,4-9,6-10,abaxially,accrescent,acuminate,adaxially,along,appressed,ark,armed,articulated,axe,becoming,beyond,blade,broadly,bu,c.,cauline,central,chartaceous,clavate,commonly,compresse,connivent,d.,decreasing,density,diameter,distal,distantly,dry,eaf,eed,equal,exserted,fruiting,geminat,gradually,half,increasing,inserted,introrsel,lamin,lateral,long,longer,lower,m.,main,margin,midpoint,midvein,mostly,multangulat,multangulate,nflorescence,oblong-conical,obtuse,occasionally,older,orangish,orolla,overlapping,pair,papillo,perfect,proximal,pubescence,pubescent,ray,reduced,relatively,ruit,shallowly,short-,side,similar,similarly,spaced,specimen,stalk,stamen,subacuminate,subchartaceous,subsessile,tal,tamen,thick,thick-stalked,time,touching,toward,triangular,unarmed,unifoliate,unit,upper,usually,vary,vein,wide,yellow,ympodial	0-1.3,0.5-1.5,2-7,abaxial,adaxial,arrangement,bark,colour,dm,feature,form,growth,height,inflorescence,introrsely,leaf,number,ovary,papillose,plant,seed,shape,size,spacing,texture,tip,type,width	-10,-4,.3-0.4,0.2-0.3,0.4-4,0.5-2,0.5-3,0.5-8,0.7-2.5,0.8-3.5,1/3-1/2,16,2-9,2.2-3,2.8-4.1,20,5-21,5-9,6-9,acute,apart,apex,attenuate,base,berry,blue,broad-based,brown,campanulate,cm,compressed,dark,densely,directed,distally,ellipsoid,extra-axillary,flattened,flower,foveate,fruit,glabrescent,glabrous,gray,green,greenish,hair,interpetalar,laterally,light,lobed,minutely,mixed,mm,moderately,narrowly,oblique,oblong-lanceolate,orange,ovate,ovoid,pale,per,porrect-stellate,prickle,purple,recurved,reticulate,rhombic,rotate-stellate,sessile,short,short-stalked,shrub,simple,slightly,somewhat,sparsely,stellate-pubescent,stelliform,straight,subcapitate,subcuneate,subelliptic,subglobose,sublenticular,subreniform,subshrub,terete,testa,tissue,unbranched,way,x,yellowish	0-1.3,0.5-1.5,2-7,dm,introrsely,papillose
225	wfo-0001028470	success	185	126	79	95	90	31	74	5	0-18,0.25-0.75,0.9-2.2,0.9-2.3,1-12.3,1-2,1-3,1.5-2.8,1.6-3.2,11.8-21,12-44,2-10,2-7,2-8,2.1-3.9,3-10,3-5,3.2-5.5,3.5-16,3.5-7,5.5-11.6,6-33,anther,axillary,berry,blade,brownish,bud,chartaceous,clavate,cm,condition,connivent,corolla,dark,deep,diameter,digestion,dot,drying,end,enzyme,flower,fresh,fruit,glabrous,green,greenish,hair,herb,homostylous,honeycomb-shaped,interjected,lanceolate,lateral,leaf,leaflet,light,lobe,long,medium,mm,mottled,odd-pinnate,one,ovoid,pedicel,peduncle,pentagonal,placed,plant,pore,poricidal,purple,removed,ripe,seed,size,sometimes,stigma,style,substellate,subtending,terminal,tip,tube,tuber,typically,unwinged,wall,white,whitish,wide,wing,x	2-5,4-6,4-7,5-merou,abaxially,acumen,acute,adaxiall,adaxially,ag,alyx,apart,apex,apparently,articulated,asymmetric,attenuate,axe,base,basiscopic,capitat,cell,covering,decreasing,distal,dorsally,eaf,edge,eed,elliptic,erec,exceeding,filament,flat,folded,forked,geminat,generally,glabrescent,glabrou,green-white,hair-like,hal,half,high,lengthening,living,lower,make,mucilaginous,nflorescence,orbicular,orolla,ovate,pair,perfect,petiole,petiolulate,plurifoliate,pubescent,rounded,ruit,scarce,sessile,seudostipule,short,side,slit,spaced,specimen,stamen,stolo,straight,subequal,subglabrou,tall,tamen,tem,testal,thick,throughout,tissue,toward,tri-,unit,usually,vary,wet,yellow,ympodial	abaxial,adaxial,arrangement,calyx,capitate,coat,colour,connation,feature,form,growth,height,hermaphroditic,history,inflorescence,length,life,number,ovary,perennial,placement,pseudostipule,reproduction,shape,spacing,stem,stolon,subglabrous,surface,texture,tuberculation	0-18,0.25-0.75,0.9-2.2,0.9-2.3,1-12.3,1-2,1-3,1.5-2.8,1.6-3.2,11.8-21,12-44,2-10,2-7,2-8,2.1-3.9,3-10,3-5,3.2-5.5,3.5-16,3.5-7,5.5-11.6,6-33,axillary,berry,brownish,bud,chartaceous,clavate,cm,condition,connivent,dark,deep,digestion,dot,drying,end,enzyme,fresh,glabrous,green,greenish,herb,homostylous,honeycomb-shaped,lanceolate,lateral,light,long,medium,mm,mottled,odd-pinnate,one,ovoid,pentagonal,placed,poricidal,purple,removed,ripe,sometimes,substellate,subtending,terminal,tip,typically,unwinged,wall,white,whitish,wide,wing,x	capitate,hermaphroditic,perennial,stolon,subglabrous
226	wfo-0001028476	success	242	112	69	84	158	28	65	4	-6,-8,0.2-0.5,0.8-1.2,0.8-1.6,1,1-1.4,1-4,1-6,2-locular,2.4-3,3.5-13-16,4-celled,7-10,8-30,abaxially,absent,acuminate,alternate,anther,articulated,branched,bright,calyx,capitate,cell,cm,conical,corolla,dark,diameter,distal,elongate,flower,fruit,glabrescent,glandular,globose,green,hair-like,half,head,herb,imparipinnate,inflorescence,interrupted,lanceolate,lateral,leaf,lobe,minutely,mixed,mm,narrowly,obovate,outgrowth,ovary,pedicel,perennial,petiole,present,pseudostipule,puberulent,pubescent,purple,rounded,scattered,simple,sparsely,stellate,stem,stigma,stripe,style,surface,testa,tip,trichome,tube,uniformly,uniseriate,wall,white,yellow	.05-0.1,.5,0-0.5,0-3-12-20,0.1-0.15,0.1-0.4,0.15-0.2,0.15-0.4,0.2-0.3,0.2-0.5-1,0.2-0.6,0.25-0.4,0.25-0.5,0.3-0.4,0.3-0.5,0.3-0.7,0.3-1.2,0.4-0.5,0.4-0.6,0.4-1.5,0.5,0.5-0.6,0.5-1.7,0.7-2.5,1-1.2,1-1.5,1-2,1-2-celled,1-celled,1.1-1.5,1.1-1.6,1.2-2.5,1.8-2.5,2,2-6,2-foliate,3-7,3-foliate,5-15,6-12-30,abundant,acroscopically,acute,age,almost,along,also,anthesi,ape,apex,apical,appearance,appendage,axi,basal,base,basiscopically,becoming,bifurcate,bifurcation,bract,bracteate,brown,column,curved,decurrent,deeply,diamete,eaf,ebracteate,edicel,eed,elliptic,entire,especially,exserted,filament,first,fortaleza,fruiting,give,gradually,gree,hal,hyaline,incurved,interjected,internode,irregularly,largest,leaflet,less,like,lobed,lon,long,lower,main,margin,maturity,midvein,minute,nflorescence,node,numerous,oblique,occasionally,often,pair,pale,peduncle,petiolule,population,primary,prominent,pubescence,rachi,rarely,recurve,reflexed,regularly,rest,ruit,rÃ­o,secondary,sessile,set,short,silky,sinus,slightly,smaller,sprawling,spreading,staminal,sterile,stiff,straight,subopposite,tall,tem,terminal,tertiary,thick,toward,truncate,ud,unicellular,unit,unpaired,usually,vein,weak-walled,wid,wide,winged,woody,ympodial	6-30,abaxial,adaxial,arrangement,bud,colour,feature,form,greyish,growth,hair,height,hirsute,history,length,life,na,number,papilla,plant,reproduction,seed,shape,size,texture,type,width,young	-6,-8,0.2-0.5,0.8-1.2,0.8-1.6,1,1-1.4,1-4,1-6,2-locular,2.4-3,3.5-13-16,4-celled,7-10,8-30,abaxially,absent,acuminate,alternate,articulated,branched,bright,capitate,cell,cm,conical,dark,distal,elongate,glabrescent,glandular,globose,green,hair-like,half,head,herb,imparipinnate,interrupted,lanceolate,lateral,minutely,mixed,mm,narrowly,obovate,outgrowth,perennial,present,puberulent,pubescent,purple,rounded,scattered,simple,sparsely,stellate,stripe,testa,trichome,uniformly,uniseriate,wall,white,yellow	6-30,greyish,hirsute,na
227	wfo-0001028481	success	194	119	84	105	89	14	82	2	.1,.3,0.5-1,0.6-1,0Â°,1-1.4,1-2,1-4,1.8-2.5,1/2-2/3,2.5-3,3,3-4,3-6,5.5-7.5,8,acuminate,almost,along,anther,anthesi,apex,apically,attenuate,bark,base,branch,brown,chartaceous,clavate,cm,colour,conical,corolla,cuneate,cupular,dendritic,dendritic-pubescent,diameter,dilated,distributed,dry,drying,elliptic,entire,evenly,filament,flaking,flower,glabrous,green,leaf,length,less,liana,like,linear,lobe,lobed,long,longitudinally,main,margin,midvein,mm,oblong,occasional,often,orange-brown,ovate,pair,pedicel,peduncle,petiole,poricidal,primary,pubescent,ray,reddish,ribbed,ridged,shortly,shrub,side,size,sparsely,stem,stigma,style,surface,terminal,tertiary,thickly,tip,trichome,tube,unarmed,unknown,vein,venation,visible,white,x,yellowish,young	.5,0-2,0.1-0.2,0.15,1-3,1.5,1.5-2,2-3,3-3.5,3-4.5,abaxially,absent,acute,adaxially,age,alyx,apar,apparently,articulated,branched,canaliculate,clearly,close,deeply,delineated,deltoid,density,different,discolorous,divided,domatia,dorsifixed,eaf,eed,ellipsoi,equal,erect,except,extending,extent,eye,faint,flat,flexuous,free,increasing,know,known,lamina,lengthening,lon,long-acuminate,longer,lower,m.,mostly,naked,narrowly,nflorescence,nther,oblique,orolla,perfec,plurifoliat,pore,portion,protruding,rachi,raised,ruit,scar,see,simple,sinus,slender,small,smoot,smoothly,spreading,stump,tearing,together,toward,ud,uneven,unit,vary,wide,ympodial	angle,arrangement,bud,calyx,ellipsoid,feature,form,growth,inflorescence,number,ovary,shape,smooth,texture	.1,.3,0.5-1,0.6-1,0Â°,1-1.4,1-2,1-4,1.8-2.5,1/2-2/3,2.5-3,3,3-4,3-6,5.5-7.5,8,acuminate,almost,along,anthesi,apically,attenuate,base,branch,brown,chartaceous,clavate,cm,conical,corolla,cuneate,cupular,dendritic,dendritic-pubescent,dilated,distributed,dry,drying,elliptic,entire,evenly,flaking,glabrous,green,length,less,liana,like,linear,lobed,long,longitudinally,midvein,mm,oblong,occasional,often,orange-brown,ovate,pair,poricidal,pubescent,ray,reddish,ribbed,ridged,shortly,shrub,side,sparsely,stem,terminal,thickly,tip,trichome,unarmed,unknown,visible,white,x,yellowish,young	ellipsoid,smooth
228	wfo-0001028482	success	224	149	96	116	108	33	93	3	.1,/3,0.2,0.5-1,0.7-1.1,00,1-11,1-4,1.2-1.6,1.5-2,10,2-3,2-celled,3-12,3-4,4-5,5-25,6-50,acuminate,acute,age,angled,anther,anthesi,apex,asymmetric,base,becoming,berry,bilobed,broadly,brownish,bud,calyx,campanulate,capitate,circinate,closely,cm,corolla,cymose,deciduous,deflexed,deltate,distinct,dry,ellipsoid,elliptic,emarginate,embryo,exfoliating,filament,flattened-reniform,fleshy,flower,fresh,fruit,glabrous,glandular,globose,green,growth,hard,internodal,leaf-opposed,less,lobe,lobed,material,maturity,minutely,mm,new,nodding,obovate,ovary,pale,pedicel,petiole,pitted,pore,poricidal,pubescent,reddish,row,scandent,scar,shaped,simple,size,slightly,slit,somewhat,soon,spaced,stem,stigma,style,subglobose,surface,tear-drop,tip,transparent,tree,trichome,truncate,tube,tuberculate,two,way,white,woody,x,yellowish,young,Âµm	.5,0,0.5,0.5-5,1-1.5,1-2,1.1-5,1.5-3,7-14,abaxially,adaxially,alternate,apiculae,ascending,bark,basal,berr,bifid,bifurcate,branched,bright,brochiodromous,channeled,chartaceous,constriction,coriaceous,corky,corrugated,creamy,cucullate,curved,densely,diameter,diffusely,difoliate,discolorous,distally,drying,eaf,eed,enlarged,entire,exerted,expanding,free,fruiting,geminat,glabrou,golden,grayish,halfway,heterostylous,impressed,incrassate,individual,investing,irregular,keeled,lengthening,long,lower,margin,markedly,materia,midrib,midvein,minute,nflorescence,occasionally,olive,overlappin,pair,papillat,peduncle,pentamerous,per,pericarp,petal,portion,primary,revolute,ruit,shiny,short,small,sometimes,sparsely,stout,straight,subcoriaceous,subpyramidal,tan,tightly,tiny,transversely,tub,tuft,twice,ud,unifoliate,uniseriate,unit,usually,vegetative,vein,venation,yellow,ympodial	arrangement,coat,colour,connation,decurrency,feature,form,height,history,inflorescence,leaf,length,life,midpoint,minor,na,number,papilla,papillate,perennial,plant,prickle,ray,reproduction,seed,shape,spacing,specimen,texture,tuberculation,type,width,winging	.1,/3,0.2,0.5-1,0.7-1.1,00,1-11,1-4,1.2-1.6,1.5-2,10,2-3,2-celled,3-12,3-4,4-5,5-25,6-50,acuminate,acute,age,angled,anthesi,apex,asymmetric,base,becoming,berry,bilobed,broadly,brownish,campanulate,capitate,circinate,closely,cm,cymose,deciduous,deflexed,deltate,distinct,dry,ellipsoid,elliptic,emarginate,exfoliating,flattened-reniform,fleshy,fresh,glabrous,glandular,globose,green,hard,internodal,leaf-opposed,less,lobed,material,maturity,minutely,mm,nodding,obovate,pale,pitted,poricidal,pubescent,reddish,row,scandent,shaped,simple,slightly,slit,somewhat,soon,spaced,subglobose,tear-drop,tip,transparent,tree,trichome,truncate,tuberculate,two,way,white,woody,x,yellowish,Âµm	na,papillate,perennial
229	wfo-0001028487	success	195	108	67	80	115	28	63	4	0.3-0.7,0.4-1.5,0.9-3,1-2,1-3,1.1-1.5,1.4-1.7,10-41,2-6,2.5-3.5,3-10,3-19,4-7,4.6-13.6,7.8-16.4,acumen,anther,axillary,berry,blade,bud,cell,central,clavate,cm,connivent,coriaceous,corolla,covering,dark,deep,diameter,elliptic,filament,flower,forked,fruit,glabrescent,glabrous,green,hair-like,herb,lanceolate,lateral,leaf,light,lobe,long,medium,mm,moniliform,narrow,odd-pinnate,ovate,ovoid,pentagonal,petiole,plant,poricidal,purple,ripe,seed,short,size,sometimes,star,stigma,style,substellate,subtending,terminal,testal,thick,tip,tube,tuber,unwinged,wall,white,wing	0-9,1-3.2,1.7-7,10-4.3,15-28,2-4,2-4.8,3-4,3-5,3.4-7.8,5-6,5-merou,abaxially,acuminate,acute,adaxiall,adaxially,ag,along,alyx,apart,apex,apparently,arranged,articulated,asymmetric,attenuate,axe,base,basiscopic,bead,brownish,capitat,condition,considerably,decreasing,digestion,distal,dorsally,drying,eaf,edge,eed,enzyme,erec,exceeding,flat,folded,fresh,geminat,generally,glabrou,green-white,greenish,hair,hal,half,high,homostylous,honeycomb-shaped,interjected,leaflet,lengthening,like,living,lower,make,mucilaginous,multiple,necklace,nflorescence,orbicular,orolla,pair,pedicel,peduncle,perfect,petiolulate,plurifoliate,pore,removed,rounded,ruit,scabrous,scarce,second,sessile,seudostipule,side,slit,smaller,spaced,specimen,stamen,stolon,straight,subequal,subglabrou,tall,tamen,tem,throughout,tissue,toward,tri-,typically,unit,usually,vary,wet,whitish,wide,x,yellow,ympodial	abaxial,adaxial,arrangement,calyx,capitate,colour,connation,feature,form,growth,height,history,inflorescence,length,life,na,number,ovary,perennial,pseudostipule,reproduction,shape,stem,subglabrous,surface,texture,type,width	0.3-0.7,0.4-1.5,0.9-3,1-2,1-3,1.1-1.5,1.4-1.7,10-41,2-6,2.5-3.5,3-10,3-19,4-7,4.6-13.6,7.8-16.4,acumen,axillary,berry,bud,cell,central,clavate,cm,connivent,coriaceous,covering,dark,deep,elliptic,forked,glabrescent,glabrous,green,hair-like,herb,lanceolate,lateral,light,long,medium,mm,moniliform,narrow,odd-pinnate,ovate,ovoid,pentagonal,poricidal,purple,ripe,short,sometimes,star,substellate,subtending,terminal,testal,thick,tip,unwinged,wall,white,wing	capitate,na,perennial,subglabrous
230	wfo-0001028489	success	222	152	99	114	108	38	96	3	-4,-6,/4,0-15,0.2-0.5,0.3-0.5,0.3-0.7,0.3-1,0.3-1.2-2.5,0.5-0.8,0.5-1,0.5-1.1,0.5-1.5,0.6-1.2,0.7-3,1-3,1-6,1-7,1.5-4,1.8-2.2,1.8-4,1.8-5.5,1/3,2-6,2.1-3,3-7,4-13,7.5,acicular,acute,anther,apart,apex,articulated,bark,base,berry,calyx,cell,cm,connivent,cordate,cream,cuneate,dark,deltate,diameter,dull,elliptic,erect,filament,flattened-reniform,flower,fruit,glabrous,gray,green,lateral,leaf,length,lobe,lobed,long,marking,maturity,mauve,midpoint,mm,moderately,obtuse,occasionally,orange,orange-brown,orange-green,outline,ovate,pale,pedicel,perpendicular,petiole,poricidal,prickle,prickly,purple,raised,ray,rounded,scar,shiny,shrub,simple,smooth,sometimes,sparsely,spherical,spreading,stellate,stellate-pubescent,stem,straight,style,surface,tapering,tip,truncate,tube,unarmed,upper,way,white,wide,yellow,yellow-orange,young	-10,-5,0-10,0-20,0-3,0-50,0.1,0.1-0.6,0.2,0.2-0.3-0.5,0.2-0.4-0.6,0.2-0.6,0.2-0.7,0.4-0.8,1-4,1.5-3,1/3-1/2,1/4-1/2,2-3,2-4,3.5-6,4-10,4-8,5-25,5-8,5-merous,abaxially,alyx,apar,apically,apparently,ba,beyond,blade,branched,broad-deltate,caudat,chartaceous,concolorous,curved,densely,difoliate,distance,drying,eaf,eed,elongating,equal,extending,eye,free,fruiting,geminat,hair,herbaceous,infructescence,less,lon,longer,lower,margin,mature,membranous,midvein,minute,naked,nflorescence,often,older,one,open,orolla,oung,pair,peduncle,pendulous,per,perfec,pericarp,porrect,portion,primary,protruding,red-brown,ruit,sessile,side,slender,spaced,stalk,subsessile,tamen,terete,tertiary,time,toward,trichome,unarme,unit,vary,vein,venation,visible,weakly,white-gra,woody,yellow-green,ympodial	anthesi,arrangement,bud,coat,colour,connation,corolla,decurrency,dry,embryo,feature,form,growth,height,history,inflorescence,life,minor,number,ovary,papilla,perennial,plant,pore,reproduction,seed,shape,size,spacing,specimen,stigma,texture,tuberculation,type,unknown,white-gray,width,winging	-4,-6,/4,0-15,0.2-0.5,0.3-0.5,0.3-0.7,0.3-1,0.3-1.2-2.5,0.5-0.8,0.5-1,0.5-1.1,0.5-1.5,0.6-1.2,0.7-3,1-3,1-6,1-7,1.5-4,1.8-2.2,1.8-4,1.8-5.5,1/3,2-6,2.1-3,3-7,4-13,7.5,acicular,acute,apart,articulated,base,berry,cell,cm,connivent,cordate,cream,cuneate,dark,deltate,diameter,dull,elliptic,erect,flattened-reniform,glabrous,gray,green,lateral,lobed,long,marking,maturity,mauve,mm,moderately,obtuse,occasionally,orange,orange-brown,orange-green,outline,ovate,pale,perpendicular,poricidal,prickle,prickly,purple,raised,rounded,shiny,shrub,simple,smooth,sometimes,sparsely,spherical,spreading,stellate,stellate-pubescent,stem,straight,tapering,tip,truncate,unarmed,upper,way,white,wide,yellow,yellow-orange,young	perennial,unknown,white-gray
231	wfo-0001028492	success	130	97	60	68	62	29	54	6	0.2-2,0.5-1,1-2.5,1-4,1-5,1.5-6,15-20,2-3,2-4,2.5-9,3,4,5-15,6-11,acute,angled,apart,apex,base,calyx,cell,cm,colored,containing,crystal,cylindrical,dark,deltate,diameter,directed,elliptic-ovate,forked,fruit,glabrous,globose,herb,lobe,mm,narrowly,pedicel,peduncle,petiole,pore,pubescent,purple,rachi,rarely,reticulate,ripe,rounded,sand-punctate,shrub,simple,stellate,stigma,style,subcordate,tip,triangular,triangular-ovate,tube,unbranched,unknown,veiny,white-punctate,whitish,wide,x	-5-foliat,1.5-2.5,1.5-3,1.75-3.5,2-2.5,2-5,3-6,5-25-flower,5-8,6-12,8-15,abaxially,absen,adaxially,aggregate,apiculate,articulated,axe,axi,blade,chartaceous,ciliolate,color,connivent,distall,eaf,eed,entire,except,glabrou,hair,irregularly,leaving,long,lower,margin,nflorescence,nther,obtuse,orolla,punctate,radiu,ruit,san,scar,somewhat,spaced,sparse,splitting,stone,subcoriaceous,succulent,tal,tem,time,truncat,unevenly,unit,vary,white,x1-3,ympodial	1-3,5-25,anther,arrangement,colour,corolla,distally,feature,flower,form,growth,height,inflorescence,leaf,length,number,ovary,plant,sand,seed,shape,size,spacing,stem,surface,tall,texture,truncate,width	0.2-2,0.5-1,1-2.5,1-4,1-5,1.5-6,15-20,2-3,2-4,2.5-9,3,4,5-15,6-11,acute,angled,apart,cell,cm,colored,containing,crystal,cylindrical,dark,deltate,diameter,directed,elliptic-ovate,forked,glabrous,globose,herb,mm,narrowly,pubescent,purple,rarely,reticulate,ripe,rounded,sand-punctate,shrub,simple,stellate,subcordate,triangular,triangular-ovate,unbranched,unknown,veiny,white-punctate,whitish,wide,x	1-3,5-25,distally,sand,tall,truncate
232	wfo-0001028501	success	195	113	74	87	108	26	71	3	0-3.2,0.3-0.7,0.8-1.6,0.8-1.7,1,1-2,1-8,1.8-10.7,13-41,2.8-18,2.8-4.9,3-10,3-5,3-7,3.1-12,6.6-21.1,8-10,8-34,acumen,anther,axillary,bud,cell,clavate,cm,connivent,coriaceous,corolla,covering,dark,diameter,flower,fruit,glabrescent,glabrous,green,hair-like,herb,lanceolate,lateral,leaf,light,linear,lobe,long,make,medium,mm,moniliform,mottled,mucilaginous,narrow,odd-pinnate,ovate,ovoid,pedicel,peduncle,petiole,plant,poricidal,purple,pyriform,ripe,rotate,seed,simple,size,sometimes,spot,stigma,straight,style,subtending,terminal,testal,thick,tip,tube,tuber,unwinged,wall,wet,white,wide,wing,x,yellow	0-3,0-4,0.3-3.3,0.6-5.8,1-3,2-4,2-5,3.1-10.4,4-8,4.8-18,5-merou,abaxially,acuminate,acute,adaxiall,adaxially,ag,along,alyx,apart,apex,apparently,arranged,articulated,attenuate,axe,base,bead,berry,blade,broadly,brownish,capitat,condition,considerably,decreasing,decurrent,digestion,distal,dorsally,drying,eaf,edge,eed,elliptic,enzyme,erec,exceeding,filament,flat,folded,forked,fresh,geminat,generally,glabrou,green-white,greenish,hair,hal,half,high,homostylous,honeycomb-shaped,interjected,larger,leaflet,lengthening,like,living,lower,multiple,narrowly,necklace,nflorescence,onto,orbicular,orolla,pair,perfect,plurifoliate,pore,present,rachi,removed,ruit,scarce,sessile,seudostipule,short,slit,spaced,specimen,stamen,stolon,subglabrou,tall,tamen,tem,throughout,toward,tri-,typically,unit,usually,vary,whitish,ympodial	abaxial,adaxial,arrangement,calyx,capitate,colour,connation,feature,form,growth,height,history,inflorescence,length,life,na,number,ovary,pseudostipule,reproduction,shape,spacing,stem,subglabrous,surface,texture	0-3.2,0.3-0.7,0.8-1.6,0.8-1.7,1,1-2,1-8,1.8-10.7,13-41,2.8-18,2.8-4.9,3-10,3-5,3-7,3.1-12,6.6-21.1,8-10,8-34,acumen,axillary,bud,cell,clavate,cm,connivent,coriaceous,covering,dark,glabrescent,glabrous,green,hair-like,herb,lanceolate,lateral,light,linear,long,make,medium,mm,moniliform,mottled,mucilaginous,narrow,odd-pinnate,ovate,ovoid,poricidal,purple,pyriform,ripe,rotate,seed,simple,sometimes,spot,straight,subtending,terminal,testal,thick,tip,unwinged,wall,wet,white,wide,wing,x,yellow	capitate,na,subglabrous
233	wfo-0001028502	success	158	121	65	82	76	39	59	6	/2,0.5-1,1-2,1.5-2,1.5-2.5,1.5-3,1.5-6,2-4,2-7,2-8,3.5-15,5-15,acute,age,anther,anthesi,apex,bark,base,beige,brown,calyx,campanulate,clavate,cm,congested,constricted,corolla,dark,deltate,dendritic,elliptic,erect,fawn,filament,flattened-reniform,fleshy,flower,glabrous,globose,inflorescence,later,lateral,leaf,lengthening,light,lobe,lobed,long,minutely,mm,obovate,ovary,papillose,pedicel,petiole,pitted,pore,poricidal,pubescent,reddish-brown,scar,seed,shrub,slit,small,stem,stigma,style,surface,terminal,thick,tip,tree,trichome,tube,warty,way,white,wide,woody,young	.5,1.6-2.4,2-2.5,2-5,3.5-4,5-6,6-8,?,abaxial,abaxially,adaxially,along,apar,ba,blade,body,branch,branched,cazalet,christmas-tree-like,closely,cone,densely,denser,dia,eaf,edicel,eed,exserted,fide,flat,free,fruiting,glabrat,heteromorphic,impressed,included,incrassate,inflorescenc,like,lon,long-styled,lower,main,margin,matted,middle,narrower,nflorescence,often,older,packed,pair,papillo,planar,plurifoliat,portion,prominent,rest,ruit,scattered,shining,short-styled,spaced,structure,tall,time,tree-like,tub,ud,unclear,unevenly,vein,widest,within,ympodia	0.5,4-6,apart,arrangement,bud,coat,colour,connation,dry,embryo,feature,form,fruit,glabrate,growth,height,history,length,life,midpoint,minor,na,new,number,papilla,plant,plurifoliate,prickle,ray,reproduction,shape,size,spacing,specimen,texture,tuberculation,type,width,winging	/2,0.5-1,1-2,1.5-2,1.5-2.5,1.5-3,1.5-6,2-4,2-7,2-8,3.5-15,5-15,acute,age,base,beige,brown,campanulate,clavate,cm,congested,constricted,dark,deltate,dendritic,elliptic,erect,fawn,flattened-reniform,fleshy,glabrous,globose,later,lateral,lengthening,light,lobed,long,minutely,mm,obovate,papillose,pitted,poricidal,pubescent,reddish-brown,shrub,slit,small,terminal,thick,tip,tree,trichome,warty,way,white,wide,woody	0.5,4-6,apart,glabrate,na,plurifoliate
234	wfo-0001028505	success	168	132	81	100	68	32	78	3	.01,.1,.3,.5,/3,0.25-0.5,0.8-1,0.8-1.5,1-3,1.2-2.5,10-15,2,2.5-4.5,3-5,3.5-5,acuminate,acute,anther,anthesi,apex,bark,basal,base,berry,bright,broadly,bud,calyx,cm,conical,corolla,decurrent,deflexed,deltoid,dia,dry,drying,elliptic,erect,expanded,f,filament,gently,glabrous,globose,greatly,green,grey,leaf,live,lobe,lobed,long,material,minor,minutely,mm,narrowly,opposite,ovary,ovate,ovoid-reniform,pale,papillose,pedicel,petiole,pitted,plant,pore,poricidal,pubescent,purple,rounded,scar,seed,shape,shaped,short,shrub,simple,size,slightly,specimen,stem,stigma,style,surface,tapering,tear-drop,tip,trichome,truncate,tube,unicellular,uniseriate,way,white,woody,x,young	1,1/3,10-14-flowered,7-8,aspect,ba,barely,beneath,black,blade,body,branch,characteristic,darker,deciduous,delicate,differentiated,differing,difoliate,distance,distinct,dried,eaf,edicel,eed,exserted,exsertion,flattened,free,fruiting,geminat,incrassate,lateral,lon,lower,m.,main,major,margin,materia,member,minute,nflorescence,obovoid,obvious,older,overlapping,pair,portion,prominent,proximal,reflexed,ruit,somewhat,soon,straight,strongly,tall,tan,touching,ud,unit,usually,vein,whit,widest,yellowish,ympodial	10-14,alternate,arrangement,coat,colour,connation,decurrency,embryo,feature,flower,form,fruit,growth,height,history,inflorescence,length,life,midpoint,na,new,number,papilla,prickle,ray,reproduction,spacing,texture,tuberculation,type,width,winging	.01,.1,.3,.5,/3,0.25-0.5,0.8-1,0.8-1.5,1-3,1.2-2.5,10-15,2,2.5-4.5,3-5,3.5-5,acuminate,acute,apex,basal,base,berry,bright,broadly,calyx,cm,conical,decurrent,deflexed,deltoid,dia,dry,drying,elliptic,erect,expanded,f,gently,glabrous,globose,greatly,green,grey,leaf,live,lobed,long,material,minutely,mm,narrowly,opposite,ovate,ovoid-reniform,pale,papillose,petiole,pitted,plant,poricidal,pubescent,purple,rounded,shaped,short,shrub,simple,slightly,tapering,tear-drop,tip,trichome,truncate,unicellular,uniseriate,way,white,woody,x	10-14,alternate,na
235	wfo-0001028524	success	236	105	65	76	160	29	59	6	1.1-1.2,10-20,2-6,2.8-3.5,3-10,3-15,3.4-3.6,4-6,4-8,9-14,anther,apical-lateral,bark,berry,blunt-tipped,branched,brown,calyx,closely,cm,conical,corolla,cream,dark,deltoid,ferrugineous,fleshy,flower,fruit,granular-tomentose,gray,green,greenish,growth,honeycombed,introrse,lanceolate,large,leaf,length,lobe,mm,oblong,ovate,ovate-lanceolate,pale,pedicel,petiole,pore,probably,reniform,reticulate-punctate,ripe,scabridulous,simple,slightly,spaced,stellate,stelliform,stem,stigma,style,subglobose,suborbicular,sulcate,terete,tomentose,tree,tube,unarmed,velutinous,x,yellow,yellowish,yellowish-green,young	-2.7,-3,.5-1,/10-3/10,0-150,0.3,0.3-0.8,0.5-3.5,0.6-1.4,1-5,1.2-1.3,1.5-1.6,1.5-3,1.8-2.5,1/3-2/3,11,2-3.8,2.5-3.4,2.5-3.8,2.5-4,3-4.3,3.3-4,4.3-6,6-7,6-9,7-10,7-11,8-13,abaxially,accrescent,acuminate,acute,adaxially,ag,along,anthesi,apart,apex,apparently,articulated,ascending,axe,axillary,ba,base,becoming,blade,branch,bud,capitat,chartaceous,continued,dehiscing,densely,diameter,distal,dm,due,eaf,echinoi,echinoid,eed,elliptic,entire,exserted,extend,few-,few-rayed,filament,first,free,fruiting,glabrescen,glabrescent,glabrous,hair,half,high,indument,inserted,interpetalar,lacking,lanceolat,late,later,lateral,lobed,long,longitudinal,lower,m.,main,many-rayed,margin,matted,midvei,midvein,mixed,multangulate,nearly,nflorescence,obscured,obtuse,often,older,orbicular,orolla,overlapping,partly,peduncle,perfect,persistent,plurifoliate,porrect-stellate,present,prominent,pseudo-terminal,pubescent,rachi,rather,ray,relatively,rounded,ruit,runk,sessile,short,short-stalked,side,slit,small,somewhat,sparingly,sparsely,stalked,stamen,stout-stalked,strongly,subcoriaceous,suture,tamen,testa,thick,thick-stalked,thin,thin-stalked,time,tissue,tomentu,touching,translucent,unarme,unit,usually,vary,vein,warty,way,wide,ympodial	1-3,30-150,abaxial,adaxial,arrangement,capitate,colour,feature,form,height,hermaphroditic,history,inflorescence,life,number,ovary,papilla,perennial,plant,pseudoterminally,reproduction,seed,shape,size,surface,texture,tip,type,width	1.1-1.2,10-20,2-6,2.8-3.5,3-10,3-15,3.4-3.6,4-6,4-8,9-14,apical-lateral,berry,blunt-tipped,branched,brown,closely,cm,conical,cream,dark,deltoid,ferrugineous,fleshy,granular-tomentose,gray,green,greenish,honeycombed,introrse,lanceolate,large,mm,oblong,ovate,ovate-lanceolate,pale,pore,probably,reniform,reticulate-punctate,ripe,scabridulous,simple,slightly,spaced,stellate,stelliform,subglobose,suborbicular,sulcate,terete,tomentose,tree,unarmed,velutinous,x,yellow,yellowish,yellowish-green	1-3,30-150,capitate,hermaphroditic,perennial,pseudoterminally
236	wfo-0001028525	success	257	126	83	103	154	23	81	2	0.2-0.6,0.5-1.5,1-1.5,1-2,1-4,1.1-1.7,1.2-1.6,1.5-3,10,10-13,2,2-3,2.5-5,3,3-7,4,7,7-13,acuminate,acute,age,almost,anther,apart,apex,apically,apparently,attenuate,bark,base,berry,black,broadly,brown,calyx,capitate,clavate,clearly,cm,cordate,corolla,dark,delineated,deltoid,developed,dilated,drying,elongated,filament,flower,form,free,fruit,glabrescent,glabrous,grey,leaf,lengthening,liana,light,linear,lobe,lobed,longitudinally,lumpy,mature,mauve,mm,multicellular-dendritic,narrowly,obconical,oblong,orange-brown,ovate,ovoid,partly,pedicel,petiole,pore,poricidal,pubescent,pyriform,ridged,scar,shrub,simple,size,smooth,spheroidal,stem,stigma,style,surface,terminal,tip,trichome,truncate,tube,unarmed,weakly,whitish,x,young	.25,.4,0.2-0.3,0.5,0.5-2.5,0Â°,1-2.5,1.5,1/3-3/4,1mm,2-2.5,3-5,4-15,4-5,4-7,6,7.5,accrescent,along,alternate,alyx,anthesi,apar,apice,around,articulated,axil,becoming,brachyblast,branch,branched,branching,centre,chartaceous,clum,clustered,conical,cup,curved,deeply,dendritic,dendritic-pubescent,densely,density,detaching,developing,diameter,discolorous,divided,domatia-like,dorsal,dorsifixed,eaf,eed,ellipsoi,entire,equal,erect,eye,fertilisation,fewer,fine,flat,flattened,flexible,flexuous,formed,forming,frequently,frui,fruiting,green-brown,increasing,inside,known,lamina,lateral,laterally,leave,less,like,long,longer,loop,loose,lower,m.,main,margin,membranous,midvein,minute,much,naked,nflorescence,nther,obscuring,often,one,orolla,outside,overlapping,pair,peduncle,pendulous,perfec,pericarp,plurifoliat,portion,primary,prominent,protruding,puberulous,rachi,ray,red-brown,rounded,ruit,scattered,sessile,side,sinus,slender,slightly,small,smaller,smoot,sometimes,somewhat,soon,sparsely,spreading,stripe,structure,stump,tangling,tearing,terete,tertiary,thick,thin,toward,ud,uneven,unit,vary,vein,venation,visible,well-developed,white,wide,wider,ympodial	arrangement,bud,colour,connation,decurrency,ellipsoid,feature,growth,inflorescence,length,minor,na,new,number,ovary,papilla,seed,shape,spacing,texture,type,width,winging	0.2-0.6,0.5-1.5,1-1.5,1-2,1-4,1.1-1.7,1.2-1.6,1.5-3,10,10-13,2,2-3,2.5-5,3,3-7,4,7,7-13,acuminate,acute,age,almost,apart,apically,apparently,attenuate,base,berry,black,broadly,brown,capitate,clavate,clearly,cm,cordate,dark,delineated,deltoid,developed,dilated,drying,elongated,free,fruit,glabrescent,glabrous,grey,lengthening,liana,light,linear,lobed,longitudinally,lumpy,mature,mauve,mm,multicellular-dendritic,narrowly,obconical,oblong,orange-brown,ovate,ovoid,partly,poricidal,pubescent,pyriform,ridged,shrub,simple,smooth,spheroidal,terminal,tip,trichome,truncate,weakly,whitish,x	ellipsoid,na
237	wfo-0001028528	success	155	118	80	92	63	26	76	4	.5,0.9-1.2,1-2,1.1-1.2,1.8-2,2-4,3.5-4,3.5-6,3/4,4-5,4-6,6-10,8-9,absent,acuminate,acute,age,anther,anthesi,apex,apical,attenuate,basal,base,becoming,berry,bi-lobed,blackish,branch,branching,calyx,cm,conical,corolla,decurrent,dendritic,diameter,elliptic,erect,filament,flattened,flower,fork,free,glabrous,globose,growth,later,leaf,lobe,lobed,long,minutely,mm,mucronate,narrowly,nodding,obovate,occasionally,outline,ovary,pedicel,per,petiole,pitted,plurifoliate,pore,poricidal,pubescent,reddish-brown,round,shrub,slit-like,somewhat,sparsely,stem,stigma,strongly,style,surface,tapering,terminal,tip,triangular,trichome,tube,violet,way,white,woody,x,young	1.5,2-3,2.5-3,6-7,?,abaxial,adaxial,adaxially,along,ba,bark,coriaceous,densely,denser,dichasia,eaf,edicel,eed,ew,except,exserted,fruiting,glabrat,glandular,immature,impressed,inserted,leave,like,lower,m.,margin,midvein,minute,nflorescence,older,pair,papillo,pericarp,petal,planar,portion,prominent,pyramidal,revolute,ruit,scar,secondary,shiny,short,sleeve,stamen,ste,tall,thin,time,tub,ud,unit,vein,wide,winged,ympodial	arrangement,bud,colour,connation,dichasial,dry,feature,form,fruit,glabrate,height,inflorescence,length,na,number,papilla,papillose,plant,seed,shape,size,specimen,texture,type,width,winging	.5,0.9-1.2,1-2,1.1-1.2,1.8-2,2-4,3.5-4,3.5-6,3/4,4-5,4-6,6-10,8-9,absent,acuminate,acute,age,anthesi,apical,attenuate,basal,base,becoming,berry,bi-lobed,blackish,branch,branching,cm,conical,decurrent,dendritic,diameter,elliptic,erect,flattened,fork,free,glabrous,globose,later,lobed,long,minutely,mm,mucronate,narrowly,nodding,obovate,occasionally,outline,per,petiole,pitted,plurifoliate,pore,poricidal,pubescent,reddish-brown,round,shrub,slit-like,somewhat,sparsely,stem,strongly,tapering,terminal,tip,triangular,trichome,violet,way,white,woody,x	dichasial,glabrate,na,papillose
238	wfo-0001028529	success	164	132	89	102	62	30	84	5	.2,0.1,0.5,0.5-2,0.8-1.3,0.8-3,0.8-3.2,1-1.5,1.5,2/3,3-40-flowered,3-5,5-6,7-8,8-14,acuminate,acute,age,anther,apart,apex,apiculate,attenuate,bark,base,becoming,beginning,berry,bluish,brown,bud,calyx,capitate,cast,close,cm,corolla,dark,decurrent,deltoid,dia,elliptic,erect,exfoliating,filament,flower,furcate,glabrous,globose,green,hyaline,internodal,lanceolate,leaf,less,linear,lobe,lobed,long,metallic,minor,minutely,mm,narrowly,nearly,oblanceolate,occasionally,older,opposite,ovary,ovoid-reniform,paler,papillose,pedicel,petiole,pitted,pore,poricidal,scar,shape,shaped,shrub,simple,size,slender,smooth,somewhat,stem,stigma,style,subshrub,surface,tapering,tear-drop,tip,tube,way,white,winged,woody,x,yellowish	1,1-1.2,2.5-3,6-9,across,anthesi,beneath,cork,course,deflexe,distal,eaf,edicel,eed,ellipsoi,evenly,exserted,free,fruiting,growing,heterostylous,hrub,immature,indistinct,inflorescenc,lateral,lenticellat,lon,lower,main,major,middle,minute,much,nflorescence,one,pair,papillae,papillo,planar,portion,present,prominent,range,reflexed,river,ruit,scattered,short,slightly,small,soon,spaced,species,straight,tall,ud,umbonate,variable,vein,widest,young	abaxial,adaxial,alternate,arrangement,colour,connation,corky,dry,feature,form,fruit,growth,height,history,inflorescence,length,lenticellate,life,na,number,papilla,plant,reproduction,seed,spacing,specimen,texture,type,width,winging	.2,0.1,0.5,0.5-2,0.8-1.3,0.8-3,0.8-3.2,1-1.5,1.5,2/3,3-40-flowered,3-5,5-6,7-8,8-14,acuminate,acute,age,apart,apiculate,attenuate,base,becoming,beginning,berry,bluish,brown,calyx,capitate,cast,close,cm,dark,decurrent,deltoid,dia,elliptic,erect,exfoliating,furcate,glabrous,globose,green,hyaline,internodal,lanceolate,leaf,less,linear,lobed,long,metallic,minutely,mm,narrowly,nearly,oblanceolate,occasionally,older,opposite,ovoid-reniform,paler,papillose,pitted,pore,poricidal,shaped,shrub,simple,slender,smooth,somewhat,stem,subshrub,tapering,tear-drop,tip,tube,way,white,winged,woody,x,yellowish	alternate,corky,inflorescence,lenticellate,na
239	wfo-0001028532	success	186	126	79	98	88	28	75	4	0-19,0.2-1,1-1.7,1-2,1-3,1.4-1.6,15-36,2-3,2-8,2.2-4.2,3-10,3-7,3.9-5,4-7,5-9,5.5-15,6.5-9.2,7.5-15.2,acumen,acuminate,acute,anther,apex,attenuate,axillary,base,berry,blade,bud,cell,chartaceous,clavate,cm,connivent,corolla,covering,dark,deep,diameter,filament,flower,forked,fruit,glabrous,globose,green,green-white,hair-like,herb,homostylous,interjected,lanceolate,lateral,leaf,leaflet,lobe,long,make,medium,mm,moniliform,mottled,mucilaginous,odd-pinnate,ovate,ovate-lanceolate,ovoid,pair,pentagonal,petiole,petiolulate,plant,pore,poricidal,purple,ripe,rotate,rounded,seed,size,sometimes,spot,stigma,straight,style,subtending,terminal,testal,thick,throughout,tip,tube,tuber,unwinged,wall,wet,white,x	1-1.6,1-5,1.3-8.7,17-42,2-6,3-5,3.3-4.4,5-merou,abaxiall,abaxially,adaxially,ag,along,alyx,apart,apparently,arranged,articulated,asymmetric,axe,basiscopic,bead,brownish,capitat,condition,decreasing,digestion,distal,dorsally,drying,eaf,edge,eed,enzyme,erec,exceeding,flat,folded,fresh,geminat,generally,glabrou,greenish,half,honeycomb-shaped,larger,lengthening,like,linear,living,lower,middl,multiple,necklace,nflorescence,orbicular,orolla,pedicel,peduncle,perfect,plurifoliate,removed,ruit,second,sessile,seudostipule,side,slightly,slit,spaced,specimen,stamen,stolon,subequal,symmetric,tall,tamen,tem,tissue,toward,tri-,typically,unit,usually,vary,whitish,yellow,ympodial	5-merous,abaxial,adaxial,arrangement,calyx,capitate,colour,connation,feature,form,growth,height,history,inflorescence,length,life,na,number,ovary,perennial,pseudostipule,reproduction,shape,staman,stem,surface,texture,type	0-19,0.2-1,1-1.7,1-2,1-3,1.4-1.6,15-36,2-3,2-8,2.2-4.2,3-10,3-7,3.9-5,4-7,5-9,5.5-15,6.5-9.2,7.5-15.2,acuminate,acute,attenuate,axillary,berry,bud,cell,chartaceous,clavate,cm,connivent,covering,dark,deep,forked,glabrous,globose,green,green-white,hair-like,herb,homostylous,lanceolate,lateral,long,make,medium,mm,moniliform,mottled,mucilaginous,odd-pinnate,ovate,ovate-lanceolate,ovoid,pentagonal,petiolulate,poricidal,purple,ripe,rotate,rounded,seed,sometimes,spot,straight,subtending,terminal,testal,thick,throughout,tip,unwinged,wall,wet,white,x	5-merous,capitate,na,perennial
240	wfo-0001028547	success	221	141	85	102	119	39	81	4	-3,.2,.5,.7,.8,/5,0-2,0.8-1,1-2.5,1-5,1.2-1.4,2-1.5,2-4,2-6,2.5-2.8,2.8-3.2,3-5,3.5-4.5-6,7-10-13,acute,anther,apart,apex,apically,articulated,bark,base,berry,bright,calyx,cell,cm,conical,connivent,cuneate,curved,deltate,densely,erect,filament,flattened,flattened-reniform,flower,fruit,glabrescent,glabrous,inflorescence,lateral,leaf,length,lobe,lobed,long,long-acuminate,maturity,mauve,midpoint,mm,moderately,narrow-deltate,oblong,orange,outline,ovate,pedicel,petiole,pit,poricidal,porrect,prickle,prickly,purple,raised,ray,red,reddish,reflexed,scar,shrub,simple,small,smooth,sometimes,somewhat,spherical,spreading,stellate-pubescent,stem,straight,style,subsessile,surface,tapering,terminal,tip,trichome,truncate,tube,way,wide,yellow-orange,young	/2,0,0-1,0-10,0-15,0-30,0-5,0.05-0.15,0.1-0.2,0.15,0.2-0.35,0.3-0.4,0.5-1.5-2.5-3,0.7-1,1-2,1-4,1.5-2.5,1.7-2,1/3-1/2,1/5-1/4,10-12,2-2.5,4-5,4-6,5-merous,6-8,7-9,abaxial,abaxially,absent,adaxial,alyx,apar,ape,apparently,appearing,blade,branched,branching,bulbous,chartaceous,cream,dark,diameter,discolorous,distance,drying,dull,eaf,eed,elongate,elongating,entire,equal,extending,faint,free,fruiting,gently,glabrou,gray-brow,green,infructescence,lon,long-styled,longer,lower,margin,marking,mature,midvein,nflorescence,occasionally,often,older,one,open,orange-brown,orolla,oung,pair,pale,peduncle,pendulous,per,perfect,pericarp,plurifoliat,portion,prickl,primary,rounded,ruit,scandent,sessile,shallowly,short-styled,side,slender,spaced,stalk,stalked,staminate,stellate,tamen,terete,tertiary,thin-acuminat,time,unit,usually,vary,vein,venation,villous,woody,yellow,yellow-green,ympodial	anthesi,arrangement,bud,coat,colour,connation,corolla,decurrency,dry,embryo,feature,form,gray-brown,growth,height,history,life,minor,new,number,ovary,papilla,perennial,plant,pore,reproduction,seed,shape,size,spacing,specimen,stigma,texture,thin-acuminate,tuberculation,type,unknown,width,winging	-3,.2,.5,.7,.8,/5,0-2,0.8-1,1-2.5,1-5,1.2-1.4,2-1.5,2-4,2-6,2.5-2.8,2.8-3.2,3-5,3.5-4.5-6,7-10-13,acute,apart,apically,articulated,base,berry,bright,cell,cm,conical,connivent,cuneate,curved,deltate,densely,erect,flattened,flattened-reniform,glabrescent,glabrous,lateral,lobed,long,long-acuminate,maturity,mauve,mm,moderately,narrow-deltate,oblong,orange,outline,ovate,pit,poricidal,porrect,prickle,prickly,purple,raised,red,reddish,reflexed,shrub,simple,small,smooth,sometimes,somewhat,spherical,spreading,stellate-pubescent,straight,subsessile,tapering,terminal,tip,trichome,truncate,way,wide,yellow-orange	gray-brown,perennial,thin-acuminate,unknown
241	wfo-0001028587	success	178	138	92	110	68	28	89	3	.4,.5,0.3,0.3-1,0.5-1,0.8-1.8,0.8-2.9,1-2,1-4,1.3-5.1,1/4,2.1-6.9,2.5,3-8,6-8,6.5-17.7,8-10,abruptly,acuminate,acute,anther,anthesi,apex,bark,base,becoming,berry,calyx,closely,cm,corolla,cracking,degree,densely,distal,drying,ellipsoid,erect,filament,flower,fruit,geminate,glabrous,globose,green,greenish-white,lamina,layer,leaf,length,lobe,lobed,long,long-styled,major,minor,minute,minutely,mm,narrowing,nearly,obe,obovate,obovoid,older,opposite,outer,ovary,ovate,ovoid-reniform,papillose,pedicel,peeling,petiole,pitted,pore,poricidal,puberulent,pubescent,pubesent,scar,scattered,seed,short,shrub,simple,slender,slit-like,spaced,sparsely,stem,stigma,straw-colored,style,subumbellate,surface,tip,triangular,trichome,tube,type,unicellular,uniseriate,upon,variable,vein,white,woody,x,young	.75,0,0.5,0.7-1.2,0.8-1.6,1-1.3,1-1.5,2-5,8-10-flowered,accrescent,across,baseflower,brown,ca,chartaceou,coat,cup,deflexed,dia,different,difoliate,eaf,edicel,eed,forming,free,fruiting,geminat,impressed,keeled,lateral,like,lon,lower,main,middle,midrib,nflorescence,occasionally,often,open,overlappin,pair,paler,papillo,per,persistent,portion,pubescence,reflexed,ruit,slightly,stiff,straight,tall,terminal,thickened,thin,transversel,two,ud,umbonate,unit,upper,usually,wide,widest,ympodial	abaxial,adaxial,arrangement,bud,colour,connation,dry,feature,form,growth,hair,height,history,inflorescence,life,na,number,overlapping,papilla,plant,reproduction,shape,size,spacing,specimen,texture,transversely,width	.4,.5,0.3,0.3-1,0.5-1,0.8-1.8,0.8-2.9,1-2,1-4,1.3-5.1,1/4,2.1-6.9,2.5,3-8,6-8,6.5-17.7,8-10,abruptly,acuminate,acute,base,becoming,berry,calyx,closely,cm,cracking,degree,densely,distal,drying,ellipsoid,erect,flower,geminate,glabrous,globose,green,greenish-white,lamina,layer,leaf,length,lobed,long,long-styled,minute,minutely,mm,narrowing,nearly,obe,obovate,obovoid,opposite,outer,ovate,ovoid-reniform,papillose,peeling,pitted,pore,poricidal,puberulent,pubescent,pubesent,scattered,short,shrub,simple,slender,slit-like,spaced,sparsely,straw-colored,style,subumbellate,tip,triangular,trichome,tube,unicellular,uniseriate,upon,variable,vein,white,woody,x	na,overlapping,transversely
242	wfo-0001028594	success	142	98	59	75	67	23	55	4	0.3-1.0,1-1.2,1-1.3,1-1.5,1-2,1.5-9,12,2,3-4,3-6,3-9,6-20,acuminate,acute,anther,apex,axillary,base,becoming,black,bottle-shaped,calyx,cm,conical,corolla,densely,diameter,drying,ellipsoid,elliptic,especially,flattened-reniform,flower,fruit,fruiting,glabrous,globose,green,hair-like,herb,immature,inflorescence,leaf,length,long,margin,maturity,minutely,mm,ovary,ovate,papillate,pedicel,petiole,planar,projection,pubescent,purple,reddish,reflexed,rounded,simple,slightly,smooth,somewhat,sparsely,stigma,style,surface,tip,trichome,tube,uniseriate,violet,x	.5,0-100,0.8-1.8,1-3,12-14,5-6,6-7,abaxially,adaxially,along,anthesi,axil,bearing,berry,capitat,cell,climbing,denser,eaf,edicel,eed,epidermal,exserted,filament,floo,forest,free,glabrat,inflorescenc,lax,like,lobe,lon,lower,minute,nflorescence,noddin,obtuse,often,open,orange-brown,pair,pendent,per,portion,primary,quit,rectangular,regular,rest,ruit,scar,scattered,side,soft,spreading,strait,strongly,tem,time,trailing,tub,ud,unifoliat,unit,vein,ympodial	abaxial,adaxial,arrangement,bud,capitate,colour,feature,form,growth,height,history,life,na,number,perennial,plant,reproduction,seed,shape,size,stem,texture,unifoliate	0.3-1.0,1-1.2,1-1.3,1-1.5,1-2,1.5-9,12,2,3-4,3-6,3-9,6-20,acuminate,acute,axillary,becoming,black,bottle-shaped,cm,conical,densely,drying,ellipsoid,elliptic,especially,flattened-reniform,glabrous,globose,green,hair-like,herb,immature,long,margin,maturity,minutely,mm,ovate,papillate,planar,projection,pubescent,purple,reddish,reflexed,rounded,simple,slightly,smooth,somewhat,sparsely,trichome,uniseriate,violet,x	capitate,na,perennial,unifoliate
243	wfo-0001028660	success	204	96	53	66	138	30	49	4	0.5-2.8,0.5-5.5,0.8-1,0.9-2.5,1-10,1-2,1.5-2.8,1.5-4,1.5-7.6,2-11,2-9,3-30,3-7,3-9,3.8-13,4-6,5-8,7-10,acute,anther,attenuate,axillary,berry,bud,chartaceous,clavate,cm,connivent,corolla,densely,diameter,filament,flower,forked,fruit,glabrous,globose,green,herb,lanceolate,lobe,long,membranous,mm,mucilaginous,odd-pinnate,ovoid,pedicel,peduncle,pentagonal,petiole,plant,pubescent,rotate,seed,size,sparsely,stem,stigma,style,substellate,subtending,terminal,tube,unwinged,wet	0-5,0.1-0.3,0.2-1.1,0.3-1.1,0.7-4.2,2-5,2-6,20,3-5,5-merou,6,abaxially,absent,acumen,adaxially,ag,along,alyx,apart,apex,apparently,articulated,axe,base,blade,blue,borne,broadly,brownish,capitat,cell,ciliate,condition,covering,decumbent,decurrent,digestion,distal,dorsally,dot,drying,eaf,edge,eed,elliptic,end,entirely,enzyme,erec,especially,exceeding,except,flat,folded,fresh,geminat,generally,glabrou,greatly,green-white,greenish,hair,hair-like,half,homostylous,honeycomb-shaped,interjected,lateral,leaflet,lengthening,less,like,linear,living,lower,make,margin,middl,midrib,minutely,narrowly,nflorescence,oblique,obtuse,often,orbicular,orolla,ovate,pair,perfect,petiolulate,petiolule,plurifoliate,pore,poricidal,proximal,puberulent,purple,rarely,reduced,removed,ripe,ruit,scabrous,scattered,sessile,seudostipule,short,singly,slit,spaced,specimen,stamen,ste,stolo,straight,subequal,sunny,tall,tamen,tem,testal,thick,throughout,tinged,tip,tri-,tuber,typically,unit,usually,vary,wall,white,whitish,x,yellow,ympodial	abaxial,adaxial,arrangement,calyx,capitate,colour,connation,feature,form,geminate,growth,height,history,inflorescence,leaf,length,life,na,number,ovary,perennial,pseudostipule,reproduction,shape,spacing,surface,texture,type,width,young	0.5-2.8,0.5-5.5,0.8-1,0.9-2.5,1-10,1-2,1.5-2.8,1.5-4,1.5-7.6,2-11,2-9,3-30,3-7,3-9,3.8-13,4-6,5-8,7-10,acute,attenuate,axillary,berry,bud,chartaceous,clavate,cm,connivent,densely,forked,glabrous,globose,green,herb,lanceolate,long,membranous,mm,mucilaginous,odd-pinnate,ovoid,pentagonal,pubescent,rotate,sparsely,substellate,subtending,terminal,unwinged,wet	capitate,geminate,na,perennial
244	wfo-0001028667	success	128	87	54	65	63	22	51	3	0.4-0.7-2.6,1-1.5,1-4.5,1-6,3,3-11,5,5-20,acute,apex,articulated,axillary,base,branch,branched,calyx,clustered,cm,completely,conical,corolla,creamy,dry,ellipsoid,elliptic,exfoliating,flattened,flower,fragrant,glabrous,growth,inflorescence,irregularly,leaf,lobe,minutely,mm,narrowly,new,occasionally,other,pedicel,petiole,pitted,reniform,scar,shiny,shoot,short,simple,sleeve,small,spaced,stem,surface,terminal,tip,triangular,tube,twice,vine,white,woody,wrinkling,x	.5,0.7-4,1-2-1.5,1.3-2,5-merou,8-10,aid,alyx,anthesi,apar,appearing,ark,around,berry,cell,climbin,climbing,coriaceous,curling,deciduous,diameter,discolorous,eaf,eed,entire,exfoliatin,exserted,fide,fruiting,like,long,lower,margin,mentz,midrib,nflorescence,older,orolla,outer,pale,papilla,papillat,peduncle,pendan,per,perfect,plurifoliat,primary,revolute,slender,slightly,soon,straw-colored,strongly,support,tem,twining,ud,unit,vein,visible,yellow,ympodial	abaxial,adaxial,apart,arrangement,bark,bud,coat,colour,feature,form,length,na,number,papillae,seed,shape,size,spacing,texture,tuberculation,type,width	0.4-0.7-2.6,1-1.5,1-4.5,1-6,3,3-11,5,5-20,acute,articulated,axillary,base,branch,branched,clustered,cm,completely,conical,creamy,dry,ellipsoid,elliptic,exfoliating,flattened,fragrant,glabrous,inflorescence,irregularly,minutely,mm,narrowly,occasionally,other,pitted,reniform,shiny,shoot,short,simple,sleeve,small,spaced,terminal,tip,triangular,twice,vine,white,woody,wrinkling,x	apart,na,papillae
245	wfo-0001028688	success	137	101	65	76	61	25	59	6	.5,0.4-1,0.5,0.5-0.75,0.5-1,0.5-1.5,0.9-1,1-1.5,1-1.8,1-3,1-5,1.4-2.8,2-3,2.2-4.8,5-11,5-6,acuminate,acute,anther,apex,area,bark,base,calyx,cm,corolla,curl-tipped,deltoid,dia,elliptic,filament,glabrous,globose,golden,lanceolate,leaf,like,lobe,lobed,long,minor,mm,near,nearly,opposite,ovary,overtopping,papillose,pedicel,petiole,pilose,pore,poricidal,pubescent,reddish-brown,scar,shaped,shiny,shoot,shrub,size,slender,slightly,sparsely,stem,stigma,style,tapering,tear-drop,tip,trichome,tube,uniseriate,white,x,young	1.1-1.2,across,along,anthesi,apar,beneath,bi-cellular,branch,clavate,deciduous,decreasing,deflexed,densely,densest,differing,difoliate,eaf,edicel,eed,exfoliatin,exserted,free,furcate,geminat,interpetalar,irregularly,know,known,lon,lower,major,markedly,membraneous,middle,minutely,nflorescence,occasionally,often,older,paler,planar,portion,proximal,ruit,sinus,soon,spaced,straight,styl,tall,terminal,thickened,thin,tub,ud,unit,usually,vein,wide,widest,ympodial	abaxial,adaxial,alternate,apart,arrangement,bud,colour,exfoliating,feature,form,fruit,growth,hair,height,inflorescence,length,na,plant,seed,shape,spacing,surface,texture,type,width	.5,0.4-1,0.5,0.5-0.75,0.5-1,0.9-1,1-1.5,1-1.8,1-3,1-5,1.4-2.8,2-3,2.2-4.8,5-11,5-6,acuminate,acute,area,base,calyx,cm,curl-tipped,deltoid,elliptic,glabrous,globose,golden,lanceolate,leaf,like,lobed,long,mm,near,nearly,opposite,overtopping,papillose,pilose,poricidal,pubescent,reddish-brown,shaped,shiny,shoot,shrub,slender,slightly,sparsely,stem,style,tapering,tear-drop,tip,trichome,tube,uniseriate,white,x	.5-1.5,alternate,apart,di,exfoliating,na
246	wfo-0001028698	success	166	87	48	60	106	27	44	4	0.3-0.75,1-2,1.9-4,2-10,2-3,2-4,3-17,3-5,5-6,5-8,6-13,6-27,8-10,9-35,branched,calyx,cm,conical,connate,corolla,cyme,dark,diameter,dichasial,dichasially,ebracteate,ellipsoid,flower,forked,green,herbaceous,interjected,lateral,leaf,leaflet,light,long,medium,mm,monochasial,mucilaginous,odd-pinnate,ovoid,pair,pentagonal,perennial,petiole,plant,puberulent,pubescent,rotate,seed,size,stigma,strigose,style,terminal,violet,white,yellow	0-1.,1-4,1-9.8,1.8-5,13-25,3-6-foliat,3.5,4-14,5-15,6,abaxiall,abaxially,acumen,acuminate,acute,adaxially,apex,apical,apically,articulate,base,broadly,cell,commonly,covering,cuneate,darker,decurrent,dehiscent,digestion,diminishing,distal,dorsally,dot,eaf,edge,eed,elliptical,emoval,enzyme,equal,exceeding,filament,first,flat,folded,generally,globo,gradually,green-white,hair-like,half,honeycomb,introrse,living,lobe,lon,long-attenuate,lower,lunat,make,maturing,minute,nflorescence,nther,oblique,often,orolla,ovate,pattern,pedicel,peduncle,perfect,petiolule,plan,poricidally,proximal,rachi,raised,rarely,reveal,ruit,sessile,seudostipule,short,slit,smooth,specimen,stamen,straight,tal,tem,testal,thick,throughout,toward,tuber-bearing,two,typically,unit,usually,vary,wall,wide,ympodial,Â¼	0-10,abaxial,adaxial,anther,arrangement,colour,connation,feature,form,fruit,globose,growth,height,history,inflorescence,length,life,na,number,ovary,reproduction,shape,stem,surface,texture,wet,width	0.3-0.75,1-2,1.9-4,2-10,2-3,2-4,3-17,3-5,5-6,5-8,6-13,6-27,8-10,9-35,branched,cm,conical,connate,cyme,dark,dichasial,dichasially,ebracteate,ellipsoid,forked,green,herbaceous,light,long,medium,mm,monochasial,mucilaginous,odd-pinnate,ovoid,pentagonal,perennial,puberulent,pubescent,rotate,strigose,violet,white,yellow	0-10,globose,na,wet
247	wfo-0001028716	success	145	109	51	70	75	39	47	4	.5,0.5,0.6-1.9,1-2,1.9-5.5,11-16.4,2-4,2.2-7.9,2.5-8,3.6-8.8,8-9,acuminate,anther,anthesi,apart,apex,bark,base,brown,calyx,cm,corolla,cuneate,dark,decurrent,ellipsoid,elliptic,filament,filiform,fruit,glabrous,hirsute,leaf,less,lobe,lobed,minor,minutely,mm,opposite,orbicular,ovary,ovate,papillose,pedicel,petiole,pore,poricidal,pubescent,rounded,scar,shape,shaped,shrub,simple,size,slightly,sparsely,stem,style,tear-drop,tip,triangular,trichome,truncate,tube,uniseriate,white,x,young	.2,0.75,10-40-flowered,5-6,7-8,9-10,across,anisophyllou,appearing,asymmetric,ba,becoming,beginning,beneath,bi-cellular,branched,deflexed,dia,differing,difoliate,eaf,edicel,eed,evenly,except,fertilization,fifth,free,geminate,glandular,inflorescenc,intermediate,know,known,lateral,lengthening,lenticellat,like,lon,long,long-triangular,lower,main,major,markedly,middle,much,nearly,nflorescence,node,often,older,one,pair,pointed,portion,prominent,proximal,puberulent,raised,reflexed,remaining,ruit,spaced,stigm,straight,strongly,tall,two,ud,unit,vein,widening,widest,ympodial	10-40,alternate,arrangement,bud,coat,colour,connation,decurrency,dry,embryo,feature,flower,form,growth,height,history,inflorescence,length,lenticellate,life,midpoint,na,new,number,papilla,plant,prickle,ray,reproduction,seed,spacing,specimen,stigma,surface,texture,tuberculation,type,width,winging	.5,0.5,0.6-1.9,1-2,1.9-5.5,11-16.4,2-4,2.2-7.9,2.5-8,3.6-8.8,8-9,acuminate,apart,brown,cm,cuneate,dark,decurrent,ellipsoid,elliptic,filiform,glabrous,hirsute,leaf,less,lobed,minutely,mm,opposite,orbicular,ovate,papillose,poricidal,pubescent,rounded,shaped,shrub,simple,slightly,sparsely,tear-drop,triangular,trichome,truncate,uniseriate,white,x	10-40,alternate,lenticellate,na
248	wfo-0001028723	success	211	118	66	96	115	22	62	4	.3,.5,0.8-1,1,1-2.2,1-2.5,2-2.5,2-2.7,2-4,4,4-5,5,5-6,5-7,abaxial,abaxially,acute,adaxially,almost,anther,apex,bark,base,branch,branching,broadly,brown,calyx,capitate,clustered,cm,common,corolla,dark,dendritic,diameter,domatia,elliptic,entire,faint,filament,fine,flat,glabrous,green,leaf,length,less,liana,lobe,lobed,long,long-attenuate,longitudinally,main,margin,membranous,midvein,minutely,mm,narrowly,obconical,oblong,obovate,occasional,orange-brown,ovate,pair,pedicel,peduncle,petiole,pore,poricidal,primary,pubescent,raised,ridged,scar,shrub,stem,stigma,style,surface,terminal,tertiary,tip,trichome,tube,unarmed,unevenly,vein,venation,white,widely,x,young	-1.5,0-0.5,0.2,0.8-2,0Â°,1-1.5,1-1.8,1/3-1/2,1/5-1/3,10-15,10-16,2.5,3-4,3.5-4,age,alternate,alyx,another,anthesi,apar,apically,apice,apparently,articulated,becoming,brachyblast,branched,clearly,concolorous,conical,curved,decurrent,delineated,deltoid,densely,density,developed,dilated,divided,dorsifixed,drying,eaf,eed,ellipsoi,equal,except,ey,flexuous,flower,formed,free,frequent,gradual,increasing,inner,junction,know,known,lengthening,like,lower,m.,middle,mostly,much,multiply,naked,nflorescence,nther,obtuse,one,orolla,outer,overlapping,pale,papillo,perfec,plurifoliat,poorly,portion,prominent,protruding,rachi,ray,region,regular,ruit,separated,short,side,simple,sinus,slender,small,smaller,smooth,sparsely,spreading,stump,surrounding,tearing,tissu,toward,transition,tuft,ud,uneven,unit,vary,visible,wide,wrinkled,yellow,ympodial,youngest	adaxial,apart,arrangement,bud,colour,ellipsoid,feature,form,fruit,growth,hair,inflorescence,na,ovary,papillose,seed,shape,size,spacing,texture,type,width	.3,.5,0.8-1,1,1-2.2,1-2.5,2-2.5,2-2.7,2-4,4,4-5,5,5-6,5-7,abaxially,acute,adaxially,almost,broadly,brown,capitate,clustered,cm,common,dark,dendritic,diameter,elliptic,entire,faint,fine,flat,glabrous,green,less,liana,lobed,long,long-attenuate,longitudinally,membranous,minutely,mm,narrowly,obconical,oblong,obovate,occasional,orange-brown,ovate,pair,poricidal,pubescent,raised,ridged,shrub,terminal,trichome,unevenly,white,widely,x	apart,ellipsoid,na,papillose
249	wfo-0001028736	success	180	123	73	86	94	37	69	4	0.5-1,0.5-1.5,1,1-1.5,1-2,1-3,1.5-3,10-15,3-8,4-12,4-6,5-10,5-15,absent,acute,anther,apex,apical,armed,attenuate,base,berry,calyx,cm,connivent,created,cylindrical,decurrent,densely,directed,extra-axillary,filament,filiform,flower,fruit,glandular,globose,green,hair,immature,leaf,length,lobe,lobed,many,mature,midpoint,mm,moderately,mottled,multicellular,narrowly,nearly,netlike,obtuse,onto,orange,pedicel,petiole,pit,pore,porrect-stellate,prickle,pubescent,raised,ray,red,reniform,rhombic,ridge,shrub,simple,small,stem,stigma,style,surface,tapering,triangular,tube,unbranched,uniseriate,white,x,yellow,yellow-white	0.2-0.4,0.5,0.5-1mm,0.5-2,1.5,1/6,2-4,2-5,2-7,3-5,3-6,3.5-5,4-9,40-70,5-merou,6-13x3-8,6-8,abaxially,accrescent,adaxiall,adaxially,alyx,apar,apparently,axe,beyond,blade,brown,chartaceous,contiguous,cordate,cut,dark,diameter,difoliate,discolorous,eaf,eed,either,exserted,flattened,frui,fruiting,geminate,glabrou,glabrous,gree,introsel,less,light,like,long,lower,m.,major,midrib,midvein,multiseriate,nflorescence,occasional,occasionally,orolla,pair,peduncle,per,perfect,purple,rachi,recurved,roselike,ruit,scanden,side,sinus,slightly,spaced,sparsely,stalk,stamen,ste,stellate,tamen,tem,thin-skinned,unarmed,unequa,unicellular,unit,unlobed,vary,vein,way,wide,ympodial	6-13,apart,arrangement,bark,bud,colour,connation,corolla,decurrency,embryo,feature,form,growth,height,history,inflorescence,introsely,life,minor,na,new,number,ovary,papilla,plant,reproduction,scar,seed,shape,size,spacing,texture,tip,type,width,winging,young	0.5-1,0.5-1.5,1,1-1.5,1-2,1-3,1.5-3,10-15,3-8,4-12,4-6,5-10,5-15,absent,acute,apical,armed,attenuate,base,berry,cm,connivent,created,cylindrical,decurrent,densely,directed,extra-axillary,filiform,flower,fruit,glandular,globose,green,hair,immature,lobed,many,mature,mm,moderately,mottled,multicellular,narrowly,nearly,netlike,obtuse,onto,orange,petiole,pit,porrect-stellate,pubescent,raised,red,reniform,rhombic,ridge,shrub,simple,small,tapering,triangular,unbranched,uniseriate,white,x,yellow,yellow-white	6-13,apart,introsely,na
250	wfo-0001028737	success	151	102	63	74	77	28	59	4	0.2-0.5,0.7-2,1,1-2.5,1-4,1-6,1.5-3.5,12-14,16-30,2-3,2-5,2.8-3.5,3-5,4-10,4-6.5,4-9,6,7-15,apical,branched,calyx,cell,cm,connate,corolla,covering,cyme,dehiscent,diameter,dichasial,dichasially,ebracteate,filament,flower,forked,glabrescent,glandular,globose,green,hair-like,herbaceous,interjected,introrse,lateral,leaf,leaflet,long,make,maturing,mm,monochasial,mucilaginous,odd-pinnate,often,ovoid,pedicel,peduncle,perennial,petiole,plant,poricidally,seed,short,size,slit,stellate,stigma,style,terminal,testal,thick,throughout,wall,wide	10,3-4,3-6-foliat,5-6,abaxially,absen,acumen,acuminate,acute,adaxially,apex,apically,apiculate,articulate,attenuate,base,caudate,decurrent,digestion,diminishing,distal,dorsally,eaf,edge,eed,elliptic-lanceolate,emoval,enzyme,exceeding,flat,folded,generally,globo,gradually,green-white,half,honeycomb,lanceolate,larger,living,lobe,lon,lower,nflorescence,nther,oblique,oblong,orolla,pair,pattern,perfect,pinnatifi,plan,proximal,rachi,reveal,ruit,second,sessile,seudostipule,specimen,stamen,straight,strongly,tal,tem,throughou,toward,tuber-bearing,typically,unit,vary,whit,without,yellow,ympodial,Â¼	abaxial,absent,adaxial,anther,arrangement,colour,connation,feature,form,fruit,growth,height,history,inflorescence,length,life,na,number,ovary,reproduction,shape,stem,surface,texture,tip,wet,white,width	0.2-0.5,0.7-2,1,1-2.5,1-4,1-6,1.5-3.5,12-14,16-30,2-3,2-5,2.8-3.5,3-5,4-10,4-6.5,4-9,6,7-15,apical,branched,cell,cm,connate,covering,cyme,dehiscent,diameter,dichasial,dichasially,ebracteate,forked,glabrescent,glandular,globose,green,hair-like,herbaceous,introrse,lateral,long,make,maturing,mm,monochasial,mucilaginous,odd-pinnate,often,ovoid,perennial,poricidally,seed,short,slit,stellate,testal,thick,throughout,wall,wide	absent,na,wet,white
251	wfo-0001028777	success	203	138	83	99	104	39	80	3	-10,.5,.8,.9,0.1-0.2,0.4-0.8,0.5-1.3,0.6-1,0.7-1.2,0.8-2.2-2.5,1,1-2.5-4,1-3,1.5-3,1.5-4,2.5,2.5-3,3/4-4/5,acute,anther,apex,apically,articulated,attenuate,bark,base,berry,calyx,cm,connivent,dark,deltate,erect,filament,flattened-reniform,flower,fruit,glabrescent,glabrous,green,inflorescence,leaf,length,less,lobe,lobed,long,marking,maturity,mauve,midpoint,minute,mm,moderately,multangulate,narrow-deltate,obovate,orange,ovate,pale,pedicel,petiole,poricidal,ray,recurved,red-brown,reflexed,retuse,rounded,scar,sessile,shoot,short,shrub,simple,small,smooth,sometimes,spherical,spreading,stalked,stellate-pubescent,stem,strongly,style,surface,tapering,terminal,tip,tree,trichome,truncate,tube,variously,way,white,wide,woody,young	-3,-4,0-2,0-30,0.1-0.3,0.2,0.7-1.3,0.8-1,1-2,1-2.5,1.5,1.8-2.5,1/4,1/4-1/2,2-3,2.5-5,3.5-5,4-5-merous,4.5-8,6-10,7-11,8-12,8-15,abaxially,acuminat,alyx,ame,apar,ape,blade,branched,briefly,c.,chartaceous,concolorous,curved,deciduou,diameter,discolorous,drying,eaf,eed,elongating,entire,equal,faint,free,fruiting,glabrescen,green-brown,infructescence,lengt,long-styled,longer,lower,margin,mature,nflorescence,occasionally,older,one,open,orange-brown,orolla,oung,pair,peduncle,per,perfect,pericarp,plurifoliat,porrect,portion,present,primary,reflexe,ruit,short-styled,shorte,shorter,somewhat,soon,spaced,sparsely,stalk,staminate,stellate,stout,tamen,terete,tertiary,time,unarme,unarmed,unit,usually,vary,vein,venation,visible,whole,wider,yellow-green,ympodial	acuminate,anthesi,apart,arrangement,bud,coat,colour,connation,corolla,decurrency,dry,embryo,feature,form,growth,height,history,life,minor,na,new,number,ovary,papilla,plant,pore,prickle,reproduction,seed,shape,size,spacing,specimen,stigma,texture,tuberculation,type,width,winging	-10,.5,.8,.9,0.1-0.2,0.4-0.8,0.5-1.3,0.6-1,0.7-1.2,0.8-2.2-2.5,1,1-2.5-4,1-3,1.5-3,1.5-4,2.5,2.5-3,3/4-4/5,acute,apex,apically,articulated,attenuate,base,berry,cm,connivent,dark,deltate,erect,flattened-reniform,glabrescent,glabrous,green,less,lobed,long,marking,maturity,mauve,minute,mm,moderately,multangulate,narrow-deltate,obovate,orange,ovate,pale,poricidal,recurved,red-brown,reflexed,retuse,rounded,sessile,shoot,short,shrub,simple,small,smooth,sometimes,spherical,spreading,stalked,stellate-pubescent,strongly,tapering,terminal,tip,tree,trichome,truncate,variously,way,white,wide,woody,young	acuminate,apart,na
252	wfo-0001028791	success	252	120	71	85	167	35	66	5	+,0.05-0.2,0.3-0.6,0.6-0.8,0.6-0.9,0.8-1.3,1-1.5,1.5-2,1.7-2.1,10,100,2-3.5,2-7,2-locular,2.8-3.0,20-to,4-5+,4-celled,8-10-celled,9-30,acuminate,anther,articulated,branched,calyx,capitate,cell,cm,corolla,dark,deltate,densely,dichotomously,elliptic,filament,flower,fruit,glabrous,glandular,globose,green,hair-like,head,imparipinnate,interrupted,lateral,leaf,liana,lobe,long,many,middle,mm,near,obovate,outgrowth,ovary,pedicel,petiole,plant,pubescent,seed,short,simple,sparsely,stellate,stem,stigma,style,surface,testa,thick,time,tip,transparent,trichome,tube,uniseriate,vine,wall,white,wide,woody,yellow,â1-2-celled	-9,.5,0-6,0.05,0.2-0.3,0.2-0.4-0.6,0.2-0.8-1.5,0.25-0.3,0.3-0.4,0.3-0.5,0.3-0.8,0.4-0.5,0.4-0.6,0.4-0.65,0.4-1.1,0.45-0.55,0.5,0.7-1.5,0.8-1,1-2,1-2-celled,1-3,1-3-celled,1-celled,1.5-2.5-4.5,1.6-4.5,1.8-3.3,2-3,2-7-celled,3-4,3-5-10,3-5-22,4-11.5,4-15,5-15,5-9-35,5-plurifoliate,50-80,abaxially,absen,absent,abundant,acute,adaxially,addition,ag,along,anthesi,apex,apical,appearance,appendage,articulation,basal,base,basiscopically,beneath,berr,border,breaking,broadly,brown,bullate,clambering,colo.,column,conical,consistently,darker,deciduous,densest,developed,diameter,eaf,ebracteate,edicel,eed,eglandular,elongating,enlarged,entire,even,exserted,extended,free,fruiting,give,glabrescent,gree,grow,growing,half,halfway,interjected,internode,lamina,large,leaflet,leaving,less,like,lon,lower,margin,midvein,minutely,mixture,much,multicellular,nflorescence,oblique,occasionally,often,pair,pale,paler,papillate,peduncle,per,petiolule,poorly,present,primary,protuberance,pseudostipule,pubescence,rachi,reflexed,rest,rough,round,ruit,sandpapery,scandent,secondary,sessile,shorter,silky,single,slightly,small,smaller,sometimes,somewhat,sparse,spreading,stamen,staminal,sterile,stiff,straight,tal,tem,terminal,tertiary,thickened,touch,truncate,ud,unicellular,unit,upper,usually,vegetation,vein,winged,ympodial	3-22,5-35,abaxial,adaxial,alternate,arrangement,bud,coat,colour,connation,embryo,feature,form,growth,hair,height,history,inflorescence,length,life,na,number,papilla,perennial,pore,prickle,reproduction,shape,size,spacing,texture,tuberculation,type,width,young	+,0.05-0.2,0.3-0.6,0.6-0.8,0.6-0.9,0.8-1.3,1-1.5,1.5-2,1.7-2.1,10,100,2-3.5,2-7,2-locular,2.8-3.0,20-to,4-5+,4-celled,8-10-celled,9-30,acuminate,articulated,branched,capitate,cell,cm,dark,deltate,densely,dichotomously,elliptic,glabrous,glandular,globose,green,hair-like,head,imparipinnate,interrupted,lateral,liana,long,many,middle,mm,near,obovate,outgrowth,pubescent,short,simple,sparsely,stellate,testa,thick,time,transparent,trichome,uniseriate,vine,wall,white,wide,woody,yellow,â1-2-celled	3-22,5-35,alternate,na,perennial
253	wfo-0001028798	success	214	121	71	84	130	37	66	5	0-1,0.2-0.4,0.9-1.2,1-6,10,2-6,2-7,2.5-3.5,3-4,3-5,5-8,7-8,8-18,acute,anther,apart,apex,apical-lateral,attenuate,base,becoming,berry,blunt-tipped,bud,calyx,cm,corolla,decurrent,dm,echinoid,extend,filament,fleshy,flower,free,fruit,granular-tomentose,greenish,growth,hair,introrse,large,lateral,leaf,length,lobe,long,longitudinal,mixed,mm,multangulate,oblanceolate,oblong,obovate,orbicular,ovate-lanceolate,pale,pedicel,petiole,pore,porrect-stellate,probably,pseudo-terminal,ripe,rotate-stellate,rough-granular,sessile,short,shrub,simple,slightly,slit,stalked,stem,stigma,style,subcampanulate,subglobose,tip,tomentose,tube,x,yellow,yellowish	.5-5,0-60,0.5-2,1-3,1-4.5,1.1-2,1.5-1.8,1/2-2/3,1/20,15-19,2-3,2-3.75,2.4-4.4,2.6-4,2/3,3.3-5.6,3.8-4.2,4-5.4,5.25-7.5,6-10,6-8,8.5-13,abaxially,accrescent,acuminate,adaxially,ag,anthesi,apparently,articulated,axe,axillary,ba,blade,boat-shaped,branch,branched,capitat,chartaceous,conical,continued,curved,cylindrical,dehiscing,densely,diameter,distal,downward,due,eaf,echinoi,eed,entire,exserted,fruiting,glabrous,granular,green,hal,high,included,inserted,irregularly,lacking,lanceolate,less,lined,lobed,lower,m.,main,many,margin,midvein,minutely,multangulat,nearly,nflorescence,oblanceolat,obscured,obtuse,often,orolla,oung,overlapping,peduncle,perfect,persistent,persistently,plurifoliate,present,prominent,pubescent,quite,rachi,rather,ray,rough,ruit,semi-ovate,short-stalked,side,small,somewhat,spaced,sparingly,splitting,stamen,stellate-pubescent,strongly,subcoriaceous,sulcate,suture,tamen,thick,time,tomentu,tomentum,toward,translucent,unarme,unarmed,unit,unknow,vary,vein,velutinous,way,wide,ympodial	10-60,age,arrangement,capitate,coat,colour,connation,decurrency,embryo,feature,form,height,history,inflorescence,life,minor,new,number,ovary,papilla,perennial,plant,prickle,reproduction,scar,seed,shape,size,spacing,surface,texture,tuberculation,type,unknown,width,winging,young	0-1,0.2-0.4,0.9-1.2,1-6,10,2-6,2-7,2.5-3.5,3-4,3-5,5-8,7-8,8-18,acute,apart,apical-lateral,attenuate,becoming,berry,blunt-tipped,cm,decurrent,dm,echinoid,extend,fleshy,flower,free,fruit,granular-tomentose,greenish,hair,introrse,large,lateral,long,longitudinal,mixed,mm,multangulate,oblanceolate,oblong,obovate,orbicular,ovate-lanceolate,pale,pore,porrect-stellate,probably,pseudo-terminal,ripe,rotate-stellate,rough-granular,sessile,short,shrub,simple,slightly,slit,stalked,subcampanulate,subglobose,tomentose,x,yellow,yellowish	10-60,age,capitate,perennial,unknown
254	wfo-0001028815	success	196	104	66	79	117	25	64	2	0.4-0.8,0.5-1,1-10,1-2,10-15,14-28,2-4,2-9,22-35,3-5,4-10,5-6,6-10,6-8,7-16,anther,auriculate,axillary,broadly,bud,cell,chartaceous,cm,connivent,corolla,covering,dark,diameter,elliptic,elliptic-lanceolate,flower,fruit,glabrous,globose,green,hair,hair-like,herb,lanceolate,lateral,like,lilac-purple,lobe,long,medium,membranous,mm,odd-pinnate,ovate,ovoid,pedicel,peduncle,petiole,plant,pore,poricidal,pubescent,purple,red-purple,ripe,rotate,seed,size,sparsely,splotched,stem,stigma,straight,style,subtending,terminal,testal,thick,tinged,tip,triangular-lanceolate,tube,wall,x	1-3.5,1-4,1-5,2-4.5,2.5-6.5,3-4,3-7,5-7,5-merou,abaxially,acumen,acute,adaxially,ag,along,alyx,apart,apex,apparently,articulated,articulation,axe,base,basiscopic,berry,blade,brownish,capitat,ciliate,condition,cuneate,decreasing,decurrent,developing,digestion,distal,distinct,dorsally,drying,eaf,edge,eed,enzyme,especially,exceeding,filament,flat,folded,forked,fresh,geminat,generally,glabrou,green-white,greenish,hal,half,high,homostylous,honeycomb-shaped,indistinct,interjected,leaflet,lengthening,living,lower,make,margin,midrib,minutely,mucilaginous,narrowly,nflorescence,obtuse,onto,orolla,pair,papillose,perfect,petiolulate,plurifoliate,pointed,puberulent,purpl,rachi,removed,rounded,rugose,ruit,semi-erec,semi-rosette,sessile,seudostipule,short,side,slightly,slit,spaced,specimen,stamen,ste,tall,tamen,tem,terminated,throughout,tri-,unit,unwinged,usually,vary,wet,whitish,winged,yellow,ympodial,young	abaxial,adaxial,arrangement,calyx,capitate,colour,connation,feature,form,growth,height,history,inflorescence,leaf,length,life,na,number,ovary,pseudostipule,reproduction,shape,spacing,surface,texture	0.4-0.8,0.5-1,1-10,1-2,10-15,14-28,2-4,2-9,22-35,3-5,4-10,5-6,6-10,6-8,7-16,auriculate,axillary,broadly,bud,cell,chartaceous,cm,connivent,covering,dark,diameter,elliptic,elliptic-lanceolate,glabrous,globose,green,hair,hair-like,herb,lanceolate,lateral,like,lilac-purple,long,medium,membranous,mm,odd-pinnate,ovate,ovoid,poricidal,pubescent,purple,red-purple,ripe,rotate,sparsely,splotched,stem,straight,subtending,terminal,testal,thick,tinged,tip,triangular-lanceolate,wall,x	capitate,na
255	wfo-0001028876	success	127	90	52	66	61	24	49	3	.5,0.4-1,0.5-2,1-2,1.5-2,1.5-3,3-5,3-8,5-6,acute,anther,apex,attenuate,bark,base,brown,calyx,capitate,closely,cm,conical,corolla,dark,dendritic,densely,ellipsoid,elliptic,filament,flower,glabrous,golden,internodal,leaf,lobed,long,minutely,mm,opposite,ovary,papillose,pedicel,petiole,pore,poricidal,pubescent,reddish,sagittate,scar,shaped,shrub,slender,small,spaced,speciman,stem,stigma,style,subshrub,surface,tear-drop,tip,trichome,tube,type,white,young	/4,2-2.3,4-5,4-8,abaxial,abaxially,adaxially,along,anthesi,branched,dia,difoliate,drying,eaf,edicel,eed,free,geminat,glabrat,hroughout,included,inflorescenc,know,known,lamina,lateral,leave,like,lobe,long-triangular,lower,main,middle,midrib,nflorescence,nodding,occasionally,older,overlappin,pair,papillae,papillo,planar,portion,rest,rounded,ruti,shining,simple,sparsely,straight,tall,tub,ud,uniseriate,unit,vein,way,widest,x,ympodial	arrangement,bud,colour,feature,form,fruit,glabrate,growth,height,history,inflorescence,length,life,na,number,overlapping,plant,reproduction,seed,shape,size,spacing,texture,width	.5,0.4-1,0.5-2,1-2,1.5-2,1.5-3,3-5,3-8,5-6,acute,apex,attenuate,base,brown,capitate,closely,cm,conical,dark,dendritic,densely,ellipsoid,elliptic,glabrous,golden,internodal,leaf,lobed,long,minutely,mm,opposite,papillose,poricidal,pubescent,reddish,sagittate,shaped,shrub,slender,small,spaced,speciman,subshrub,tear-drop,tip,trichome,type,white	glabrate,na,overlapping
256	wfo-0001028883	success	207	120	76	81	126	39	64	12	0.6,1,2,50,absent,acuminate,acute,anther,apex,articulated,attenuate,base,berry,calyx,capitate,circular,cm,connivent,cyme,dark,decurrent,deltate,drying,dull,elliptic,elliptic-ovate,emarginate,filament,flower,fruit,glabrous,globose,green,greenish,growth,herb,introrsely,lateral,leaf,length,light,lobe,long,minor,mm,moderately,narrowly,new,oblong,obtuse,onto,ovate-lanceolate,pedicel,petiole,pore,poricidal,pubescent,reniform,ripe,rounded,seed,shrub,simple,size,slightly,small,sparse,sparsely,stellate,stem,stigma,style,subopposite,surface,trichome,unbranched,undulate,uniseriate,white,yellow,Ã	0.3â0.6,0.4â1.2,0.5â2,1.5â7,1â2,1â6,2â3,2â5,3â5,4,4â6,5,5-merou,6,6â10,6â12,abaxially,accrescent,adaxiall,adaxially,almost,along,alyx,antrorse,antrorsely,apar,arched,ark,ascending,axi,becoming,blade,branch,brochidodromous,brow,capitat,cell,chartaceous,ciliate,common,completely,concolorous,coriaceous,curved,cylindrical,densely,diameter,differing,directed,eaf,eed,entire,equal,erect,exfoliating,eye,flattened,frui,geminate,geniculat,glabrescent,glabrou,glandular,head,hilum,hollow,impressed,less,like,longitudinal,lower,lying,margin,membranaceous,midrib,multicellular,naked,nflorescence,normally,notably,often,older,opening,orolla,parallel,peduncle,pendan,per,perfect,plurifoliate,present,primarily,prominent,pubescence,rachi,rarely,region,ruit,secondary,sessile,shap,shiny,similar,single,single-celled,slit,sometimes,spaced,spreading,stalk,straight,subapical,subsessile,swollen,tall,tamen,tem,unit,vary,vein,venation,visible,whitish,wide,woody,ympodial	0.4-1.2,0.5-2,1-6,1.5-7,2-3,2-5,3-5,4-6,6-12,apart,arrangement,brown,bud,colour,connation,corolla,decurrency,feature,form,height,history,inflorescence,life,na,number,ovary,papilla,plant,reproduction,scar,shape,spacing,texture,tip,tube,type,width,winging,young	0.6,1,2,50,absent,acuminate,acute,articulated,attenuate,base,berry,capitate,circular,cm,connivent,cyme,dark,decurrent,deltate,drying,dull,elliptic,elliptic-ovate,emarginate,flower,fruit,glabrous,globose,green,greenish,herb,introrsely,lateral,leaf,light,long,mm,moderately,narrowly,oblong,obtuse,onto,ovate-lanceolate,petiole,poricidal,pubescent,reniform,ripe,rounded,shrub,simple,slightly,small,sparse,sparsely,stellate,subopposite,trichome,unbranched,undulate,uniseriate,white,yellow,Ã	0.4-1.2,0.5-2,1-6,1.5-7,2-3,2-5,3-5,4-6,6-12,apart,brown,na
257	wfo-0001028885	success	212	124	81	101	111	23	80	1	0.3-0.5-1,0.5-1,0.5-5,0.7-2,1-1.2,1-2,1-3,10-20,2-3.5-8.5,2.3-2.5,2/3,3-5,7-8,9-11,abaxial,acute,adaxial,adaxially,along,anther,apart,apex,attenuate,base,berry,black,branched,brown,calyx,capitate,cm,connivent,corolla,cup-shaped,dark,densely,ellipsoid,elliptic,erect,filament,flower,furcate,glabrous,globose,golden,gradually,groove,growth,height,inflorescence,irregularly,known,lanceolate,lateral,leaf,less,lobed,long,loosely,minutely,mm,mostly,multicellular,narrowing,narrowly,new,nodding,occasionally,pedicel,petiole,plant,poricidal,pubescent,purple,recorded,reddish,ripe,scandent,scar,scattered,shiny,shrub,simple,slender,spaced,sparsely,stellate,stem,stigma,style,surface,terminal,time,tip,trichome,tube,uniseriate,vine,way,woody,Â¾	.5,1-1.5,1.5-1.7,1.5-3.5,2,2-2.5,2.5-3.5,3.5-4.5,4-5,5-merou,7-9,9-12,?,ag,alyx,anthesi,apiculate,apparently,archin,ark,articulated,basal,blackish,branch,broadly,cell,collapsing,dark-pigmented,decurrent,deltate,dendriti,diameter,distal,dried,drying,eaf,eed,entire,exserted,extending,fleshy,free,fruiting,glabrescent,glabrou,glandular,groupe,ilament,immature,inserted,lamina,leaving,lengthening,like,live,lobe,lower,margin,material,midvein,minute,nflorescence,noddin,often,older,orolla,pair,papillo,part,peduncle,peg,perfect,pericarp,pigmentation,plurifoliat,pore,portion,primary,quarter,retaining,revolute,rhachi,ruit,shin,short,sleeve,slightly,slit,small,smaller,sometimes,spheroidal,spreading,strongly,tangled,tem,thin,third,twinin,ud,unit,upper,usually,vary,vein,wall,weak,weak-walled,wide,winged,ympodial	arrangement,bark,bud,colour,connation,dry,feature,form,fruit,length,number,ovary,papilla,papillose,seed,shape,size,spacing,specimen,texture,type,width,young	0.3-0.5-1,0.5-1,0.5-5,0.7-2,1-1.2,1-2,1-3,10-20,2-3.5-8.5,2.3-2.5,2/3,3-5,7-8,9-11,acute,adaxially,along,apart,attenuate,base,berry,black,branched,brown,capitate,cm,connivent,cup-shaped,dark,densely,ellipsoid,elliptic,erect,furcate,glabrous,globose,golden,gradually,groove,irregularly,known,lanceolate,lateral,less,lobed,long,loosely,minutely,mm,mostly,multicellular,narrowing,narrowly,nodding,occasionally,pedicel,poricidal,pubescent,purple,recorded,reddish,ripe,scandent,scattered,shiny,shrub,simple,slender,spaced,sparsely,stellate,terminal,time,tip,trichome,uniseriate,vine,way,woody,Â¾	papillose
258	wfo-0001028888	success	207	155	116	126	81	29	111	5	0-3.5,0-7,0.15-0.5,1,1-1.5,1-10,1-2,1.5-4,10-25,2-5,2-6,2.3-7,2.5-3.3,3-4,3.8-8.3,4-25,4-7,5-10,6-11,8-11,abaxially,acuminate,acute,adaxially,anther,apart,apex,apiculate,axillary,base,berry,broadly,bud,cell,center,chartaceous,clavate,cm,connivent,corolla,covered,covering,diameter,distal,dot,elliptic,end,filament,flower,forked,fruit,generally,glabrous,globose,green,green-white,hair,hair-like,half,herb,homostylous,interjected,lanceolate,lateral,leaflet,lengthening,less,like,lobe,long,make,membranous,mm,mottled,mucilaginous,oblique,odd-pinnate,often,one,orbicular,ovate,ovoid,pedicel,peduncle,pentagonal,petiole,placed,plant,pore,poricidal,pubescent,purple,ripe,rounded,scattered,seed,short,size,slightly,slit,sparsely,stem,stigma,straight,streak,style,subglabrous,substellate,subtending,terminal,testal,thick,throughout,tip,tube,tuber,typically,unwinged,violet,wall,wet,white,whitish,wing,x,yellow	0-5,1-3,12.5-25,2.3-5,3-5,3.6-12.5,5-7,5-merou,8-13.5,acumen,ag,along,alyx,apparently,articulated,axe,blade,brownish,capitat,central,ciliate,condition,cuneate,digestion,dorsally,drying,eaf,edge,eed,enzyme,erec,especially,exceeding,except,flat,folded,fresh,geminat,glabrou,glaucous,greatly,greenish,hal,honeycomb-shaped,living,low,lower,margin,middle,midrib,minutely,nflorescence,orolla,pair,perfect,petiolulate,petiolule,plurifoliate,proximal,puberulent,reduced,removed,ruit,sessile,seudostipule,sometimes,spaced,specimen,stamen,ste,stolo,subequal,tall,tamen,tem,tri-,truncate,unit,usually,vary,ympodial	5-merous,age,arrangement,calyx,capitate,coat,colour,connation,feature,form,growth,height,history,inflorescence,leaf,length,life,na,ovary,placement,pseudostipule,reproduction,shape,spacing,staman,stolon,surface,texture,type	0-3.5,0-7,0.15-0.5,1,1-1.5,1-10,1-2,1.5-4,10-25,2-5,2-6,2.3-7,2.5-3.3,3-4,3.8-8.3,4-25,4-7,5-10,6-11,8-11,abaxially,acuminate,acute,adaxially,apart,apiculate,axillary,berry,broadly,bud,cell,center,chartaceous,clavate,cm,connivent,corolla,covered,covering,diameter,distal,dot,elliptic,end,flower,forked,generally,glabrous,globose,green,green-white,hair,hair-like,half,herb,homostylous,lanceolate,lateral,lengthening,less,like,lobe,long,make,membranous,mm,mottled,mucilaginous,oblique,odd-pinnate,often,one,orbicular,ovate,ovoid,pentagonal,placed,plant,pore,poricidal,pubescent,purple,ripe,rounded,scattered,seed,short,slightly,slit,sparsely,stem,straight,streak,subglabrous,substellate,subtending,terminal,testal,thick,throughout,tip,typically,unwinged,violet,wall,wet,white,whitish,wing,x,yellow	5-merous,age,capitate,na,stolon
259	wfo-0001028920	success	152	129	75	94	58	35	71	4	.5,0.2-1,0.5-1,0.8-1.1,1-1.5,1-3,1.5-2,2-2.5,2-7,3-15-flowered,3-3.5,3-4,6-15,6-6.5,acuminate,acute,anther,anthesi,apex,arachnoid,arachnoid-pubescent,area,attenuate,bark,base,berry,broadly,brownish,calyx,closely,cm,congested,conical,corolla,deflexed,deltate,dense,difoliate,ellipsoid,elliptic,filament,flower,glabrate,glabrous,globose,green,later,leaf,lightly,lobe,lobed,long-styled,minor,minutely,mm,nearly,obovate,obovoid,occasionally,opposite,ovary,ovoid-reniform,papillose,pedicel,petiole,pitted,pore,poricidal,pubescence,pubescent,scar,shape,shaped,short-styled,shrub,simple,size,small,spaced,sparsely,stem,stigma,style,surface,tapering,tear-drop,tip,tree,tube,unifoliate,white,winged,x,young	.25,1-1.2,1-2.4,5-9,abaxially,adaxially,axil,ba,brown,cucullate,dark,decurrent,dendritic,densely,dia,differing,eaf,edicel,eed,erect,exserted,felty,fleshy,free,fruiting,geminat,gray-brow,lateral,lon,long,lower,main,major,middle,nflorescence,older,overlappin,pair,planar,portion,present,ruit,somewhat,soon,strongly,styl,tall,thick,trichome,tub,tuft,ud,uniseriate,unit,vein,widest,woody,ympodial	arrangement,bud,coat,colour,connation,dry,embryo,feature,form,fruit,geminate,gray-brown,growth,height,history,inflorescence,length,life,midpoint,na,number,overlapping,papilla,plant,prickle,ray,reproduction,seed,spacing,specimen,texture,tuberculation,type,width,winging	.5,0.2-1,0.5-1,0.8-1.1,1-1.5,1-3,1.5-2,2-2.5,2-7,3-15-flowered,3-3.5,3-4,6-15,6-6.5,acuminate,acute,arachnoid,arachnoid-pubescent,area,attenuate,base,berry,broadly,brownish,closely,cm,congested,conical,deflexed,deltate,dense,difoliate,ellipsoid,elliptic,glabrate,glabrous,globose,green,later,leaf,lightly,lobed,long-styled,minutely,mm,nearly,obovate,obovoid,occasionally,opposite,ovoid-reniform,papillose,pitted,poricidal,pubescence,pubescent,shaped,short-styled,shrub,simple,small,spaced,sparsely,tapering,tear-drop,tip,tree,unifoliate,white,winged,x	geminate,gray-brown,na,overlapping
260	wfo-0001028929	success	209	134	82	97	112	37	78	4	-2,/5,0.15-0.3,0.2-0.8,0.4-0.8,0.5-2,0.7-1,0.7-2,0.8-1,1-1.1,2-3,2-4,2-6,2-9,2.2-2.3,2.5-4,2.7-3,3-20,4-6,5-7.5,acicular,acute,anther,apart,apex,apically,articulated,base,berry,branched,calyx,cell,cm,connivent,cuneate,densely,diameter,erect,filament,flattened-reniform,flower,fruit,glabrous,inflorescence,lateral,leaf,length,lobe,lobed,long,maturity,midpoint,minutely,mm,narrow-deltate,narrow-ovate,oblong,obtuse,outline,pale,pedicel,pendulous,perpendicular,petiole,pit,poricidal,porrect,prickle,prickly,raised,ray,red,reticulate,scar,sessile,shrub,simple,small,smooth,spherical,stalked,stellate-pubescent,stem,straight,style,surface,tapering,tip,trichome,tube,unarmed,variously,way,white,wide,woody,yellow	.5,.7,.9,0-1,0-10,0-2,0-20,0-3,0.1,0.2-0.3,0.2-0.4,0.3-0.6,0.5-1.5,1,1-3,1.5-2.4,1/2-2/3,1/4-1/3,2/3-3/4,3-4,5-25,5-6,5-merous,6-8,7-9,8-10,abaxial,abaxially,adaxial,alyx,apar,ape,apparently,bark,blade,chartaceous,concolorous,curved,difoliate,discolorous,distance,drying,dull,eaf,eed,elliptic,elongating,equal,extending,foliaceous,free,fruiting,geminat,gently,glabrescent,glabrou,gra,hair,infructescence,lon,long-styled,longer,lower,margin,mature,midvein,minute,nflorescence,obovate,obtu,occasionally,older,one,open,orange-brown,orolla,oung,pair,patch,peduncle,per,perfect,pericarp,portion,prickl,primary,red-brown,red-green,rounded,ruit,short-styled,side,slender,sometimes,spaced,spreading,stalk,staminate,stellate,subsessile,tamen,terete,tertiary,time,unit,usually,vary,vein,venation,visible,yellow-green,ympodial	0.5,0.9,2,anthesi,arrangement,bud,coat,colour,connation,corolla,decurrency,dry,embryo,feature,form,growth,height,minor,na,new,number,ovary,papilla,plant,pore,seed,shape,size,spacing,specimen,stigma,texture,tuberculation,type,width,winging,young	-2,/5,0.15-0.3,0.2-0.8,0.4-0.8,0.5-2,0.7-1,0.7-2,0.8-1,1-1.1,2-3,2-4,2-6,2-9,2.2-2.3,2.5-4,2.7-3,3-20,4-6,5-7.5,acicular,acute,apart,apically,articulated,base,berry,branched,cell,cm,connivent,cuneate,densely,diameter,erect,flattened-reniform,glabrous,lateral,lobed,long,maturity,minutely,mm,narrow-deltate,narrow-ovate,oblong,obtuse,outline,pale,pendulous,perpendicular,pit,poricidal,porrect,prickly,raised,red,reticulate,sessile,shrub,simple,small,smooth,spherical,stalked,stellate-pubescent,stem,straight,tapering,tip,trichome,unarmed,variously,way,white,wide,woody,yellow	0.5,0.9,2,na
261	wfo-0001028963	success	197	123	78	95	102	28	76	2	/2,0-0.4,0.3-0.6,0.3-0.7,0.3-1,0.3-1.5,0.45-0.6,0.6-0.9,0.6-1,0.8-1.8,1-4,1.5-2,1/5,2-2.3,2-3,2-4,2.4-2.8,3-4.5,4-10,4-8,acute,anther,apex,apparently,attenuate,base,berry,bright,broad-deltate,calyx,cell,cm,connivent,deltate,densely,diameter,entire,erect,evenly,filament,flattened-reniform,flower,fruiting,green,herb,inflorescence,lanceolate,lateral,leaf,length,lobe,lobed,long,longer,margin,maturity,mauve,mm,moderately,narrow-cuneate,narrow-elliptic,narrowly,obtuse,orange,outline,pale,pedicel,petiole,pit,poricidal,purple,raised,red,scar,shrub,simple,small,smooth,spherical,stellate-pubescent,stem,style,surface,tapering,terminal,time,tip,tube,unarmed,unbranched,upper,way,wide,winged,young	.5,0-2,0.1,0.1-0.2,0.1-0.25,0.15-0.3,0.9-1.5,1/,1/4-1/3,1/6,2-5,2-9,3.5-4.2,5-25,5-merous,6-10,7-8,abaxially,alyx,apar,ape,apically,articulated,bark,becoming,blade,brown,chartaceous,concolorous,curved,cuspidat,difoliate,discolorous,drying,dull,eaf,eed,elongating,equal,eye,free,frui,geminat,glabrescent,glabrous,gra,gray-green,herbaceous,infructescence,less,light,long-styled,lower,mature,midpoint,naked,nflorescence,occasionally,older,one,open,orolla,oung,pair,peduncle,pendulous,per,perfect,pericarp,porrect,portion,primary,ray,ruit,sessile,short-styled,shorter,slender,slightly,spaced,spreading,stalk,stalked,staminate,stellate,straight,subsessile,tamen,terete,tertiary,trichome,unarme,unit,usually,variously,vary,vein,venation,visible,woody,yellow-orange,ympodial	apart,arrangement,coat,colour,connation,corolla,embryo,feature,form,fruit,growth,height,na,new,number,ovary,papilla,plant,seed,shape,size,spacing,stigma,texture,tuberculation,type,width,winging	/2,0-0.4,0.3-0.6,0.3-0.7,0.3-1,0.3-1.5,0.45-0.6,0.6-0.9,0.6-1,0.8-1.8,1-4,1.5-2,1/5,2-2.3,2-3,2-4,2.4-2.8,3-4.5,4-10,4-8,acute,apparently,attenuate,base,berry,bright,broad-deltate,cell,cm,connivent,deltate,densely,entire,erect,evenly,flattened-reniform,green,herb,lanceolate,lateral,lobed,long,longer,maturity,mauve,mm,moderately,narrow-cuneate,narrow-elliptic,narrowly,obtuse,orange,outline,pale,pit,poricidal,purple,raised,red,shrub,simple,small,smooth,spherical,stellate-pubescent,tapering,terminal,time,tip,unarmed,unbranched,upper,way,wide,winged,young	apart,na
262	wfo-0001028971	success	224	112	61	75	149	37	56	5	0.1-0.4,0.25-1.25,0.4-0.9,1-2,1.75-2.5,10-15,15-30,2.2-3.5,2.5-3.5,20-35,3-14,3-6,4-9,5-10,5-8,6-16,acute,anther,apart,apex,attenuate,base,branched,broadly,calyx,campanulate,cm,coarsely,connivent,dentate,directed,erect,extra-axillary,filament,flower,form,fruit,globose,inflorescence,lanceolate,leaf,length,lenticular,linear-lanceolate,lobe,minute,minutely,mm,obtuse,orange,ovate,ovate-lanceolate,pedicel,perennial,petiole,pitted,pore,prickle,pubescent,reniform-ovate,ripe,simple,spreadingly,stellate,stellate-pubescent,stem,stigma,style,surface,trichome,truncate,tube,unbranched,white,x	-1.4,.1-0.2,0.1-0.5,0.2-0.5-0.8,0.25-0.6,0.3-0.6,0.4-1.5,0.8-2.5,05-2.5,1-5,1.5-2.2,1.5-4,1/5-1/2,2-5,2-foliate,2.5-4.5,2.5-5,3-5,4-5,5-15,6-8.5,6-9,7-16,abaxially,acute-,adaxiall,adaxially,along,also,appearance,appearing,armed,articulated,ascending,axe,ba,bearing,becoming,blade,broad-based,capitat,cauline,close,compressed,cylindrical,delicate,deltoid,densely,diameter,distal,distall,eaf,eed,elongate,elongate-deltoid,entire,essentially,farinaceous,felty,felty-pubescent,female-sterile,frequently,geminat,glabrous,grading,growt,hair,inserted,interlobal,invested,largest,later,lateral,laterally,least,lignescent,like,lon,long,longer,longest,lower,major,manifestly,margin,maturit,midpoint,midrib,mixture,much,multiseriate,narrowly,nflorescence,numerous,occasionally,often,one,orolla,other,outline,ovate-apiculate,pair,peduncle,per,persistent,prickly,principal,rachi,ray,reduced,round-tipped,ruit,scattered,sericeous,sessile,short,short-stalked,shorter,side,similar,sinus,smaller,sometimes,spaced,sparse,spreading-hirsute,stalk,ste,stellae,stipitate,tal,tamen,tan,tem,termination,thin-textured,time,tooth-like,underdeveloped,unit,usually,variable,variously,vary,vein,well-developed,wide,yellow,ympodial	0.1-0.2,arrangement,berry,bud,capitate,coat,colour,connation,corolla,decurrency,distally,embryo,feature,growth,height,history,life,minor,na,new,number,ovary,papilla,plant,reproduction,scar,seed,shape,size,spacing,texture,tip,tuberculation,type,width,winging,young	0.1-0.4,0.25-1.25,0.4-0.9,1-2,1.75-2.5,10-15,15-30,2.2-3.5,2.5-3.5,20-35,3-14,3-6,4-9,5-10,5-8,6-16,acute,apart,attenuate,branched,broadly,campanulate,cm,coarsely,connivent,dentate,directed,erect,extra-axillary,flower,fruit,globose,lanceolate,lenticular,linear-lanceolate,minute,minutely,mm,obtuse,orange,ovate,ovate-lanceolate,perennial,pitted,pubescent,reniform-ovate,ripe,simple,spreadingly,stellate,stellate-pubescent,trichome,truncate,unbranched,white,x	0.1-0.2,berry,capitate,distally,na
263	wfo-0001028975	success	163	120	68	83	80	37	62	6	0.1-1,1,1-3,1-5,1.5-2,2.2-6,3-6.5,5.5-10,6-6.5,7.5-15,8-9,acuminate,acute,anther,anthesi,apart,apex,appearing,area,bark,base,berry,broad,calyx,cm,conically,corolla,cup-shaped,decurrent,deflexed,dia,elliptic,erect,filament,fruit,glabrous,globose,golden,green,immature,leaf,length,lobe,lobed,long,minor,minutely,mm,narrowly,once-furcate,opposite,ovary,ovoid-reniform,pedicel,petiole,pitted,pore,poricidal,pubescent,scar,shaped,shrub,simple,size,small,somewhat,stem,stigma,style,surface,tapering,tear-drop,tip,tree,triangular,trichome,tube,uniseriate,white,wide,woody,x,young	.2,.5,0.5-1,1.2-1.5,1.5-1.8,3-10-flowered,3-3.5,5-ribbed,?,along,beneath,brown,closely,conical,corky,dark,densely,denser,differing,difoliate,eaf,edicel,eed,entire,epidermi,equal,exserted,extension,free,fruiting,geminat,hyaline,large-celled,late,lateral,like,lon,lower,main,mainly,major,margin,member,mere,middle,nearly,nflorescence,obscured,occasionally,older,one,pair,papillo,portion,prominent,pubescenc,raised,reddi,reflexed,remaining,rib,ruit,shiny,short,sinus,slender,slightly,spaced,sparsely,straight,strongly,tall,tub,ud,unit,upper,varying,vein,widest,ympodial	0.5,3-10,9,arrangement,bud,coat,colour,connation,decurrency,dry,feature,flower,form,growth,height,history,inflorescence,life,midpoint,na,number,papilla,papillose,plant,prickle,ray,reddish,reproduction,seed,shape,spacing,specimen,texture,tuberculation,type,width,winging	0.1-1,1,1-3,1-5,1.5-2,2.2-6,3-6.5,5.5-10,6-6.5,7.5-15,8-9,acuminate,acute,apart,appearing,area,berry,broad,cm,conically,cup-shaped,decurrent,deflexed,dia,elliptic,erect,fruit,glabrous,globose,golden,green,immature,leaf,lobed,long,minutely,mm,narrowly,once-furcate,opposite,ovoid-reniform,petiole,pitted,poricidal,pubescent,shaped,shrub,simple,small,somewhat,style,tapering,tear-drop,tip,tree,triangular,trichome,uniseriate,white,wide,woody,x	0.5,3-10,9,na,papillose,reddish
264	wfo-0001028980	success	168	147	101	113	55	34	97	4	.1,.5,/3,1-1.2,1.2-1.8,1.2-3,1.5-1.8,1.5-2,1.5-6,2.5,2.5-5,20-25-flowered,3/4,5-6,5-8,6,acuminate,acute,along,anther,anthesi,apart,apex,bark,base,beginning,berry,broadly,calyx,capitate,clearly,cm,coarsely,conical,corolla,cucullate,deflexed,deltoid,densely,dia,differentiated,dry,elliptic,filament,flattened-reniform,fleshy,furcate,glabrate,glabrous,glandular,globose,green,incrassate,leaf,like,lobe,lobed,long,margin,material,member,minor,minutely,mm,occasionally,opposite,ovary,ovate,ovoid,pair,papillose,pedicel,peduncle,petiole,pit,pitted,planar,pore,poricidal,pubescent,reddish,reflexed,scar,seed,shaped,sharply,shining,shrub,simple,size,slightly,small,soon,speciman,stem,stigma,strongly,style,surface,tall,tear-drop,thick,tip,tree,trichome,tube,type,uniseriate,way,white,woody,x,young	.75,0.5-1.5,3-4,4-5,6-8,7-12,axil,basal,beneath,black,corky,differing,difoliate,drying,eaf,edicel,eed,expanded,exserted,extending,f,free,frui,fruiting,geminat,impressed,inflorescenc,lamina,lateral,lenticellat,lon,lower,m.,main,major,middle,nflorescence,older,one,pale,paler,portion,prominent,ruit,scarious,sparsely,tapering,ti,ud,unit,usually,vein,widest,yellowish,ympodial	alternate,arrangement,bud,coat,colour,connation,decurrency,feature,flower,form,fruit,growth,height,history,inflorescence,length,lenticellate,life,midpoint,na,new,number,papilla,plant,prickle,ray,reproduction,shape,spacing,specimen,texture,tuberculation,width,winging	.1,.5,/3,1-1.2,1.2-1.8,1.2-3,1.5-1.8,1.5-2,1.5-6,2.5,2.5-5,20-25-flowered,3/4,5-6,5-8,6,acuminate,acute,along,anthesi,apart,base,beginning,berry,broadly,capitate,clearly,cm,coarsely,conical,cucullate,deflexed,deltoid,densely,dia,differentiated,dry,elliptic,flattened-reniform,fleshy,furcate,glabrate,glabrous,glandular,globose,green,incrassate,leaf,like,lobe,lobed,long,margin,material,member,minutely,mm,occasionally,opposite,ovate,ovoid,pair,papillose,pedicel,peduncle,pit,pitted,planar,pore,poricidal,pubescent,reddish,reflexed,seed,shaped,sharply,shining,shrub,simple,slightly,small,soon,speciman,strongly,style,tall,tear-drop,thick,tip,tree,trichome,type,uniseriate,way,white,woody,x	alternate,inflorescence,lenticellate,na
265	wfo-0001028984	success	173	124	70	77	96	47	68	2	-3,-9,0.5-1,1-1.7,1-2,1-9,1.2-4,1.5,10-20,15-35-65,2-16,2-2.5,2-3,4-30,4-6,4-6.3,4-7,acuminate,acute,age,almost,also,apex,apical,basal,base,broadly,calyx,campanulate,cm,concave,cordate,densely,eglandular,ellipsoid-fusiform,flower,forked,fruit,glabrous,gland,globose,greenish,hair,lanceolate,lobe,long,mm,moderately,obtuse,often,ovate,ovoid,pale,pedicel,petiole,pore,puberulent,pubescent-pilose,purple,rarely,shrub,simple,small,sparsely,stigma,style,tip,tree,triangular,truncate,tube,turning,two,unbranched,unknown,x,yellow	-2,-2.5,1-2-4-6,1-2.5,1-6,12-20,2-3-10-14,2-3-28,20-40,3-26,3-6,4-5,4-foliat,5-10,5-6,7-14,8-15,abaxially,abruptly,absen,adaxially,adpressed,aggregate,apart,ape,articulated,axe,blade,broad,cell,chartaceous,color,connective,diameter,dilated,directed,distally,eaf,eed,entire,equalling,especially,exceeding,fleshy,glandular-puberulent,laterally,leaving,lon,longer,lower,margin,minutely,narrowed,near,nflorescence,nther,obconical,orolla,papillose,pedicellar,peduncle,perfect,pilo,pilose,possibly,presence,present,puberulent-pubescent,pubescent-pilo,rachi,radiu,remnant,ripe,ruit,shorter,slightly,spaced,stamen,stone,strongly,subcoriaceous,swelling,tal,tem,thecae,time,tomento,tomentose,toward,ud,unit,unknow,vary,violet,wide,ympodial	3-28,anther,anthesi,arrangement,bud,coat,colour,connation,corolla,decurrency,dry,embryo,feature,filament,form,growth,height,history,inflorescence,leaf,length,life,midpoint,minor,na,new,number,ovary,papilla,plant,prickle,ray,reproduction,scar,seed,shape,size,spacing,specimen,stem,surface,texture,tuberculation,type,width,winging,young	-3,-9,0.5-1,1-1.7,1-2,1-9,1.2-4,1.5,10-20,15-35-65,2-16,2-2.5,2-3,4-30,4-6,4-6.3,4-7,acuminate,acute,age,almost,also,apex,apical,basal,base,broadly,campanulate,cm,concave,cordate,densely,eglandular,ellipsoid-fusiform,forked,glabrous,gland,globose,greenish,hair,lanceolate,lobe,long,mm,moderately,obtuse,often,ovate,ovoid,pale,puberulent,pubescent-pilose,purple,rarely,shrub,simple,small,sparsely,tip,tree,triangular,truncate,turning,two,unbranched,unknown,x,yellow	3-28,na
266	wfo-0001028997	success	136	98	59	73	63	25	55	4	.5,0.5-0.7,0.5-1.5,0.8-1.1,1-1.5,2-2.5,2-3.5,3.3.5,4-10,4-4.5,4-angled,5-6,6-10,acute,anther,apex,appearing,area,attenuate,bark,base,berry,broadened,cm,corolla,deflexed,difoliate,dry,drying,elliptic,elliptic-obovate,erect,filament,filiform,flattened-reniform,fruiting,glabrous,globose,golden,green,height,later,leaf,matte,minutely,mm,mustard,opposite,ovary,papillose,pedicel,petiole,pitted,poricidal,quadrate,scar,shaped,shiny,shrub,stem,stigma,style,surface,tear-drop,terminal,tip,trifoliate,tube,unknown,white,x,yellow,young	0.5-1,1-1.2,20-50-flowered,3-4,6-7,abaxially,adaxially,anthesi,apar,ba,branched,calyx,conical,coriaceous,cucullate,dia,eaf,edicel,eed,exserted,fragrant,free,geminat,glabrou,greenish-brow,incrassate,lateral,lobe,lobed,lon,long,lower,main,many,margin,merely,middle,nearly,nflorescence,older,pair,pale,partially,pericarp,pore,portion,revolute,ruit,spaced,specimen,strongly,styl,tan,thick,thickened,time,tub,ud,unevenly,vein,widest,woody,ympodia	20-50,abaxial,adaxial,apart,arrangement,bud,colour,feature,flower,form,fruit,greenish-brown,growth,inflorescence,length,number,plant,seed,shape,size,spacing,sympodia,texture,type,width	.5,0.5-0.7,0.5-1.5,0.8-1.1,1-1.5,2-2.5,2-3.5,3.3.5,4-10,4-4.5,4-angled,5-6,6-10,acute,appearing,area,attenuate,berry,broadened,cm,deflexed,difoliate,dry,drying,elliptic,elliptic-obovate,erect,filiform,flattened-reniform,glabrous,globose,golden,green,later,leaf,matte,minutely,mm,mustard,opposite,papillose,pitted,poricidal,quadrate,shaped,shiny,shrub,tear-drop,terminal,trifoliate,unknown,white,x,yellow,young	20-50,apart,greenish-brown,sympodia
267	wfo-0001029003	success	207	150	108	121	86	29	103	5	0.5,1,1-10,1-2,1-3,1-5,1.2-1.9,1.2-2.5,1.5-2.3,11-32,12.2-30,13-36,2.5-10,3,3-20,3-5,3.5-7.5,4-8,5,5-10.5,5-12.5,7-15.5,7-9,9-14,abaxially,acuminate,adaxially,anther,apart,apex,attenuate,axillary,base,berry,blade,blue-violet,bud,cell,chartaceous,cm,conical,connivent,corolla,covering,decreasing,diameter,elliptic,end,filament,flower,fruit,glabrous,gradually,green,green-white,hair,hair-like,herb,highly,homostylous,lanceolate,lateral,leaf,leaflet,light,like,lobe,long,make,medium,membranous,minute,mm,mottled,mucilaginous,obtuse,odd-pinnate,one,ovoid,pale,pedicel,peduncle,pentagonal,petiole,pigmentation,placed,plant,pore,poricidal,pubescent,purple,ripe,rotate,rounded,seed,size,sometimes,sparsely,stem,stigma,straight,style,subcapitate,subequal,subglabrous,subtending,terminal,testal,thick,throughout,tip,toward,tube,tuber,typically,violet,wall,wet,wide,wing,x	0-6,0.3-0.5,0.4-3,1-2.5,2-6,2.5-7.5,5-merou,absent,acumen,ag,alyx,apparently,articulated,axe,brownish,capitat,ciliate,condition,digestion,distal,dorsally,drying,eaf,edge,eed,elongated,enzyme,equal,erec,especially,exceeding,flat,folded,forked,fourth,fresh,geminat,generally,glabrou,greenish,hal,half,honeycomb-shaped,interjected,larger,lengthening,living,lower,margin,middle,nflorescence,orbicular,orolla,ovate,pair,perfect,petiolule,plurifoliate,prostrate,proximal,rarely,ray,removed,ruit,secondary,sessile,seudostipule,slightly,slit,spaced,specimen,stamen,ste,stolo,symmetrical,tall,tamen,tem,tri-,unit,usually,vary,white,whitish,yellow,ympodial	5-merous,arrangement,calyx,capitate,colour,connation,feature,form,growth,height,history,inflorescence,length,life,na,number,ovary,perennial,placement,pseudostipule,pubescence,reproduction,shape,spacing,staman,stolon,surface,texture,type	0.5,1,1-10,1-2,1-3,1-5,1.2-1.9,1.2-2.5,1.5-2.3,11-32,12.2-30,13-36,2.5-10,3,3-20,3-5,3.5-7.5,4-8,5,5-10.5,5-12.5,7-15.5,7-9,9-14,abaxially,acuminate,adaxially,apart,attenuate,axillary,base,berry,blue-violet,bud,cell,chartaceous,cm,conical,connivent,covering,decreasing,elliptic,end,glabrous,gradually,green,green-white,hair,hair-like,herb,highly,homostylous,lanceolate,lateral,leaf,leaflet,light,like,long,make,medium,membranous,minute,mm,mottled,mucilaginous,obtuse,odd-pinnate,one,ovoid,pale,pentagonal,pigmentation,placed,poricidal,pubescent,purple,ripe,rotate,rounded,seed,size,sometimes,sparsely,stem,straight,subcapitate,subequal,subglabrous,subtending,terminal,testal,thick,throughout,tip,toward,typically,violet,wall,wet,wide,wing,x	5-merous,capitate,na,perennial,stolon
268	wfo-0001029006	success	217	140	84	100	117	40	79	5	-+,0.4-2.5,0.5,0.5-2,1,1-1.5,1-5,2-6,2.5,5,5-6,50,7-8,<,acuminate,acute,age,anther,anthesi,apex,area,asymmetrical,base,berry,blackish,bright,c.,calyx,cm,conical,connivent,corolla,deeply,deltate,ellipsoid,elongate,filament,filiform,flattened,flower,glabrous,globose,green,growing,growth,inflated,inflorescence,later,lateral,lengthening,lobe,lobed,long,loosely,minute,minutely,mm,new,oblique,occasionally,often,pale,papillate,pedicel,petiole,pinnatifid,pitted,pore,poricidal,puberulent,purple,purplish,reddish,reniform,ripe,rotate-stellate,sagittate,scar,simple,size,slit,somewhat,sparsely,stem,stigma,style,surface,terminal,tip,trichome,truncate,tube,uniseriate,vine,violet,way,white,woody,x,young	.5,0.2,0.5-4,1-4,1.2-1.5,1.8-2.2,1/3,10,10-20,2-3,3.5-4,4-6,5-merou,7-9,>,abaxially,adaxial,adaxiall,ag,along,alyx,apar,ark,articulated,axi,axil,basal,beyond,bilobed,black,branched,broadest,cell,chartaceous,clavat,dense,depending,diameter,drying,eaf,eed,elliptic,entire,exserted,extending,free,fruiting,groove,ilament,intramarginal,irregular,irregularly,keeled,lamina,leaving,lower,many,margin,markedly,membranous,midrib,narrowly,nearly,nflorescence,nodding,obvious,older,one,orolla,pair,part,peduncle,peg,pendan,pentagonal,per,perfect,pericarp,planar,plurifoliat,portion,primary,puberulen,pubescent,reaching,ruit,shiny,sleeve,small,smaller,sometimes,spaced,spreading,strong,strongly,sunligh,tan,tem,testal,thin,time,tiny,tuft,twinin,twining,ud,unit,upper,usually,variable,variously,vary,vein,widest,within,ympodial,zig-zag	3,apart,arrangement,bark,bud,coat,colour,connation,decurrency,dry,embryo,feature,form,fruit,height,history,leaf,length,life,midpoint,minor,na,number,ovary,papilla,plant,plurifoliate,prickle,ray,reproduction,seed,shape,spacing,specimen,sunlight,texture,tuberculation,type,width,winging	-+,0.4-2.5,0.5,0.5-2,1,1-1.5,1-5,2-6,2.5,5,5-6,50,7-8,<,acuminate,acute,age,area,asymmetrical,base,berry,blackish,bright,c.,cm,conical,connivent,deeply,deltate,ellipsoid,elongate,filiform,flattened,glabrous,globose,green,growing,inflated,later,lateral,lengthening,lobed,long,loosely,minute,minutely,mm,oblique,occasionally,often,pale,papillate,pinnatifid,pitted,poricidal,puberulent,purple,purplish,reddish,reniform,ripe,rotate-stellate,sagittate,simple,slit,somewhat,sparsely,style,terminal,tip,trichome,truncate,uniseriate,vine,violet,way,white,woody,x	3,apart,na,plurifoliate,sunlight
269	wfo-0001029031	success	211	134	88	102	109	32	85	3	-8,.5-1.2,0-5,0.1-0.5,0.5-1.5,0.7-1.1,1-2,1-2.6-3.6,1-5,1.5-2.8,1.8-2.7,1.8-4,2-10.7,2-3.3,2-5,2.5-5.5,20-150,3-10,3-10-12.3,5-17,6-21,acuminate,acute,adaxially,angle,anther,apart,apex,base,becoming,berry,black,bluish,calyx,capitate,chartaceous,cm,connivent,corolla,cuneate,densely,directed,distally,elliptic,elliptic-ovate,erect,filament,flattened,fleshy,flower,fruit,glabrous,globose,green,hair,held,lanceolate,large,lateral,leaf,leaf-opposed,length,lobe,long,mm,oblong,occasionally,outline,pedicel,peltate,peltate-stellate,petiole,pore,possibly,pseudoterminal,pubescent,rarely,reniform,ripening,rounded,rugulose,sessile,shrub,simple,small,somewhat,sparsely,stellate,stellate-pubescent,stem,stigma,strongly,style,suborbicular,surface,tip,tree,trichome,tube,white,x,yellowish	.1-0.3,0.5,0.5-4,0.6-1.2,1-1.5,1-2.5,1-3,1-9.4-11.4,1.3-3.3,1.5-3.5,1/3,10,13.5,2-3,2.5-5.6,4-5-,4-7.5,6-12,abaxially,absent,accrescent,adaxiall,ag,apexacute,apparently,around,articulated,axe,ba,bilobe,blade,branched,brown,center,covering,curved,cylindrical,deltate,denser,diameter,eaf,edge,eed,eglandula,eglandular,entire,equal,farinose,forked,frui,fruiting,fused,geminate,glabrescent,immature,impressed,inserted,least,light,like,longitudinal,lower,major,many-foliate,margin,midpoint,midvein,nearly,nflorescence,obtuse,opening,orange,orolla,paired,peduncle,perfect,porrect-stellate,prominent,pubescen,pubescence,rachi,ray,ruit,short,short-stalked,side,silvery,slightly,slit,smaller,sometimes,spaced,ste,straight,subtending,tall,tamen,tem,time,unarme,unbranched,unit,usually,vary,vein,whitish,wide,yellow,ympodial	1,arrangement,bilobed,bud,colour,connation,decurrency,feature,form,growth,height,history,inflorescence,life,minor,na,new,number,ovary,papilla,plant,reproduction,scar,seed,shape,size,spacing,texture,type,width,winging,young	-8,.5-1.2,0-5,0.1-0.5,0.5-1.5,0.7-1.1,1-2,1-2.6-3.6,1-5,1.5-2.8,1.8-2.7,1.8-4,2-10.7,2-3.3,2-5,2.5-5.5,20-150,3-10,3-10-12.3,5-17,6-21,acuminate,acute,adaxially,angle,apart,base,becoming,berry,black,bluish,capitate,chartaceous,cm,connivent,cuneate,densely,directed,distally,elliptic,elliptic-ovate,erect,flattened,fleshy,flower,fruit,glabrous,globose,green,hair,held,lanceolate,large,lateral,leaf-opposed,long,mm,oblong,occasionally,outline,peltate,peltate-stellate,possibly,pseudoterminal,pubescent,rarely,reniform,ripening,rounded,rugulose,sessile,shrub,simple,small,somewhat,sparsely,stellate,stellate-pubescent,strongly,suborbicular,tree,trichome,white,x,yellowish	1,bilobed,na
270	wfo-0001029048	success	162	130	78	90	72	40	74	4	.01,.5,/3,0.5,0.5-1,0.5-1.7,0.8-1,1-2,1-8,1.5-2,14,2,26,3-4,3-7,4-6,9-15,acuminate,anther,anthesi,apex,attenuate,base,berry,bicellular,broadly,calyx,cm,conical,corolla,decurrent,elliptic,filament,filiform,flower,glabrate,glabrous,globose,golden,greenish-white,greenish-yellow,hanging,incrassate,leaf,less,like,lobe,lobed,long,margin,minute,minutely,mm,obtuse,opposite,ovary,ovoid-reniform,pale,papillose,pedicel,petiole,pitted,pore,poricidal,puberulent,rounded,scar,shaped,sharply,shrub,slender,slightly,small-capitate,somewhat,specimen,stem,stigma,style,surface,tear-drop,thread-like,tip,trichome,tube,uni-,unifoliate,way,winged,x,young	.2,1,11,25,3.5-4,5-8,8-10,angle,another,apar,apparent,arching,basal,bearing,becoming,beneath,blade,branch,bright,dia,eaf,edicel,eed,elongated,except,expanded,f,free,fruiting,geminate,greatly,green,greenish-yello,hispidulous,lateral,live,lower,main,matte,middle,midrib,much,nflorescence,node,non-reproductive,obovoid,older,one,pair,papillo,parallel,planar,portion,reflexed,right,ripe,ruit,spaced,straight,tall,tan,tapering,time,translucent,ud,unevenly,unit,vein,widely,widest,ympodial,zig-zag	apart,arrangement,bark,bud,coat,colour,connation,decument,decurrency,dry,embryo,feature,form,fruit,growth,height,history,inflorescence,length,life,midpoint,minor,na,new,number,papilla,perennial,plant,prickle,ray,reproduction,seed,shape,size,spacing,texture,tuberculation,type,width,winging	.01,.5,/3,0.5,0.5-1,0.5-1.7,0.8-1,1-2,1-8,1.5-2,14,2,26,3-4,3-7,4-6,9-15,acuminate,attenuate,base,berry,bicellular,broadly,cm,conical,decurrent,elliptic,filiform,glabrate,glabrous,globose,golden,greenish-white,greenish-yellow,hanging,incrassate,leaf,less,like,lobed,long,margin,minute,minutely,mm,obtuse,opposite,ovoid-reniform,pale,papillose,petiole,pitted,pore,poricidal,puberulent,rounded,shaped,sharply,shrub,slender,slightly,small-capitate,somewhat,stem,tear-drop,thread-like,tip,trichome,uni-,unifoliate,way,winged,x,young	apart,decument,na,perennial
271	wfo-0001029055	success	169	101	66	76	93	25	62	4	0.4-1.5,1-2.6,1-5,1.6-3.5,1.8-3.5,14-50,2-3,2.2-3,2.5-8,4-10,4-6,4-7,5-24,5.5-9,6-14,8-9,9-22,apical,apically,branched,calyx,cell,cm,connate,corolla,covering,cyme,dehiscent,diameter,dichasial,dichasially,ebracteate,flower,forked,gland,hair-like,herbaceous,interjected,introrse,lateral,leaf,leaflet,long,make,maturing,mm,monochasial,mucilaginous,odd-pinnate,often,outline,ovoid,pedicel,peduncle,pentagonal,perennial,petiole,pilose,plant,poricidally,pubescent,rotate,seed,short,short-stalked,size,slit,stigma,style,terminal,testal,thick,triangular,type,wall,wide	1-4,1.7-2.2,2-1.,2-4,3,3-10,3-6,3-6-foliat,abaxially,acumen,acuminate,acute,adaxially,apex,articulate,attenuate,base,cordate,covered,cuneate,dark,decurrent,densely,digestion,diminishing,distal,dorsally,eaf,edge,eed,elliptcal,elliptical,emoval,enzyme,exceeding,filament,first,flat,folded,generally,globo,green,green-white,hair,half,honeycomb,living,lobe,lon,long-attenuate,longer,longitudional,lower,lunat,near,nflorescence,nther,oblique,orolla,ovate,pair,pattern,perfect,plan,proximal,purple,rarely,reveal,ruit,second,sessile,seudostipule,short-petiolate,sometimes,specimen,spreading,stamen,straight,stripe,tal,tem,throughout,time,toward,tuber-bearing,typically,unit,vary,whit,widest,yellow,ympodial,Â¼	2-11,anther,arrangement,connation,feature,form,fruit,globose,growth,height,history,inflorescence,length,life,na,number,ovary,reproduction,shape,stem,surface,texture,tip,wet,width	0.4-1.5,1-2.6,1-5,1.6-3.5,1.8-3.5,14-50,2-3,2.2-3,2.5-8,4-10,4-6,4-7,5-24,5.5-9,6-14,8-9,9-22,apical,apically,branched,cell,cm,connate,covering,cyme,dehiscent,diameter,dichasial,dichasially,ebracteate,forked,gland,hair-like,herbaceous,introrse,lateral,long,make,maturing,mm,monochasial,mucilaginous,odd-pinnate,often,outline,ovoid,pentagonal,perennial,pilose,poricidally,pubescent,rotate,seed,short,short-stalked,slit,testal,thick,triangular,type,wall,wide	2-11,globose,na,wet
272	wfo-0001029059	success	199	143	92	105	94	38	84	8	.5,0.1-0.5,0.1-1,0.2,0.2-0.5,0.5-1,1-1.2,1-1.5,1-3,1-4,1-6,1.2-3,1.3-1.7,1.5-2,10-19,2.5,3-3.5,3-6.5,3.5-8,4-10.5,7-9,acute,anther,anthesi,apex,apiculate,bark,base,berry,bud,calyx,clavate,cm,connivent,corolla,deflexed,deltoid,densely,dia,dirty,elliptic,filament,flattened-reniform,glabrate,glabrous,globose,hispidulous,inflorescence,leaf,lobe,lobed,long,minor,minute,minutely,mm,nearly,occasionally,older,opposite,orbiculate,ovary,paler,papillose,partially,pedicel,petiole,pitted,pore,poricidal,pubescent,purplish,ripe,rounded,shallowly,shape,shaped,shrub,simple,size,slender,small,specimen,stem,stigma,style,surface,tapering,tear-drop,thickened,tightly,tinge,tip,tree,trichome,tube,unicellular,uniseriate,waxy,white,wide,woody,x,yellowish-green,young	0.5,1.5-2.8,3.5-6,5,5-15-flowered,6-10,along,anisophyllou,apar,ape,apiculae,arising,beneath,bout,branched,closely,coiba,cordate,covered,cuneate,de,deep,dense,differing,difoliate,eaf,edicel,eed,ellipsoid,expanded,exserted,extending,extremely,foetid,free,fruiting,geminate,greatly,impressed,incrassate,interpetalar,isla,lamina,lateral,lon,longest,lower,main,major,margin,member,membranous,middle,narrowly,nflorescence,oblique,often,one,orange,orangish-yellow,pair,pale,panama,papillo,planar,pointed,population,portion,prominent,pubescence,reddish-gre,rest,ruit,scar,sinus,somewhat,soon,spaced,sparse,straight,tall,terminal,ti,triangular,ud,underside,unit,usually,variable,vein,widest,yellowish,yellowish-tan,ympodial	5-15,abaxial,adaxial,alternate,arrangement,coat,colour,connation,dry,feature,flower,form,fruit,green,greyish,growth,hair,height,hirsute,history,length,life,midpoint,na,number,papilla,perennial,plant,prickle,ray,reddish-grey,reproduction,seed,spacing,texture,tuberculation,type,width	.5,0.1-0.5,0.1-1,0.2,0.2-0.5,0.5-1,1-1.2,1-1.5,1-3,1-4,1-6,1.2-3,1.3-1.7,1.5-2,10-19,2.5,3-3.5,3-6.5,3.5-8,4-10.5,7-9,acute,anthesi,apiculate,base,berry,calyx,clavate,cm,connivent,deflexed,deltoid,densely,dia,dirty,elliptic,flattened-reniform,glabrate,glabrous,globose,hispidulous,leaf,lobed,long,minute,minutely,mm,nearly,occasionally,opposite,orbiculate,paler,papillose,partially,pitted,poricidal,pubescent,purplish,ripe,rounded,shallowly,shaped,shrub,simple,slender,small,tapering,tear-drop,thickened,tightly,tinge,tip,tree,trichome,tube,unicellular,uniseriate,waxy,white,wide,woody,x,yellowish-green,young	5-15,alternate,green,greyish,hirsute,na,perennial,reddish-grey
273	wfo-0001029072	success	233	118	78	96	137	22	76	2	0.1-0.4,0.4-0.9,0.5-2,0.8-1.5,0.8-2.5,1-1.2,1-25,1/3,1/4-1/2,2-7,2-8,2.2-2.5,2.2-3.2,2.5-4.5,3-20,3-8,4.5-9,5-10,7-15,8-27,abaxial,acute,adaxial,anther,apart,apex,bark,base,berry,branched,bright,calyx,cm,connivent,cordate,cuneate,densely,dirty,dull,erect,flattened-reniform,flower,fruit,glabrous,green-brown,herb,lateral,leaf,length,lobed,long,long-styled,longitudinal,maturity,mauve,mm,moderately,multangulate,orange-brown,ovate,pale,pedicel,peduncle,pendent,petiole,plant,poricidal,porrect,prickly,raised,ridge,rounded,scar,short-styled,shrub,simple,sometimes,spherical,stalked,stellate-pubescent,stem,style,surface,tapering,terminal,tip,trichome,tube,upper,variously,way,white,whitish,wide,yellow,young	-15,.5,/6,0,0-2,0-20,0-4,0-8,0.2-0.3,0.2-0.4,0.3,0.5-3,0.7,00-200,1,1-1.5,1-3,1.5-2.5,1.5-2.6,1.5-3.2,1/4-1/3,1/4-1/3-1/2,12-19,2-10,2-5,2.5-3.5,2.5-3.8,20-50,3-10,3-5,3-50,3.5-6,3/,4-10,4-5-merous,4.2-6.5,5-50,5-7,5-9,7-10,8-20,abaxially,adaxially,alyx,ame,andromonoecious,angled,apar,apically,apparently,articulated,blade,broad-deltate,broadly,c.,chartaceous,clearly,conical,cream,curved,dark,deltate,diameter,discolorous,distal,distance,drying,eaf,eed,elongated,elongating,equal,extending,filament,flattened,free,fruiting,gently,gra,green,hermaphrodite,heterostylous,infructescence,least,lobe,longer,lower,lowermost,margin,marking,mature,midpoint,midvein,narrow-deltate,nflorescence,obtu,older,one,open,orolla,oung,pair,pendulous,per,pericarp,plurifoliat,portion,prickl,prickle,primary,ray,reflexed,ruit,sessile,side,smooth,spaced,sparsely,spreading,stalk,staminat,stellate,stout,straight,strongly,tamen,tertiary,time,unarmed,unit,vary,vein,venation,visible,weakly,woody,ympodial	arrangement,colour,corolla,feature,form,gray,growth,height,inflorescence,na,new,number,ovary,papilla,seed,shape,size,spacing,stigma,texture,type,width	0.1-0.4,0.4-0.9,0.5-2,0.8-1.5,0.8-2.5,1-1.2,1-25,1/3,1/4-1/2,2-7,2-8,2.2-2.5,2.2-3.2,2.5-4.5,3-20,3-8,4.5-9,5-10,7-15,8-27,acute,apart,base,berry,branched,bright,cm,connivent,cordate,cuneate,densely,dirty,dull,erect,flattened-reniform,glabrous,green-brown,herb,lateral,lobed,long,long-styled,longitudinal,maturity,mauve,mm,moderately,multangulate,orange-brown,ovate,pale,pendent,poricidal,porrect,prickly,raised,ridge,rounded,short-styled,shrub,simple,sometimes,spherical,stalked,stellate-pubescent,tapering,terminal,tip,trichome,upper,variously,way,white,whitish,wide,yellow	gray,na
274	wfo-0001029073	success	211	119	79	97	114	22	78	1	0.5,0.5-1,0.6-2,1-1.5,1-2.5,1-3,1.1-1.5,1.5-2,10-16,2,2-3,2-4,2/3,3.5-9,4-5,4-6,5-6,8-14,acuminate,acute,anther,apart,apex,base,beneath,berry,broad-based,calyx,chartaceous,cm,conical,corolla,curved,dark,densely,dimorphic,elliptic,filament,flattened,flower,globose,growth,hooked,inflorescence,internodal,lanceolate,leaf,length,lengthening,lobe,lobed,maturity,minutely,mm,narrowly,new,oblique,occasionally,opposite,orange,paler,papillose,pedicel,petiole,pore,poricidal,prickle,prickly,pubescent,purple,reniform,reticulate,scar,shrub,simple,slightly,slit,somewhat,sparsely,stellate,stem,stigma,straight,strongly,style,surface,tapering,tip,triangular,truncate,tube,unarmed,unequally,way,whitish,x,Â½	.5,.7,0.3-1,0.6-0.7,1-1.2,1.2-1.6,10-15,5-8,5-merous,6-9,7-10,abaxially,adaxially,along,another,anthesi,armed,articulated,away,awn-like,ba,bark,basal,brown,cell,cream,darker,dense,diameter,difoliate,discolorous,drying,eaf,eed,enlarged,entire,equal,erect,except,exserted,four,free,frui,fruiting,geminat,glabrous,golden,gre,interpetalar,lamina,like,linear,long,long-styled,lower,margin,midpoint,midvein,mixture,multangulate,nflorescence,nodding,older,one,pair,pale,peduncle,per,perfect,pericarp,planar,plurifoliate,porrect,portion,primary,pubescence,ray,rectangular,ruit,sessile,shallowly,shiny,short,short-stalked,shorter,sinuate,sometimes,spaced,splitting,styled,tan,testal,thin,three,ti,tissue,trichome,two,ud,underside,unequal,unisexual,unit,upper,upward,vein,visible,wall,wide,woody,yellow,yellowish,ympodial,zygomorphic	abaxial,adaxial,arrangement,bud,colour,connation,feature,form,fruit,height,na,number,ovary,papilla,plant,seed,shape,size,spacing,texture,type,width	0.5,0.5-1,0.6-2,1-1.5,1-2.5,1-3,1.1-1.5,1.5-2,10-16,2,2-3,2-4,2/3,3.5-9,4-5,4-6,5-6,8-14,acuminate,acute,apart,apex,base,beneath,berry,broad-based,calyx,chartaceous,cm,conical,curved,dark,densely,dimorphic,elliptic,flattened,globose,hooked,internodal,lanceolate,leaf,lengthening,lobed,maturity,minutely,mm,narrowly,oblique,occasionally,opposite,orange,paler,papillose,poricidal,prickly,pubescent,purple,reniform,reticulate,shrub,simple,slightly,slit,somewhat,sparsely,stellate,straight,strongly,tapering,tip,triangular,truncate,unarmed,unequally,way,whitish,x,Â½	na
275	wfo-0001029074	success	173	138	86	101	72	37	82	4	.1,.5,0.2-1,0.3-0.4,0.3-0.8,0.5-1,0.5-1.2,0.7-0.8,1,1-1.2,1-1.5,1-2,1.5-4,11,2-7,5-6,acute,age,anther,anthesi,apart,apex,bark,base,berry,black,broadly,calyx,capitate,cm,conical,corolla,cuneate,deflexed,densely,ellipsoid,filament,flattened,flower,glabrous,globose,green,grey,growth,herb,immature,internodal,lacking,leaf,lengthening,less,like,lobe,lobed,markedly,midpoint,minutely,mixture,mm,new,opposite,ovary,ovate,pale,pedicel,petiole,pitted,pore,poricidal,pubescent,purplish,ray,reflexed,reniform,ripening,rounded,sagittate,scar,sessile,simple,slit,small,stalked,stellate,stem,stigma,style,subshrub,surface,tip,triangular,trichome,truncate,tube,way,white,woody,x,yellow,yellowish,Â¾	0,0.7-0.95,1-3-6,1.4-1.8,1.5-2,2-2.3,2-4,2-5,3-,3.5-5,5-7,abaxially,absent,adaxially,almost,along,apparently,appearing,articulation,basa,denser,diameter,eaf,eed,entire,exerted,expanding,free,frui,fruiting,glabrescen,lignescent,longest,lower,margin,midvein,nflorescence,obscuring,often,older,pair,papillat,peduncle,per,perfect,pericarp,petal,planar,plurifoliat,portion,primary,prominent,pulp,ruit,scattered,somewhat,sparsely,stalk,stellate-pubescent,strongly,swollen,thin,tub,ud,underside,uniformly,uniseriate,unit,usually,vein,watery,ympodial	3-6,arrangement,bud,coat,colour,connation,decurrency,dry,embryo,feature,form,fruit,glabrescent,height,history,inflorescence,length,life,minor,na,number,papilla,papillate,plant,prickle,reproduction,seed,shape,size,spacing,specimen,texture,tuberculation,type,width,winging,young	.1,.5,0.2-1,0.3-0.4,0.3-0.8,0.5-1,0.5-1.2,0.7-0.8,1,1-1.2,1-1.5,1-2,1.5-4,11,2-7,5-6,acute,age,anthesi,apart,base,berry,black,broadly,capitate,cm,conical,cuneate,deflexed,densely,ellipsoid,flattened,glabrous,globose,green,grey,herb,immature,internodal,lacking,leaf,lengthening,less,like,lobed,markedly,midpoint,minutely,mixture,mm,opposite,ovate,pale,pitted,poricidal,pubescent,purplish,ray,reflexed,reniform,ripening,rounded,sagittate,sessile,simple,slit,small,stalked,stellate,stem,subshrub,tip,triangular,trichome,truncate,way,white,woody,x,yellow,yellowish,Â¾	3-6,glabrescent,na,papillate
276	wfo-0001029075	success	217	135	96	107	110	28	91	5	.3,.5,0.8-1.5,1-10,1-2,1-2.5,1-3,10-20,2-4,2-5,2.5-3,30-60,4-10,4-14,4-7,4.5-6.5,5-10,5-8.5,6-12,7-17,7-9,8-9,abaxially,abruptly,acumen,adaxially,anther,apart,axillary,base,berry,blade,broadly,brown,bud,canescent,cm,connivent,corolla,decreasing,densely,diameter,digestion,enzyme,flower,fruit,glabrescent,glabrous,glandular-pilose,glandular-puberulent,gradually,gray-green,greatly,hair,herb,honeycomb-shaped,lanceolate,lateral,leaf,leaflet,lengthening,light,like,lobe,long,long-spatulate,mm,narrowed,odd-pinnate,ovoid,pedicel,peduncle,pentagonal,petal,petiole,plant,pore,poricidal,pubescent,purple,removed,seed,short,size,slit,sometimes,stem,stigma,style,subequal,subquadrate,substellate,subtending,terminal,tip,toward,tube,tuber,unwinged,upper,wall,whitish-gray,wide,x,yellow,yellow-green,yellowish-white	0-3,0-8,0.5-0.8,0.8-1.2,2.7-4.2,4-5,5-8,5-merou,ag,along,alyx,apex,apparently,articulated,attenuate-acuminate,atypically,axe,brownish,cell,ciliate,clavifor,condition,covering,cuneate,dark,decurrent,distal,dorsally,dot,drying,eaf,edge,eed,elliptic-lanceolate,end,erect,erect-ascendin,especially,etota,exceeding,filament,flat,flecked,folded,forked,fresh,geminat,generally,glabrou,green,green-white,greenish,hair-like,half,homostylous,interjected,larger,living,lower,make,margin,middl,midrib,minutely,mucilaginous,narrowly,nflorescence,orbicular,orne,orolla,ovate,pair,perfect,petiolulate,petiolule,plurifoliate,pointed,puberulent,rachi,rounded,ruit,sec,sessile,seudostipule,singly,slightly,small,spaced,specimen,stamen,ste,stolo,straight,subobtuse,tall,tamen,tem,testal,thick,throughout,tri-,typically,unit,usually,vary,wet,white,whitish,woody,ympodial	abaxial,adaxial,age,arrangement,calyx,claviform,coat,colour,feature,form,growth,height,hermaphroditic,history,inflorescence,length,life,number,ovary,perennial,presence,present,pseudostipule,reproduction,shape,spacing,surface,texture	.3,.5,0.8-1.5,1-10,1-2,1-2.5,1-3,10-20,2-4,2-5,2.5-3,30-60,4-10,4-14,4-7,4.5-6.5,5-10,5-8.5,6-12,7-17,7-9,8-9,abaxially,abruptly,acumen,adaxially,apart,axillary,base,berry,broadly,brown,bud,canescent,cm,connivent,decreasing,densely,digestion,enzyme,glabrescent,glabrous,glandular-pilose,glandular-puberulent,gradually,gray-green,greatly,hair,herb,honeycomb-shaped,lanceolate,lateral,leaf,lengthening,light,like,lobe,long,long-spatulate,mm,narrowed,odd-pinnate,ovoid,pentagonal,petal,pore,poricidal,pubescent,purple,removed,short,size,slit,sometimes,stem,subequal,subquadrate,substellate,subtending,terminal,tip,toward,unwinged,upper,wall,whitish-gray,wide,x,yellow,yellow-green,yellowish-white	age,claviform,hermaphroditic,perennial,present
277	wfo-0001029084	success	192	112	69	88	104	24	67	2	.5,0.8-2,0.8-2.1,1-2,1.1-2.2,10-50,2-3.5,2-4,2-5,3-6,4-17,4.5-10,4.5-6.5,5,5-7,7-9,acuminate,anther,apex,axillary,base,berry,blade,brownish,bud,chartaceous,cm,condition,conical,connivent,corolla,diameter,digestion,drying,enzyme,filament,flower,forked,fresh,fruit,glabrous,green,greenish,herb,homostylous,honeycomb-shaped,lanceolate,lateral,leaf,leaflet,light,lilac,lobe,minute,mm,moniliform,mottled,narrow,odd-pinnate,ovate-lanceolate,ovoid,petiole,petiolule,plant,pore,poricidal,pubescent,purple,removed,ripe,rotate,seed,size,sparsely,stigma,style,subglabrous,subsessile,subtending,terminal,tip,tube,tuber,unwinged,wall,whitish,wing,x	1-10,1-3,1-4,1.5-2.5,3.5-7.5,3.5-8,4-7,5-merou,6-13,8-23,abaxially,absent,acumen,adaxially,ag,along,alyx,apart,apparently,arranged,articulated,axe,bead,capitat,cell,ciliate,covering,darker,decreasing,distal,dorsally,eaf,edge,eed,especially,exceeding,flat,folded,geminat,generally,glabrou,gradually,green-white,hair-like,half,interjected,interpetalar,larger,lengthening,like,living,lon,long,lower,make,margin,middle,midrib,minutely,mucilaginous,multiple,necklace,nflorescence,obtuse,orolla,pair,pedicel,peduncle,perfect,pilose,plurifoliate,proximal,puberulent,ray,ruit,secondary,semierec,seudostipule,slit,spaced,specimen,stamen,stolon,subequal,subglabrou,symmetrical,tall,tamen,tem,testal,thick,thir,throughout,tissue,toward,tri-,typically,unit,usually,vary,wet,wide,yellow,ympodial	5-merous,arrangement,calyx,capitate,coat,colour,connation,feature,form,growth,height,inflorescence,length,number,ovary,pseudostipule,shape,staman,stem,surface,texture,tuberculation,type,width	.5,0.8-2,0.8-2.1,1-2,1.1-2.2,10-50,2-3.5,2-4,2-5,3-6,4-17,4.5-10,4.5-6.5,5,5-7,7-9,acuminate,axillary,berry,brownish,bud,chartaceous,cm,condition,conical,connivent,digestion,drying,enzyme,forked,fresh,glabrous,green,greenish,herb,homostylous,honeycomb-shaped,lanceolate,lateral,light,lilac,minute,mm,moniliform,mottled,narrow,odd-pinnate,ovate-lanceolate,ovoid,petiolule,poricidal,pubescent,purple,removed,ripe,rotate,sparsely,subglabrous,subsessile,subtending,terminal,tip,unwinged,wall,whitish,wing,x	5-merous,capitate
278	wfo-0001029088	success	149	111	55	66	83	45	52	3	.3,0.6â3.2,1.5â2,1.5â3,15â25,1â3,2â2.5,2â3,3.5â7,3.5â8,3â16,4â8,5,acuminate,acute,anther,apex,base,berry,bronze-brown,calyx,capitate,cm,cordate,extra-axillary,filament,flattened,flower,fruit,glabrous,greenish-brown,herbaceous,immature,lanceolate,leaf,lenticular,lobe,mature,membranous,minutely,mm,narrowly,near,obtuse,ovoid-rhomboid,papillose,pedicel,petiole,purplish,rounded,rugose,shortly,simple,slender,somewhat,sparsely,stellate,stigma,style,surface,tip,tube,unbranched,vine,white,x	.2,0.1,0.9â1.5,1.3â4.5,1â1.2,1â1.5,1â1.6,2-lobe,2.5â20,2.5â4.2,25â30,5-merous,5â8,6-10,<,abaxially,accrescent,adaxially,alyx,apar,apicall,axe,blade,c.,ciliate,climbing,cylindrical,densely,diameter,eaf,eed,emarginate,entire,flavor,fleshy,fragrant,fruiting,glabrou,groun,hair,half,heavy,juicy,light,long,lower,m.,margin,moderately,nflorescence,nternode,orolla,palmate,peduncle,perfec,plurifoliat,primary,pubescent,rachi,reddish-brown,revolute,ruit,sand-punctate,scent,slightly,spaced,stout,straight,strongly,swee,sweet,tamen,tem,terrestrial,truncate,truncate-acuminat,unit,vary,vein,venation,wider,ympodial,â7	2-lobed,anthesi,apart,arrangement,bud,coat,colour,connation,corolla,decurrency,dry,embryo,feature,form,growth,height,history,inflorescence,length,life,midpoint,minor,na,new,number,ovary,papilla,plant,pore,prickle,ray,reproduction,scar,seed,shape,size,spacing,specimen,stem,texture,tuberculation,type,width,winging,young	.3,0.6â3.2,1.5â2,1.5â3,15â25,1â3,2â2.5,2â3,3.5â7,3.5â8,3â16,4â8,5,acuminate,acute,apex,berry,bronze-brown,capitate,cm,cordate,extra-axillary,flattened,glabrous,greenish-brown,herbaceous,immature,lanceolate,lenticular,mature,membranous,minutely,mm,narrowly,near,obtuse,ovoid-rhomboid,papillose,purplish,rounded,rugose,shortly,simple,slender,somewhat,sparsely,stellate,tip,unbranched,vine,white,x	2-lobed,apart,na
279	wfo-0001029089	success	177	124	66	86	91	38	63	3	.5,0.1-0.25,0.5-0.6,0.8-1,1,1-1.5,1.5-2,1.5-6,10-25,2.5-3.5,5-10,5-20-flowered,5-6,5-9,6-7,acute,anther,anthesi,apart,bark,base,berry,bilobed,bud,calyx,campanulate,caniculate,cm,corolla,cracking,deflexed,densely,elliptic,erect,filament,flattened-reniform,furcate,glabrous,globose,golden,green,leaf,lobe,lobed,minor,minutely,mm,occasionally,opposite,ovary,papillose,pedicel,peeling,petiole,pinkish,pitted,pore,pubescent,purplish,reddish-grey,resinous,rounded,rounded-deltoid,scar,shaped,shiny,shrub,simple,size,slightly,small,smooth,stem,stigma,style,surface,tapering,tear-drop,tip,tree,tube,varnished,white,woody,x,young	.75,/4,0.5-1,0.8-1.2,1/2,4.5-5,8-9,abrupt,along,apex,apiculate,axil,ba,beginning,beneath,branched,closely,completely,covered,covering,dark,decurrent,dia,differing,difoliate,drying,eaf,edicel,eed,either,enclosed,entire,expand,exserted,free,fruiting,geminat,glabrou,impressed,incrassate,inflorescenc,lamina,later,lateral,like,lon,long,lower,main,major,margin,material,member,middle,nflorescence,obovoid,older,one,otherwise,overlapping,pair,papillo,part,persistent,planar,poricidal,portion,primary,prominent,resinou,ruit,secretion,somewhat,spaced,still,straight,tall,tan,trichome,tub,ud,underside,uniseriate,unit,usually,varnish,vein,way,widening,widest,ympodial	2,abaxial,adaxial,alternate,arrangement,coat,colour,connation,dry,embryo,feature,flower,form,fruit,growth,hair,height,history,inflorescence,length,life,midpoint,na,number,papilla,plant,prickle,ray,reproduction,seed,shape,spacing,specimen,texture,tuberculation,type,width,winging	.5,0.1-0.25,0.5-0.6,0.8-1,1,1-1.5,1.5-2,1.5-6,10-25,2.5-3.5,5-10,5-20-flowered,5-6,5-9,6-7,acute,apart,berry,bilobed,campanulate,caniculate,cm,cracking,deflexed,densely,elliptic,erect,flattened-reniform,furcate,glabrous,globose,golden,green,leaf,lobed,minutely,mm,occasionally,opposite,papillose,peeling,pinkish,pitted,pubescent,purplish,reddish-grey,resinous,rounded,rounded-deltoid,shaped,shiny,shrub,simple,slightly,small,smooth,tapering,tear-drop,tree,varnished,white,woody,x	2,alternate,na
280	wfo-0001029091	success	207	98	65	76	131	22	63	2	-4,1-2,1.5-2,1.5-2-3,10,10-20,15-40,2-2.5,3-4,7-8,acuminate,acute,anther,apex,base,berry,broadly,calyx,campanulate,capitate,clonal,cm,colour,corolla,cuneate,cyme,discoidal,ellipsoid,elliptic,flattened,flower,flushed,globose,globular,intense,irregular,irregularly,larger,lasting,leaf,long,minutely,mm,oblong,obovate,ochre-yellow,ovate,overlain,ovoid,pattern,pedicel,pentagonal,petiolate,petiole,poricidal,pubescent,reddish-purple,reticulate-concentric,ridge,ridged,several,shortly,shrub,slightly,soft-wooded,sparsely,speckled,stellate-rotate,stem,stigma,style,surface,tip,transverse,violet-purple,year	-4.5,0.3-0.5-0.8-1,0.5-1,1,1-10,10-toothed,170-210,2-12,2-3,2.5-4,20-30,3,3-11-lobed,3-5-7-15,46/1,5,635/1,age,appearing,aromatic,articulated,articulation,aspect,axil,ba,becoming,blunt,bluntly,brownish,buff,cell,close,common,conspicuous,cut,dark,deeply,develop,developed,dia,downward,eed,effect,emarginated,erect,exceeding,exerted,filament,floral,fork,forked,fresh,fruiting,general,giving,glandular,gree,grey,growing,hair,half,interacuminal,juvenile,lacking,later,lateral,lavende,lavender,lengthening,light,line,linear,linear-lanceolate,lobe,long-triangular,lower,may,mid-vein,mineral,narrowly,nflorescence,obscure,occasionally,ower,pale,pedicellate,peduncle,petiol,plurifoliat,point,pore,rachi,raised,readily,relatively,rh,ripe,rounded,ruit,scarcely,separate,shallowly,shed,sigmoid,simple,sinus,slender,slit,soft,soon,stone,straggly,subulate,succulent,swollen,tall,tissue,toward,triangular,tub,ud,unit,upper,usually,violet,well,winged,without,woody,x,ympodial	2.5-4.5,arrangement,bud,feature,form,fruit,growth,height,history,inflorescence,length,life,plant,plurifoliate,reproduction,seed,shape,size,texture,tube,type,width	-4,1-2,1.5-2,1.5-2-3,10,10-20,15-40,2-2.5,3-4,7-8,acuminate,acute,berry,broadly,campanulate,capitate,clonal,cm,cuneate,cyme,discoidal,ellipsoid,elliptic,flattened,flower,flushed,globose,globular,intense,irregular,irregularly,larger,lasting,long,minutely,mm,oblong,obovate,ochre-yellow,ovate,overlain,ovoid,pattern,pentagonal,petiolate,poricidal,pubescent,reddish-purple,reticulate-concentric,ridge,ridged,several,shortly,shrub,slightly,soft-wooded,sparsely,speckled,stellate-rotate,tip,transverse,violet-purple,year	2.5-4.5,plurifoliate
281	wfo-0001029101	success	230	132	82	94	136	38	76	6	/3,0.1-0.4,0.4-1.5,0.5-1,1-1.5,1-3,1-8,1.3-2,1.8-3,2.5-3.5,2.5-6,2.8-3.3,3-10,3-7,4-12,4-7,6-8,anther,apart,apex,apparently,articulated,base,berry,broad-deltate,calyx,cell,cm,connivent,cream,cuneate,dark,dull,elliptic,erect,filament,flattened,flattened-reniform,flower,fruit,glabrous,green,lateral,leaf,length,lobe,lobed,long,long-styled,marking,maturity,mauve,midpoint,mm,moderately,narrow-deltate,obovate,obtuse,outline,ovate,pale,pedicel,petiole,pit,plant,poricidal,prickle,prickly,raised,ray,rounded,scar,short-styled,shrub,simple,small,smooth,sometimes,sparsely,spherical,spreading,stellate-pubescent,stem,straight,style,surface,tapering,tip,tube,way,wide,yellow,yellow-orange,young	-15,.5,/4,0-100,0-2,0-20,0-5,0-8,0.1,0.1-0.5,0.1-0.7,0.1-1,0.2,0.7-1.5-2,0.8-3.5,00-200,1,1-4,1.3-2.6,1.4-2.2,1.5-2,1.5-2.5,1.7,1/5-1/4,10-14,10-20,2-20,2-3-4,2-6,2/3-3/4,3-4,3-5-9,30-100,5-20,5-6,5-7,5-7-13,5-8,5-merous,5.5-8,8-15,abaxial,abaxially,acute,adaxial,almost,always,alyx,andromonoecious,apar,apically,bark,blade,branched,brown-green,chartaceous,concolorous,darker,deltate,diameter,discolorous,distal,distance,drying,eaf,eed,elongating,equal,extending,free,fruiting,glabrescent,green-brow,hermaphrodite,heterostylous,infructescence,lengt,like,lon,longer,lower,lowermost,margin,mature,midvein,multangulate,nflorescence,oblong,often,older,one,open,orange-brown,orolla,oung,pair,peduncle,pendulous,per,pericarp,plurifoliat,porrect,portion,present,prickl,primary,rarely,reduced,reflexed,rounde,ruit,secondary,sessile,side,spaced,stalk,stalked,staminat,stellate,suborbicular,tamen,terete,tertiary,thick,time,trichome,unit,variously,vary,vein,venation,visible,well-developed,woody,yellow-green,ympodial	0.5,0.7-1.5,1.5,5-9,7-13,anthesi,arrangement,bud,coat,colour,connation,corolla,decurrency,dry,embryo,feature,form,growth,height,inflorescence,minor,na,new,number,ovary,papilla,pore,seed,shape,size,spacing,specimen,stigma,texture,tuberculation,type,width,winging	/3,0.1-0.4,0.4-1.5,0.5-1,1-1.5,1-3,1-8,1.3-2,1.8-3,2.5-3.5,2.5-6,2.8-3.3,3-10,3-7,4-12,4-7,6-8,apart,apex,apparently,articulated,base,berry,broad-deltate,cell,cm,connivent,cream,cuneate,dark,dull,elliptic,erect,flattened,flattened-reniform,flower,glabrous,green,lateral,lobed,long,long-styled,marking,maturity,mauve,mm,moderately,narrow-deltate,obovate,obtuse,outline,ovate,pale,pit,poricidal,prickly,raised,rounded,short-styled,shrub,simple,small,smooth,sometimes,sparsely,spherical,spreading,stellate-pubescent,straight,tapering,tip,way,wide,yellow,yellow-orange,young	0.5,0.7-1.5,1.5,5-9,7-13,na
282	wfo-0001029106	success	198	113	74	86	112	27	71	3	.5,/3,0-10,0-2,0-6,0.2-1,0.25-0.7,0.5-0.9,0.5-2.5,0.9-1.2,1-5,1.5-3.5,2-5.5,2-8,2.2-3,3-25,3-3.5,3-4,5-14,anther,apart,apex,articulated,base,berry,calyx,cell,cm,cuneate,curved,diameter,erect,flattened,flattened-reniform,flower,fruit,gently,glabrous,lateral,leaf,length,lobed,long,margin,maturity,mauve,mm,obtuse,orange,orange-brown,outline,pale,pedicel,petiole,pit,poricidal,prickle,prickly,raised,red,reflexed,rounded,shiny,shrub,simple,size,small,smooth,sparsely,spherical,spreading,stellate,stellate-pubescent,stem,straight,style,subentire,surface,tapering,tip,tube,way,weakly,white,wide,yellow-orange	.1,0-0.3,0-20,0-5,0.1,0.2-0.4,0.5,0.5-0.8,0.5-1,1-1.6,1-2,1.5-1.8,1.5-2,1/4,1/5-1/4,2-3.5,2-4,2-6,2/,4-6,4-8,5-8,5-merous,6-8,abaxially,acuminat,acute,alyx,ame,apar,apically,apparently,appearing,bark,blade,branched,c.,concolorous,deltate,densely,discolorous,distance,drying,eaf,eed,elliptic,elongating,equal,extending,eye,filament,free,fruiting,glabrescent,infructescence,light,lobe,lon,longer,lower,mature,membranous,midpoint,midvein,naked,nflorescence,older,one,open,orange-brow,orbicular,orolla,oung,ovate,pair,peduncle,pendulous,per,perfec,pericarp,plurifoliat,porrect,portion,prickl,primary,ray,scandent,scar,sessile,shallow,shorter,side,slender,sometimes,spaced,stalk,stalked,tamen,terete,tertiary,time,trichome,uit,unit,variously,vary,vein,venation,visible,woody,yellowish-green,ympodial	arrangement,colour,connation,corolla,feature,form,growth,height,history,inflorescence,life,na,number,ovary,papilla,perennial,plant,reproduction,seed,shape,spacing,stigma,texture,type,unknown,width,young	.5,/3,0-10,0-2,0-6,0.2-1,0.25-0.7,0.5-0.9,0.5-2.5,0.9-1.2,1-5,1.5-3.5,2-5.5,2-8,2.2-3,3-25,3-3.5,3-4,5-14,apart,articulated,base,berry,cell,cm,cuneate,curved,diameter,erect,flattened,flattened-reniform,gently,glabrous,lateral,lobed,long,maturity,mauve,mm,obtuse,orange,orange-brown,outline,pale,pit,poricidal,prickle,prickly,raised,red,reflexed,rounded,shiny,shrub,simple,small,smooth,sparsely,spherical,spreading,stellate,stellate-pubescent,straight,subentire,tapering,tip,way,weakly,white,wide,yellow-orange	na,perennial,unknown
283	wfo-0001029112	success	190	115	74	90	100	25	70	4	0.5,0.9-1.7,1-10,1-2,1.4-2.5,1.5-1.8,1.5-2,10-17,10-21,2-3.5,2.5-4.5,2.6-3,2.7-3.5,2.7-4.2,2.7-5.7,20,3-7,3.5-7,5,5-8,6.5-5.5,9.5-13,abaxially,acuminate,adaxially,anther,apart,axillary,berry,blade,bud,cell,chartaceous,cm,conical,connivent,corolla,covering,densely,diameter,flower,fruit,glabrous,green,hair,hair-like,herb,homostylous,lanceolate,lateral,leaf,leaflet,light,like,lobe,long,minute,mm,moniliform,mottled,narrow,odd-pinnate,ovoid,pale,pedicel,peduncle,petiole,plant,pore,poricidal,pubescent,purple,ripe,rotate,seed,size,stigma,style,subtending,terminal,testal,thick,tip,tube,tuber,violet,wall,wide,wing,x	0-2,1-3,1-4,3-4,3-5,3-6,3.5-4.5,5-merou,acumen,ag,along,alyx,apex,apparently,arranged,articulated,axe,base,bead,brownish,capitat,ciliate,condition,decreasing,digestion,distal,dorsally,drying,eaf,edge,eed,elliptic-lanceolate,enzyme,equal,especially,exceeding,filament,flat,folded,forked,fresh,geminat,generally,glabrou,gradually,green-white,greenish,half,honeycomb-shaped,interjected,larger,lengthening,living,lower,make,margin,middle,mucilaginous,multiple,necklace,nflorescence,obtuse,orolla,ovate,pair,perfect,petiolule,plurifoliate,present,pubescen,ray,removed,ruit,secondary,semierec,seudostipule,slightly,slit,spaced,specimen,stamen,ste,stolon,subequal,symmetrical,tall,tamen,tem,thir,throughout,toward,tri-,typically,unit,usually,vary,wet,whitish,yellow,ympodial	arrangement,calyx,capitate,colour,connation,feature,form,growth,height,history,inflorescence,length,life,na,number,ovary,perennial,pseudostipule,pubescence,reproduction,shape,spacing,stem,surface,texture	0.5,0.9-1.7,1-10,1-2,1.4-2.5,1.5-1.8,1.5-2,10-17,10-21,2-3.5,2.5-4.5,2.6-3,2.7-3.5,2.7-4.2,2.7-5.7,20,3-7,3.5-7,5,5-8,6.5-5.5,9.5-13,abaxially,acuminate,adaxially,apart,axillary,berry,bud,cell,chartaceous,cm,conical,connivent,covering,densely,glabrous,green,hair,hair-like,herb,homostylous,lanceolate,lateral,light,like,long,minute,mm,moniliform,mottled,narrow,odd-pinnate,ovoid,pale,poricidal,pubescent,purple,ripe,rotate,subtending,terminal,testal,thick,tip,violet,wall,wide,wing,x	capitate,na,perennial,stem
284	wfo-0001029120	success	168	117	74	82	86	35	69	5	.5,/2,0.1-0.5,0.5-1.5,0.7-1,1-1.5,1.1-1.5,2.5-3.5,2.6-7,6-8,6.5-16.5,abrupt,acuminate,acute,anther,apart,apex,bark,basal,base,beginning,black,bud,calyx,cm,corolla,dark,decurrent,densely,dia,f,filament,glabrous,globose,golden,greenish-brown,hirsute,internodal,large,leaf,lobe,lobed,long,long-triangular,minor,minutely,mm,narrower,narrowly,nearly,opposite,ovary,ovate,paler,pedicel,petiole,pore,poricidal,pubescent,scar,shaped,shrub,simple,slightly,sparsely,speckle,stem,stigma,style,surface,tapering,tear-drop,thickened,tip,trichome,tube,unifoliate,uniseriate,way,white,widening,young	.05,.75,1.1-2,3-3.5,5-10-flowered,5-8,8511,anthesi,beneath,bullate,cell,deflexed,difoliate,dry,drying,eaf,edicel,eed,epidermi,erose,especially,evenly,fide,fleshy,free,geminat,inflorescenc,infloresence,know,known,lanceolate,larger,later,lateral,lehmann,like,lon,lower,main,margin,middle,midrib,narrow,nflorescence,occasionally,often,older,outer,pair,pale,papillose,peduncl,peduncle,petaloid,point,portion,present,prominently,proximal,raised,reproductive,rest,ruit,scattered,slender,spaced,specimen,straight,sympodial,tall,terminal,tub,ud,unbranched,unit,upper,urceolate,vein,venation,white-papillo,wide,widest,x,yellow,yellow-green,ympodial	5-10,arrangement,coat,colour,connation,decument,decurrency,embryo,feature,flower,form,fruit,growth,height,history,inflorescence,length,life,na,new,number,papilla,plant,prickle,reproduction,seed,shape,size,spacing,texture,tuberculation,type,white-papillose,width,winging	.5,/2,0.1-0.5,0.5-1.5,0.7-1,1-1.5,1.1-1.5,2.5-3.5,2.6-7,6-8,6.5-16.5,abrupt,acuminate,acute,apart,basal,base,beginning,black,bud,calyx,cm,dark,decurrent,densely,dia,f,glabrous,globose,golden,greenish-brown,hirsute,internodal,large,leaf,lobed,long,long-triangular,minutely,mm,narrower,narrowly,nearly,opposite,ovate,paler,petiole,poricidal,pubescent,shaped,shrub,simple,slightly,sparsely,speckle,stem,style,tapering,tear-drop,thickened,tip,trichome,tube,unifoliate,uniseriate,way,white,widening,young	5-10,decument,inflorescence,na,white-papillose
285	wfo-0001029121	success	159	80	38	53	106	27	35	3	0.2-2,1-4,1-5,1.1-3.9,1.2-2.5,15-30,2-13,2-3,3.8-11,4-10,4-5.5,4.5-10.0,5-20,5-8,8-16,9-33,blue,branched,calyx,cm,conical,connate,corolla,cyme,diameter,dichasially,filament,flower,forked,glabrous,herbaceous,lateral,leaf,leaflet,long,mm,mucilaginous,odd-pinnate,ovoid,pair,pedicel,peduncle,perennial,petiole,plant,purple,rotate,seed,size,stigma,style,terminal,yellow	0,0-2,1.2-3.3,10,2-10,2-3-5-6,2-3-celled,3-6-foliat,3.6-9,abaxiall,abaxially,acumen,acuminate,acute,adaxially,apex,apical,apically,articulate,attenuate,base,cell,commonly,covering,cuneate,deep,dehiscent,dichasial,digestion,diminishing,distal,dorsally,eaf,ebracteate,edge,eed,elliptical,emoval,enzyme,exceeding,flat,folded,generally,globo,gradually,green,green-white,hair,hair-like,half,honeycomb,interjected,introrse,living,lobe,lon,lower,lunat,make,maturing,medium,monochasial,narrowly,nflorescence,nther,oblique,obtuse,often,orolla,ovate,pattern,perfect,petiolule,plan,poricidally,proximal,rarely,reveal,rounded,ruit,scattered,sessile,seudostipule,short,short-attenuate,slit,specimen,stamen,straight,subequal,tal,tem,testal,thick,throughou,throughout,tip,toward,tuber-bearing,typically,unit,vary,wall,wide,ympodial,Â¼	2-6,abaxial,adaxial,anther,arrangement,colour,connation,feature,form,fruit,globose,growth,height,history,inflorescence,length,life,na,number,ovary,reproduction,shape,stem,surface,texture,type,width	0.2-2,1-4,1-5,1.1-3.9,1.2-2.5,15-30,2-13,2-3,3.8-11,4-10,4-5.5,4.5-10.0,5-20,5-8,8-16,9-33,blue,branched,cm,conical,connate,cyme,dichasially,forked,glabrous,herbaceous,long,mm,mucilaginous,odd-pinnate,ovoid,perennial,purple,rotate,yellow	2-6,globose,na
286	wfo-0001029125	success	196	130	95	93	103	37	76	19	0.5,1,abaxial,acuminate,acute,adaxial,along,anther,apex,appressed,attenuate,base,berry,black,brownish,central,closely,cm,concave-reniform,conical,corolla,cuneate,deltate,diameter,ellipsoid,end,especially,fruit,glabrous,globose,green,herb,hilum,internodal,lateral,leaf,like,lobe,long,maturity,maximum,minutely,mm,narrower,oblique,occasionally,one,orange,ovary,ovate-lanceolate,papillate,pedicel,peduncle,petiole,plant,poricidal,positioned,pubescent,purple,purple-tinged,purplish,ridged,ripe,scar,seed,shiny,simple,slightly,small,spaced,sparsely,star,stellate,stem,stigma,style,sub-lateral,subshrub,surface,terete,tip,toward,trichome,tube,turning,unequal,uniseriate,vein,white,wide,woody,yellow,young	.0â3.5,.1,.1â1.4,.2,.4,.5â2.0,.6,0.5â0.6,0.5â1.0,0.8â0.9,0.9,1.0â1.2,1.0â1.5,1.0â4.0,1.5â2.0,1.5â3.0,1.7-3.0â3.4,1.8â3.5,1â2-celled,2.5â12.0,2/3,20â100,2â3-celled,2â4,3.5â4,35â45,3â5,3â5-celled,4â8,5-merous,5â6,6,6â7,abaxially,adaxially,age,anthesi,apar,apparently,arising,articulated,ba,beyond,branching,calyx,cell,cone,delicate,densely,difoliate,eaf,eed,entire,exerted,filament,flower,free,fruiting,geminat,growt,later,lengthening,live,lobed,lon,lower,margin,nearly,nflorescence,often,outline,pair,pale,pentagonal,per,perfect,place,pore,portion,primary,reflexe,reflexed,ruit,scattered,shorter,single,slit,spreading,stemmed,stone,straight,strongly,tall,tem,testal,tinged,traingular,ud,unit,usually,whitewith,ympodial,Â¼	0.4,0.5-0.6,0.5-1.0,1-2-celled,1.0-1.5,1.0-4.0,1.1,1.2,1.5-2.0,1.5-3.0,2-4,2.5-12.0,20-100,3.5-4,6-7,apart,arrangement,bud,colour,feature,form,growth,height,history,inflorescence,length,life,na,papilla,reproduction,shape,size,spacing,texture,triangular,type,width	0.5,1,acuminate,acute,along,apex,appressed,attenuate,base,berry,black,brownish,central,closely,cm,concave-reniform,conical,cuneate,deltate,ellipsoid,end,especially,glabrous,globose,green,herb,hilum,internodal,lateral,leaf,like,long,maturity,maximum,minutely,mm,narrower,oblique,occasionally,one,orange,ovate-lanceolate,papillate,poricidal,positioned,pubescent,purple,purple-tinged,purplish,ridged,ripe,seed,shiny,simple,slightly,small,spaced,sparsely,star,stellate,stem,sub-lateral,subshrub,terete,tip,toward,trichome,turning,unequal,uniseriate,vein,white,wide,woody,yellow,young	0.4,0.5-0.6,0.5-1.0,1-2-celled,1.0-1.5,1.0-4.0,1.1,1.2,1.5-2.0,1.5-3.0,2-4,2.5-12.0,20-100,3.5-4,6-7,apart,growth,na,triangular
287	wfo-0001029150	success	177	125	83	97	80	28	81	2	0.3,0.3-0.5,0.3â0.5,0.5â1.1,0.8-1,0.8â1.5,0.8â3.5,1.2â1.5,1.5,1.5â2.2,15,1â1.5,1â11,1â5,1â6,2.5â3,2.5â5,2.5â8,2â10,2â2.5,3â10,6,8-shaped,9â12,acute,adaxially,anther,apex,apically,apiculate,attenuate,base,branched,calyx,ciliate,climbing,cm,conical,cros,cylindrical,ellipsoidal,elliptical,enlarged,except,extra-axillary,filament,flower,fruit,glabrous,lanceolate,larger,leaf,lobe,long,margin,membranaceous,midvein,minutely,mm,moderately,nearly,oblique,opposed,ovate,pedicel,peduncle,petiole,pinnate,pubescent,rachi,rarely,rounded,rugose,sand-punctate,section,shortly,simple,slender,slightly,small,spaced,sparsely,stellate,stem,stigma,style,surface,teardrop-shaped,tip,trichome,truncate,tube,venation,vine,white,woody,x	.5,0.8â1,1.5â2,1â2,2â3,3-5,3â4,3â50,5-merous,7â8,abaxially,accrescent,across,adaxiall,alyx,apar,apicall,axe,berry,blade,c.,canopy,capitat,color,delicate,diameter,distant,dried,eaf,eed,entire,flattened,fleshy,flush,fruiting,glabrou,inconspicuous,lamina,light,living,lon,lower,m.,material,mor,nflorescence,nternode,older,orolla,pair,pale,perfec,pinkish-white,plurifoliat,pointed,reaching,rounded-deltoid,ruit,scar,secondary,side,somewhat,specimen,strong,tamen,tan,tem,thick,thickened,time,translucent,tree,understory,unit,vary,vegetation,vein,wide,wiry,ympodial	abaxial,adaxial,apart,arrangement,capitate,colour,connation,corolla,feature,form,growth,hair,height,history,inflorescence,internode,length,life,ovary,papilla,plant,reproduction,seed,shape,size,texture,type,width	0.3,0.3-0.5,0.3â0.5,0.5â1.1,0.8-1,0.8â1.5,0.8â3.5,1.2â1.5,1.5,1.5â2.2,15,1â1.5,1â11,1â5,1â6,2.5â3,2.5â5,2.5â8,2â10,2â2.5,3â10,6,8-shaped,9â12,acute,adaxially,apically,apiculate,attenuate,branched,ciliate,climbing,cm,conical,cros,cylindrical,ellipsoidal,elliptical,enlarged,except,extra-axillary,flower,fruit,glabrous,lanceolate,larger,leaf,long,margin,membranaceous,midvein,minutely,mm,moderately,nearly,oblique,opposed,ovate,pinnate,pubescent,rarely,rounded,rugose,sand-punctate,section,shortly,simple,slender,slightly,small,spaced,sparsely,stellate,teardrop-shaped,tip,trichome,truncate,vine,white,woody,x	apart,capitate
288	wfo-0001029152	success	197	132	77	101	96	31	73	4	.1,0.5-1,0.8-1,0.9-1.3,1-1.5,1-2,1-4,1.5-2,2-2.5,2-3,2-4,2-5,3-5,8.5-16,acuminate,acute,anther,anthesi,apex,appressed,area,attenuate,bark,base,berry,broadly,bud,calyx,closely,cm,conical,corolla,cuneate,deciduous,decurrent,deep,deltoid,densely,dry,elliptic,erect,filament,flower,fruit,glabrous,globose,green,greyish-red,inflorescence,leaf,lightly,lobe,lobed,minor,minutely,mm,nearly,obovate,often,opposite,ovary,overlapping,ovoid-reniform,pale,papillose,pedicel,petiole,pitted,plane,plant,pore,poricidal,red-floccose,reddish-floccose,rounded,scar,shape,shaped,shiny,shrub,simple,single,size,small,spaced,stem,stigma,style,surface,tapering,tear-drop,tip,tree,trichome,tube,weak,white,winged,woody,x,young	.5,0.25-0.5,0.75-1,1,1-3,1.1-1.3,1.5-1.7,2.5-3,3-8-flowered,4-6,6-8,61-25,appearanc,appearing,ba,beginning,beneath,blade,branch,broadened,brown,citronella,completely,corky,dark,deflexed,dia,differing,difoliate,distal,eaf,edicel,eed,ellipsoi,enclosing,et,exsertion,fide,flattened,floccose,fragrance,free,fruiting,geminat,giving,held,hyaline,inflorescenc,keeled,large-lenticellate,late,lateral,live,lon,long,long-styled,longer,lower,main,major,margin,material,middle,midrib,nflorescence,older,one,pair,per,planar,portion,prominent,prominently,quite,red,reddish,reflexed,reminiscent,ruit,short-styled,slender,slightly,somewhat,soon,straight,styl,tall,terminal,third,tillett,ud,unit,usually,vein,widest,ympodial	1.5-4-6,3-8,arrangement,coat,colour,connation,decurrency,feature,form,growth,height,history,length,life,lighty,midpoint,na,new,number,papilla,prickle,ray,reproduction,seed,spacing,specimen,texture,tuberculation,type,width,winging	.1,0.5-1,0.8-1,0.9-1.3,1-1.5,1-2,1-4,1.5-2,2-2.5,2-3,2-4,2-5,3-5,8.5-16,acuminate,acute,appressed,area,attenuate,base,berry,broadly,closely,cm,conical,cuneate,deciduous,decurrent,deep,deltoid,densely,elliptic,erect,glabrous,globose,green,greyish-red,leaf,lightly,lobed,minutely,mm,nearly,obovate,often,opposite,overlapping,ovoid-reniform,pale,papillose,pitted,plane,poricidal,red-floccose,reddish-floccose,rounded,shaped,shiny,shrub,simple,single,small,spaced,tapering,tear-drop,tip,tree,trichome,weak,white,winged,woody,x	1.5-4-6,3-8,lighty,na
289	wfo-0001029156	success	65	72	51	57	8	15	49	2	-3,0.5,1,1.5-2,10-12,2,4-6,6,6-8,<,almost,apex,bark,berry,cell,center,cm,completely,deeply,diameter,exfoliating,flattened,fruiting,glabrous,golden,growth,lateral,liana,long,margin,markedly,minute,minutely,mm,multiseriate,new,pale,pedicel,per,pitted,rectangular,reniform,rib-like,seed,shiny,shreddy,sinuate,stem,surface,tan,testal,thickening,trichome,vine,wall,wide,woody	apparently,eed,epiphytic,fide,nee,noddin,occasionally,older	colour,feature,form,height,history,length,life,na,nodding,number,plant,reproduction,shape,texture,width	-3,0.5,1,1.5-2,10-12,2,4-6,6,6-8,<,almost,apex,berry,center,cm,completely,deeply,diameter,exfoliating,flattened,glabrous,golden,lateral,liana,long,margin,markedly,minute,minutely,mm,multiseriate,pale,per,pitted,rectangular,reniform,rib-like,seed,shiny,shreddy,sinuate,surface,tan,thickening,trichome,vine,wall,wide,woody	na,nodding
290	wfo-0001029156	success	65	72	47	52	13	20	43	4	-3,0.5,1,1.5-2,10-12,2,4-6,6-8,<,almost,berry,cell,center,cm,completely,deeply,diameter,exfoliating,flattened,glabrous,golden,growth,lateral,liana,margin,markedly,minute,minutely,mm,multiseriate,new,pale,pedicel,per,pitted,rectangular,reniform,rib-like,seed,shiny,shreddy,sinuate,stem,surface,tan,testal,thickening,trichome,vine,wall,woody,x	apex,apparently,ark,eed,em,epiphytic,fide,fruiting,lon,nee,noddin,occasionally,older	6,bark,colour,feature,form,fruit,height,history,length,life,long,na,nodding,number,plant,reproduction,shape,size,texture,type	-3,0.5,1,1.5-2,10-12,2,4-6,6-8,<,almost,center,cm,completely,deeply,exfoliating,flattened,glabrous,golden,lateral,liana,margin,markedly,minute,minutely,mm,multiseriate,pale,pedicel,pitted,rectangular,reniform,rib-like,seed,shiny,shreddy,sinuate,tan,thickening,trichome,vine,wall,woody,x	6,long,na,nodding
291	wfo-0001029163	success	148	116	61	71	77	45	59	2	-9,0.3-2.5,0.5-1,1-2,10-20-30,2,2-3,2-7,3-14,3-4,3-5,4-20,4.5-23,5-12-25,5-8,acuminate,acute,apart,apex,base,calyx,cm,connivent,cuneate,decurrent,deltate,densely,eglandular,elliptic,elliptic-ovate,flower,free,fruit,glabrous,glandular,globose,hair,herb,lanceolate,lenticular,like,lobe,mm,narrowly,nearly,pedicel,perennial,petiole,pore,pseudohair,puberulent,puberulent-pubescent,purple,shrub,simple,sparsely,stalked,stellate,stem,stigma,style,subcoriaceous,surface,tip,triangular,tube,unbranched,unknown,white,whitish,x	-4,1,1.5-2,1.5-2.5,1.5-3,13-18,2-18,2-6,2.5-3,20-30,4-5-foliat,4-6,7-9,9-15,abaxial,abaxially,absen,adaxiall,adaxially,aggregate,articulated,axe,band,blade,cell,chartaceous,color,cylindrical,denser,diameter,directed,distall,distally,eaf,eed,entire,leaving,lon,long,lower,margin,moderately,narrowed,nflorescence,nther,obtuse,orolla,papillose,pedicellar,peduncle,projection,puberulent-pubescen,pubescence,rachi,radiu,remnant,ripe,roughened,ruit,scale-like,slightly,small,sometimes,spaced,stone,subapical,tal,tem,thickened,time,truncat,unit,vary,vein,wide,yellow,ympodial	anther,anthesi,arrangement,bud,coat,colour,connation,corolla,decurrency,dry,embryo,feature,filament,form,growth,height,history,inflorescence,leaf,length,life,midpoint,minor,na,new,number,ovary,papilla,plant,prickle,ray,reproduction,scar,seed,shape,size,spacing,specimen,texture,truncate,tuberculation,type,width,winging,young	-9,0.3-2.5,0.5-1,1-2,10-20-30,2,2-3,2-7,3-14,3-4,3-5,4-20,4.5-23,5-12-25,5-8,acuminate,acute,apart,apex,base,cm,connivent,cuneate,decurrent,deltate,densely,eglandular,elliptic,elliptic-ovate,free,glabrous,glandular,globose,hair,herb,lanceolate,lenticular,like,mm,narrowly,nearly,perennial,pseudohair,puberulent,puberulent-pubescent,purple,shrub,simple,sparsely,stalked,stellate,stem,subcoriaceous,triangular,unbranched,unknown,white,whitish,x	na,truncate
292	wfo-0001029171	success	137	114	67	76	61	38	65	2	-,-10-15,0.5,1-3,1-4.5,1.5-2,1.5-7.5,10-25,3-4,3.5-18,4-10-15,4-5,5-6,7-9,abruptly,acuminate,acute,also,and/or,angled,apart,apex,base,branched,calyx,chartaceous,cm,connivent,cuneate,decurrent,deltate,dendritically,dense,densely,eglandular,flower,forked,fruit,glabrous,gland,globose,hair,lanceolate,lobe,mm,moderately,narrowed,narrowly,often,orange,pedicel,petiole,pore,puberulent,pubescent,purple,rarely,red,ripe,rugose,short-stalked,shrub,simple,slightly,smooth,sometimes,stellate,stigma,style,tip,triangular,tube,unbranched,usually,white,x	-10,1-5,10-35,11-20,2-3,3.5-6.5,5-8,6-,8-17,abaxially,absen,adaxially,aggregate,articulated,axe,ba,blade,cell,cylindrical,diameter,directed,distall,eaf,eed,elliptic,entire,except,glandula,glandular,like,long,lower,many-foliat,margin,midrib,near,nearly,nflorescence,nther,obtuse,orolla,ovate-elliptic,peduncle,perfect,rachi,radiu,ruit,shoot,spaced,sparsely,ste,stone,tal,tem,time,truncat,unit,vary,wide,yellow,ympodial	abaxial,adaxial,anther,arrangement,bud,colour,connation,corolla,embryo,feature,filament,form,growth,height,inflorescence,leaf,length,midpoint,na,number,ovary,papilla,plant,prickle,ray,scar,seed,shape,size,spacing,stem,surface,texture,truncate,type,width,winging,young	-,-10-15,0.5,1-3,1-4.5,1.5-2,1.5-7.5,10-25,3-4,3.5-18,4-10-15,4-5,5-6,7-9,abruptly,acuminate,acute,also,and/or,angled,apart,apex,branched,chartaceous,cm,connivent,cuneate,decurrent,deltate,dendritically,dense,densely,eglandular,forked,glabrous,gland,globose,hair,lanceolate,mm,moderately,narrowed,narrowly,often,orange,puberulent,pubescent,purple,rarely,red,ripe,rugose,short-stalked,shrub,simple,slightly,smooth,sometimes,stellate,tip,triangular,unbranched,usually,white,x	na,truncate
293	wfo-0001029215	success	49	59	39	36	13	23	33	6	0.3-0.5,0.5-0.7,0.5-2.5,1,2.3-2.9,appearance,border,calyx,cell,cm,diameter,elongating,entire,fide,hair-like,herb,lateral,long,markedly,mm,narrowly,obovate,outgrowth,pubescent,round,shrub,silky,strong,surface,testa,thick,wall,weigend,wide,winged,xyledecor	-1.8-2.3,.2,brown,coarse,eed,fruit,give,lobe,small,smelling,spreadin,tall,woody	0.2,1.8-2.3,elongation,feature,form,giving,growth,height,history,length,life,lobed,na,odour,orientation,plant,reproduction,seed,shape,size,spreading,width,winging	0.3-0.5,0.5-0.7,0.5-2.5,1,2.3-2.9,appearance,border,cell,cm,elongating,entire,fide,hair-like,herb,lateral,long,markedly,mm,narrowly,obovate,outgrowth,pubescent,round,shrub,silky,strong,testa,thick,wall,weigend,wide,winged,xyledecor	0.2,1.8-2.3,giving,lobed,na,spreading
294	wfo-0001029216	success	240	161	108	117	123	44	101	7	+,.5,0.1-0.3,0.2-0.4,0.2-0.8,0.3-0.4,0.3-0.5,0.5,0.5-1.5,0.6-0.8,0.6-1,1-1.2,1.5-2.5-10,10,2-locular,2.5-3.3,3,acute,adpressed,and/or,annual,anther,anthesi,apex,appearance,articulated,articulation,attenuate,axi,base,basiscopically,biennial,bright,calyx,capitate,cell,cm,composed,conical,cordate,corolla,cultivar,decurrent,deep,distal,elliptic,filament,fruit,giving,gland-tipped,glandular,globose,green,hair-like,herb,imparipinnate,inflorescence,interrupted,lanceolate,lateral,length,like,linear,lobe,long,longer,maturity,minutely,mixture,mm,multicellular,multilocular,narrowly,numerous,oblique,obovate,often,one,orange,outgrowth,ovary,ovate,particularly,pedicel,pentagonal,perennial,petiole,plant,pubescent,red,shaggy,shape,short,silky,simple,sparse,sparsely,stem,stigma,straight,style,surface,tangled,testa,tip,toward,trichome,truncate,tube,unicellular,uniseriate,usually,varying,villous,wall,winged,yellow	-5,.8-1,0.1-0.5,0.1-0.6,0.1-0.8,0.2-0.25,0.2-0.3,0.2-0.3-0.5,0.3-2,0.4,0.4-0.5,0.5-0.8,0.5-2,0.8-2.5,1-2,1-3,1-4,1-6,1.2-6,1.5-2.3,1.5-3,1/,10-14,10-20-35,2,2-4.5,3-4,3-5,3-7,3-7-10,3-foliate,4,5,5-15-flower,6-10,<,absen,absent,accrescent,acroscopically,allogamous,always,angeld,apical,appendage,basal,becoming,branch,brown,cente,column,cone,crenate,deeply,dentate,diameter,eaf,edicel,eed,entire,erect,exserted,extending,facultatively,fasciated,fruited,fruiting,glabrescent,gree,half,halfway,included,initially,interjected,internode,large,larger,later,leaflet,less,lobulate,lon,lower,mainly,margin,minute,near,nflorescence,pair,pale,peduncle,petiolule,population,present,primary,procumbent,pseudostipule,rarely,reflexe,ruit,scen,secondary,sessile,shaped,sometimes,somewhat,spreading,staminal,sterile,strong,strongly,tem,terminal,tertiary,thick,thickening,total,ud,unit,variety,viny,wide,ympodial	1/3,10-35,5-15,7-10,alternate,angled,arrangement,bark,bud,coat,colour,connation,decurrency,dry,embryo,feature,flower,form,growth,height,history,leaf,life,midpoint,minor,na,new,number,papilla,pore,prickle,ray,reproduction,scar,seed,size,spacing,specimen,texture,tuberculation,type,width,winging,young	+,.5,0.1-0.3,0.2-0.4,0.2-0.8,0.3-0.4,0.3-0.5,0.5,0.5-1.5,0.6-0.8,0.6-1,1-1.2,1.5-2.5-10,10,2-locular,2.5-3.3,3,acute,adpressed,and/or,annual,apex,appearance,articulated,articulation,attenuate,axi,base,basiscopically,biennial,bright,capitate,cell,cm,composed,conical,cordate,cultivar,decurrent,deep,distal,elliptic,giving,gland-tipped,glandular,globose,green,hair-like,herb,imparipinnate,inflorescence,interrupted,lanceolate,lateral,like,linear,long,longer,maturity,minutely,mixture,mm,multicellular,multilocular,narrowly,numerous,oblique,obovate,often,one,orange,outgrowth,ovate,particularly,pentagonal,perennial,pubescent,red,shaggy,shape,short,silky,simple,sparse,sparsely,stem,straight,surface,tangled,testa,toward,trichome,truncate,unicellular,uniseriate,usually,varying,villous,wall,winged,yellow	1/3,10-35,5-15,7-10,alternate,angled,na
295	wfo-0001029226	success	206	134	97	107	99	27	93	4	-7,-9,.5,0.5,0.5-5,1-1.5,1-3,1-celled,10-40+,2-6,2-9,2.5-10,4,4-6,5-7,7-11,acuminate,acute,anther,apart,apex,apparently,base,berry,breaking,bright,capitate,cell,cm,congested,cordate,corolla,decurrent,densely,ellipsoid,elongate,flattened,flower,glabrescent,glabrous,gland,globose,growth,hairy,herbaceous,irregularly,lateral,lavender,leaf,lengthening,like,lobed,long,longer,mature,minutely,mm,new,occasionally,one,pale,papillate,pedicel,peduncle,petiole,pinnatifid,pitted,pore,poricidal,pubescent,red,reniform,scar,seed,short-glandular,shorter,shrub,simple,slender,slit,spaced,spreading,stellate,stem,stigma,style,surface,tan,terminal,testal,tip,translucent,trichome,truncate,tube,uniformly,uniseriate,usually,vine,wall,way,weak,white,wide,woody,yellowish,Â¾	.75,0-1,1-2,2,2-3,3-3.5,3-6,30,5-merou,8-13,>,ag,alyx,anthesi,ark,articulated,ba,basal,black,blue,branched,calyx,completely,conical,connivent,dark,deltate,diameter,distall,divided,dry,eaf,eed,enation,entire,exserted,filament,flexuous,free,fruiting,glandular,green,ilament,juice,lobe,loosely,lower,lyrate,many,margin,material,membranous,mere,minute,nflorescence,often,older,open,orolla,overtopping,pair,papillat,papillo,per,perfect,pinnate,plurifoliat,portion,primary,reflexed,remainin,rim,ripe,ruit,sagittate,scarlet,shiny,sleeve,small,sometimes,sparsely,spot,sprawling,spreadin,staining,strongly,tangled,tem,thin,third,time,twinin,ud,unit,vary,vein,widest,winged,ympodial	abaxial,adaxial,age,arrangement,bark,bud,coat,colour,distally,feature,form,fruit,history,inflorescence,length,life,number,ovary,plurifoliate,remaining,shape,size,spacing,texture,tuberculation,type,width	-7,-9,.5,0.5,0.5-5,1-1.5,1-3,1-celled,10-40+,2-6,2-9,2.5-10,4,4-6,5-7,7-11,acuminate,acute,apart,apparently,base,berry,breaking,bright,capitate,cell,cm,congested,cordate,decurrent,densely,ellipsoid,elongate,flattened,glabrescent,glabrous,gland,globose,hairy,herbaceous,irregularly,lateral,lavender,lengthening,like,lobed,long,longer,mature,minutely,mm,occasionally,one,pale,papillate,petiole,pinnatifid,pitted,pore,poricidal,pubescent,red,reniform,seed,short-glandular,shorter,shrub,simple,slender,slit,spaced,spreading,stellate,stem,tan,terminal,testal,tip,translucent,trichome,truncate,uniformly,uniseriate,usually,vine,wall,way,weak,white,wide,woody,yellowish,Â¾	age,distally,plurifoliate,remaining
296	wfo-0001029236	success	159	127	73	89	70	38	69	4	.5,0.2-0.7,0.2-1,0.45-0.5,0.9-2.3,1-1.5,1-2,1/2,2-5,3,6-9,absent,age,anther,anthesi,apex,apically,bark,base,berry,calyx,cm,completely,conical,corolla,cupulate,deflexed,dendritic,densely,diameter,elliptic,except,filament,flattened,flower,free,fruit,glabrous,globose,grey-brown,growth,later,leaf,lenticular,lobe,lobed,long,margin,minutely,mm,narrowly,near,nodding,obscurely,occasionally,ovary,pedicel,petiole,pitted,pointed,pore,poricidal,pubescent,purplish,purplish-black,revolute,scar,scattered,shiny,shrub,slightly,slit-like,sparsely,stem,stigma,strongly,style,surface,terminal,tip,trichome,trongly,tube,violet,way,winged,woody,x,young	0.5,0.5-1.5,1.4-1.7,2-4,abaxially,adaxial,apical,apparently,appearing,axi,ba,basal,becoming,bi-lobe,branch,branching,branchlet,broadly,compact,coriaceous,decurrent,deltate,dichasial,eaf,edicel,eed,erect,ew,exserted,fleshy,fruiting,inserted,lateral,less,lower,m.,many,middle,midvein,nflorescence,obscure,older,overtopping,packe,pale,per,pericarp,persistent,plurifoliate,portion,prominent,reddish-brown,ruit,secondary,shoot,short,simple,sleeve,stamen,tall,tapering,thin,time,tub,ud,unit,usually,venation,wide,ympodial	1,arrangement,bi-lobed,bud,coat,colour,connation,decurren,decurrency,dry,embryo,feature,form,height,history,inflorescence,length,life,midpoint,minor,na,new,number,papilla,plant,prickle,ray,reproduction,seed,shape,size,spacing,specimen,texture,tuberculation,type,width,winging	.5,0.2-0.7,0.2-1,0.45-0.5,0.9-2.3,1-1.5,1-2,1/2,2-5,3,6-9,absent,age,anthesi,apex,apically,base,berry,cm,completely,conical,cupulate,deflexed,dendritic,densely,diameter,elliptic,except,flattened,free,glabrous,globose,grey-brown,later,leaf,lenticular,lobed,long,margin,minutely,mm,narrowly,near,nodding,obscurely,occasionally,pitted,pointed,poricidal,pubescent,purplish,purplish-black,revolute,scattered,shiny,shrub,slightly,slit-like,sparsely,strongly,terminal,tip,trichome,trongly,violet,way,winged,woody,x	1,bi-lobed,decurren,na
297	wfo-0001029246	success	207	150	98	113	94	37	97	1	/5,0-15,0.1-0.4-1.5,0.15-0.3,0.2-1.5,0.3-0.8,0.7-1.3,0.7-2,0.8-1.1,0.8-3,0.9-1.3,1-1.5,1-10,1-4,1.5-2.5,1.5-6,1.7-6,1.8-3,1/3,2.5-3.2,2.8-4,3-5,4-6,6-10,6-8,7-12,8-16,abaxially,acuminate,acute,anther,apart,apex,apically,apparently,articulated,bark,base,berry,calyx,cm,connivent,cuneate,deltate,densely,diameter,dull,elliptic,filament,flattened,flattened-reniform,flower,fruit,glabrescent,glabrous,lateral,leaf,length,lobe,lobed,long,lower,maturity,mauve,midpoint,midvein,mm,moderately,narrow-deltate,narrow-ovate,obtuse,orange-brown,orange-red,pale,pedicel,petiole,poricidal,porrect,prickle,prickly,pubescent,purple,ray,recurved,scar,sessile,shrub,simple,sometimes,spaced,sparsely,spherical,spreading,stellate,stellate-pubescent,stem,straight,style,surface,tapering,terete,tip,trichome,tube,unarmed,unbranched,upper,way,white,wide,yellow,yellow-orange,Â¼	-4,0-1,0-5,0.1-0.3,0.3-0.5,0.5,0.5-1.5,0.7-1.5,1-1.8,1-3,1-5,1-8,1.2-2,1.5-2.3,1/10-1/5,2,2-3,2-3.5,2-5,2/3,2/3-3/,3-20,3.5-5,5-20,5-6-8,5-merous,abaxial,acuminat,adaxial,almost,alyx,apar,blade,broad-deltate,c.,chartaceous,concolorous,curved,discolorous,distance,drying,eaf,eed,elongating,entire,equal,erect,extending,eye,free,fruiting,infructescence,less,lon,longer,margin,mature,naked,nflorescence,oblong,older,one,open,orange-brow,orolla,oung,pair,peduncle,pendulous,per,perfec,pericarp,plurifoliat,portion,prickl,primary,procumbent,rounded,ruit,side,smooth,stout,strongly,tamen,tertiary,time,unit,usually,vary,vein,venation,visible,woody,ympodial	anthesi,arrangement,bud,coat,colour,connation,corolla,decurrency,dry,embryo,feature,form,growth,height,history,inflorescence,life,minor,na,number,ovary,papilla,plant,pore,reproduction,seed,shape,size,spacing,specimen,stigma,texture,tuberculation,type,width,winging,young	/5,0-15,0.1-0.4-1.5,0.15-0.3,0.2-1.5,0.3-0.8,0.7-1.3,0.7-2,0.8-1.1,0.8-3,0.9-1.3,1-1.5,1-10,1-4,1.5-2.5,1.5-6,1.7-6,1.8-3,1/3,2.5-3.2,2.8-4,3-5,4-6,6-10,6-8,7-12,8-16,abaxially,acuminate,acute,apart,apically,apparently,articulated,base,berry,cm,connivent,cuneate,deltate,densely,diameter,dull,elliptic,flattened,flattened-reniform,glabrescent,glabrous,lateral,lobe,lobed,long,lower,maturity,mauve,midpoint,midvein,mm,moderately,narrow-deltate,narrow-ovate,obtuse,orange-brown,orange-red,pale,poricidal,porrect,prickle,prickly,pubescent,purple,ray,recurved,sessile,shrub,simple,sometimes,spaced,sparsely,spherical,spreading,stellate,stellate-pubescent,straight,tapering,terete,tip,trichome,unarmed,unbranched,upper,way,white,wide,yellow,yellow-orange,Â¼	na
298	wfo-0001029286	success	224	119	69	96	128	23	63	6	.4,0.8,1-1.5,1-2,1.5-2,1.5-4,1.5-8,2-3,3-4,4-5,4-6,4.5,4.5-7,5,5-6,6-8,6-9,7-10,abaxial,abaxially,acute,adaxially,almost,anther,apart,apex,apiculate,attenuate,bark,base,branch,branching,broadly,brown,capitate,chartaceous,clustered,cm,conical,corolla,diameter,domatia,entire,faint,filament,flat,glabrous,green,grey,hair,known,leaf,length,liana,light,lilac,lobed,main,margin,mauve,membranous,midvein,minutely,mm,obconical,oblong,obovate,pair,pedicel,peduncle,petiole,pore,poricidal,primary,prominent,raised,scar,simple,smooth,stem,stigma,style,surface,terete,terminal,tertiary,time,tip,trichome,tube,unarmed,vein,venation,widely,x,young	.5,0-0.5,0.1,0.15-0.4,0.4-1.2,0.6-1.2,0Â°,1/8,15-50,2.5-3,abscising,age,along,altered,alyx,another,anthesi,apar,apically,apice,apparently,arising,around,articulated,articulation,axil,becoming,branched,canaliculate,clearly,closer,concave,concolorous,crenulate,curved,cuspidate,delineated,deltoid,dendritic,density,dilated,distributed,drying,eaf,eed,equal,except,extending,fertilization,flexuous,flower,formed,forming,free,fresh,glabrescent,globo,increasing,inflorescenc,inside,isolated,junction,know,lamina,lengthening,less,lobe,long,lower,m.,margi,mas,meeting,middle,much,multicellular,narrowly,nflorescence,nther,occasional,often,one,orolla,outside,ovate,papillo,perfec,plurifoliat,portion,protruding,rachi,rarely,regular,rounded,ruit,separated,shallowly,side,slender,smaller,sometimes,somewhat,soon,sparsely,specimen,spreading,stretchy,stump,tangled,tearing,textur,thick,thickened,thinner,tissue,together,toward,translucent,translucent-violet,tuft,ud,uneven,unit,vary,visible,wide,yellowish,ympodial	arrangement,bud,calyx,colour,feature,form,fruit,globose,greyish,growth,inflorescence,number,ovary,papillose,present,prominence,seed,shape,size,spacing,texture,true,white	.4,0.8,1-1.5,1-2,1.5-2,1.5-4,1.5-8,2-3,3-4,4-5,4-6,4.5,4.5-7,5,5-6,6-8,6-9,7-10,abaxially,acute,adaxially,almost,apart,apiculate,attenuate,base,broadly,brown,capitate,chartaceous,clustered,cm,conical,diameter,entire,faint,flat,glabrous,green,grey,known,liana,light,lilac,lobed,mauve,membranous,minutely,mm,obconical,oblong,obovate,pair,poricidal,prominent,raised,simple,smooth,terete,terminal,time,widely,x	globose,greyish,papillose,present,true,white
299	wfo-0001029310	success	214	121	78	90	124	31	75	3	.5,/4,0.2-0.8,0.5-3,0.6-1.1,1-1.5,1-4,1.2-1.5,10,10-13-16,15-20-25,2-3.5,2-4,3-4,3.5,4-10,5-10,5-30,5-8,acute,anther,apart,apex,apically,articulated,bark,base,berry,brown,calyx,cm,conical,connivent,cordate,dark,deltate,dull,erect,filament,flattened-reniform,flower,fruit,glabrescent,glabrous,gray,hair,herb,lateral,leaf,length,lobe,lobed,long,long-styled,maturity,mauve,mm,narrow-deltate,pedicel,pendent,perpendicular,petiole,pinnatifid,poricidal,porrect,prickle,prickly,scar,sessile,short-styled,shrub,simple,spherical,spreading,stalked,stem,straight,style,surface,tapering,terete,tip,toward,trichome,truncate,tube,variously,way,wide,yellow	.1,.6,/6,0-20,0-5,0.1-0.2,0.2-0.3,0.5,00,1,1-2,1.8-3,1/,10-15,10-20,2.5-6,2/3-3/4,20-40,20-60,200-500,3-5,4-8,45-60,5,5-12,5-20,5-6,5-7,5-merous,6-8,7-12,7-13,8,abaxially,accrescent,alyx,ame,andromonoecious,apar,apparently,beyond,blade,branched,c.,concolorous,diameter,difoliate,distal,distance,drying,eaf,eed,elliptic,elongating,enclosing,equal,extending,filifor,free,fruiting,geminat,gently,hermaphrodite,heterostylous,inflated,infructescence,lobing,lon,longer,lower,lowermost,margin,mature,membranous,midpoint,midvein,minute,moderately,nflorescence,older,one,open,orange-green,ornately,orolla,oung,pair,peduncle,pendulous,per,pericarp,plant,portion,prickl,primary,ray,recurved,red-brow,retrorse,ruit,secondary,shorter,side,smooth,sometimes,spaced,sparsely,stalk,staminat,stellate,stellate-pubescent,stout,strongly,tamen,tertiary,time,tissue,unit,vary,vein,venation,visible,woody,ympodial	arrangement,bud,coat,colour,connation,corolla,decurrency,embryo,feature,filiform,form,growth,inflorescence,minor,na,number,ovary,papilla,pore,red-brown,seed,shape,size,spacing,stigma,texture,tuberculation,type,width,winging,young	.5,/4,0.2-0.8,0.5-3,0.6-1.1,1-1.5,1-4,1.2-1.5,10,10-13-16,15-20-25,2-3.5,2-4,3-4,3.5,4-10,5-10,5-30,5-8,acute,apart,apex,apically,articulated,base,berry,brown,cm,conical,connivent,cordate,dark,deltate,dull,erect,flattened-reniform,glabrescent,glabrous,gray,hair,herb,lateral,lobed,long,long-styled,maturity,mauve,mm,narrow-deltate,pendent,perpendicular,pinnatifid,poricidal,porrect,prickle,prickly,sessile,short-styled,shrub,simple,spherical,spreading,stalked,stem,straight,tapering,terete,tip,toward,trichome,truncate,variously,way,wide,yellow	filiform,na,red-brown
300	wfo-0001029317	success	151	99	64	76	75	23	60	4	.5,0.25,0.5,0.5-0.75,0.5-1,1,1-1.5,1.5-3.5,10-16,2-3,2.5-5,6-8,6.5-11,7-8,8-9,acuminate,along,anther,area,attenuate,base,broadly,bud,ca,calyx,cm,corolla,deltoid,densely,denser,dia,filament,glabrous,globose,grayish,inflorescence,leaf,lobe,lobed,long,minor,minutely,mm,narrowly,nearly,older,opposite,ovary,ovate,papillose,pedicel,petiole,pore,poricidal,pubescent,rachi,rounded,shaped,shrub,simple,size,slender,sparsely,stem,stigma,style,tapering,tear-drop,tip,trichome,tube,uniseriate,vein,white,x,young	0.8-1,10-30-flowered,11-14,anthesi,apar,apex,barely,beneath,brow,channeled,closely,cup-like,deciduou,deflexed,differing,difoliate,dry,eaf,edicel,eed,ellipsoi,epidermi,erect,exserted,extreme,free,frui,fruiting,geminate,glabrate,immature,known,lateral,like,lon,lower,main,major,margin,middle,nflorescence,occasionally,often,one,otherwise,overlapping,ovoid,pair,paler,portion,probably,prominent,proximal,raised,reflexed,remaining,rest,ruit,scar,slightly,soft,soon,spaced,specimen,straight,styl,tall,thickened,tuft,ud,unit,visible,widest,yellowish,ympodial	10-30,abaxial,adaxial,alternate,arrangement,brown,colour,feature,flower,form,fruit,growth,height,length,na,number,plant,seed,shape,surface,texture,type,width	.5,0.25,0.5,0.5-0.75,0.5-1,1,1-1.5,1.5-3.5,10-16,2-3,2.5-5,6-8,6.5-11,7-8,8-9,acuminate,along,area,attenuate,base,broadly,ca,calyx,cm,deltoid,densely,denser,dia,glabrous,globose,grayish,leaf,lobed,long,minutely,mm,narrowly,nearly,opposite,ovate,papillose,poricidal,pubescent,rachi,rounded,shaped,shrub,simple,slender,sparsely,style,tapering,tear-drop,tip,trichome,tube,uniseriate,vein,white,x	10-30,alternate,brown,na
301	wfo-0001029332	success	196	116	75	89	107	27	71	4	/3,0,0-2,0-20,0-4,0.5-1,1-2,1-4,1.3-1.5,1.5-2,1/2,2,2-2.5,2-4,2.5-3.5,2/3-3/4,3-4,3-6,4-10,5-8,6-8,abaxial,adaxial,andromonoecious,anther,apart,apex,bark,base,berry,calyx,cm,connivent,cordate,densely,diameter,elongating,flattened-reniform,flower,fruit,fruiting,glabrescent,glabrous,lateral,leaf,length,lobe,lobed,long,long-styled,mature,maturity,mauve,mm,moderately,orange-brown,ovate,pale,pedicel,peduncle,petiole,plant,poricidal,porrect,prickle,prickly,rounded,scar,sessile,shrub,simple,spherical,spreading,stalked,stellate-pubescent,stem,style,subsessile,surface,tapering,terminal,tip,trichome,tube,upper,variously,way,wide,yellow	.5,0-0.5,0-100,0-5,0.1,0.1-0.2,0.15-0.2,0.15-0.25,0.8-1,1-1.5,1-3,1/3,1/4,1/4-1/3,10-30,2.8-3.7,2/,3.5-5,4-15,5-6,5-merous,8.5-9.5,abaxially,alyx,apar,apically,apparently,articulated,becoming,blade,broad-deltate,chartaceous,concolorous,conical,curved,difoliate,distal,distance,drying,eaf,eed,equal,erect,extending,filament,flattened,free,geminat,gland,globular,grayi,herbaceous,hermaphrodite,heterostylous,infructescence,less,long-acuminat,longer,lower,lowermost,margin,midpoint,midvein,narrow-deltate,nflorescence,often,older,one,open,orolla,oung,pair,pendulous,per,pericarp,portion,prickl,primary,pubescent,ray,reduced,ruit,scandent,short-styled,shorter,side,slender,smooth,spaced,stalk,staminat,stellate,tamen,terete,tertiary,time,unbranched,unit,vary,vein,venation,visible,weakly,woody,yellow-green,yellow-orange,ympodial	1.5,arrangement,colour,connation,corolla,feature,form,grayish,growth,height,history,inflorescence,life,na,number,ovary,perennial,reproduction,seed,shape,size,spacing,stigma,texture,type,width,young	/3,0,0-2,0-20,0-4,0.5-1,1-2,1-4,1.3-1.5,1.5-2,1/2,2,2-2.5,2-4,2.5-3.5,2/3-3/4,3-4,3-6,4-10,5-8,6-8,andromonoecious,apart,base,berry,cm,connivent,cordate,densely,diameter,elongating,flattened-reniform,flower,fruit,glabrescent,glabrous,lateral,length,lobed,long,long-styled,mature,maturity,mauve,mm,moderately,orange-brown,ovate,pale,poricidal,porrect,prickle,prickly,rounded,sessile,shrub,simple,spherical,spreading,stalked,stellate-pubescent,subsessile,tapering,terminal,tip,trichome,upper,variously,way,wide,yellow	1.5,grayish,na,perennial
302	wfo-0001029333	success	155	123	66	86	69	37	60	6	.25,.5,0.7-1,1-1.2,1-1.5,1-15,1-2,1-3,1-7,1.5-3,17-26,3-7.5,5-6,8-15,acuminate,acute,anther,anthesi,apex,auriculate,bark,base,beige,berry,broadly,calyx,clavate,cm,conical,corolla,deflexed,dendritic,densely,dry,elliptic-obovate,erect,filament,flattened-reniform,flower,fresh,globose,golden,green,leaf,lobe,lobed,minor,minutely,mm,obovate,occasionally,opposite,orbicular,ovary,pale,pedicel,petiole,pitted,pore,poricidal,pubescent,reddish-brown,rounded,scar,sessile,shape,shaped,shrub,simple,size,somewhat,spaced,sparsely,stem,stigma,style,surface,tear-drop,tip,triangular,trichome,truncate,tube,type,woody,young	/4,0.5,0.5-1,1.5-2,1.5-2.5,10-15-flowered,100,2-2.5,3-7,9-13,abaxial,abaxially,adaxially,along,anisophyllou,ba,beneath,contracted,dendritic-pubescent,denser,dia,differing,difoliate,eaf,edicel,eed,exserted,free,fruiting,geminate,glabrous,heteromorphic,incrassate,inflorescenc,lateral,like,lon,long,long-styled,lower,main,major,margin,nflorescence,older,overlappin,pair,paler,papillo,planar,portion,present,pubescence,rest,ruit,shining,short-styled,slender,small,strongly,tall,time,tree,ud,unit,vein,way,wide,ympodial	10-15,alternate,arrangement,bud,coat,colour,connation,decurrency,embryo,feature,form,fruit,growth,height,history,inflorescence,length,life,midpoint,na,new,number,overlapping,papilla,papillose,perennial,plant,prickle,ray,reproduction,seed,spacing,specimen,texture,tuberculation,width,winging	.25,.5,0.7-1,1-1.2,1-1.5,1-15,1-2,1-3,1-7,1.5-3,17-26,3-7.5,5-6,8-15,acuminate,acute,auriculate,beige,berry,broadly,clavate,cm,conical,deflexed,dendritic,densely,dry,elliptic-obovate,erect,flattened-reniform,fresh,globose,golden,green,leaf,lobed,minutely,mm,obovate,occasionally,opposite,orbicular,pale,pitted,poricidal,pubescent,reddish-brown,rounded,sessile,shaped,shrub,simple,somewhat,spaced,sparsely,tear-drop,triangular,trichome,truncate,woody	10-15,alternate,na,overlapping,papillose,perennial
303	wfo-0001029334	success	211	99	54	69	142	30	51	3	0.15-0.3,1-10,1-2,1-3,1-6,1.3-4.5,1.5-6,2-2.5,2-8,2.5-3,3-7,4-8.5,5-10,7.5-15.5,8-30,9-12,acute,almost,anther,attenuate,berry,chartaceous,clavate,cm,connivent,corolla,densely,diameter,filament,flower,fruit,glabrous,globose,green,herb,lanceolate,lengthening,lobe,long,membranous,mm,mucilaginous,odd-pinnate,ovoid,pedicel,peduncle,petiole,plant,pore,poricidal,puberulent,pubescent,pure,ripe,seed,size,slit,stellate,stem,stigma,style,terminal,tinged,tip,tube,unwinged,violet,wet,white	.2,0-4,1,1.5-3.9,1.8-2.9,2,2-4,2-5,3-5,3.2-5.8,3.3-6.5,4-5.5,5-merou,abaxially,absent,acumen,adaxially,ag,along,alyx,among,apart,apex,apparently,articulated,axe,axillary,base,blade,borne,broadly,brownish,bud,capitat,cell,ciliate,condition,cordate,covering,cuneate,decreasing,decurrent,digestion,distal,dorsally,drying,eaf,edge,eed,elliptic,end,enzyme,erect,especially,exceeding,except,flat,folded,forked,fresh,geminat,generally,glabrou,gradually,grassland,greatly,green-white,greenish,hair,hair-like,half,homostylous,honeycomb-shaped,interjected,lateral,leaflet,like,living,low-growin,lower,make,margin,middl,midrib,minutely,narrowly,nflorescence,oblique,obtuse,often,orbicular,orolla,ovate,pair,perfect,petiolulate,petiolule,plurifoliate,proximal,rarely,reduced,removed,rounded,ruit,semi-rosette,sessile,seudostipule,shady,short,singly,situation,slightly,spaced,specimen,stamen,ste,stolo,straight,subequal,subsessile,subtending,sunny,tall,tamen,tem,testal,thick,throughout,toward,tri-,tuber,typically,unit,usually,vary,wall,whitish,wide,woodland,x,yellow,ympodial	abaxial,adaxial,age,arrangement,calyx,capitate,colour,connation,feature,form,growth,height,history,inflorescence,leaf,length,life,na,number,ovary,papilla,reproduction,scar,shape,spacing,surface,texture,type,width,young	0.15-0.3,1-10,1-2,1-3,1-6,1.3-4.5,1.5-6,2-2.5,2-8,2.5-3,3-7,4-8.5,5-10,7.5-15.5,8-30,9-12,acute,almost,attenuate,berry,chartaceous,clavate,cm,connivent,densely,glabrous,globose,green,herb,lanceolate,lengthening,long,membranous,mm,mucilaginous,odd-pinnate,ovoid,poricidal,puberulent,pubescent,pure,ripe,slit,stellate,terminal,tinged,tip,unwinged,violet,wet,white	age,capitate,na
304	wfo-0001029344	success	147	100	69	75	72	25	66	3	.5,0.5-1,0.5-1.5,0.5-3,1,1-5,1-6,1.5,1.5-3,1.5-4,10-20,10-35,2-3,2-4,3-10,4-6,5-15,abundant,acute,anther,apex,base,calyx,center,chartaceous,cm,cordate,decurrent,densely,dm,edge,elliptic,elliptic-ovoid,filament,fine,flower,fruit,glabrous,hair,herb,interpetalar,lobe,long,margin,membranaceous,mm,moderately,nearly,oblong,obtuse,often,parallel,pedicel,per,petiole,pubescent,radiating,raised,ridge,rotate,rounded,running,shallow,sparsely,stigma,straight,style,surface,tissue,triangular,tube,two-celled,unbranched,white,x	0.4-1,1-2,1-3,2-3-celled,2-7,5-12,abaxially,absent,adaxiall,adaxially,along,axe,berry,beyond,blade,brown,ciliate,connected,dehiscing,denser,diameter,difoliate,drying,eaf,eed,emarginat,entire,equal,explosively,exserted,flat,frui,geminat,globose,held,immature,lacking,linear-lanceolate,lower,lying,maturing,maturit,mesocarp,nflorescence,notch,obvious,one-,orolla,peduncle,placenta,pressure,pubescen,rachi,rhizomatous,ruit,semitransparent,short,slightly,sometimes,stamen,swollen,tal,tamen,tem,unit,vary,vein,watery,wid,woody,yellow,ympodial	abaxial,adaxial,arrangement,colour,corolla,emarginate,feature,form,growth,height,inflorescence,leaf,length,na,ovary,plant,seed,shape,size,staman,stem,texture,type,wide,width	.5,0.5-1,0.5-1.5,0.5-3,1,1-5,1-6,1.5,1.5-3,1.5-4,10-20,10-35,2-3,2-4,3-10,4-6,5-15,abundant,acute,apex,base,center,chartaceous,cm,cordate,decurrent,densely,dm,edge,elliptic,elliptic-ovoid,fine,flower,fruit,glabrous,hair,herb,interpetalar,long,margin,membranaceous,mm,moderately,nearly,oblong,obtuse,often,parallel,per,petiole,pubescent,radiating,raised,ridge,rotate,rounded,running,shallow,sparsely,straight,tissue,triangular,two-celled,unbranched,white,x	emarginate,na,wide
305	wfo-0001029363	success	152	116	64	83	69	33	61	3	0.2-1.1,0.5-1,1,1.5-3.5,2-6,3-7,4-11,6-7,6-8,acuminate,acute,anther,anthesi,apex,bark,base,berry,bi-lobed,bud,calyx,capitate,closely,cm,corolla,cup-shaped,deep,deflexed,deltoid,densely,drying,edge,elliptic,erect,filament,fruit,glabrous,globose,green,greyish,leaf,lobe,lobed,maroon,meeting,minutely,mm,narrowly,obtuse,opposite,ovary,overlapping,paler,papillose,pedicel,petiole,pore,poricidal,pubescent,scar,shiny,shrub,simple,slender,slit-like,small,spaced,sparsely,stem,stigma,style,surface,tapering,thickened,tip,tree,trichome,tube,uniseriate,upon,white,white-papillose,woody,young	.25,.75,/4,0-0.1,0.1-0.5,0.5,1-1.2,1.5-1.7,5-7-flowered,7-10,axil,ba,becoming,beginning,beneath,coroll,dia,eaf,edicel,eed,except,exsertion,free,fruiting,immature,inflorescenc,internodal,known,lamina,larger,later,lateral,lon,long,lower,main,margin,mature,middle,minute,much,near,nflorescence,occasionally,often,older,pair,pale,papillo,portion,prominent,reflexed,ruit,somewhat,sparse,straight,tall,terminal,tuft,ud,unifoliat,unit,usually,vein,way,wide,widest,yellowish,ympodial	5-7,arrangement,coat,colour,connation,dry,feature,flower,form,growth,height,history,inflorescence,length,life,midpoint,na,number,papilla,plant,prickle,ray,reproduction,seed,shape,size,spacing,specimen,texture,tuberculation,type,unifoliate,width	0.2-1.1,0.5-1,1,1.5-3.5,2-6,3-7,4-11,6-7,6-8,acuminate,acute,berry,bi-lobed,capitate,closely,cm,cup-shaped,deep,deflexed,deltoid,densely,drying,edge,elliptic,erect,glabrous,globose,green,greyish,leaf,lobed,maroon,meeting,minutely,mm,narrowly,obtuse,opposite,overlapping,paler,papillose,poricidal,pubescent,shiny,shrub,simple,slender,slit-like,small,spaced,sparsely,tapering,thickened,tip,tree,trichome,uniseriate,upon,white,white-papillose,woody	5-7,na,unifoliate
306	wfo-0001029364	success	151	101	62	76	75	25	57	5	0.2-0.5,1-2-6,1-3,1-4,1-5,1.5-2,2,2-6,4-9,5-11,5-9,7-9,8-15,?,abaxially,acuminate,adaxially,anther,apart,apex,base,calyx,chartaceous,cm,corolla,cuneate,diameter,distally,elliptic,entire,extra-axillary,filament,finger,flower,fruit,glabrous,gland-tipped,globose,green,hair,herb,immature,lobe,major,margin,minutely,mm,narrowly,nearly,obtuse,ovate,pedicel,peduncle,petiole,puberulent,pubescent,rachi,radiu,sagittate,shallow,shrub,side,simple,sparsely,spot,stigma,strongly,style,tapered,triangular,tube,unknown,vein,white,x,yellow	-2,-3,-6,.5,1,191.,2-4-12,2-foliat,3-4,5-10-27,6-8,8-10,according,acute,aggregate,around,articulated,axe,ba,bitter,blade,blue,cell,center,color,connivent,cream,curled,cylindrical,darker,deep,directed,distall,eaf,ed,fide,free,glandular-puberulen,greenish,inserted,long,lower,membranaceous,mesocarp,moderately,nflorescence,orolla,part,perfect,pore,presence,present,puberulen,ripe,ruit,rusby,short-tomentose,shorter,small,spaced,stellate,stone,tal,tamen,tem,thecae,tightly,time,tomento,truncat,unbranched,unit,vary,wide,ympodial	1-2,10-27,2-12,arrangement,colour,feature,form,growth,height,inflorescence,leaf,length,number,ovary,plant,seed,shape,size,spacing,staman,stem,surface,texture,tomentose,truncate	0.2-0.5,1-2-6,1-3,1-4,1-5,1.5-2,2,2-6,4-9,5-11,5-9,7-9,8-15,?,abaxially,acuminate,adaxially,apart,base,chartaceous,cm,cuneate,distally,elliptic,entire,extra-axillary,finger,glabrous,gland-tipped,globose,green,hair,herb,immature,lobe,minutely,mm,narrowly,nearly,obtuse,ovate,puberulent,pubescent,sagittate,shallow,shrub,side,simple,sparsely,spot,strongly,tapered,triangular,unknown,white,x,yellow	1-2,10-27,2-12,tomentose,truncate
307	wfo-0001029368	success	139	109	52	67	72	42	45	7	0.5-2,1.5-2,1.5-3,1.5-4,11-13,16-25,2-5,2.5-4,acuminate,acute,anther,anthesi,apex,bark,base,berry,broadly,calyx,capitate,closely,cm,corolla,crumpled,deflexed,elliptic,erect,filament,flower,fruit,glabrous,globose,golden,green,herb,inflorescence,internodal,lanceolate,leaf,lobe,minute,minutely,mm,opposite,ovary,papillose,pedicel,petiole,pore,poricidal,puberulent,reflexed,scar,shaped,shrub,simple,somewhat,spaced,stem,stigma,style,tear-drop,tip,trichome,tube,uniseriate,white,young	.2,.25,.5,0,0.9-1,1.5-1.6,5-6,?,abaxially,adaxially,along,apparently,bearing,bitter,borne,breaking,brow,coarse,conical,cup,densely,dia,distal,eaf,edicel,eed,exserted,few-branched,fide,flattened,free,fruiting,half,indistinct,inflorescenc,known,lamina,lateral,leaving,like,long,lower,main,margi,margin,middle,midrib,nflorescence,non-flower,obtuse,older,one,overlappin,pair,papillo,parallel,portion,rest,ruit,straight,strongly,tall,ud,unifoliat,unit,upper,vein,widest,winged,woody,x,ympodial	0.5,1,1.2,arrangement,brown,bud,coat,colour,connation,decurrency,dry,embryo,feature,form,growth,height,history,length,life,midpoint,minor,na,new,number,papilla,perennial,plant,prickle,ray,reproduction,seed,shape,size,spacing,specimen,surface,texture,tuberculation,type,unifoliate,width,winging	0.5-2,1.5-2,1.5-3,1.5-4,11-13,16-25,2-5,2.5-4,acuminate,acute,apex,berry,broadly,capitate,closely,cm,crumpled,deflexed,elliptic,erect,glabrous,globose,golden,green,herb,internodal,lanceolate,leaf,minute,minutely,mm,opposite,papillose,poricidal,puberulent,reflexed,shaped,shrub,simple,somewhat,spaced,tear-drop,trichome,uniseriate,white	0.5,1,1.2,brown,na,perennial,unifoliate
308	wfo-0001029370	success	223	99	66	80	143	19	63	3	0-35,0.5-2.2,1.5-6,1.8-2.8,1/4-1/3,2.5-3.5,3.5-4,3.5-8,6-15-32,7-13,8-23,abaxial,adaxial,almost,anther,apex,apically,bark,basal,base,berry,broad-deltate,calyx,cm,cordate,densely,fine,flattened-reniform,flower,fruit,glabrescent,greenish,herb,lateral,leaf,length,lobe,lobed,long,maturity,mauve,mm,moderately,multangulate,obtuse,orange,ornate,overlapping,pale,pattern,pedicel,peduncle,petiole,poricidal,prickly,red-brown,reticulate,rotate,rounded,sessile,shiny,shrub,simple,smooth,spherical,stalked,stellate-pubescent,stem,surface,tapering,tip,trichome,tube,variously,way,white,whitish,wide,yellow,young	.1,.3,.5,/4,0-10,0-100,0-3,0.1,0.1-0.15,0.2,0.3,0.5-1,1,1-2,1-3,1-4,1.8-2.5,1/3-1/2,10-17,10-17-20,10-40,10-50,12-17,15-30,2-10,2-20,2-3,2-6,3-4,3/,4-6,4-7,4-9,5-10,5-12,5-merous,5.5-7,7-11,8-14,8-20,abaxially,acut,alyx,ame,andromonoecious,apar,apart,apparently,articulated,blade,branched,c.,chartaceous,clearly,conical,connivent,cream,curved,dark,diameter,discolorous,distal,distance,drying,eaf,eed,elongate,elongating,equal,erect,extending,fewer,filament,flattened,free,fruiting,fully,gently,glabrous,green,hermaphrodite,heterostylous,infructescence,long-styled,longer,lower,lowermost,margin,marking,mature,midpoint,midvein,mixture,nflorescence,often,older,one,open,opening,orange-brown,orolla,oung,ovate,pair,pendulous,per,pericarp,perpendicular,plant,plurifoliat,porrect,portion,prickl,prickle,primary,ray,ruit,scar,short-styled,side,slightly,sometimes,spaced,spreading,stalk,staminat,stout,straight,strongly,style,tamen,terete,tertiary,time,unarmed,unit,vary,vein,venation,visible,white-gra,woody,ympodial	acute,arrangement,colour,corolla,feature,form,growth,hair,inflorescence,number,ovary,plurifoliate,seed,shape,size,texture,type,white-gray,width	0-35,0.5-2.2,1.5-6,1.8-2.8,1/4-1/3,2.5-3.5,3.5-4,3.5-8,6-15-32,7-13,8-23,almost,apically,basal,base,berry,broad-deltate,cm,cordate,densely,fine,flattened-reniform,glabrescent,greenish,herb,lateral,lobe,lobed,long,maturity,mauve,mm,moderately,multangulate,obtuse,orange,ornate,overlapping,pale,pattern,poricidal,prickly,red-brown,reticulate,rotate,rounded,sessile,shiny,shrub,simple,smooth,spherical,stalked,stellate-pubescent,tapering,tip,trichome,variously,way,white,whitish,wide,yellow	acute,plurifoliate,white-gray
309	wfo-0001029373	success	199	117	72	76	123	41	54	18	5,6.8,acute,age,anther,apex,articulated,base,bayonet,berry,broadly,bud,calyx,clavate,cm,corolla,curved,deltate,densely,ellipsoid,filament,finger,flattened-reniform,flower,fruit,glabrous,glandular-tipped,globose,green,growth,hair,herb,internodal,lateral,leaf,lengthening,like,live,lobe,long,minute,minutely,mm,moderately,new,obtuse,ovary,ovate-lanceolate,papillate,pedicel,petiole,pitted,plant,pore,poricidal,pubescent,rounded,scar,shallowly,shape,simple,slit,spreading,stellate,stem,stigma,straight,style,surface,tip,trichome,tube,uniseriate,white,wide,yellow-green	.0â1.2,.2,.3,.5,.5â2.0,0.3â0.5,0.4â1.6,0.5â1.2,0.5â1.8,0.6â0.7,1.0â1.2,1.0â1.6,1.2â1.5,1.3â2.2,1.4â3.5,1.5â2.0,1.5â2.5,1.5â2.7,1.8â2.0,1.8â2.3,180Â°,2-celled,2.0â2.5,2.7â3.0,20â30,2â4-celled,3,3.5â4.0,30â40,3â5,4â5,4â6,5-merous,5â6,8â9,abaxial,abaxially,accrescent,acuminate,adaxial,adaxially,anthesi,apar,appearanc,appressed,arising,bark,basal,beyond,capped,cell,cone,conical,developing,diameter,distal,eaf,eed,elongate,enclosed,enclosing,entire,exerted,free,fruiting,fully,geminat,grey-brown,half,halfway,hilum,immature,individual,laterally,less,lobed,lon,lower,margin,mature,mesocarp,middle,mouth,nflorescence,node,older,outline,pair,peduncle,pentagonal,per,perfect,plurifoliate,portion,positioned,primary,reflexed,resembling,root,ruit,seen,seudostipule,short,slightly,smoot,spaced,still,tall,tem,terete,testal,thicker-walled,trailing,tub,ud,unit,upper,vein,woody,yellow,yellowish,ympodial,â5	-5,.0-1.2,.5-2.0,0.5-1.2,0.6-0.7,1.0-1.2,1.0-1.6,1.2-1.5,1.4-3.5,1.5-2.7,2-4-celled,20-30,3-5,4-5,5-6,8-9,apart,arrangement,colour,connation,decurrency,embryo,feature,form,height,inflorescence,length,minor,na,number,papilla,prickle,reproduction,seed,size,spacing,texture,type,width,winging,young	5,6.8,acute,age,articulated,base,bayonet,berry,broadly,clavate,cm,curved,deltate,densely,ellipsoid,finger,flattened-reniform,glabrous,glandular-tipped,globose,green,hair,herb,internodal,lateral,lengthening,like,live,long,minute,minutely,mm,moderately,obtuse,ovate-lanceolate,papillate,pitted,plant,poricidal,pubescent,rounded,shallowly,simple,slit,spreading,stellate,stem,straight,tip,trichome,uniseriate,white,wide,yellow-green	-5,.0-1.2,.5-2.0,0.5-1.2,0.6-0.7,1.0-1.2,1.0-1.6,1.2-1.5,1.4-3.5,1.5-2.7,2-4-celled,20-30,3-5,4-5,5-6,8-9,apart,na
310	wfo-0001029402	success	113	74	37	52	61	22	36	1	0.5-1,0.5-2,1-2.5,15-30,2,2-10,2-3,3-4,3-5,3-6,4-6,4-7,5-25,6-16,7-11,7-8,7-9,8-15,acute,apex,base,branched,calyx,ciliolate,cm,connivent,cylindrical,deltate,diameter,flower,free,glabrous,lanceolate,lobe,margin,mm,pedicel,peduncle,petiole,rachi,radiu,shrub,simple,stellate,stigma,style,surface,tapered,triangular,tube,unknown,x	11-17,4-8,abaxial,abaxially,acuminate,adaxially,apart,articulated,axe,band,blade,chartaceous,color,denser,directed,distall,eaf,eed,elliptic,fleshy,forked,glabrate,glabrou,hair,inrolled,leaving,long,lower,many-foliat,moderately,narrowed,narrowly,nearly,nflorescence,nther,often,orolla,papillose,pore,pubescence,pubescent,rachise,roughened,ruit,scale-like,scar,somewhat,spaced,sparsely,tal,tem,thickened,time,tip,truncat,unit,unknow,vary,violet,wide,ympodial	anther,arrangement,connation,corolla,feature,form,growth,height,inflorescence,leaf,length,number,ovary,plant,seed,shape,size,spacing,stem,texture,truncate,width	0.5-1,0.5-2,1-2.5,15-30,2,2-10,2-3,3-4,3-5,3-6,4-6,4-7,5-25,6-16,7-11,7-8,7-9,8-15,acute,branched,ciliolate,cm,connivent,cylindrical,deltate,free,glabrous,lanceolate,mm,shrub,simple,stellate,tapered,triangular,unknown,x	truncate
311	wfo-0001029404	success	154	115	77	90	64	25	74	3	-10,-5,0.5-1,1,1-4,1.5-2,2,2-3,2-4,2-5,2-8,2.5-22,2.5-3,20-35,3-4,3-5,3-8.5,5-10,5-20,5-24,6-8,6.5-34,8-12,acuminate,acute,anther,apart,apex,apiculate,auriculate,basal,base,branched,calyx,cm,connective,connivent,cordate,cream,cylindrical,dark,deltate,densely,diameter,directed,distally,eglandular,ellipsoidal,flattened,fleshy,flower,fruit,glabrous,glandular,green,hair,lanceolate,less,light,lobe,long,longitudinal,mm,moderately,mottling,narrowly,obtuse,orange,ovoid,pedicel,peduncle,petiole,pore,puberulent,pubescent,rachi,remnant,shrub,simple,somewhat,sparsely,stellate,stigma,style,tree,triangular,tube,unbranched,x,yellow	-1.5,-3,0-60-flower,15-25,4-foliat,5-6,6-9,abaxially,absent,adaxially,aggregate,ape,articulated,axe,beyond,blade,cell,center,chartaceous,darker,eaf,eed,entire,exserted,glandular-puberulen,leaving,lemon,lon,lower,margin,nflorescence,nther,orang,orolla,ovate,pedicellar,perfect,pink,presen,purple,radiu,ripe,ruit,shorter,slightly,small,spaced,star,stone,subcoriaceous,tal,tem,thecae,time,tomento,toward,truncat,ud,unit,vary,vein,white,wide,ympodial	20-60,arrangement,bud,colour,corolla,feature,form,glandular-puberulent,growth,height,inflorescence,leaf,length,number,ovary,plant,seed,shape,size,spacing,stem,surface,texture,truncate,width	-10,-5,0.5-1,1,1-4,1.5-2,2,2-3,2-4,2-5,2-8,2.5-22,2.5-3,20-35,3-4,3-5,3-8.5,5-10,5-20,5-24,6-8,6.5-34,8-12,acuminate,acute,apart,apex,apiculate,auriculate,basal,branched,cm,connivent,cordate,cream,cylindrical,dark,deltate,densely,directed,distally,eglandular,ellipsoidal,flattened,fleshy,glabrous,glandular,green,hair,lanceolate,less,light,lobe,long,longitudinal,mm,moderately,mottling,narrowly,obtuse,orange,ovoid,puberulent,pubescent,shrub,simple,somewhat,sparsely,stellate,tree,triangular,unbranched,x,yellow	20-60,glandular-puberulent,truncate
312	wfo-0001029406	success	136	110	58	78	58	32	57	1	0.3-1,0.5-1,0.6-1,0.7-1.5,1-1.5,1-10,1-2,1.5-2.5,2-11,2.5-3.5,28,3-9,30,4-18,acute,anther,apex,arachnoid-pubescent,bark,base,berry,broadly,calyx,clavate,cm,conical,corolla,deciduous,deflexed,deltate,elliptic,felt-like,filament,glabrous,globose,grayish-brown,grayish-green,green,greenish-white,large,leaf,lenticel,lobe,lobed,matted,maturity,minor,minutely,mm,nearly,often,ovary,ovoid,ovoid-reniform,papillose,pedicel,petiole,pitted,pore,poricidal,shaped,shrub,size,slightly,small,soon,stem,stigma,style,surface,tear-drop,tip,tree,tube,waxy,white,woody,young	.5,1.5-2.2,1.5-5,2,2-3,4-6,7-12,abaxially,adaxially,along,anthesi,arachnoid,ba,brown,brownish,bullate,conspicuously,dark,densely,dia,differing,difoliate,dry,eaf,eed,free,fruiting,geminat,impressed,lateral,lilac,lon,long,lower,main,major,margin,middle,occasionally,older,pair,pale,papillo,planar,pointed,population,portion,pubescent,ruit,shiny,tall,tinge,trichome,unit,vein,wide,widest,ympodial	arrangement,bud,colour,connation,decurrency,embryo,feature,flower,form,fruit,growth,height,history,inflorescence,length,life,midpoint,na,number,papilla,plant,prickle,ray,reproduction,scar,seed,shape,spacing,texture,type,width,winging	0.3-1,0.5-1,0.6-1,0.7-1.5,1-1.5,1-10,1-2,1.5-2.5,2-11,2.5-3.5,28,3-9,30,4-18,acute,arachnoid-pubescent,base,berry,broadly,clavate,cm,conical,deciduous,deflexed,deltate,elliptic,felt-like,glabrous,globose,grayish-brown,grayish-green,green,greenish-white,large,lenticel,lobed,matted,maturity,minutely,mm,nearly,often,ovoid,ovoid-reniform,papillose,pitted,poricidal,shaped,shrub,slightly,small,soon,tear-drop,tree,waxy,white,woody	na
313	wfo-0001029407	success	204	124	78	93	111	31	77	1	-6,.5,/3,0-2,0-4,0.4-0.7,0.5-0.7,0.5-1.5,0.5-2,0.6-0.9,1-4.5-7,1.8-2.5,1/5,2-3,2-4,2.5-3,3-4,4-15-25,6-20,acute,anther,apart,apex,apically,apparently,articulated,base,berry,bright-red,calyx,cm,connivent,cuneate,deltate,densely,diameter,dull,elliptic,erect,evenly,filament,flattened-reniform,flower,fruit,green,lateral,leaf,length,lobe,lobed,long,maturity,mauve,mm,obtuse,occasionally,orange,orange-brown,ovate,pale,pedicel,petiole,poricidal,porrect,prickle,prickly,rounded,scar,sessile,shrub,simple,smooth,sometimes,sparsely,spherical,stalked,stellate,stellate-pubescent,stem,straw-yellow,style,surface,tapering,tip,trichome,tube,unbranched,upper,way,white,wide,yellow,young	-10,-2,0-15,0-5,0.1-0.2,0.1-0.25,0.15-0.4,0.2-0.3,0.4-1,0.6,0.7-1.2,1,1-1.4,1-2,1-3,1-4,1.5,1/3,1/3-1/2,1/8-1/5,2-5,3-6,3.5-4.5,4-9,4.5-6,5-7,5-merous,6-13,7-8,abaxial,abaxially,acut,adaxial,almost,alyx,apar,bark,blade,brow,chartaceous,curved,dark,difoliate,discolorous,drying,eaf,eed,elongating,entire,equal,flattened,free,fruiting,geminat,geminate,glabrescent,glabrous,gray-greenish,green-brown,infructescence,lengt,longer,lower,margin,mature,midpoint,moderately,nflorescence,older,one,open,orolla,oung,pair,peduncle,pendulous,per,perfec,pericarp,portion,prickl,primary,pubescent,rarely,ray,recurved,reflexed,ruit,shorter,side,slender,spaced,spreading,stalk,stout,straight,strongly,tamen,terete,tertiary,thick,time,unit,vary,vein,venation,visible,weakly,woody,yellow-green,ympodial	arrangement,bud,coat,colour,connation,corolla,decurrency,embryo,feature,form,growth,height,inflorescence,minor,na,new,number,ovary,papilla,plant,pore,seed,shape,size,spacing,stigma,texture,tuberculation,type,width,winging	-6,.5,/3,0-2,0-4,0.4-0.7,0.5-0.7,0.5-1.5,0.5-2,0.6-0.9,1-4.5-7,1.8-2.5,1/5,2-3,2-4,2.5-3,3-4,4-15-25,6-20,acute,apart,apically,apparently,articulated,base,berry,bright-red,cm,connivent,cuneate,deltate,densely,diameter,dull,elliptic,erect,evenly,flattened-reniform,green,lateral,lobed,long,maturity,mauve,mm,obtuse,occasionally,orange,orange-brown,ovate,pale,poricidal,porrect,prickle,prickly,rounded,sessile,shrub,simple,smooth,sometimes,sparsely,spherical,stalked,stellate,stellate-pubescent,straw-yellow,tapering,tip,trichome,unbranched,upper,way,white,wide,yellow,young	na
314	wfo-0001029408	success	243	139	87	101	142	38	83	4	0.3-5,0.9-1.3,0.9-1.6,1-8,1.4-1.9,1.5-3,1.7-2.4,11-31,2-12,2-3.5,2-5,4-14,5-24,5-6.5,acute,anther,anthesi,apart,apex,apical-lateral,base,becoming,berry,blunt-tipped,broadly,brown,bud,calyx,clavate,cm,continued,corolla,cuneate,deltoid,due,elliptic,extend,filament,fleshy,flower,free,fruit,globose,gray,growth,honeycombed,introrse,lanate,lanceolate,large,lateral,leaf,length,lilac,lobe,long-attenuate,longitudinal,mm,mostly,oblong,obtuse,orbicular,ovate,ovate-lanceolate,pale,pedicel,petiole,pore,pseudo-terminal,purplish,rarely,ray,reniform,reticulate-punctate,ripe,rotate-stellate,short-attenuate,shrub,simple,slightly,slit,small,stelliform,stem,stigma,style,subcampanulate,suborbicular,terete,top,tree,tube,turbinate,unarmed,velutinous,white,whitish,x,yellow,yellowish,young	-1.5,-10.5,.2-3.5-4.5,/10,0,0-100,0.2-0.3,0.5-2.5,0.7-1.2,1.1-1.5,1.6-2.8,1.8-3.5,1/2,1/2-3/4,1/4,2-4,2.2-3.7,2.5-7,2/3,3-5,3.5-5,4-20,4-7.5,5-6,5-8,5-merou,7-12,abaxially,accrescent,acuminate,adaxiall,adaxially,ag,alyx,articulated,axe,axillary,ba,barely,bark,blade,branch,branched,capitat,chartaceous,conical,dark,decurrent,dehiscing,dendritic-echinoi,dendritic-multangulate,densely,develope,diameter,directed,distal,distall,eaf,echinoi,echinoid,eed,entire,exserted,faintly,few-rayed,fruiting,glabrous,green,hair,high,homostylous,indument,inserted,interpetalar,lacking,lobed,long,long-,long-stalked,lower,m.,main,many,margin,midvein,mixed,moderately,multangulate,near,nearly,nflorescence,obscured,often,older,orolla,overlapping,part,partly,peduncle,perfect,persistent,plurifoliate,porrect-stellate,present,pubescent,rachi,rather,relatively,ribbed,ruit,runk,sessile,short-,short-stalked,side,sometimes,spaced,stamen,subovate,suture,tamen,testa,thick,thick-stalked,thick-textured,thin-stalked,time,tissue,tomentose,tomentu,tomentum,touching,toward,unarme,unit,usually,vary,vein,way,well,wide,ympodial	20-100,age,arrangement,capitate,coat,colour,connation,decurrency,dry,feature,form,height,history,inflorescence,life,midpoint,minor,na,new,number,ovary,papilla,plant,prickle,reproduction,scar,seed,shape,size,spacing,specimen,surface,texture,tip,tuberculation,type,width,winging	0.3-5,0.9-1.3,0.9-1.6,1-8,1.4-1.9,1.5-3,1.7-2.4,11-31,2-12,2-3.5,2-5,4-14,5-24,5-6.5,acute,apart,apex,apical-lateral,becoming,berry,blunt-tipped,broadly,brown,clavate,cm,continued,cuneate,deltoid,due,elliptic,extend,fleshy,free,globose,gray,growth,honeycombed,introrse,lanate,lanceolate,large,lateral,lilac,long-attenuate,longitudinal,mm,mostly,oblong,obtuse,orbicular,ovate,ovate-lanceolate,pale,petiole,pore,pseudo-terminal,purplish,rarely,reniform,reticulate-punctate,ripe,rotate-stellate,short-attenuate,shrub,simple,slightly,slit,small,stelliform,stem,subcampanulate,suborbicular,terete,top,tree,turbinate,unarmed,velutinous,white,whitish,x,yellow,yellowish	20-100,age,capitate,na
315	wfo-0001029417	success	213	123	78	91	122	32	73	5	.5,0.2-0.6,0.7-3,1-2,1.3-8,1.5-1.8,1.5-8,12,2.5-10,3-5,5-15,8-15,8-9,anther,attenuate,axillary,berry,blue,bud,cell,chartaceous,clavate,cm,coarsely,connivent,corolla,covering,dark,deep,diameter,dot,erect,filament,flower,forked,fruit,glabrous,globose,green,hair-like,herb,lanceolate,lateral,lengthening,linear,lobe,long,lunate,medium,membranous,minute,mm,moderately,non-glandular,odd-pinnate,often,ovoid,pedicel,peduncle,pentagonal,petiole,pilose,plant,pore,poricidal,pubescent,purple,ripe,rotate,scattered,seed,size,slightly,slit,sometimes,stem,stigma,style,subtending,terminal,testal,thick,tinged,tip,trichome,tube,typically,violet,wall,white,whitish	0-7,0.4-8,1,1-1.5,1-10,1-4,1-8,1.5-10,2-4,2.8-3.5,3-14,4-7,5-merou,6-11,abaxially,acumen,acuminate,acute,adaxially,ag,along,alyx,apart,apex,apiculate,apparently,articulated,axe,base,basiscopic,blade,borne,broadly,brownish,capitat,central,ciliate,condition,decreasing,decurrent,digestion,distal,dorsally,drying,eaf,edge,eed,end,enzyme,erec,especially,exceeding,flat,folded,fresh,geminat,generally,glabrou,greatly,green-white,greenish,hair,hal,half,homostylous,honeycomb-shaped,interjected,leaflet,like,living,lower,make,margin,midrib,minutely,mucilaginous,narrowly,nflorescence,orbicular,orolla,ovate,pair,perfect,petiolulate,plurifoliate,puberulent,rapidly,rarely,removed,rounded,ruit,sessile,seudostipule,short,short-petiolulate,side,singly,spaced,specimen,stamen,star,ste,stolo,straight,subequal,tall,tamen,tem,throughout,tri-,tuber,unit,unwinged,usually,vary,wet,wide,widely,wing,x,yellow,ympodial	abaxial,adaxial,age,arrangement,calyx,capitate,colour,connation,feature,form,geminate,growth,height,history,inflorescence,leaf,length,life,na,new,number,ovary,papilla,perennial,pseudostipule,reproduction,shape,surface,texture,type,width,young	.5,0.2-0.6,0.7-3,1-2,1.3-8,1.5-1.8,1.5-8,12,2.5-10,3-5,5-15,8-15,8-9,attenuate,axillary,berry,blue,bud,cell,chartaceous,clavate,cm,coarsely,connivent,covering,dark,deep,dot,erect,forked,glabrous,globose,green,hair-like,herb,lanceolate,lateral,lengthening,linear,long,lunate,medium,membranous,minute,mm,moderately,non-glandular,odd-pinnate,often,ovoid,pentagonal,pilose,poricidal,pubescent,purple,ripe,rotate,scattered,slightly,slit,sometimes,subtending,terminal,testal,thick,tinged,tip,trichome,typically,violet,wall,white,whitish	age,capitate,geminate,na,perennial
316	wfo-0001029461	success	210	125	69	87	123	38	67	2	-1.5,.5,0.6-1,0.7-1,1-1.6,1-3,1.2-1.8,1.3-2.2-3.2,1.5-2-4-5,1/3,1/4-1/2,2.5-3,5-merous,7-12,anther,apex,attenuate,bark,base,becoming,berry,broad-deltate,brown,calyx,cell,cm,cuneate,dark,densely,elliptic,evenly,filament,fine,flattened-reniform,flower,fruit,glabrescent,green,leaf,length,lobe,lobed,maturity,mauve,midpoint,mm,moderately,oblong,orange,outline,ovate,pedicel,pendulous,petiole,pit,plant,poricidal,porrect,prickle,prickly,raised,ray,reddish,rounded,sessile,shrub,simple,small,smooth,spherical,spreading,stalked,stellate-pubescent,stem,style,surface,tip,trichome,tube,upper,variously,way,weakly,woody,yellow,young,zygomorphic	-3,-4.5,0-2,0-4,0.1,0.1-0.25,0.15-0.25,0.8,0.8-1.5,1-1.5-2,1-2,1-3-6,1-4,1-6,1.2-1.7,1/3-2/3,1/4-3/4,2-2.4,2-2.8,2-3,3-20,4-10-14,4-6.5,4-7,4.5-7,4.7-7.2,5-10,5-25,7-10,8-9,abaxially,acuminat,almost,alyx,ame,andromonoecious,apart,apically,black,blade,breaking,brittle,c.,chartaceous,concolorous,curved,diameter,discolorous,distal,distance,drying,dull,eaf,eed,elongating,erect,extending,faint,fifth,flattened,four,free,fruiting,glabrous,gra,hermaphrodite,heterostylous,infructescence,lengt,long,long-styled,longer,lower,lowermost,margin,mature,midvein,obovate,obtuse,older,orolla,oung,pair,per,pericarp,plurifoliat,portion,prickl,primary,reduced,reflexed,ruit,shallow,shiny,short-styled,shorter,side,slender,slightly,sometimes,spaced,sparsely,stalk,staman,staminat,stellate,straight,strongly,subentire,tamen,terete,tertiary,time,unarme,unarmed,unequal,unit,vary,vein,venation,visible,wide,ympodial	anthesi,arrangement,bud,coat,colour,connation,corolla,decurrency,dry,embryo,feature,form,gray,growth,height,history,inflorescence,life,minor,na,new,number,ovary,papilla,pore,reproduction,scar,seed,shape,size,spacing,specimen,stigma,texture,tuberculation,type,width,winging	-1.5,.5,0.6-1,0.7-1,1-1.6,1-3,1.2-1.8,1.3-2.2-3.2,1.5-2-4-5,1/3,1/4-1/2,2.5-3,5-merous,7-12,attenuate,base,becoming,berry,broad-deltate,brown,cell,cm,cuneate,dark,densely,elliptic,evenly,fine,flattened-reniform,glabrescent,green,lobed,maturity,mauve,mm,moderately,oblong,orange,outline,ovate,pendulous,pit,poricidal,porrect,prickly,raised,reddish,rounded,sessile,shrub,simple,small,smooth,spherical,spreading,stalked,stellate-pubescent,tip,trichome,upper,variously,way,weakly,woody,yellow,young,zygomorphic	gray,na
317	wfo-0001029462	success	163	120	65	72	91	48	62	3	-2,-5,0.5-2,1-2,1-3,1-6,1.5-7,2.5-5.5,3,3-18,3-4,3-5,4-20-30,5-30,6-9,acuminate,acute,apex,base,calyx,campanulate,cm,connivent,cuneate,curled,dark,densely,dentate,eglandular,ellipsoidal,elliptic,flattened,flower,fruit,glabrous,green,hair,lanceolate,laterally,light,lobe,long,longitudinal,mm,narrowly,obtuse,often,oval,ovate,ovoid,pedicel,petiole,pore,pubescent-pilose,purplish,reticulate,rounded,simple,smooth,somewhat,stellate-,stigma,stripe,style,tip,tree,triangular,truncate,tube,unbranched,white,x	-4,0.5-1,1,1-4-15-30,1.5,1.5-2,1.5-3,10-15-25,10-22,2-3,2-6.5,2.5-3.5,20-35,3-27,3-6,3-7,4-foliat,7-19,7-8,8-9,abaxially,abruptly,absent,adaxially,aggregate,apart,ape,articulated,axe,basal,beyond,blade,broad,cell,chartaceous,ciliate,connective,constricted,cylindrical,diameter,directed,eaf,eed,entire,equal,exceeding,exserted,leaving,lon,lower,m.,margin,membranaceous,minutely,moderately,near,nflorescence,nther,occasionally,orolla,pedicellar,peduncle,perfect,puberulent,pubescent,pubescent-pilo,purpl,rachi,radiu,remnant,ruit,shorter,slightly,small,spaced,sparsely,stamen,stone,tal,tem,thecae,time,tomentose,truncat,ud,unit,vary,wide,without,yellow,ympodial	10-25,2-4,anther,anthesi,arrangement,bud,coat,colour,connation,corolla,decurrency,dry,embryo,feature,filament,form,growth,height,history,inflorescence,leaf,length,life,midpoint,minor,na,new,number,ovary,papilla,plant,prickle,ray,reproduction,scar,seed,shape,size,spacing,specimen,stem,surface,texture,tuberculation,type,width,winging,young	-2,-5,0.5-2,1-2,1-3,1-6,1.5-7,2.5-5.5,3,3-18,3-4,3-5,4-20-30,5-30,6-9,acuminate,acute,apex,base,campanulate,cm,connivent,cuneate,curled,dark,densely,dentate,eglandular,ellipsoidal,elliptic,flattened,glabrous,green,hair,lanceolate,laterally,light,long,longitudinal,mm,narrowly,obtuse,often,oval,ovate,ovoid,pubescent-pilose,purplish,reticulate,rounded,simple,smooth,somewhat,stellate-,stripe,tip,tree,triangular,truncate,unbranched,white,x	10-25,2-4,na
318	wfo-0001029464	success	232	138	83	102	130	36	82	1	.9,0.2-0.5,0.5,1-10,1-3,1-8,1.2-3,1/4,1/4-1/2,10-23,10-50,2-3,2-3.5,2.5-5,2.9-3.2,3-20,3-5,3-7,6-15,8-13,9-15,acicular,acute,andromonoecious,annual,anther,apart,apex,apparently,base,berry,black,broad-deltate,brown,calyx,cm,connivent,cordate,curved,dark,ellipsoid,erect,filament,flattened-reniform,flower,fruit,glabrescent,glabrous,globular,green,herb,lateral,leaf,length,less,lobe,lobed,maroon,maturity,mauve,midpoint,mm,moderately,mottled,oblong,obtuse,occasionally,ovate,ovoid,pedicel,pendent,petiole,pink,plant,poricidal,prickle,prickly,purple,ray,scar,simple,sometimes,spreading,stellate,stellate-pubescent,stem,straight,striped,style,surface,tapering,terminal,tip,tube,unarmed,upper,usually,variously,way,white,yellow-orange,young	0-2,0-30,0-5,0-80,0.2,0.2-0.7,0.3-0.7,0.3-1,0.5-2,0.8-2,00-200,1,1.5-2,1/,1/4-1/3,1/4-1/3-2/3,10-15,10-40,12-50,2-4,2.2-2.5,2.4-4,2.5-8,3.5-5,4-7,4-8,4-8-merous,5-17,5-8,5.5-6,5.5-7.5,7-10,8-15,abaxial,abaxially,adaxial,alyx,ame,apar,apically,around,articulated,bark,blade,branched,broad,brow,c.,chartaceous,cultivar,cup-shaped,deltate,diameter,difoliate,discolorous,distal,distance,drying,eaf,eed,elongated,elongating,equal,extending,free,fruiting,fully,geminat,glaucous,green-brown,hair,hermaphrodite,heterostylous,infructescence,long,long-acuminat,long-styled,longer,lower,lowermost,margin,mature,midvein,minute,narrow-deltate,nflorescence,often,older,one,open,opening,orange-brown,orolla,oung,pair,peduncle,pendulous,per,pericarp,porrect,portion,prickl,primary,red-brown,rounded,ruit,sessile,short-styled,side,smooth,spaced,sparsely,stalk,stalked,staminat,tamen,terete,tertiary,time,translucent,trichome,unit,vary,vein,venation,visible,wide,woody,yellow-green,ympodial	anthesi,arrangement,bud,coat,colour,connation,corolla,decurrency,dry,embryo,feature,form,growth,height,history,inflorescence,life,minor,na,new,number,ovary,papilla,pore,reproduction,seed,shape,size,spacing,specimen,stigma,texture,tuberculation,type,width,winging	.9,0.2-0.5,0.5,1-10,1-3,1-8,1.2-3,1/4,1/4-1/2,10-23,10-50,2-3,2-3.5,2.5-5,2.9-3.2,3-20,3-5,3-7,6-15,8-13,9-15,acicular,acute,andromonoecious,annual,apart,apparently,base,berry,black,broad-deltate,brown,cm,connivent,cordate,curved,dark,ellipsoid,erect,flattened-reniform,glabrescent,glabrous,globular,green,herb,lateral,less,lobed,maroon,maturity,mauve,mm,moderately,mottled,oblong,obtuse,occasionally,ovate,ovoid,pendent,pink,poricidal,prickly,purple,simple,sometimes,spreading,stellate,stellate-pubescent,straight,striped,tapering,terminal,tip,unarmed,upper,usually,variously,way,white,yellow-orange,young	na
319	wfo-0001029546	success	203	128	95	106	97	22	92	3	0.3-1,1-10,1-2,1-4.5,1.5-2,1.5-6.2,3-8,4-10,4.5-12.5,5,5-10,5-18,7-10,8-17,8-19.5,abaxially,adaxially,anther,apart,axillary,blue,brownish,bud,cell,chartaceous,clavate,cm,connivent,corolla,covered,covering,curved,densely,diameter,distal,dot,filament,flower,forked,frequently,fruit,generally,glabrous,glandular,globose,green,green-white,hair-like,half,herb,lanceolate,lateral,leaf,lengthening,long,longer,lunate,make,membranous,mm,mucilaginous,non-glandular,odd-pinnate,often,ovoid,pedicel,peduncle,pentagonal,petiole,plant,pore,poricidal,pubescent,rachi,rarely,ripe,rotate-pentagonal,seed,short,simple,size,slightly,slit,soft,stem,stigma,straight,style,subtending,terminal,testal,thick,throughout,tinged,tip,trichome,tube,unwinged,usually,wall,wet,white,whitish,wide,wing,x	0-2,1-3.2,1-5,1.6-6.5,2-4,2-9,2.2-2.8,3.5-5,4.5-7,5-8,5-merou,6.3-19.5,8,absent,acumen,acuminate,acute,adaxiall,ag,alyx,apex,apiculate,apparently,articulated,attenuate,axe,base,berry,blade,broadly,capitat,condition,cordate,decreasing,decumben,decurrent,digestion,dorsally,drying,eaf,edge,eed,elliptic,elliptical,enzyme,erect,exceeding,flat,folded,fresh,geminat,glabrou,greatly,greenish,hair,homostylous,honeycomb-shaped,interjected,leaflet,like,living,lobe,lower,middl,minutely,mottle,nearly,nflorescence,oblique,orbicular,ovate,pair,perfect,petiolule,plurifoliate,purple,regular,removed,ruit,sessile,seudostipule,sometimes,spaced,specimen,stamen,ste,subequal,tall,tamen,tem,tri-,truncate,typically,unit,vary,yellow,ympodial	age,arrangement,capitate,colour,connation,feature,form,growth,height,history,inflorescence,length,life,na,number,ovary,pseudostipule,reproduction,shape,spacing,surface,texture	0.3-1,1-10,1-2,1-4.5,1.5-2,1.5-6.2,3-8,4-10,4.5-12.5,5,5-10,5-18,7-10,8-17,8-19.5,abaxially,adaxially,apart,axillary,blue,brownish,bud,cell,chartaceous,clavate,cm,connivent,covered,covering,curved,densely,diameter,distal,dot,flower,forked,frequently,generally,glabrous,glandular,globose,green,green-white,hair-like,half,herb,lanceolate,lateral,lengthening,long,longer,lunate,make,membranous,mm,mucilaginous,non-glandular,odd-pinnate,often,ovoid,pentagonal,plant,pore,poricidal,pubescent,rarely,ripe,rotate-pentagonal,seed,short,simple,slightly,slit,soft,straight,subtending,terminal,testal,thick,throughout,tinged,tip,trichome,unwinged,usually,wall,wet,white,whitish,wide,wing,x	age,capitate,na
320	wfo-0001029552	success	161	137	89	101	60	36	84	5	.25,.5,0.1-0.5,0.5,0.6-1,1-1.5,1-3,1-5,1.5-2,1.5-6.5,10-20,12,2-2.5,2-9,2.5-3,5.5-8,abruptly,acuminate,acute,anther,anthesi,apex,area,bark,base,berry,branched,broadened,broadly,calyx,closely,cm,conical,contracted,corolla,decurrent,deflexed,deltate,dendritic,densely,elliptic,erect,filament,flattened-reniform,flower,glabrous,globose,green,incrassate,inflorescence,later,leaf,lobe,lobed,long,long-styled,margin,minor,minute,minutely,mm,nearly,occasionally,opposite,orbicular,ovary,pale,paler,pedicel,petiole,pitted,pore,poricidal,pubescent,rounded,scar,shape,shaped,short-styled,shrub,simple,size,slender,small,somewhat,spaced,stem,stigma,style,surface,tear-drop,tip,tree,tree-like,trichome,tube,white,wide,woody,x,young	1-1.3,1-2,5-10-flowered,6-9,abaxial,abaxially,adaxially,along,clavate,denser,dia,differing,difoliate,drying,eaf,edicel,eed,exserted,free,fruiting,geminat,greyish-brow,heteromorphic,inflorescenc,lamina,lateral,like,lon,lower,main,major,middle,nflorescence,older,onto,overlappin,pair,papillo,persistent,planar,portion,present,reflexed,rest,ruit,scattered,shining,slightly,sparsely,strongly,swollen,tall,tan,tub,ud,unit,vein,widest,yellowish,ympodial	5-10,arrangement,bud,coat,colour,connation,decurrency,dry,feature,form,fruit,greyish-brown,growth,height,history,length,life,midpoint,na,new,number,overlapping,papilla,papillose,plant,prickle,ray,reproduction,seed,spacing,specimen,texture,tuberculation,type,width,winging	.25,.5,0.1-0.5,0.5,0.6-1,1-1.5,1-3,1-5,1.5-2,1.5-6.5,10-20,12,2-2.5,2-9,2.5-3,5.5-8,abruptly,acuminate,acute,area,base,berry,branched,broadened,broadly,calyx,closely,cm,conical,contracted,decurrent,deflexed,deltate,dendritic,densely,elliptic,erect,flattened-reniform,flower,glabrous,globose,green,incrassate,later,leaf,lobed,long,long-styled,margin,minute,minutely,mm,nearly,occasionally,opposite,orbicular,pale,paler,pedicel,petiole,pitted,poricidal,pubescent,rounded,shaped,short-styled,shrub,simple,slender,small,somewhat,spaced,style,tear-drop,tip,tree,tree-like,trichome,tube,white,wide,woody,x,young	5-10,greyish-brown,na,overlapping,papillose
321	wfo-0001029584	success	180	109	64	80	100	29	61	3	0-30,1,1-2,1-6,16.2-33,2-3,2-4,3-10,3-7,4-14,4-15,4-5,4.5-11.5,6-7,6.1-9.4,7-14,9.7-23.4,9.8-17,anther,axillary,bud,cell,clavate,cm,connivent,coriaceous,corolla,covering,dark,densely,diameter,filament,flower,forked,glabrescent,glabrous,green,hair,hair-like,herb,interjected,lateral,leaf,leaflet,light,lobe,long,mm,oblong-lanceolate,odd-pinnate,ovate,ovoid,pair,pentagonal,perfect,petiole,plant,pore,poricidal,present,pubescent,purple,seed,short,simple,size,stigma,straight,style,substellate,subtending,terminal,testal,thick,tip,tube,tuber,wall,white,x	1-3,1.5-6.5,2.4-6.3,3-5,5-merou,5.3-13.3,8-15,abaxially,acumen,acuminate,acute,adaxially,ag,alyx,apart,apex,apparently,articulated,asymmetric,attenuate,axe,base,basiscopic,blade,borne,brownish,capitat,condition,considerably,decreasing,dense,digestion,distal,dorsally,drying,eaf,edge,eed,elliptic,end,enzyme,erry,finer,flat,folded,fresh,fruit,geminat,generally,green-white,greenish,hal,half,homostylous,honeycomb-shaped,larger,lengthening,linear,living,lower,make,margin,middle,mucilaginous,nflorescence,orbicular,orolla,pedicel,peduncle,petiolulate,plurifoliate,proximal,removed,second,semi-erec,sessile,seudostipule,side,singly,slit,spaced,specimen,stolo,tall,tamen,tem,throughout,tissue,toward,tri-,typically,unit,unknow,unwinged,usually,vary,wet,whitish,yellow,ympodial	abaxial,adaxial,arrangement,calyx,capitate,coat,colour,connation,feature,form,growth,height,history,inflorescence,length,life,number,ovary,perennial,presence,pseudostipule,reproduction,shape,stem,surface,texture,tuberculation,type,unknown	0-30,1,1-2,1-6,16.2-33,2-3,2-4,3-10,3-7,4-14,4-15,4-5,4.5-11.5,6-7,6.1-9.4,7-14,9.7-23.4,9.8-17,axillary,bud,cell,clavate,cm,connivent,coriaceous,covering,dark,densely,forked,glabrescent,glabrous,green,hair,hair-like,herb,lateral,light,long,mm,oblong-lanceolate,odd-pinnate,ovate,ovoid,pentagonal,perfect,poricidal,present,pubescent,purple,short,simple,straight,substellate,subtending,terminal,testal,thick,tip,wall,white,x	capitate,perennial,unknown
322	wfo-0001029593	success	181	119	74	90	91	29	69	5	-10,0.5-5,0.8-1.2,1,1-1.2,1-1.5,1.6-2.3,10-50,2.3,2.3-3.0,3-4,3.5-8,4-6,5-10,5-15,7-25,7.5-15,9-15,abaxially,acuminate,acute,anther,anticlinal,apex,apically,attenuate,axillary,base,basiscopically,berry,broadly,brown,calyx,capitate,cm,conical,decurrent,deltate,densely,diameter,elliptic,enlarged,filiform,flower,fruit,glabrescent,glabrous,globose,green,irregular,lateral,leaf,leaflet,markedly,mm,oblique,obovate,occasionally,onto,ovary,ovoid-reniform,papillose,pedicel,petiole,pinnate,plant,pointed,poricidal,projection,pubescent,rachi,seed,shape,shrub,sinuous,slightly,somewhat,stigma,style,surface,terminal,thickening,tip,tube,usually,white-lenticellate,winged,without,woody,x	0.05,0.5-1,0.8-1,1-2,1-8,100,2,2-14,2-3,2-5,35-60,abruptly,adaxially,age,always,anthesi,arising,axil,basal,bearing,cateniform,cell,clavat,colony,cone,dry,drying,eaf,edicel,eed,entire,epidermal,exserted,extremely,filament,free,fruiting,growing,half,hollow,included,lamina,large,lobe,long,lower,minutely,much,narrowing,nflorescence,noddin,often,once-branched,open,opposite,pair,per,perfectly,petiolule,place,portion,primary,pubescen,pubescence,purple,rarely,reflecting,rest,ruit,scar,short-styled,similar,simple,single-stemmed,small,smaller,smooth,sparsely,tall,tem,trichome,tub,ud,unifoliat,uniseriate,unit,variable,vein,white,wider,ympodial	abaxial,adaxial,arrangement,bud,clavate,coat,colour,corolla,feature,form,growth,height,history,inflorescence,length,life,na,nodding,number,perennial,reproduction,size,stem,texture,tuberculation,type,unifoliate,width,young	-10,0.5-5,0.8-1.2,1,1-1.2,1-1.5,1.6-2.3,10-50,2.3,2.3-3.0,3-4,3.5-8,4-6,5-10,5-15,7-25,7.5-15,9-15,abaxially,acuminate,acute,anticlinal,apically,attenuate,axillary,basiscopically,berry,broadly,brown,capitate,cm,conical,decurrent,deltate,densely,elliptic,enlarged,filiform,glabrescent,glabrous,globose,green,irregular,markedly,mm,oblique,obovate,occasionally,onto,ovoid-reniform,papillose,pinnate,pointed,poricidal,projection,pubescent,rachi,shrub,sinuous,slightly,somewhat,thickening,tip,usually,white-lenticellate,winged,without,woody,x	clavate,na,nodding,perennial,unifoliate
323	wfo-0001029601	success	187	139	91	107	80	32	86	5	0-37,0.2-0.8,0.5-5.8,1-2,1-3,1-4,1-53,1.1-2.7,1.2-2.3,1.7-6.5,2,2-12,2-3,2-9,2.2-4.5,2.3-5.9,2.8-10.5,3-10,3-5,3-7,4-13.5,5-41,6.6-22,6.8-14.5,abaxially,acumen,adaxially,anther,axillary,blade,borne,brownish,bud,cell,clavate,cm,condition,connivent,coriaceous,corolla,covering,dark,diameter,dot,drying,end,filament,flower,forked,fresh,fruit,glabrous,globose,green,green-white,greenish,hair-like,herb,interjected,lanceolate,lateral,leaf,leaflet,light,lobe,long,make,middle,mm,mucilaginous,narrow,odd-pinnate,ovate,ovoid,pedicel,peduncle,pentagonal,petiole,plant,pore,poricidal,puberulent,ripe,rotate,seed,singly,size,slightly,small,stigma,style,subtending,terminal,testal,thick,throughout,tip,tube,tuber,typically,unwinged,wall,wet,white,whitish,wing,x	0.5-8,2-7,5-merou,6-10,abaxiall,acuminate,acute,ag,alyx,apart,apex,apparently,articulated,asymmetric,attenuate,axe,base,basiscopic,berry,capitat,decreasing,digestion,distal,dorsally,eaf,edge,eed,elliptic,enzyme,erec,exceeding,flat,folded,geminat,generally,glabrescent,glabrou,hair,half,homostylous,honeycomb-shaped,larger,lengthening,linear,living,lower,middl,nflorescence,orbicular,orolla,pair,perfect,petiolulate,plurifoliate,removed,rounded,ruit,sessile,seudostipule,short,side,slit,spaced,specimen,stamen,stolo,straight,subequal,subglabrou,tall,tamen,tem,tissue,toward,tri-,unit,usually,vary,yellow,ympodial	abaxial,adaxial,arrangement,articulation,calyx,capitate,colour,connation,feature,form,growth,height,hermaphroditic,history,inflorescence,length,life,number,ovary,perennial,presence,pseudostipule,reproduction,shape,spacing,staman,stem,stolon,subglabrous,surface,texture,type	0-37,0.2-0.8,0.5-5.8,1-2,1-3,1-4,1-53,1.1-2.7,1.2-2.3,1.7-6.5,2,2-12,2-3,2-9,2.2-4.5,2.3-5.9,2.8-10.5,3-10,3-5,3-7,4-13.5,5-41,6.6-22,6.8-14.5,abaxially,adaxially,axillary,borne,brownish,bud,cell,clavate,cm,condition,connivent,coriaceous,covering,dark,diameter,dot,drying,end,forked,fresh,glabrous,globose,green,green-white,greenish,hair-like,herb,lanceolate,lateral,light,long,make,middle,mm,mucilaginous,narrow,odd-pinnate,ovate,ovoid,pentagonal,poricidal,puberulent,ripe,rotate,seed,singly,slightly,small,subtending,terminal,testal,thick,throughout,tip,typically,unwinged,wall,wet,white,whitish,wing,x	capitate,hermaphroditic,perennial,stolon,subglabrous
324	wfo-0001029621	success	165	128	88	98	67	30	79	9	.1,0.5-0.75,0.5-1,0.5-1.2,0.5-1.5,0.7-1.1,0.8-1,0.8-4.5,1-1.5,1-2,1.5-2.5,1.5-5,2.5-3,2/3,3-3.5,5-20-flowered,6-20,7-9,accrescent,acute,anther,apex,appressed,area,attenuate,bark,base,becoming,berry,calyx,cluster,cm,constricted,corolla,cup-shaped,decurrent,deltoid,dia,ellipsoid,erect,filament,fleshy,fruit,fruiting,glabrate,glabrous,globose,green,irregularly,lanceolate,later,lateral,leaf,lobe,lobed,long,merely,minutely,mm,oblanceolate,older,onto,ovary,ovoid-reniform,papillate,papillose,pedicel,pitted,plant,poricidal,puberulent,reddish,ripe,scar,sessile,shaped,shiny,shrub,somewhat,stem,stigma,style,surface,tapering,tear-drop,terminal,tip,trichome,tube,uniseriate,way,white,whorl-like,widened,woody,x,yellowish,young	1.5-2,1/3,3.5-4.5,6-8,along,anthesi,apar,appearing,beneath,borne,branched,brown,caudate,completely,course,dark,densely,distal,dry,eaf,edicel,eed,elongate,enclosed,exsertio,free,geminate,late,like,live,lon,lower,main,many,margin,material,middle,nflorescence,occasionally,often,pair,pale,papillo,planar,plurifoliat,pore,portion,prominent,quite,rarely,reddish-gre,river,ruit,small,spaced,ste,straight,tall,tan,thick,time,ud,unit,vein,widest,yellow,ympodial	abaxial,adaxial,apart,arrangement,bud,colour,exsertion,feature,flower,form,growth,height,history,inflorescence,length,life,na,number,perennial,plurifoliate,red,reddish-grey,reproduction,seed,shape,size,spacing,texture,type,width	.1,0.5-0.75,0.5-1,0.5-1.2,0.7-1.1,0.8-1,0.8-4.5,1-1.5,1-2,1.5-2.5,1.5-5,2.5-3,2/3,3-3.5,5-20-flowered,6-20,7-9,acute,appressed,area,attenuate,base,becoming,berry,calyx,cluster,cm,constricted,corolla,cup-shaped,decurrent,deltoid,dia,ellipsoid,erect,fleshy,glabrate,glabrous,globose,green,irregularly,lanceolate,later,lateral,lobed,long,merely,minutely,mm,oblanceolate,onto,ovoid-reniform,papillate,papillose,pitted,poricidal,puberulent,reddish,ripe,sessile,shaped,shiny,shrub,somewhat,stem,style,tapering,tear-drop,terminal,tip,trichome,tube,uniseriate,way,white,whorl-like,widened,x,yellowish	.5-1.5,apart,di,exsertion,na,perennial,plurifoliate,red,reddish-grey
325	wfo-0001029622	success	182	109	72	88	94	21	68	4	.1,.5,0.5-0.7,0.5-1,1-1.2,1-4,1.5,2-11,3-4,30-35,4-6.5,45-50,5-6,absent,anther,appearing,base,brown,bud,calyx,chartaceous,cm,consisting,corolla,cylindrical,deflexed,diameter,differing,dimorphic,elliptic,filament,flower,fruit,glabrous,globose,green,inflorescence,internodal,jointed,lateral,leaf,lobed,longitudinal,main,major,minor,mm,narrowly,obconic,oblong,occasionally,older,one,opening,opposite,ovate,pair,pedicel,peduncle,petiole,pore,rachi,reddish,sagittate,shaped,shiny,shrub,simple,single,size,slightly,slit,somewhat,stellate,stem,stigma,straight,style,tapering,tear-drop,tip,trichome,tube,uniseriate,vein,white,x,young	.2,/3,0.3,0.5,0.6-0.9,0.8-1,1-1.5,1-2.7,2-4,2-5,2.5-3,3-5,40,7-11,abaxially,accrescent,acute,adaxially,ag,alyx,anthesi,apex,apparently,arising,attenuate,axe,axil,bark,beneath,blade,capitat,connivent,deciduous,difoliate,eaf,eed,elongate,entire,except,free,fruiting,geminate,glabrou,ilament,immature,included,interlaced,known,lamina,less,lobe,long,long-acuminate,long-triangular,m.,margin,mature,measured,midrib,minute,minutely,nflorescence,often,onto,orolla,oung,ovate-lanceolate,papillose,pendent,portion,present,probably,raised,reflexed,remaining,rounded,ruit,scar,second,slende,slender,tal,thin,thus,tuft,ud,unarme,unifoliat,unit,vary,way,within,yellow,ympodial	abaxial,adaxial,age,arrangement,capitate,colour,feature,form,growth,hair,height,length,na,ovary,plant,seed,shape,surface,texture,type,unarmed	.1,.5,0.5-0.7,0.5-1,1-1.2,1-4,1.5,2-11,3-4,30-35,4-6.5,45-50,5-6,absent,appearing,base,brown,chartaceous,cm,consisting,cylindrical,deflexed,diameter,differing,dimorphic,elliptic,flower,fruit,glabrous,globose,green,internodal,jointed,leaf,lobed,longitudinal,major,minor,mm,narrowly,obconic,oblong,occasionally,one,opening,opposite,ovate,pair,pedicel,reddish,sagittate,shaped,shiny,shrub,simple,single,size,slightly,slit,somewhat,stellate,straight,tapering,tear-drop,trichome,uniseriate,white,x	age,capitate,na,unarmed
326	wfo-0001029625	success	166	121	66	82	84	39	59	7	0.5-1,0.5-1.3,0.5-2,0.8-1.4,1-1.5,2,3,3-3.5,4-10,5-6,6-9,9-25,abaxial,anther,anthesi,bark,base,branched,calyx,cell,cm,conical,corolla,cucullate,darker,deflexed,densely,dry,elliptic,erect,filament,flattened,flower,four,fruit,glabrescent,glabrous,globose,green,greenish,growth,herb,inflorescence,later,lobe,lobed,long,markedly,mixed,mm,narrowly,nearly,new,outer,outline,ovary,ovate-reniform,papillate,pedicel,pointed,pubescent,regularly,sinuate,slightly,smooth,sparsely,stem,stigma,striate,stripe,strongly,style,surface,time,tip,triangular,trichome,tube,uniseriate,wall,white,young	..,.1-0.2,.5,0.5-2mm,0.8-1.8,1-2,1-3,1.2-1.6,100,2.5-.,3-3,3-5-8,4-4,4-5-celled,4-7-celled,4-9,5,5-10-15,8-13,along,apical,beneath,branc,branch,brittle,brow,capitat,cel,deflexe,deltate,denser,diameter,distinct,eaf,edicel,eed,frui,fruiting,gland,gland-tipped,glandular,hyaline,lamina,lighter,like,lower,margin,middle,midline,minute,nflorescence,occasionally,open,pair,pale,peduncle,per,pericarp,planar,plurifoliat,point,primary,purplish,rarely,reddish,ruit,scar,scattered,shrub,single,single-stemmed,small,tan,testa,thin,tinged,tuft,ud,unit,vein,weight,without,x,ympodial	0.1-0.2,1,3-8,adaxial,arrangement,brown,bud,capitate,coat,colour,connation,embryo,feature,form,hair,height,history,leaf,length,life,midpoint,na,number,papilla,plant,plurifoliate,pore,prickle,ray,reproduction,seed,shape,size,spacing,specimen,texture,tuberculation,type,width	0.5-1,0.5-1.3,0.5-2,0.8-1.4,1-1.5,2,3,3-3.5,4-10,5-6,6-9,9-25,base,branched,cell,cm,conical,cucullate,darker,deflexed,densely,elliptic,erect,flattened,four,glabrescent,glabrous,globose,green,greenish,herb,lobed,long,markedly,mixed,mm,narrowly,nearly,outer,outline,ovate-reniform,papillate,pointed,pubescent,regularly,sinuate,slightly,smooth,sparsely,striate,stripe,strongly,time,tip,triangular,trichome,uniseriate,wall,white	0.1-0.2,1,3-8,brown,capitate,na,plurifoliate
327	wfo-0001029645	success	160	117	82	94	66	23	80	2	.5-1,0.2-0.5,0.5-2.5,0.5-7,1,1-2,1-4,1.3-7,1.5,1.5-2,2-4,2.5-17,3-10,3-15,3-7,3.5-4,337,5,5-8,6-12,7-12,750,?,acuminate,acute,along,anther,apart,apex,base,brown,calyx,cm,corolla,cuneate,decurrent,deltate,diameter,directed,distally,entire,et,except,extra-axillary,filament,finger,flattened,flower,fruit,glabrous,gland-tipped,globose,green,hair,herb,immature,kayap,knapp,line,lobe,margin,minutely,mm,moderately,nearly,obtuse,pedicel,peduncle,petiole,pore,puberulent,purple,rachi,radiu,rarely,red,rotate-stellate,rugose-verrucate,sagittate,short,short-tomentose,simple,small,smith,sparsely,stigma,strongly,style,subcordate,tapered,triangular,truncate,tube,x	-1,0.3-0.5,1-1.5,2-3-foliat,2.5-4,4-5,4-8,abaxially,abundantly,adaxially,aggregate,around,articulated,axe,ba,blade,blue,cell,chartaceous,connivent,cylindrical,distall,eaf,eed,fide,free,glabrou,greenish,inserted,long,lower,major,membranaceous,mesocarp,nflorescence,orolla,ovate,ovate-elliptic,part,perfect,puberulen,ruit,sand-punctate,shorter,shru,side,spaced,stone,tal,tamen,tem,thecae,tightly,time,tomento,truncat,unbranched,unit,vary,vein,veiny,white,wide,yellow,ympodial,Â±	0.5-1,arrangement,colour,feature,form,growth,height,inflorescence,leaf,length,number,ovary,plant,seed,shape,shrub,size,spacing,staman,stem,surface,texture,width	.5-1,0.2-0.5,0.5-2.5,0.5-7,1,1-2,1-4,1.3-7,1.5,1.5-2,2-4,2.5-17,3-10,3-15,3-7,3.5-4,337,5,5-8,6-12,7-12,750,?,acuminate,acute,along,apart,apex,base,brown,cm,cuneate,decurrent,deltate,directed,distally,entire,et,except,extra-axillary,finger,flattened,glabrous,gland-tipped,globose,green,hair,herb,immature,kayap,knapp,line,lobe,margin,minutely,mm,moderately,nearly,obtuse,petiole,puberulent,purple,radiu,rarely,red,rotate-stellate,rugose-verrucate,sagittate,short,short-tomentose,simple,small,smith,sparsely,strongly,subcordate,tapered,triangular,truncate,x	0.5-1,shrub
328	wfo-0001029646	success	141	75	38	51	90	24	36	2	0.1-0.6,0.5-0.8,0.7-2.2,1-4,1.5-2,1.5-4.9,10-15,2-3,3-14,4-5.5,6-8,7-15,acuminate,acute,apex,attenuate,base,branched,calyx,cm,corolla,cyme,diameter,dichasially,filament,finely,flower,free,globose,green,herbaceous,leaf,long,mm,mucilaginous,ovoid,pedicel,peduncle,perennial,petiole,plant,pubescent,seed,simple,stellate,stigma,style,tone,white,yellow,yellow-green	0.5,3-6-foliat,5-15,abaxially,acumen,adaxially,apical,apically,articulate,cell,commonly,covering,dehiscent,dichasial,digestion,distal,dorsally,eaf,ebracteate,edge,eed,elliptic,emoval,enzyme,epiphytic,equaling,flat,folded,forked,generally,globo,green-white,ground,growing,hair-like,half,honeycomb,introrse,lateral,linear,living,lobe,lon,lower,make,maturing,monochasial,mos,mould,mucronate,narrowly,nflorescence,nther,oak,often,orolla,ovat,ovate,pattern,perfect,pine,plan,poricidally,proximal,rarely,reveal,ruit,seudostipule,short,slit,specimen,stamen,straight,tall,tem,testal,thick,throughou,throughout,tree,tuber-bearing,typically,unit,vary,viole,wall,wide,without,ympodial,Â¼	anther,arrangement,colour,feature,form,fruit,growth,height,history,inflorescence,length,life,na,number,ovary,reproduction,shape,size,stem,surface,texture,type,violet,width	0.1-0.6,0.5-0.8,0.7-2.2,1-4,1.5-2,1.5-4.9,10-15,2-3,3-14,4-5.5,6-8,7-15,acuminate,acute,attenuate,branched,cm,cyme,dichasially,finely,free,globose,green,herbaceous,long,mm,mucilaginous,ovoid,perennial,pubescent,simple,stellate,tone,white,yellow,yellow-green	na,violet
329	wfo-0001029652	success	160	125	71	85	75	40	65	6	.5,0.5-1,0.5-4,0.8-1,1,1-2,1-3,1.5-2,2,2-2.5,2-4,3.5-4,3/4,4-4.5,6-15,anther,anthesi,apical,attenuate,bark,base,berry,broadly,calyx,cm,conical,corolla,curling,deflexed,deltate,elliptic-ovate,filament,filiform,flower,glabrous,globose,golden,green,greenish-white,hispid,leaf,lobe,lobed,long,long-acuminate,long-styled,minor,minute,minutely,mm,narrowly,near,occasionally,opposite,ovary,ovoid-reniform,papillose,pedicel,petiole,pitted,pore,poricidal,projection,pubescent,reddish-brown,scar,shaped,short-styled,shrub,simple,size,stem,stigma,style,surface,swollen,tear-drop,tip,trichome,tube,uniseriate,way,white,x,young	.25,.3,0.75-1,2.5-3,25,7-9,abaxially,adaxially,along,apar,ape,apex,arch,arching,ba,bearing,cone,deciduous,denser,dia,differing,difoliate,drying,eaf,edicel,eed,evenly,exserted,free,fruiting,geminat,golden-red,hard,heteromorphic,included,joining,lamina,lateral,like,lon,lower,main,major,margin,maturity,middle,midrib,nflorescence,older,pair,pale,papillo,pericarp,portion,reflexed,ruit,series,slende,slender,slightly,soon,spaced,sparsely,tall,tan,thickened,time,tub,ud,undulate,unit,vein,widest,within,ympodial	0.3,0.5,abaxial,adaxial,alternate,apart,arrangement,bud,coat,colour,connation,dry,embryo,feature,form,fruit,growth,hair,height,history,inflorescence,length,life,midpoint,na,number,papilla,perennial,plant,prickle,ray,reproduction,seed,shape,spacing,specimen,texture,tuberculation,type,width	.5,0.5-1,0.5-4,0.8-1,1,1-2,1-3,1.5-2,2,2-2.5,2-4,3.5-4,3/4,4-4.5,6-15,apical,attenuate,base,berry,broadly,cm,conical,curling,deflexed,deltate,elliptic-ovate,filiform,flower,glabrous,globose,golden,green,greenish-white,hispid,leaf,lobed,long,long-acuminate,long-styled,minute,minutely,mm,narrowly,near,occasionally,opposite,ovoid-reniform,papillose,pitted,poricidal,projection,pubescent,reddish-brown,shaped,short-styled,shrub,simple,swollen,tear-drop,tip,trichome,uniseriate,way,white,x	0.3,0.5,alternate,apart,na,perennial
330	wfo-0001029673	success	159	127	76	94	65	33	74	2	.5,0.5-1,0.7-1.1,0.8-1,1-10,1-2,1-5,1.2-3.5,1.5-2,2-2.5,2.5,3/4,4-6,5-25,5.5-15,absent,acuminate,acute,age,anther,anthesi,apex,appearing,base,berry,black,branch,broadly,calyx,clavate,cm,conical,corolla,deep,deflexed,deltoid,dendritic,densely,elliptic,filament,flower,fork,free,fruit,glabrous,globose,greyish,greyish-yellow,growth,later,lateral,leaf,length,lenticular,lobe,long,minutely,mm,narrowly,occasionally,ovary,overtopping,pedicel,petiole,pitted,planar,plurifoliate,pore,poricidal,pubescent,purple,pyramidal,reflexed,shoot,shrub,slightly,slit-like,small,stem,stigma,style,surface,tapering,terminal,tip,tree,triangular,trichome,tube,violet,winged,woody,x,young	0.75-1,1.5-1.8,10-20,2-3,2-4,3-5,abaxial,abaxially,accrescent,adaxial,adaxially,along,apical,bark,basal,becoming,blade,branching,decurrent,denser,diameter,dichasia,eaf,edicel,eed,ew,exserted,fruiting,greyish-yello,individual,inserted,lamina,like,lon,longer,lower,m.,monochasial,nflorescence,nodding,older,pair,papillo,pericarp,petal,portion,prominent,reddish-brown,ruit,scar,secondary,sleeve,somewhat,sparsely,stamen,strongly,tall,thin,time,tub,ud,unit,vein,wide,ympodial	arrangement,bud,coat,colour,connation,dry,embryo,feature,form,height,history,inflorescence,life,midpoint,na,new,number,papilla,papillose,plant,prickle,ray,reproduction,seed,shape,size,spacing,specimen,texture,tuberculation,type,width,winging	.5,0.5-1,0.7-1.1,0.8-1,1-10,1-2,1-5,1.2-3.5,1.5-2,2-2.5,2.5,3/4,4-6,5-25,5.5-15,absent,acuminate,acute,age,apex,appearing,base,berry,black,branch,broadly,clavate,cm,conical,deep,deflexed,deltoid,dendritic,densely,elliptic,fork,free,glabrous,globose,greyish,greyish-yellow,later,lateral,length,lenticular,long,minutely,mm,narrowly,occasionally,overtopping,pitted,planar,plurifoliate,poricidal,pubescent,purple,pyramidal,reflexed,shoot,shrub,slightly,slit-like,small,tapering,terminal,tip,tree,triangular,trichome,violet,winged,woody,x	na,papillose
331	wfo-0001029680	success	212	120	82	96	116	24	80	2	.0,0.1,1.0â1.1,1.0â1.5,1.1â1.2,1.4â7.5,10,11â25,12,1â2,4.0â16,4.0â6.5,4.5â20,4.5â7.0,5.5â8.5,50,5â11,7â10,8â32,acute,annual,anther,anthesi,apex,axillary,base,becoming,bipinnate,blue,branched,calyx,clavate,cm,decurrent,entire,filament,flattened,fleshy,flower,fruit,glabrous,globose,green,herb,leaf,length,light,lobe,long,longitudinal,mm,oblong,obovate,obtuse,opening,ovate,pedicel,pentagonal,petiole,pinnate,pitted,pore,pubescent,purple,rapidly,rarely,red,ripe,rotate,shallowly,shaped,size,sometimes,sparsely,split,stem,stigma,style,surface,tear-drop,terminal,time,tip,tripinnate,tube,turning,violet,white,wide,winged,woody,x,yellow,â10,â19,â3	0.4,0.5â1.5,0.6,0.6â1.2,0.6â2.0,0.9â1.0,1,1.0,1.0â1.8,1.4â2.5,1.5,1.6â2.7,1.7â7,1.8â3.8,11â16,1â3,1â6,1â8,2.2â4.2,2â20,3.0â4.2,3.3â5.5,3â22,3â6,4â10,4â30,5,abaxially,absen,adaxiall,adaxially,ag,along,apart,appressed,arequipa,arranged,articulated,asymmetrically,axe,ba,beyond,blade,borne,brown,cell,connivent,cylindrical,decreasing,densely,diameter,difoliate,divided,eaf,eed,equal,erect,extending,flange,forming,geminat,hair,indistinct,irregularly,lon,lower,m.,margin,midrib,moderately,multicellular,narrow,nflorescence,node,occasionally,often,orolla,pair,pale,parallel,peduncle,pendant,perfect,pinnae,plurifoliate,poricidal,primary,prostrate,ruit,running,secondary,shoot,side,simple,spaced,specimen,stone,straight,subglabrous,tacna,tal,tamen,tem,tertiary,unicellular,uniseriate,unit,usually,vary,wing,winge,ympodial,â12.5,â3.2,â46,â48	age,arrangement,colour,corolla,feature,form,growth,height,history,inflorescence,life,na,number,ovary,papilla,plant,reproduction,seed,shape,texture,type,width,winging,young	.0,0.1,1.0â1.1,1.0â1.5,1.1â1.2,1.4â7.5,10,11â25,12,1â2,4.0â16,4.0â6.5,4.5â20,4.5â7.0,5.5â8.5,50,5â11,7â10,8â32,acute,annual,anther,anthesi,axillary,becoming,bipinnate,blue,branched,clavate,cm,decurrent,entire,flattened,fleshy,fruit,glabrous,globose,green,herb,length,light,long,longitudinal,mm,oblong,obovate,obtuse,opening,ovate,pentagonal,petiole,pinnate,pitted,pubescent,purple,rapidly,rarely,red,ripe,rotate,shallowly,shaped,sometimes,sparsely,split,tear-drop,terminal,time,tripinnate,turning,violet,white,wide,winged,woody,x,yellow,â10,â19,â3	age,na
332	wfo-0001029704	success	144	121	66	80	64	41	63	3	1.5,1.5-2.5,1.5-3,2-2.5,2-3,3-4-celled,3-5,7-10,acuman,acuminate,acute,anther,anthesi,apex,base,berry,blue,branch,broadly,calyx,cm,composed,corolla,cuneate,dark,deeply,ellipsoid,extra-axillary,few-flowered,filament,flower,fork,glabrous,globose,green,halfway,leaf,lengthening,less,lobe,lobed,minute,minutely,mm,mottled,obovate,obovoid,occasionally,one,ovary,pedicel,petiole,pinnatisect,pore,poricidal,pubescent,purple,record,reticulate,rounded,short,shrub,simple,single,slit,sombre,stellate,stigma,stout,striped,style,subdiscoidal,surface,tip,trichome,tube,variable,variously,white,young	.5,0-1.5,0.5,1,1-2,1-4,1.5-2.5-3,1000-1200,140-185,15-25,2-5,4,4-7,5,7-10-14-17,9-20,along,also,apparently,aspect,axi,brown,c.,cell,conical,cunate,cut,deflexed,dia,diam,eaf,eed,enlarged,erect,especially,exerted,flowering,fruiting,gradually,lanceolate,long,lower,midrib,moderately,nflorescence,peduncle,plurifoliat,reddish,ruit,shoot,sinus,sprawling,stone,straight,subglobo,swollen,tub,twig,ud,unit,vein,within,x,ympodial	arrangement,bud,coat,colour,connation,decurrency,dry,embryo,feature,form,fruit,growth,height,history,inflorescence,length,life,midpoint,minor,na,new,number,papilla,plant,plurifoliate,prickle,ray,reproduction,scar,seed,shape,size,spacing,specimen,stem,subglobose,texture,tuberculation,type,width,winging	1.5,1.5-2.5,1.5-3,2-2.5,2-3,3-4-celled,3-5,7-10,acuman,acuminate,acute,base,berry,blue,branch,broadly,cm,composed,cuneate,dark,deeply,ellipsoid,extra-axillary,few-flowered,flower,fork,glabrous,globose,green,halfway,lengthening,less,lobed,minute,minutely,mm,mottled,obovate,obovoid,occasionally,one,pinnatisect,poricidal,pubescent,purple,record,reticulate,rounded,short,shrub,simple,single,slit,sombre,stellate,stout,striped,subdiscoidal,tip,trichome,variable,variously,white	na,plurifoliate,subglobose
333	wfo-0001029727	success	257	116	65	87	170	29	63	2	-3,/3,0-2,0.4-1,0.7-0.9,1-1.2,1-2,1-4,1.5-5.5-10,1/4,2.5-3.2,2.5-5.5,2.8-4,3-11,5-12,acuminate,acute,almost,anther,apart,apex,apically,articulated,bark,base,calyx,clavate,climber,cm,connivent,cordate,corolla,cupular,deltate,densely,erect,filament,finely,flattened-reniform,flower,lateral,leaf,length,lobe,lobed,long,mauve,middle,minor,mm,obconical,ovate,papillose,pedicel,petiole,pitted,pore,poricidal,porrect,prickle,prickly,red-brown,rounded,scar,seed,sessile,shape,shrub,simple,size,smooth,stalked,stellate-pubescent,stem,stigma,style,surface,tapering,terminal,tip,trichome,tube,upper,variously,way,wide,young	.5,0-15,0-20,0-30,0-4,0-40,0-5,0-8,0.1-5,0.15-0.2,0.15-0.3,0.2,0.2-0.5,0.2-2.5,0.3,0.4,0.5,0.5-1.2,0.5-3,0.7-1,1,1-2-5,1.2-2,1.5-2.3,1.5-2.5,1.5-3,1.6-3,1/2-2/3,1/3-1/2,1/8-1/5-1/3,2.5,3-6,3-7,3/,4-7,4-merou,4-merous,4.5,4.5-5.5-7,5-8,5-9,5.5-7,6-11,7-10,abaxial,abaxially,acicular,adaxial,age,along,alternate,alyx,ame,anthesi,apar,apparently,berry,blade,branched,bristle,brown,c.,chartaceous,colourles,covered,curved,darker,deltoid,developing,diameter,different,dimorphic,discolorous,divided,drying,eaf,edge,eed,elongating,equal,except,extending,ferrugineous,filiform,filiform-acuminat,fissure,free,geminate,glabrous,increasing,inside,lengthening,less,like,lon,longer,lower,m.,margin,mature,midpoint,midvein,minutely,mixture,moderately,narrow-deltate,nflorescence,nther,oblong,occasional,older,one,open,orange-brown,orolla,oung,outside,pair,papillo,peduncle,per,perfec,perfect,pit,plurifoliat,portion,prickl,primary,protruding,pubescent,raised,rarely,ray,red-brow,reddish,reduced,regular,scandent,series,shallowly,short,sinus,sometimes,spaced,spreading,stalk,stellate,straight,strongly,subentire,tamen,tearing,terete,tertiary,time,toward,translucent,transverse,unarmed,uneven,unit,variable,vary,vein,venation,violet,visible,x,yellowish,ympodial	arrangement,bud,coat,colour,connation,decurrency,embryo,feature,filiform-acuminate,form,fruit,growth,height,history,inflorescence,life,na,new,number,ovary,papilla,plant,reproduction,spacing,texture,tuberculation,type,width,winging	-3,/3,0-2,0.4-1,0.7-0.9,1-1.2,1-2,1-4,1.5-5.5-10,1/4,2.5-3.2,2.5-5.5,2.8-4,3-11,5-12,acuminate,acute,almost,apart,apically,articulated,base,clavate,climber,cm,connivent,cordate,cupular,deltate,densely,erect,finely,flattened-reniform,lateral,lobed,long,mauve,middle,mm,obconical,ovate,papillose,pitted,poricidal,porrect,prickly,red-brown,rounded,seed,sessile,shrub,simple,smooth,stalked,stellate-pubescent,tapering,terminal,tip,trichome,upper,variously,way,wide	filiform-acuminate,na
334	wfo-0001029731	success	246	106	54	71	175	35	51	3	0.25-0.3,1-2,1-2.5,1.5,1.5-2.5,10-20,2-6,2.5-4.5,3-10,3-4,4,7-11,8-9,acquiring,acuminate,acute,anther,apex,apically,base,berry,black,calyx,clavate,cm,connate,corolla,cuneate,deltoid,dilated,distributed,elliptic,epiphyte,evenly,filament,flower,fruit,glabrous,leaf,liana,linear,lobe,lobed,long-ellipsoid,mauve,mm,narrowly,obconical,oblong,obovate,pedicel,petiole,pore,poricidal,pyriform,ribbed,rounded,scar,stem,stigma,style,surface,terminal,thick,tip,tube,white,widely,winged,woody,young	.5,.6,0.05,0.1-0.8,1,1-1.5,1.5-3,1/3,1994,2,2-3,2.5,3,31,4-5,4-9,6,6-7,abaxially,accrescent,adaxially,age,almost,along,alyx,anthesi,apar,apparently,arcy,articulated,bark,basal,basally,beak,becoming,boundary,branch,branched,branching,broadly,brown,bumpy,clearly,concolorous,conical,coriaceous,crinkled,darker,delimited,delineated,dense,development,diameter,different,domatia,dorsal,dorsifixed,dry,drying,dull,eaf,early,elongating,enlarge,entire,equal,erect,even,exserted,faint,filiform,fine,finely,flaring,flattened,fleshy,free,fruiting,ground,hair,iscoid,lamina,large,later,lateral,lengthening,less,like,lon,long,longitudinal,longitudinally,lower,main,margin,mature,maturity,midvein,much,nflorescence,nther,obtuse,occasionally,often,orange-brown,orolla,pair,papillae,papillose,part,peduncle,pendulous,perfec,pericarp,persisting,plurifoliat,portion,primary,prominent,protruding,rachi,raised,rakotozafy,rarely,reflexed,reported,revolute,ridge,ridged,ruit,see,several,shallowly,shorter,simple,sinus,slender,slightly,small,smaller,smoot,sometimes,sparsely,straight,stretched,stump,succulent,sunk,tearing,thickened,thinner,though,time,toward,trichome,tub,tuft,ud,unit,usually,vary,vein,venation,ventral,visibl,visible,well-developed,wide,wing,wrinkling,x,yellow,yellow-green,ympodial,â	0.5,arrangement,bud,coat,colour,connation,decurrency,embryo,feature,form,growth,height,history,inflorescence,length,life,minor,na,new,number,ovary,papilla,plant,prickle,reproduction,seed,shape,size,smooth,spacing,texture,tuberculation,type,width,winging	0.25-0.3,1-2,1-2.5,1.5,1.5-2.5,10-20,2-6,2.5-4.5,3-10,3-4,4,7-11,8-9,acquiring,acuminate,acute,apically,berry,black,clavate,cm,connate,cuneate,deltoid,dilated,distributed,elliptic,epiphyte,evenly,glabrous,liana,linear,lobed,long-ellipsoid,mauve,mm,narrowly,obconical,oblong,obovate,poricidal,pyriform,ribbed,rounded,surface,terminal,thick,white,widely,winged,woody	0.5,na,smooth
335	wfo-0001029741	success	137	120	66	82	55	38	60	6	0.5-1.5,0.8-3.5,0.9-1.2,1-1.5,1-3.5,1.1-1.3,1.5,1.5-4,1.5-6,2.2-9,2.5-7.8,9.5-22.5,?,acute,age,anther,anthesi,apex,apiculate,attenuate,base,becoming,berry,calyx,capitate,closely,cm,completely,corolla,dark,deflexed,deltoid,dry,elliptic,erect,filament,flower,fruit,furcate,glabrous,globose,green,growth,inflorescence,leaf,lenticellate,lighter,lobe,lobed,minor,minutely,mm,nearly,new,opposite,ovary,ovate,overlapping,papillose,pedicel,petiole,pore,poricidal,scar,shaped,shrub,size,slender,slightly,spaced,stem,stigma,style,tapering,tear-drop,tip,tree,tube,weak,white,woody,x	.4,.5,10-50-flowered,2-2.5,3,accrescent,black,branched,ca,caly,dia,differing,difoliate,divisio,drying,eaf,early,edicel,eed,exserted,free,fruiting,geminat,glabrou,immature,known,lateral,lon,long,lower,main,major,middle,nflorescence,pair,papillo,planar,portion,produced,prominent,proximal,quite,raised,reddish-brown,ruit,straight,tall,ud,unit,usually,variable,vein,widest,wood,ympodial	0.5,1,10-50,7.5,alternate,arrangement,bark,bud,coat,colour,connation,decurrency,embryo,feature,form,height,history,length,life,midpoint,na,number,papilla,plant,prickle,ray,reproduction,seed,shape,spacing,specimen,surface,texture,tuberculation,type,width,winging,young	0.5-1.5,0.8-3.5,0.9-1.2,1-1.5,1-3.5,1.1-1.3,1.5,1.5-4,1.5-6,2.2-9,2.5-7.8,9.5-22.5,?,acute,age,apiculate,attenuate,base,becoming,berry,calyx,capitate,closely,cm,completely,dark,deflexed,deltoid,elliptic,erect,furcate,glabrous,globose,green,leaf,lenticellate,lighter,lobed,minutely,mm,nearly,opposite,ovate,overlapping,papillose,poricidal,shaped,shrub,slender,slightly,spaced,tapering,tear-drop,tip,tree,tube,weak,white,woody,x	0.5,1,10-50,7.5,alternate,na
336	wfo-0001029744	success	113	89	57	70	43	19	56	1	0.3-0.6,1,1.5,1.5-3.2,2,2-4,5-8,50,7-15,8-10-flowered,acute,apart,apex,bark,base,blunt,branch,calyx,cm,deltate,dendritic,densely,elliptic,entire,extreme,flattened,flexuous,form,glabrescent,glabrous,golden,incrassate,lanceolate,leaf,long-acuminate,major,margin,minor,minutely,mm,narrowly,oblanceolate,oblique,older,opposite,ovoid-reniform,pale,pedicel,petiole,pitted,pubescent,revolute,scar,shape,shrub,similar,simple,single-celled,slightly,smaller,sometimes,somewhat,stem,surface,thin,tip,trichome,uniseriate,x,young	0.5-1,8-11,abaxially,adaxially,along,beginning,brow,denser,difoliate,distinct,eaf,eed,examined,fide,fruit,geminate,inflorescenc,lamina,leave,lobe,looping,lower,marginal,mature,nflorescence,node,non-reproductive,occasionally,pair,primary,pubescence,see,small,smith,spaced,thee,ud,unicellular,unifoliate,unit,vein,white,ympodial	abaxial,adaxial,arrangement,brown,colour,feature,flower,growth,hair,height,inflorescence,length,number,plant,seed,size,spacing,texture,type	0.3-0.6,1,1.5,1.5-3.2,2,2-4,5-8,50,7-15,8-10-flowered,acute,apart,blunt,branch,cm,deltate,dendritic,densely,elliptic,entire,extreme,flattened,flexuous,glabrescent,glabrous,golden,incrassate,lanceolate,leaf,long-acuminate,major,minutely,mm,narrowly,oblanceolate,oblique,opposite,ovoid-reniform,pale,pitted,pubescent,revolute,shape,shrub,similar,simple,single-celled,slightly,smaller,sometimes,somewhat,thin,tip,trichome,uniseriate,x	brown
337	wfo-0001029746	success	179	137	103	117	62	20	102	1	.5,0.7-1,1,1-1.3,1-1.5,1.2-1.5,1.5,2-2.5,2-4,2-7,2-8,3,3-4,3-6,4-9,acuminate,acute,age,anther,anthesi,apex,base,bearing,berry,blackish,broadly,calyx,capitate,cell,centre,ciliate,cm,color,cordate,corolla,cup-shaped,curved,darker,densely,diameter,ellipsoid,enlarged,entire,erect,exerted,filament,flattened,fleshy,flower,fruit,fruiting,glabrous,gland-tipped,glandular,globose,greenish,herb,heteromorphic,hollow,horn,inflorescence,internodal,lamina,leaf,lengthening,less,lobe,long,margin,mature,minutely,mm,nodding,occasionally,orange,ovary,ovate,ovoid,pale,papillose,pedicel,petiole,pitted,pore,poricidal,principal,pubescent,purple,red,reddish,reflexed,shallowly,simple,single,slender,slightly,slit,somewhat,spreading,stem,stigma,straight,strongly,style,subshrub,surface,testal,tip,triangular,trichome,tube,uniseriate,upward,vein,wall,x,â3	0.3-2,0.5-1,2,3-4-pluri-foliate,3-4.5,6,6-7,8-10,8-11,abaxially,adaxially,apart,becoming,brown,c.,conical,crenate,crowded,dark,eaf,edicel,eed,elliptic,flush,free,growing,irregularly,lon,longer,longest,lower,markedly,maturit,mid-length,mixed,narrowly,near,nflorescence,pair,papillo,peduncle,pericarp,plan,portion,primary,pubescen,rachi,ruit,scar,shortest,spaced,sparse,sparsely,thin,third,ud,unit,upper,widely,widest,woody,ympodial	abaxial,adaxial,arrangement,bud,colour,feature,form,growth,height,length,maturity,number,plant,position,seed,shape,size,texture,width,young	.5,0.7-1,1,1-1.3,1-1.5,1.2-1.5,1.5,2-2.5,2-4,2-7,2-8,3,3-4,3-6,4-9,acuminate,acute,age,anthesi,base,bearing,berry,blackish,broadly,calyx,capitate,cell,centre,ciliate,cm,color,cordate,cup-shaped,curved,darker,densely,diameter,ellipsoid,enlarged,entire,erect,exerted,flattened,fleshy,fruit,glabrous,gland-tipped,glandular,globose,greenish,herb,heteromorphic,hollow,horn,internodal,lamina,leaf,lengthening,less,lobe,long,margin,mature,minutely,mm,nodding,occasionally,orange,ovate,ovoid,pale,papillose,pitted,pore,poricidal,principal,pubescent,purple,red,reddish,reflexed,shallowly,simple,single,slender,slightly,slit,somewhat,spreading,straight,strongly,subshrub,testal,tip,triangular,trichome,uniseriate,upward,vein,wall,x,â3	maturity
338	wfo-0001029769	success	142	116	61	77	65	39	57	4	.25,.5,0.5-1.5,1-3,2.5-3,2.5-8,3.5-4,4-5,5-8,6-17,8.5-17,acuminate,acute,anther,anthesi,apex,bark,base,berry,brown,calyx,capitate,cm,conical,corolla,curl-tipped,cyathiform,dark,deflexed,deltoid,elliptic,filament,filiform,flower,glabrous,globose,golden,green,internodal,leaf,lobe,lobed,long,minutely,mm,nearly,opposite,ovary,ovoid-reniform,papillose,pedicel,petiole,pitted,pore,poricidal,puberulent,pubescent,scar,shaped,shrub,simple,smooth,somewhat,sparsely,stem,stigma,style,surface,swollen,tear-drop,tip,trichome,tube,white,woody,x,young	1-1.2,1.5-2,1.5-2.5,30-60-flowered,4,7-8,8-9,abaxially,adaxially,along,apar,ape,archin,ba,bearing,branch,brochidodromu,cerro,densely,dia,eaf,edicel,eed,exserted,free,fresh,fruiting,hen,horizontally,inglÃ©,lateral,less,like,lon,lower,main,margin,midrib,nflorescence,older,onto,pair,papillo,portion,reflexed,ried,ruit,scattered,spaced,straight,tall,three,time,tub,two,ud,unevenly,unifoliat,uniseriate,unit,vein,wide,widely,winged,ympodial	30-60,apart,arrangement,bud,coat,colour,connation,decurrency,dry,embryo,feature,form,fruit,growth,height,history,inflorescence,length,life,midpoint,minor,na,number,papilla,plant,prickle,ray,reproduction,seed,shape,size,spacing,specimen,texture,tuberculation,type,unifoliate,width,winging	.25,.5,0.5-1.5,1-3,2.5-3,2.5-8,3.5-4,4-5,5-8,6-17,8.5-17,acuminate,acute,base,berry,brown,capitate,cm,conical,curl-tipped,cyathiform,dark,deflexed,deltoid,elliptic,filiform,glabrous,globose,golden,green,internodal,leaf,lobed,long,minutely,mm,nearly,opposite,ovoid-reniform,papillose,pitted,poricidal,puberulent,pubescent,shaped,shrub,simple,smooth,somewhat,sparsely,swollen,tear-drop,tip,trichome,white,woody,x	30-60,apart,na,unifoliate
339	wfo-0001029780	success	204	153	116	128	76	25	112	4	1-1.2,1-10,1-2,1.5-2,11-24,15-22,15-45,2-12,2-2.8,2-3.5,2-5.5,20-60,3,3.5-7.3,4.5-6,5-7,5.5-13,50-70,600-950,8-12,?,abaxially,absent,acumen,acute,adaxially,anther,apart,apex,attenuate,axillary,base,berry,borne,bud,cell,cm,connivent,cordate,corolla,covering,cuneate,dark,densely,diameter,distal,end,flower,forked,fruit,generally,glabrous,gland,glandular,globose,green,green-white,hair,hair-like,half,head,herb,homostylous,interjected,invested,lanceolate,lateral,leaflet,length,lengthening,like,lobe,long,longer,make,minute,mm,mucilaginous,non-glandular,obtuse,odd-pinnate,orbicular,ovate,ovoid,pale,pedicel,peduncle,petiole,petiolulate,petiolule,pinkish,plant,poricidal,pubescent,rarely,ripe,rotate,seed,sessile,short,singly,size,slit,stem,stigma,straight,streak,stripe,style,subtending,terminal,testal,tetralobulate,thick,throughout,tip,trichome,truncate,tube,tuber,typically,unwinged,usually,wall,wet,white,x,yellow	1.4-1.9,120-210,2-2.5,2.4-4.2,3-6,4-6,5-merou,5.5,ag,along,alyx,apparently,articulated,axe,blade,brownish,capitat,chartaceous,ciliate,condition,decumbent,digestion,dorsally,drying,eaf,edge,eed,enzyme,erec,especially,exceeding,except,filament,flat,folded,fresh,geminat,glabrou,greatly,greenish,hal,high,honeycomb-shaped,living,lower,margin,membranous,midrib,minutely,nflorescence,often,orolla,pair,perfect,plurifoliate,pore,proximal,puberulent,reduced,removed,ruit,seudostipule,spaced,specimen,stamen,ste,stolo,subequal,tall,tamen,tem,tri-,unit,vary,whitish,ympodial	age,arrangement,calyx,capitate,colour,feature,form,growth,height,history,inflorescence,leaf,life,na,number,ovary,presence,pseudostipule,reproduction,shape,spacing,stolon,surface,texture,young	1-1.2,1-10,1-2,1.5-2,11-24,15-22,15-45,2-12,2-2.8,2-3.5,2-5.5,20-60,3,3.5-7.3,4.5-6,5-7,5.5-13,50-70,600-950,8-12,?,abaxially,absent,acumen,acute,adaxially,apart,attenuate,axillary,berry,borne,bud,cell,cm,connivent,cordate,covering,cuneate,dark,densely,diameter,distal,end,flower,forked,generally,glabrous,gland,glandular,globose,green,green-white,hair,hair-like,half,head,herb,homostylous,invested,lanceolate,lateral,length,lengthening,like,long,longer,make,minute,mm,mucilaginous,non-glandular,obtuse,odd-pinnate,orbicular,ovate,ovoid,pale,petiolulate,petiolule,pinkish,plant,poricidal,pubescent,rarely,ripe,rotate,seed,sessile,short,singly,slit,stem,straight,streak,stripe,subtending,terminal,testal,tetralobulate,thick,throughout,tip,trichome,truncate,typically,unwinged,usually,wall,wet,white,x,yellow	age,capitate,na,stolon
340	wfo-0001029784	success	229	111	51	69	160	42	47	4	0.3-0.4,0.4-0.45,0.5,0.5-1.5,0.6-1,1-1.1,1.5-3-5,1.7-2.6,2,2-2.5-5,2-5-14,3-5-8,5-10-12,abaxial,acuminate,acute,anther,anthesi,apex,articulated,base,basicopically,berry,broadly,calyx,capitate,cm,conical,corolla,dark,densely,diameter,elliptic,filament,flower,fruit,globose,golden,green,herb,imparipinnate,inflorescence,interrupted,lanceolate,lobe,mm,obovate,orbicular,ovary,pale,pedicel,pentagonal,perennial,petiole,plant,pubescent,simple,soft,sparsely,stem,stigma,stripe,style,surface,trailing,truncate,tube,velvety,yellow	.1,.2,.5,0-4,0.1-0.15,0.1-0.2-0.3,0.1-0.5,0.2,0.2-0.3,0.2-0.5,0.2-0.7-1.2,0.25-0.3,0.3-0.35,0.3-0.5,0.3-1,0.4-0.5,0.4-0.6,0.4-1-2,0.5-1.2-2.5,0.9-1.2,1,1-1.2,1-1.5,1-2,1-2-4.5,1-2-celled,1-2.5-3.5,1-4,1.0-1.3,1/3,2-3-celled,2-4,2-foliate,2-locular,2/3,abaxially,absent,abundant,adaxially,adpressed,along,angled,apical,appearance,appendage,arising,articulation,axi,basal,beneath,bract,brown,cell,column,crenate-serrate,crenation,decurrent,deeper,developed,distal,distributed,due,eaf,edicel,eed,eglandular,enclosing,entire,evenly,exserted,fruiting,giving,glabrescent,glabrous,glandular,gree,hair-like,hal,half,halfway,head,included,interjected,internode,interspersed,irregularly,lamina,larger,lateral,leaflet,like,live,lon,long,long-acuminate,loosely,lower,margin,markedly,maturing,mostly,multicellular,narrowly,nflorescence,node,northern,occasionally,often,outgrowth,pair,paler,patent,peduncle,petiolule,population,present,primary,proximal,pseudostipule,pubescence,rarely,reflexed,ripe,robust,ruit,scattered,secondary,sessile,silky,smaller,sometimes,somewhat,sparse,spreadin,staminal,sterile,stout,straight,strongly,tem,terminal,tertiary,testa,thick,trichome,ud,undulate,unicellular,uniseriate,unit,unseriate,usually,vein,wall,white,wide,winged,woody,x,ympodial	0.1,0.1-0.3,adaxial,alternate,arrangement,bud,coat,colour,connation,decurrency,dry,embryo,feature,form,growth,hair,height,history,leaf,length,life,midpoint,minor,na,number,papilla,pore,prickle,ray,reproduction,seed,shape,size,spacing,specimen,texture,tip,tuberculation,type,width,winging,young	0.3-0.4,0.4-0.45,0.5,0.5-1.5,0.6-1,1-1.1,1.5-3-5,1.7-2.6,2,2-2.5-5,2-5-14,3-5-8,5-10-12,acuminate,acute,articulated,basicopically,berry,broadly,capitate,cm,conical,dark,densely,elliptic,globose,golden,green,herb,imparipinnate,interrupted,lanceolate,mm,obovate,orbicular,pale,pentagonal,perennial,pubescent,simple,soft,sparsely,stripe,trailing,truncate,velvety,yellow	0.1,0.1-0.3,alternate,na
341	wfo-0001029785	success	223	136	98	112	111	24	95	3	0-2,0-3,0.1-0.5,0.8-1,1-1.2,1-10,1-2,1.2-3.2,1.5-3.6,1.8-3.5,1.8-7,10-26,2-4,3-6,3-8,3.8-7.2,4-10.5,5-16,5-9,6,8-11,abaxially,absent,acute,adaxially,along,anther,apart,attenuate,axillary,broadly,bud,cell,chartaceous,clavate,cm,commonly,connivent,corolla,covering,dark,darker,denser,diameter,elliptic,filament,flower,fruit,glabrous,globose,green,hair,hair-like,herb,interjected,invested,lanceolate,lateral,leaf,leaflet,long,make,margin,membranous,minute,mm,mottled,mucilaginous,multiple-celled,non-glandular,obovate,odd-pinnate,outer,ovate,ovoid,pair,pedicel,peduncle,pentagonal,petiole,plant,pore,poricidal,pubescent,purple,purple-tinged,ripe,rotate,rounded,scale-like,seed,short,size,slightly,sparsely,stem,stigma,style,subglabrous,subtending,terminal,testal,thick,tip,unbranched,unwinged,vein,violet,wall,wet,wide,x	0.3-2.2,0.4-4.9,1-5,3-4,3.5-5,5-merou,acumen,ag,alyx,apex,apparently,articulation,axe,base,berry,blade,borne,brownish,capitat,condition,cordate,cuneate,decreasing,decumbent,digestion,distal,dorsally,drying,eaf,edge,eed,end,enzyme,erec,especially,exceeding,flat,folded,forked,fresh,geminat,generally,glabrou,greatly,green-white,greenish,half,homostylous,honeycomb-shaped,larger,lengthening,like,living,lobe,lower,markedly,medium,middle,midrib,minutely,much,nflorescence,oblique,obtuse,one-quarte,orbicular,orolla,pale,perfect,petiolulate,petiolule,plurifoliate,point,present,puberulent,quite,rarely,removed,ruit,sessile,seudostipule,shallowly,singly,slit,sometimes,spaced,specimen,stamen,ste,stolo,straight,stripe,tall,tamen,tem,throughout,toward,tri-,truncate,tube,tuber,typically,unequal,unit,usually,variable,vary,white,whitish,yellow,ympodial	arrangement,calyx,capitate,colour,connation,feature,form,growth,height,history,inflorescence,length,life,na,number,ovary,perennial,pseudostipule,reproduction,shape,spacing,staman,surface,texture	0-2,0-3,0.1-0.5,0.8-1,1-1.2,1-10,1-2,1.2-3.2,1.5-3.6,1.8-3.5,1.8-7,10-26,2-4,3-6,3-8,3.8-7.2,4-10.5,5-16,5-9,6,8-11,abaxially,absent,acute,adaxially,along,apart,attenuate,axillary,broadly,bud,cell,chartaceous,clavate,cm,commonly,connivent,corolla,covering,dark,darker,denser,elliptic,glabrous,globose,green,hair,hair-like,herb,invested,lanceolate,lateral,long,make,margin,membranous,minute,mm,mottled,mucilaginous,multiple-celled,non-glandular,obovate,odd-pinnate,outer,ovate,ovoid,pentagonal,poricidal,pubescent,purple,purple-tinged,ripe,rotate,rounded,scale-like,seed,short,slightly,sparsely,stem,subglabrous,subtending,terminal,testal,thick,tip,unbranched,unwinged,vein,violet,wall,wet,wide,x	capitate,na,perennial
342	wfo-0001029789	success	167	99	54	74	93	25	52	2	0-2,0.2-0.5,0.5-2.8,0.8-3.5,1-10,1-2,1-3,1.7-8.5,1.8-6.5,12,2-25,2-6,2-6.5,2.7-4.7,3-8.5,4-10,4-13,5-7,6-7,7-16.6,7-21,8-9,anther,axillary,blade,blue,bud,chartaceous,clavate,cm,connivent,corolla,diameter,filament,flower,fruit,glabrous,green,herb,interjected,lanceolate,lateral,leaf,leaflet,light,lilac,membranous,minute,mm,odd-pinnate,orbicular,ovary,ovate,pedicel,peduncle,pentagonal,petiole,plant,pore,poricidal,pubescent,rachi,rotate,size,sparsely,stigma,style,subglabrous,subtending,terminal,tip,tube,white,x	1.5-2,2-3,3-5,5-merou,6,abaxially,acumen,acuminate,acute,adaxiall,adaxially,ag,alyx,apart,apex,apparently,articulated,attenuate,axe,base,basiscopic,broadly,capitat,dark,decreasing,decurrent,distal,dorsally,eaf,edge,eed,erec,exceeding,flat,folded,forked,formed,geminat,generally,greatly,hair,hal,half,homostylous,lant,lengthening,like,linear,lobe,long,long-attenuate,lower,lunate,maturing,minutely,mottled,narrowly,never,nflorescence,orolla,pair,perfect,petiolulate,plurifoliate,pubescen,purpl,rarely,sessile,seudostipule,short,side,simple,slightly,slit,spaced,stamen,star,ste,sterile,straight,subequal,tall,tamen,tem,tinged,toward,tri-,typically,unit,usually,vary,yellow,ympodial	abaxial,adaxial,arrangement,calyx,capitate,colour,connation,feature,form,growth,height,inflorescence,length,na,number,pseudostipule,seed,shape,spacing,staman,stem,surface,texture,type,width	0-2,0.2-0.5,0.5-2.8,0.8-3.5,1-10,1-2,1-3,1.7-8.5,1.8-6.5,12,2-25,2-6,2-6.5,2.7-4.7,3-8.5,4-10,4-13,5-7,6-7,7-16.6,7-21,8-9,axillary,blue,bud,chartaceous,clavate,cm,connivent,glabrous,green,herb,lanceolate,light,lilac,membranous,minute,mm,odd-pinnate,orbicular,ovate,pentagonal,poricidal,pubescent,rotate,sparsely,subglabrous,subtending,terminal,tip,white,x	capitate,na
343	wfo-0001029810	success	149	136	83	98	51	38	79	4	.25,.5,0.5-1,0.5-3,1-1.5,1-10,1-2,1-3,1.1-2.3,1.5-3,2.5-3,3-4,3-6,4-10,5-16,5-6,acuminate,acute,anther,anthesi,apex,apically,arachnoid,attenuate,bark,base,berry,brown,calyx,capitate,closely,cm,compact,compressed,conical,corolla,dark,deflexed,deltate,dendritic,densely,dia,ellipsoid,elliptic,filament,fleshy,glabrous,globose,green,inflorescence,internodal,large,later,leaf,lenticel,less,lobe,lobed,long,minor,minutely,mm,narrowly,nearly,occasionally,opposite,ovary,ovoid-reniform,papillose,pedicel,petiole,pitted,pointed,pore,poricidal,pubescent,scar,shaped,shrub,simple,size,slender,small,spaced,stem,stigma,style,surface,tapering,tear-drop,tip,tree,trichome,tube,white,wide,woody,young	1-1.3,2-3,2-5,3-3.5,5-15-flowered,8-12,abaxially,adaxially,along,ape,congested,differing,difoliate,drying,eaf,edicel,eed,exserted,free,fruiting,geminat,glabrou,lateral,like,lon,lower,main,major,margin,middle,nflorescence,older,overlappin,pale,papillo,planar,portion,reddish-brown,rest,ruit,shining,sparsely,tall,tan,tub,ud,unit,vein,widest,yellowish,ympodial	5-15,alternate,arrangement,bud,coat,colour,connation,decurrency,dry,embryo,feature,flower,form,fruit,growth,height,history,length,life,midpoint,na,new,number,overlapping,papilla,plant,prickle,ray,reproduction,seed,shape,spacing,specimen,texture,tuberculation,type,width,winging	.25,.5,0.5-1,0.5-3,1-1.5,1-10,1-2,1-3,1.1-2.3,1.5-3,2.5-3,3-4,3-6,4-10,5-16,5-6,acuminate,acute,apically,arachnoid,attenuate,base,berry,brown,calyx,capitate,closely,cm,compact,compressed,conical,dark,deflexed,deltate,dendritic,densely,dia,ellipsoid,elliptic,fleshy,glabrous,globose,green,internodal,large,later,leaf,lenticel,less,lobed,long,minutely,mm,narrowly,nearly,occasionally,opposite,ovoid-reniform,papillose,pitted,pointed,poricidal,pubescent,shaped,shrub,simple,slender,small,spaced,tapering,tear-drop,tip,tree,trichome,tube,white,wide,woody,young	5-15,alternate,na,overlapping
344	wfo-0001029811	success	224	133	77	96	128	37	75	2	-3,0.1-0.4,0.3-1,0.3-1.5,0.5-2,1,1.3-1.7,1.5-2.5,1.5-6,1/2-2/3,1/3,2.5-3,2.8-3.2,3-5.5,3-7,5-11,5-9,6-12,8-12,8-18,acicular,andromonoecious,anther,apart,apex,apically,base,berry,broad-deltate,brown,calyx,cell,cm,connivent,cordate,cuneate,dark,densely,erect,filament,flattened,flattened-reniform,flower,fruit,glabrous,glandular,hair,herb,lateral,leaf,length,less,lobe,lobed,maturity,mauve,midpoint,mm,moderately,narrow-deltate,obtuse,outline,ovate,pedicel,petiole,pit,plant,poricidal,prickle,prickly,raised,ray,scandent,scar,shrub,simple,small,smooth,sometimes,spaced,spherical,spreading,stellate-pubescent,stem,straight,style,surface,tapering,tip,tube,unbranched,upper,usually,way,yellow,young	-merous,.5,/3,0,0-30,0-35,0.1-0.3,0.2,0.2-0.6,0.8-1.5,1-1.5,1-2.5,1-3,1/,1/3-2/3,10-22,13-20,15-23,15-50,2-2.5,2-5,2-5.5,20-100,3-5,3.5-4.5,4-8,4.5-5,5-17,5-40,5-6,7-18,7-9,abaxial,abaxially,adaxial,alyx,apar,apparently,articulated,bark,blade,chartaceous,cream,diameter,discolorous,distal,distance,drying,eaf,eed,elongate,elongating,equal,extending,eye,faint,fewer,free,fruiting,green,green-brow,hermaphrodite,heterostylous,inflated,infructescence,lobing,long,long-acuminat,long-styled,longer,lower,lowermost,margin,marking,mature,midvein,minute,multangulate,naked,nflorescence,often,older,one,open,orange-brown,orolla,oung,pair,pale,peduncle,pendulous,per,pericarp,perpendicular,plurifoliat,porrect,portion,prickl,primary,ruit,secondary,sessile,short,short-styled,shorter,side,slightly,sparsely,stalk,stalked,staminat,stellate,stout,tamen,terete,tertiary,time,trichome,unarmed,unit,vary,vein,venation,visible,wide,woody,yellow-green,ympodial	anthesi,arrangement,bud,coat,colour,connation,corolla,decurrency,dry,embryo,feature,form,growth,height,history,inflorescence,life,long-acuminate,minor,na,new,number,ovary,papilla,pore,reproduction,seed,shape,size,spacing,specimen,stigma,texture,tuberculation,type,width,winging	-3,0.1-0.4,0.3-1,0.3-1.5,0.5-2,1,1.3-1.7,1.5-2.5,1.5-6,1/2-2/3,1/3,2.5-3,2.8-3.2,3-5.5,3-7,5-11,5-9,6-12,8-12,8-18,acicular,andromonoecious,apart,apically,base,berry,broad-deltate,brown,cell,cm,connivent,cordate,cuneate,dark,densely,erect,flattened,flattened-reniform,glabrous,glandular,hair,herb,lateral,less,lobed,maturity,mauve,mm,moderately,narrow-deltate,obtuse,outline,ovate,pit,poricidal,prickly,raised,scandent,shrub,simple,small,smooth,sometimes,spaced,spherical,spreading,stellate-pubescent,straight,tapering,tip,unbranched,upper,usually,way,yellow	long-acuminate,na
345	wfo-0001029978	success	208	121	64	83	125	38	61	3	0.5-0.6,1-10,1-2,1.3-1.5,1.4-1.5,1.5-3.1,11-19,15-27,3-5,3-7,3.5-9.5,4-7,5-16.5,8-10,acuminate,anther,apart,apex,attenuate,axillary,base,berry,bud,cell,clavate,cm,coarsely,conical,connivent,corolla,covering,diameter,elliptic,filament,finely,flower,fruit,glabrous,green,hair,hair-like,herb,lanceolate,lateral,leaf,lengthening,light,lobe,long,mm,mottled,odd-pinnate,ovate,ovoid,pedicel,pentagonal,petiole,plant,pore,poricidal,pubescent,purple,ray,ripe,rotate,seed,simple,size,slit,sparsely,specimen,stem,stigma,style,subsessile,subtending,terminal,testal,thick,tip,tube,wall,whitish	0.3-0.4,0.3-0.7,0.7-1.9,0.8,0.9-2.3,1.8-5,2-4,3.1-6.3,3.2-2.5,3.7-8.1,4-11,4.2-5.2,5,5-merou,abaxially,acumen,adaxially,ag,along,alyx,apparently,arranged,articulated,asymmetrical,axe,basiscopic,bead,blade,brownish,capitat,chartaceous,ciliate,commonly,condition,dark,darker,decreasing,digestion,distal,dorsally,drying,eaf,edge,eed,enzyme,erec,especially,exceeding,flat,folded,forked,fourt,fresh,geminat,generally,glabrou,gradually,green-white,greenish,half,homostylous,honeycomb-shaped,interjected,larger,leaflet,less,like,living,lower,make,margin,medium,membranous,middle,midrib,minute,minutely,moniliform,mucilaginous,multiple,narrow,necklace,nflorescence,orbicular,orolla,pair,peduncle,perfect,petiolule,plurifoliate,puberulent,pubescen,removed,ruit,secondary,semierect,sessile,seudostipule,side,slightly,spaced,stamen,ste,stolon,straight,subequal,symmetrical,tall,tamen,tem,throughout,tissue,toward,tri-,tuber,typically,unit,usually,vary,wet,wide,wing,x,yellow,ympodial	age,anthesi,arrangement,calyx,capitate,coat,colour,connation,decurrency,dry,embryo,feature,form,growth,height,history,inflorescence,length,life,midpoint,minor,na,new,number,ovary,papilla,prickle,reproduction,scar,shape,spacing,surface,texture,tuberculation,type,width,winging,young	0.5-0.6,1-10,1-2,1.3-1.5,1.4-1.5,1.5-3.1,11-19,15-27,3-5,3-7,3.5-9.5,4-7,5-16.5,8-10,acuminate,apart,attenuate,axillary,berry,bud,cell,clavate,cm,coarsely,conical,connivent,covering,elliptic,finely,glabrous,green,hair,hair-like,herb,lanceolate,lateral,lengthening,light,long,mm,mottled,odd-pinnate,ovate,ovoid,pentagonal,poricidal,pubescent,purple,ripe,rotate,simple,slit,sparsely,subsessile,subtending,terminal,testal,thick,tip,wall,whitish	age,capitate,na
346	wfo-0001029980	success	173	138	88	106	67	32	85	3	.1,.5,0.1-0.25,0.25-0.5,0.25-1,0.5-2.5,0.5-5,0.7-1.3,0.8-1.2,0.9-4.5,1-1.5,1.5-2,1.5-6,2-5,2-6,2/3,3-4,3-9,6.4-17,acute,anther,anthesi,apex,appressed,bark,base,berry,black,bright,brown,bud,calyx,cm,corolla,curved,dark,decurrent,deflexed,deltoid,elliptic,filament,flattened-reniform,glabrous,globose,gray,green,greenish-white,knob,leaf,live,lobe,lobed,long,minor,minutely,mm,near,node,one,onto,opposite,orbicular,ovary,ovate,pale,papillose,pedicel,petiole,pitted,plant,pore,poricidal,puberulent,rounded,scar,shape,shaped,shiny,shrub,side,simple,size,slender,slightly,small-capitate,somewhat,specimen,stem,stigma,straight,style,surface,tapering,tear-drop,tip,trichome,tube,tuft,unicellular,uniseriate,way,white,winged,woody,x,young	0.5-1,0.5-1.2,1-1.7,1.2-2.5,5-10,5-50-flowered,abaxially,adaxially,apar,appearing,axil,ba,closely,conical,density,dia,differing,difoliate,dried,drying,eaf,edicel,eed,elevation,especially,exserted,five,free,fruiting,geminat,greatly,high,impressed,incrassate,lateral,lon,lower,main,major,margin,material,middle,nflorescence,often,older,overlapping,pair,paler,portion,prominent,proximal,race,reflexed,ruit,soon,spaced,tall,tan,ud,unit,varying,vein,venezuelan,whit,widest,yellowish,ympodial	5-50,apart,arrangement,coat,colour,connation,decurrency,dry,feature,flower,form,fruit,growth,height,history,inflorescence,length,life,midpoint,na,number,papilla,prickle,ray,reproduction,seed,spacing,texture,tuberculation,type,width,winging	.1,.5,0.1-0.25,0.25-0.5,0.25-1,0.5-2.5,0.5-5,0.7-1.3,0.8-1.2,0.9-4.5,1-1.5,1.5-2,1.5-6,2-5,2-6,2/3,3-4,3-9,6.4-17,acute,appressed,base,berry,black,bright,brown,calyx,cm,curved,dark,decurrent,deflexed,deltoid,elliptic,flattened-reniform,glabrous,globose,gray,green,greenish-white,knob,leaf,live,lobed,long,minutely,mm,near,node,one,onto,opposite,orbicular,ovate,pale,papillose,petiole,pitted,plant,poricidal,puberulent,rounded,shaped,shiny,shrub,side,simple,slender,slightly,small-capitate,somewhat,straight,tapering,tear-drop,tip,trichome,tube,tuft,unicellular,uniseriate,way,white,winged,woody,x	5-50,apart,na
347	wfo-0001029989	success	161	117	59	75	86	42	53	6	0.5-1,0.5-1.5,1-2.5,1-4,1.3-2.3,3-8,3.5-8,4-4.5,7-20,acute,anther,anthesi,apex,bark,base,berry,broadly,calyx,capitate,closely,cm,conical,corolla,deflexed,deltoid,dendritic,difoliate,elliptic,erect,filament,flattened,glabrous,globose,golden,gray,green,greenish-black,inflorescence,internodal,leaf,lenticular,lobe,lobed,minutely,mm,nodding,occasionally,opposite,ovary,pedicel,petiole,pitted,pore,poricidal,pubescent,scar,shaped,shrub,simple,small,somewhat,spaced,stem,stigma,style,surface,tear-drop,tip,tree,trichome,tube,unifoliate,white,woody,young	.2,.5,/2,0.25-0.5,1-1.5,1-2,1.5-2.5,10-14,2.5-3,3-5,5-10-flowered,5-6,abaxial,abaxially,adaxially,branch,branched,brownish-re,central,collection,congested,dense,densely,described,dia,dimaeter,discussion,drying,due,eaf,edicel,eed,exserted,fleshy,free,fruiting,geminat,heteromorphic,incrassate,inflorescenc,lamina,lateral,like,lon,long,lower,main,margin,middle,nearly,nflorescence,northern,older,overlappin,pair,papillo,peru,peruvian,perÃº,petal,petaloid,planar,population,portion,probably,pubescence,reddish,reddish-brown,rest,ruit,scattered,see,shining,short-style,sparsely,tall,tree-like,ud,unit,vein,way,wide,widest,x,yellow,ympodial	0.2,2.5-6,5-10,arrangement,brownish-red,bud,coat,colour,connation,decurrency,dry,embryo,feature,flower,form,fruit,growth,height,history,length,life,midpoint,minor,na,new,number,papilla,papillose,plant,prickle,ray,reproduction,seed,shape,size,spacing,specimen,texture,tuberculation,type,width,winging	0.5-1,0.5-1.5,1-2.5,1-4,1.3-2.3,3-8,3.5-8,4-4.5,7-20,acute,berry,broadly,capitate,closely,cm,conical,deflexed,deltoid,dendritic,difoliate,elliptic,erect,flattened,glabrous,globose,golden,gray,green,greenish-black,internodal,leaf,lenticular,lobed,minutely,mm,nodding,occasionally,opposite,pitted,poricidal,pubescent,shaped,shrub,simple,small,somewhat,spaced,tear-drop,tree,trichome,unifoliate,white,woody	0.2,2.5-6,5-10,brownish-red,na,papillose
348	wfo-0001030000	success	146	112	77	84	62	28	72	5	-4,0.5-1,1-10,1-2,1.5-2,15-25,2-2.5,2-3,2-4,2-5,25-30-50,3-4,3.5-5,4-5,7-15,abaxially,acute,also,apart,apex,apiculate,base,calyx,cm,connective,cucullate,deltate,densely,dia,diameter,dilated,directed,distally,eglandular,ellipsoidal,equal,exceeding,flattened,flower,fruit,glabrous,globose,green,hair,immature,laterally,lobe,long,mature,mm,moderately,narrowly,oblong,obtuse,occasionally,orange,ovoid,pedicel,pilose,pore,puberulent,pubescent,radiu,shorter,shrub,slightly,small,sparsely,spotted,stigma,strongly,style,subcoriaceous,thecae,tip,tree,triangular,truncate,tube,umbrella-shaped,unbranched,white,x,yellow	-pilose,0.5-14,0.5-2-2.5,0.5-3,1,1-2.5-3,1.5-2.5-3.5,1.5-3-16,10-20,10-30-50,2.5-4-4.5-7,3-4-foliat,absent,adaxially,aggregate,ape,articulated,axe,biglandula,cell,chartaceous,ciliat,connivent,conspicuous,coriaceous,creamy-whit,eed,leaving,lon,lower,margin,nflorescence,nther,orolla,pedicellar,peduncle,perfect,produced,pubescen,purplish,rachi,rarely,remnant,ruit,scar,smal,spaced,stamen,stellate,stone,swelling,tal,tem,tinge,tomentose,ud,unit,vary,wide,yellow-brown,yellowish,ympodial	1.5-16,1.5-3.5,2.5-4.5-7,30-50,anther,arrangement,biglandular,bud,colour,corolla,direction,feature,form,growth,height,inflorescence,length,number,ovary,plant,seed,shape,size,spacing,stem,surface,texture,theca	-4,0.5-1,1-10,1-2,1.5-2,15-25,2-2.5,2-3,2-4,2-5,25-30-50,3-4,3.5-5,4-5,7-15,abaxially,acute,also,apart,apex,apiculate,base,cm,cucullate,deltate,densely,dia,dilated,directed,distally,eglandular,ellipsoidal,equal,exceeding,flattened,glabrous,globose,green,hair,immature,laterally,long,mature,mm,moderately,narrowly,oblong,obtuse,occasionally,orange,ovoid,pilose,puberulent,pubescent,shorter,shrub,slightly,small,sparsely,spotted,strongly,subcoriaceous,thecae,tip,tree,triangular,truncate,umbrella-shaped,unbranched,white,x,yellow	1.5-16,1.5-3.5,2.5-4.5-7,30-50,biglandular
349	wfo-0001030000	success	167	103	70	74	93	29	64	6	-4,0.5-1,0.5-13,1-10,15-25,2-3,25-30-50,3-4,3.5-5,4-5,abaxially,acuminate,acute,also,apart,apex,apiculate,basal,base,calyx,cm,cordate,cucullate,deltate,densely,dia,directed,distally,ellipsoidal,flattened,flower,fruit,glabrous,globose,green,immature,laterally,lobe,mature,mm,moderately,narrowly,oblique,oblong,obtuse,occasionally,often,orange,ovoid,pedicel,petiole,pilose,pore,puberulent,pubescent,shrub,simple,slightly,small,sparsely,spotted,stellate,stigma,style,tip,tree,triangular,truncate,tube,unbranched,white,x,yellow,yellowish	-pilose,0.5-1-5,0.5-14,0.5-2-2.5,0.5-3,1,1-1.5-2,1-2,1-2.5-3,1.5-2,1.5-2.5-3.5,1.5-3-16,10-20,10-30-50,2-2.5,2-4,2-4-25,2-5,2.5-4-4.5-7,3-4-foliat,3-5-25,7-15,absent,adaxially,aggregate,ape,articulated,axe,biglandula,blade,cell,chartaceous,ciliat,connective,connivent,conspicuous,coriaceous,creamy-whit,diameter,dilated,eaf,eed,eglandular,elliptic,entire,equal,exceeding,glabrescent,hair,leaving,lon,long,lower,margin,nflorescence,nther,orolla,ovate,pedicellar,peduncle,perfect,pilo,produced,pubescen,purplish,rachi,radiu,rarely,remnant,ruit,scar,shorter,smal,spaced,stamen,stone,strongly,subcoriaceous,swelling,tal,tem,thecae,time,tinge,tomentose,ud,umbrella-shaped,unit,vary,vein,wide,yellow-brown,ympodial	1.5-16,1.5-3.5,2-25,2.5-4.5-7,30-50,anther,arrangement,biglandular,bud,colour,corolla,feature,form,growth,height,inflorescence,leaf,length,number,ovary,plant,seed,shape,size,spacing,stem,surface,texture,width	-4,0.5-1,0.5-13,1-10,15-25,2-3,25-30-50,3-4,3.5-5,4-5,abaxially,acuminate,acute,also,apart,apex,apiculate,basal,cm,cordate,cucullate,deltate,densely,dia,directed,distally,ellipsoidal,flattened,glabrous,globose,green,immature,laterally,lobe,mature,mm,moderately,narrowly,oblique,oblong,obtuse,occasionally,often,orange,ovoid,pilose,puberulent,pubescent,shrub,simple,slightly,small,sparsely,spotted,stellate,tip,tree,triangular,truncate,unbranched,white,x,yellow,yellowish	1.5-16,1.5-3.5,2-25,2.5-4.5-7,30-50,biglandular
350	wfo-0001030004	success	177	130	75	92	85	38	70	5	0-0.5,0-1.5,0.2-1,0.3-1,1-2,1.5-2.5,2-20,3-3.5,3.5-5,4-15,5-25,9-30,acuminate,acute,always,anther,anthesi,apex,bark,base,berry,broadly,calyx,capitate,cm,conical,corolla,decurrent,deltate,dendritic,elliptic,erect,filament,flattened-reniform,fleshy,glabrous,globose,green,inflorescence,knob,later,lateral,leaf,like,lobe,lobed,long,loose,minutely,mm,nearly,obovate,obovoid,often,onto,ovary,pale,pedicel,petiole,pitted,plant,plurifoliate,pore,poricidal,prominent,pubescent,scar,seed,sessile,shaped,shrub,small,stem,stigma,stout,style,surface,tear-drop,terminal,thick,tip,translucent,tree,trichome,tube,variously,white,wide,winged,woody,yellowish-green,young	.3,0.8-1.1,1-1.5,1.2-2,15,15-20,20-200-flowered,3-4,abaxial,abaxially,across,adaxially,along,apar,appearanc,axillary,barely,basal,blade,body,branched,branching,bushy,collection,cone,crotaloid,dense,densely,denser,dia,diamete,distal,drying,eaf,edicel,eed,especially,exserted,flat,free,fruiting,giving,greenish-yello,hard,incrassate,juvenile,lamina,large,lower,main,many,margin,middle,much,nflorescence,occasionally,older,pair,papillate,papillo,pericarp,planar,portion,possessing,pubescence,rest,ruit,simple,spaced,sparsely,strongly,surpassing,tall,tan,thin,time,tub,tuft,ud,unevenly,vein,widest,x,yellowish,ympodia	20-200,apart,arrangement,bud,coat,colour,connation,decurrency,dry,feature,flower,form,fruit,greenish-yellow,growth,height,history,length,life,midpoint,minor,na,new,number,papilla,papillose,prickle,ray,reproduction,shape,size,spacing,specimen,texture,tuberculation,type,width,winging	0-0.5,0-1.5,0.2-1,0.3-1,1-2,1.5-2.5,2-20,3-3.5,3.5-5,4-15,5-25,9-30,acuminate,acute,always,base,berry,broadly,capitate,cm,conical,decurrent,deltate,dendritic,elliptic,erect,flattened-reniform,fleshy,glabrous,globose,green,knob,later,lateral,leaf,like,lobed,long,loose,minutely,mm,nearly,obovate,obovoid,often,onto,pale,pitted,plurifoliate,poricidal,prominent,pubescent,sessile,shaped,shrub,small,stem,stout,tear-drop,terminal,thick,translucent,tree,trichome,variously,white,wide,winged,woody,yellowish-green	20-200,apart,greenish-yellow,na,papillose
351	wfo-0001030007	success	168	148	101	114	54	34	98	3	.05,.4,.5,0.1-0.5,0.2-1,0.5-1,0.8-1,1-1.5,1-15,1-2,1.5-5,1.6-2.2,15-20,2-4,2-7,3-5,3/4,6-10-flowered,7-10,7-9,abrupt,acuminate,acute,anther,anthesi,apart,apex,bark,base,berry,branched,broadly,brown,bud,calyx,campanulate,clavate,cm,corolla,decurrent,deltoid,densely,dia,dry,elliptic,filament,flattened,fleshy,glabrate,globose,golden,golden-pubescent,green,leaf,live,lobe,lobed,long,longer,major,material,minor,minutely,mm,oblique,occasionally,one,onto,opposite,outline,ovary,pale,papillose,pedicel,petiole,pitted,plant,pore,poricidal,pubescent,raised,reniform,rounded,scar,shaped,short,shrub,simple,slender,slightly,small,soft,sparsely,specimen,stem,stigma,style,surface,tapering,tear-drop,thick,tip,tree,trichome,tube,two,type,uniseriate,way,white,widening,winged,x,young	4.5-5,along,ba,becoming,beneath,closely,cork,dark,difoliate,edicel,eed,erect,exserted,free,fruiting,geminateleaf,glabrous,gre,hooded,impressed,incrassate,inflorescenc,lateral,like,lon,lower,main,margin,middle,midrib,nflorescence,obovoid,older,pair,papillo,planar,portion,prominent,rest,ruit,shorter,soon,spaced,straight,tall,thickened,trunk,tub,ud,unit,vein,widest,woody,ympodial	arrangement,coat,colour,connation,corky,decurrency,embryo,feature,flower,form,fruit,grey,growth,height,history,inflorescence,length,life,midpoint,na,new,number,papilla,prickle,ray,reproduction,seed,shape,size,spacing,texture,tuberculation,width,winging	.05,.4,.5,0.1-0.5,0.2-1,0.5-1,0.8-1,1-1.5,1-15,1-2,1.5-5,1.6-2.2,15-20,2-4,2-7,3-5,3/4,6-10-flowered,7-10,7-9,abrupt,acuminate,acute,apart,base,berry,branched,broadly,brown,calyx,campanulate,clavate,cm,decurrent,deltoid,densely,dia,dry,elliptic,flattened,fleshy,glabrate,globose,golden,golden-pubescent,green,leaf,live,lobed,long,longer,major,material,minutely,mm,oblique,occasionally,one,onto,opposite,outline,pale,papillose,petiole,pitted,plant,pore,poricidal,pubescent,raised,reniform,rounded,shaped,short,shrub,simple,slender,slightly,small,soft,sparsely,stem,tapering,tear-drop,thick,tip,tree,trichome,tube,two,type,uniseriate,way,white,widening,winged,x,young	corky,grey,na
352	wfo-0001030010	success	156	122	66	86	70	36	61	5	0.5-5,0.7-1,0.9-1.1,1-1.3,1-1.5,1-2,1.5-2,10-15,2-2.2,2-7,2.5,20-40,3-5,5-7,7-10,acuminate,acute,anther,anthesi,apex,area,attenuate,bark,base,berry,bud,calyx,closely,cm,corolla,cyathiform,deflexed,deltate,dry,filament,fleshy,fruit,furcate,glabrate,glabrous,globose,green,grey,leaf,lobe,long,minor,minutely,mm,nearly,obovate,opposite,ovary,ovoid-reniform,papillose,pedicel,petiole,pitted,pore,poricidal,puberulent,reddish,scar,shaped,shrub,simple,size,slightly,small,smooth,spaced,stem,stigma,style,surface,tear-drop,tiny,tip,tree,trichome,tube,white,winged,woody,x,young	.5,.75,/4,1.2-1.5,10-50-flowered,11-12,4-4.5,appearing,basal,beneath,brown,dark,deciduous,decurrent,dia,differing,difoliate,distal,eaf,edicel,eed,ellipsoid,exserted,f,free,fruiting,geminat,hooded,lateral,lobed,lon,lower,m.,main,major,margin,materia,material,middle,midrib,minute,near,nflorescence,occasionally,often,older,one,orange,overlappin,pair,persistent,planar,portion,prominent,rather,ruit,shin,soon,straight,styl,tall,tapering,trunk,ud,uniseriate,unit,vein,way,widest,ympodial	0.5,10-50,4,arrangement,coat,colour,connation,decurrency,feature,flower,form,growth,height,history,inflorescence,length,life,midpoint,na,new,number,papilla,plant,prickle,ray,reproduction,seed,shape,shiny,spacing,specimen,texture,tuberculation,type,width,winging	0.5-5,0.7-1,0.9-1.1,1-1.3,1-1.5,1-2,1.5-2,10-15,2-2.2,2-7,2.5,20-40,3-5,5-7,7-10,acuminate,acute,area,attenuate,berry,closely,cm,cyathiform,deflexed,deltate,fleshy,furcate,glabrate,glabrous,globose,green,grey,leaf,long,minutely,mm,nearly,obovate,opposite,ovoid-reniform,papillose,pitted,poricidal,puberulent,reddish,shaped,shrub,simple,slightly,small,smooth,spaced,tear-drop,tiny,tip,tree,trichome,white,winged,woody,x	0.5,10-50,4,na,shiny
353	wfo-0001030023	success	168	122	77	83	85	39	69	8	0.5-1,1-2,1-8,1.5-2,1.5-7,10-25,12-18,20-30,3-4.5,3-5,4,4-12,5,5-16,5-6,6-26,7-9,acute,adaxially,apex,apiculate,basal,base,branched,calyx,cm,connivent,cordate,cuneate,deeply,densely,directed,distally,ellipsoidal,entire,especially,finely,flattened,fleshy,flower,fruit,glabrous,glandular-puberulent,globose,greenish-white,hair,highly,lanceolate,lobe,long,loosely,margin,membranaceous,mm,moderately,narrowly,oblique,oblong,occasionally,often,pedicel,peduncle,peltiform,petiole,pore,puberulent,pubescent,purplish-,rachi,short-acuminate,simple,sparsely,stellate,stigma,style,tip,tree,triangular,truncate,tube,unknown,x,young	-,0-100+,1,1-4-10,10-30-50+,13-20,2,2-3,2.5-3.5,4-foliat,5-11-40+,6-7,abaxially,aggregate,apart,ape,articulated,axe,beyond,blade,capitat,cell,ciliate,color,connective,cylindrical,denser,diameter,dilated,eaf,eed,elliptic,exceeding,except,exserted,forked,glandular-puberulen,leaving,lon,lower,main,narrow,near,nflorescence,nther,obtuse,orolla,ovate,pedicellar,perfect,presen,present,probably,prominent,pubescen,pubescence,pubescent-pilo,radiu,remnant,ripe,ruit,shorter,slightly,small,somewhat,spaced,stamen,stone,subcoriaceous,swelling,tal,tem,thecae,time,ud,unbranched,unit,unknow,usually,vary,vein,villous,wide,yellowish,ympodial	1-10,11-40+,30-50+,50-100+,abaxial,adaxial,anther,arrangement,bud,capitate,colour,connation,corolla,feature,filament,form,growth,height,hermaphroditic,history,inflorescence,leaf,length,life,number,ovary,papilla,perennial,plant,pubescent-pilose,reproduction,seed,shape,size,spacing,stem,surface,texture,width	0.5-1,1-2,1-8,1.5-2,1.5-7,10-25,12-18,20-30,3-4.5,3-5,4,4-12,5,5-16,5-6,6-26,7-9,acute,adaxially,apex,apiculate,basal,branched,cm,connivent,cordate,cuneate,deeply,densely,directed,distally,ellipsoidal,entire,especially,finely,flattened,fleshy,glabrous,glandular-puberulent,globose,greenish-white,highly,lanceolate,lobe,long,loosely,membranaceous,mm,moderately,narrowly,oblique,oblong,occasionally,often,peltiform,puberulent,pubescent,purplish-,short-acuminate,simple,sparsely,stellate,tip,tree,triangular,truncate,unknown,x,young	1-10,11-40+,30-50+,50-100+,capitate,hermaphroditic,perennial,pubescent-pilose
354	wfo-0001030032	success	250	127	68	90	160	37	66	2	+,0.1-0.5,0.2,0.5-1,0.6-1.1,0.8-1.1,1-1.3,1-1.5,1.5-2,11-20,13-35,2-3-locular,2-60,2-lobed,30,4-5,4.3-5.0,8-10,8-20,absent,acuminate,acute,anther,anthesi,apex,articulated,base,basiscopically,bent,branched,bright,calyx,capitate,cm,completely,corolla,decurrent,deltate,densely,dry,elliptic,filament,flower,fruit,glabrous,golden,green,greenish-brown,hair-like,imparipinnate,interrupted,irregularly,leaf,length,lobe,many,mm,oblanceolate,obovate,occasionally,orbicular,outgrowth,ovary,pale,pedicel,petiole,pithy,pubescent,rotate,rotate-stellate,seed,slightly,somewhat,specimen,splitting,stem,stigma,straight,style,surface,time,tip,trichome,truncate,tube,uniseriate,vine,white,woody,yellow	.05,.5,0.1-0.4,0.2-0.3,0.2-0.5,0.25-0.4,0.4-1.5,0.5,0.5-0.6,0.5-0.7,0.5-1.5,0.5-2,0.7-0.8,0.8-1.0,1-2-celled,1-3,1-celled,1.5-2.5,2,2-10,2-3.5,2-4,2-5,2.4-3.5,3,3-5,3.0-3.5,3.5-12,4-6-celled,4-celled,5-plurifoliate,6-11,60-80,7-16,7.5-10,8-10-celled,abaxially,abundant,adaxial,adaxially,along,also,apical,appearance,appendage,articulation,basal,basally,border,branche,breaking,brown,cell,clambering,column,conical,conspicuou,dark,densest,desne,diameter,eaf,ebracteate,edicel,eed,entire,exserted,free,fruiting,give,glandular,gree,halfway,hea,head,herbarium,interjected,internode,lamina,large,larger,lateral,leaflet,leave,like,long,longest,lower,margin,markedly,middle,midvein,mixed,moderately,much,multicellular,nflorescence,node,oblique,often,older,onto,opposite,pair,paler,patent,peduncle,petiolule,present,primary,pseudostipule,pubescence,rachi,reflexed,rest,rough,round,ruit,secondary,set,shorter,silky,simple,smaller,soft,sometimes,sparsely,sparser,spreading,stamen,staminal,sterile,subopposite,swollen,tall,tangled,tem,terminal,tertiary,testa,thick,thickened,tiny,touch,transparent,ud,unicellular,unit,usually,vegetatio,vein,venation,wall,weaker-walled,well-developed,wide,winged,ympodial,younger,Â½-3/4	alternate,arrangement,bark,bud,coat,colour,connation,decurrency,embryo,feature,form,growth,height,history,inflorescence,life,midpoint,minor,na,new,number,papilla,plant,pore,prickle,ray,reproduction,scar,shape,size,spacing,texture,tuberculation,type,width,winging,young	+,0.1-0.5,0.2,0.5-1,0.6-1.1,0.8-1.1,1-1.3,1-1.5,1.5-2,11-20,13-35,2-3-locular,2-60,2-lobed,30,4-5,4.3-5.0,8-10,8-20,absent,acuminate,acute,articulated,basiscopically,bent,branched,bright,capitate,cm,completely,decurrent,deltate,densely,elliptic,glabrous,golden,green,greenish-brown,hair-like,imparipinnate,interrupted,irregularly,many,mm,oblanceolate,obovate,occasionally,orbicular,outgrowth,pale,pithy,pubescent,rotate,rotate-stellate,slightly,somewhat,splitting,straight,time,trichome,truncate,uniseriate,vine,white,woody,yellow	alternate,na
355	wfo-0001030048	success	156	131	80	92	64	39	75	5	.5,0.5-1.5,1-1.5,1-2,1.3-1.6,1.5-7,2-3,2-5,3-3.5,4-15,4-4.5,5-8,acute,anther,anthesi,apex,apically,arachnoid,bark,base,becoming,berry,bi-lobed,blue,broadly,brown,calyx,clavate,closely,cm,conical,corolla,decurrent,deflexed,deltate,densely,dia,ellipsoid,elliptic,felt-like,filament,fleshy,glabrate,glabrous,globose,golden,green,greyish,internodal,leaf,lightly,lobe,lobed,long,margin,minutely,mm,nearly,onto,opposite,ovary,ovoid-reniform,pale,papillose,pedicel,petiole,pitted,pointed,pore,poricidal,pubescent,scar,shaped,shrub,simple,small,somewhat,spaced,stem,stigma,style,surface,tear-drop,thickened,tip,tree,trichome,tube,white,wide,woody,young	1.2-2,1.5-3.5,10-16,3-5,5-10-flowered,5973,abaxial,abaxially,adaxially,along,ape,apparently,bi-colored,completely,covered,difoliate,drying,eaf,edicel,eed,exserted,fide,four-angle,free,fruiting,geminat,impressed,inflorescenc,lamina,lateral,like,lon,lower,main,matted,middle,nflorescence,occasionally,older,overlappin,pair,papillo,planar,portion,prominent,rather,reddish-brown,rest,ruit,shiny,solomon,sparsely,strongly,tall,tan,thick,trifoliate,tub,ud,unit,vein,widest,yellowish,ympodial	5-10,arrangement,bud,coat,colour,connation,decurrency,dry,embryo,feature,flower,form,four-angled,fruit,geminate,growth,height,history,inflorescence,length,life,midpoint,na,number,overlapping,papilla,plant,prickle,ray,reproduction,seed,shape,size,spacing,specimen,texture,tuberculation,type,width	.5,0.5-1.5,1-1.5,1-2,1.3-1.6,1.5-7,2-3,2-5,3-3.5,4-15,4-4.5,5-8,acute,anthesi,apically,arachnoid,base,becoming,berry,bi-lobed,blue,broadly,brown,clavate,closely,cm,conical,decurrent,deflexed,deltate,densely,dia,ellipsoid,elliptic,felt-like,fleshy,glabrate,glabrous,globose,golden,green,greyish,internodal,leaf,lightly,lobed,long,margin,minutely,mm,nearly,onto,opposite,ovoid-reniform,pale,papillose,petiole,pitted,pointed,poricidal,pubescent,shaped,shrub,simple,small,somewhat,spaced,tear-drop,thickened,tip,tree,trichome,white,wide,woody	5-10,four-angled,geminate,na,overlapping
356	wfo-0001030053	success	140	96	60	76	64	20	59	1	0.5-1,1-1.3,1-13,1.3-3.5,1.5-5.5,1.8-2,100,2-2.5,2.5-3,3.5-4,4-7-11,7-9,abruptly,acuminate,acute,apex,apical,base,branch,branched,brown,calyx,cm,completely,corolla,cyathiform,decurrent,diameter,elliptic,filiform,fine,flattened,flower,fragrant,glabrous,greenish,growth,inflorescence,irregularly,many,minutely,mm,near,nipple,pair,pale,parallel,pedicel,peduncle,petiole,pitted,primary,reniform,scar,secondary,shining,shiny,simple,slightly,spaced,stem,strongly,surface,terminal,time,tip,truncate,tube,turbinate,vein,venation,vine,white,woody,x,yellowish	0.5,10-20,5,5-merou,<,abscission,aiding,alyx,anthesi,apart,apiculae,ark,around,articulated,berry,bfeore,cell,climbin,coriaceous,eaf,eed,entire,exserted,far,fide,frui,fruiting,hyaline,leaving,lobe,lobed,long,lower,margin,mentz,new,nflorescence,older,orolla,papilla,papillo,peg,pendant,per,perfect,plurifoliat,rectangular,revolute,rim,shallowly,shin,sleeve,small,spreadin,spreading,support,tem,testal,tiny,twining,ud,unit,usually,ympodial	abaxial,adaxial,arrangement,bark,bud,colour,feature,form,leaf,length,number,papillose,seed,shape,size,spacing,texture,type,width,young	0.5-1,1-1.3,1-13,1.3-3.5,1.5-5.5,1.8-2,100,2-2.5,2.5-3,3.5-4,4-7-11,7-9,abruptly,acuminate,acute,apical,branch,branched,brown,cm,completely,cyathiform,decurrent,diameter,elliptic,filiform,fine,flattened,fragrant,glabrous,greenish,inflorescence,irregularly,many,minutely,mm,near,nipple,pair,pale,parallel,pitted,reniform,shining,shiny,simple,slightly,spaced,strongly,terminal,time,tip,truncate,turbinate,vine,white,woody,x,yellowish	papillose
357	wfo-0001030057	success	141	77	45	63	78	14	45	0	-2,1-10,2-3-celled,2-4,2-4.5,2-6,2.1-4.1,20-30,20-80,3-5,3.5-8,4-10,4.3-8.2,5.5-12,7-14,8-19,acuminate,acute,apex,axillary,base,blade,bud,chartaceous,cm,cordate,cuneate,diameter,elliptic,extremely,flower,fruit,globose,green,greenish,hair,herb,lateral,leaf,leaflet,membranous,mm,mucilaginous,odd-pinnate,ovate,ovoid,pedicel,peduncle,petiole,petiolule,plant,pubescent,scale-like,seed,size,small,stem,subglabrous,subtending,terminal,truncate,whitish,x	1-2,8,abaxially,absent,adaxially,apart,apparently,articulated,axe,berry,borne,broadly,brownish,cell,condition,covering,decreasing,digestion,distal,drying,eaf,eed,end,enzyme,erec,forked,fresh,geminat,generally,glabrou,greatly,green-white,hair-like,half,high,honeycomb-shaped,interjected,larger,like,living,long,lunate,make,mottled,narrow,nflorescence,pair,perfect,plurifoliate,purple,removed,ruit,seudostipule,short,singly,sometimes,spaced,specimen,ste,stolo,suborbicular,tall,tem,testal,thick,thir,throughout,toward,tri-,tuber,typically,unit,unwinged,usually,wall,wet,wing,ympodial	arrangement,colour,feature,form,growth,height,inflorescence,length,number,pseudostipule,shape,spacing,surface,texture	-2,1-10,2-3-celled,2-4,2-4.5,2-6,2.1-4.1,20-30,20-80,3-5,3.5-8,4-10,4.3-8.2,5.5-12,7-14,8-19,acuminate,acute,axillary,bud,chartaceous,cm,cordate,cuneate,elliptic,extremely,globose,green,greenish,herb,membranous,mm,mucilaginous,odd-pinnate,ovate,ovoid,pubescent,scale-like,small,subglabrous,subtending,terminal,truncate,whitish,x	
358	wfo-0001030057	success	197	120	70	92	105	28	67	3	-10,-2,.5-3.5,1-10,1-2,2-3-celled,2-4,2-4.5,2-6,20-30,20-80,3-5,4-10,5-10,5-6,7-14,8-19,abaxially,absent,acuminate,acute,adaxially,anther,apex,axillary,base,blade,bud,cell,chartaceous,cm,connivent,cordate,corolla,covering,cuneate,diameter,distal,elliptic,filament,flower,fruit,glabrous,globose,green,hair,hair-like,herb,high,homostylous,lanceolate,lateral,leaf,leaflet,linear,lobe,membranous,mm,odd-pinnate,ovate,ovate-lanceolate,ovoid,pedicel,peduncle,pentagonal,petiole,petiolule,plant,pore,poricidal,pubescent,rotate,scale-like,seed,short,size,stem,stigma,style,subglabrous,subtending,terminal,testal,thick,tip,truncate,tube,tuber,wall,white,whitish,x	2-3,2-5,2.1-4.1,3.5-8,4.3-8.2,5-merou,5.5-12,8,acumen,ag,along,alyx,apart,apparently,articulated,axe,berry,borne,broadly,brownish,ciliate,condition,decreasing,digestion,dorsally,drying,eaf,edge,eed,end,enzyme,erec,especially,exceeding,extremely,flat,folded,forked,fresh,geminat,generally,glabrou,globo,greatly,green-white,greenish,greenish-yellow,half,honeycomb-shaped,interjected,larger,lengthening,like,living,long,lower,lunate,make,margin,middle,midrib,minutely,mottled,mucilaginous,narrow,nflorescence,orolla,pair,perfect,petal,plurifoliate,puberulent,purple,removed,ruit,seudostipule,singly,slit,small,sometimes,spaced,specimen,stamen,star,ste,stolo,straight,striped,suborbicular,tall,tamen,tem,thir,throughout,toward,tri-,typically,unit,unwinged,usually,vary,wet,wing,yellow,ympodial	abaxial,adaxial,arrangement,articulation,calyx,colour,connation,feature,form,growth,height,history,inflorescence,length,life,na,number,ovary,presence,present,pseudostipule,reproduction,shape,spacing,staman,surface,texture,third	-10,-2,.5-3.5,1-10,1-2,2-3-celled,2-4,2-4.5,2-6,20-30,20-80,3-5,4-10,5-10,5-6,7-14,8-19,abaxially,absent,acuminate,acute,adaxially,axillary,bud,cell,chartaceous,cm,connivent,cordate,covering,cuneate,distal,elliptic,glabrous,globose,green,hair,hair-like,herb,high,homostylous,lanceolate,lateral,linear,membranous,mm,odd-pinnate,ovate,ovate-lanceolate,ovoid,pentagonal,poricidal,pubescent,rotate,scale-like,short,subglabrous,subtending,terminal,testal,thick,tip,truncate,wall,white,whitish,x	na,present,third
359	wfo-0001030080	success	186	117	72	90	96	27	68	4	0.3-7,0.4-1.5,0.5-4,1-2,1.5-2,1.5-2.5,2-3,2-4,3-10,4-12,4-7,5-13.5,6.5-18.6,8-16,9.9-33,acuminate,anther,apex,axillary,base,blade,brownish,bud,cell,clavate,cm,condition,connivent,coriaceous,corolla,covering,cuneate,dark,decurrent,diameter,dot,drying,elliptic,flower,forked,fresh,fruit,glabrous,green,greenish,hair-like,herb,homostylous,lanceolate,lateral,leaf,leaflet,light,lobe,long,mm,moniliform,mottled,odd-pinnate,ovate,ovoid,pair,petiole,plant,pore,poricidal,purple,pyriform,seed,size,sometimes,stellate,stigma,straight,style,subtending,terminal,testal,thick,throughout,tiny,tip,tube,tuber,wall,white,whitish,width,winged,yellow	1-3,1.8-4.5,1999,2.1-7.1,3-5,3.3-7.7,5-7,5-merou,5.5-9.9,8-23,abaxiall,abaxially,absent,acumen,adaxially,ag,along,alyx,apart,apparently,arranged,articulated,axe,bead,berry,capitat,ccording,decreasing,digestion,distal,dorsally,eaf,edge,eed,enzyme,erec,exceeding,filament,flat,folded,geminat,generally,glabrescent,glabrou,green-white,hair,hal,half,high,honeycomb-shaped,inconspicuous,interjected,larger,lengthening,like,linear,living,lower,make,medium,mucilaginous,multiple,necklace,nflorescence,ochoa,onto,orolla,pedicel,peduncle,perfect,plurifoliate,rachi,removed,second,seudostipule,slightly,slit,spaced,specimen,stamen,stolon,strongly,subequal,tall,tamen,tem,toward,tri-,typically,unit,unknown,usually,vary,wet,x,ympodial	5-merous,abaxial,adaxial,arrangement,calyx,capitate,colour,connation,feature,form,growth,height,history,inflorescence,length,life,na,number,perennial,pseudostipule,reproduction,shape,stem,surface,texture,type,young	0.3-7,0.4-1.5,0.5-4,1-2,1.5-2,1.5-2.5,2-3,2-4,3-10,4-12,4-7,5-13.5,6.5-18.6,8-16,9.9-33,acuminate,axillary,brownish,bud,cell,clavate,cm,condition,connivent,coriaceous,covering,cuneate,dark,decurrent,dot,drying,elliptic,forked,fresh,glabrous,green,greenish,hair-like,herb,homostylous,lanceolate,lateral,light,long,mm,moniliform,mottled,odd-pinnate,ovate,ovoid,poricidal,purple,pyriform,sometimes,stellate,straight,subtending,terminal,testal,thick,throughout,tiny,tip,wall,white,whitish,winged,yellow	5-merous,capitate,na,perennial
360	wfo-0001030081	success	157	110	75	80	77	30	69	6	.5,0.5-1,0.5-2.5,1,1-3,1-4,1-5,1.5,1.5-7,10-20,10-35,2-foliate,3-10,3-6,4-6,5-12,5-15,abundant,acute,anther,apex,base,berry,brown,calyx,center,chartaceous,cm,decurrent,diameter,dm,drying,edge,elliptic,elliptic-ovoid,filament,fine,flower,fruit,geniculate,glabrous,globose,hair,herb,immature,interpetalar,lobe,long,margin,maturing,membranaceous,mm,moderately,oblong,obtuse,often,parallel,pedicel,per,petiole,pubescent,radiating,raised,ridge,rotate,rounded,running,semitransparent,shallow,stigma,style,surface,tissue,triangular,tube,unit,usually,white,x,yellow	0.25-0.5,0.5-1.5,1-2,1-2-celled,1.5-3,1st,2-4,2-7,2nd,abaxially,absent,adaxiall,adaxially,along,apically,axe,beyond,blade,cell,ciliate,connected,cordate,dehiscing,densely,denser,eaf,eed,emarginat,entire,equal,explosively,exserted,few-branched,flat,frui,geminat,held,linear-lanceolate,longer,lower,lying,maturit,mesocarp,nearly,nfloresence,notch,one,orolla,other,peduncle,placenta,pointing,pressure,pubescen,rachi,rarely,ruit,short,single-,slightly,small,sometimes,sparsely,stamen,straight,swollen,tal,tamen,tem,two-celled,unbranched,vary,vein,watery,wid,woody,ympodial	abaxial,adaxial,arrangement,colour,connation,corolla,emarginate,feature,form,geminate,greyish,growth,inflorescence,leaf,length,na,number,ovary,papilla,seed,shape,size,stem,sympodial,texture,tip,type,wide,width,young	.5,0.5-1,0.5-2.5,1,1-3,1-4,1-5,1.5,1.5-7,10-20,10-35,2-foliate,3-10,3-6,4-6,5-12,5-15,abundant,acute,apex,berry,brown,center,chartaceous,cm,decurrent,diameter,dm,drying,edge,elliptic,elliptic-ovoid,fine,flower,fruit,geniculate,glabrous,globose,herb,immature,interpetalar,long,margin,maturing,membranaceous,mm,moderately,oblong,obtuse,often,parallel,per,petiole,pubescent,radiating,raised,ridge,rotate,rounded,running,semitransparent,shallow,tissue,triangular,unit,usually,white,x,yellow	emarginate,geminate,greyish,na,sympodial,wide
361	wfo-0001030083	success	146	120	65	82	64	38	61	4	0.25-0.5,0.5-1,0.5-2,0.8-1,0.8-3,1-1.5,1-2,10-30,2,3/4,4-15,4-6,acute,anther,anthesi,apex,bark,base,berry,broadly,calyx,closely,cm,corolla,cup-shaped,decurrent,deeply,deltoid,dry,elliptic,flower,fruit,glabrous,globose,green,greenish-white,internodal,leaf,lobe,lobed,long-acuminate,long-styled,minutely,mm,narrowly,opposite,ovary,ovate,overlapping,ovoid-reniform,pale,papillose,pedicel,petiole,pitted,pore,poricidal,red-papillose,scar,shallowly,shaped,short-styled,shrub,simple,small-capitate,spaced,specimen,stem,stigma,strongly,style,surface,tapering,tear-drop,tip,translucent,tube,way,white,winged,x,young	.5,.75,0.1,1.5-3,2-3,2-5-flowered,3-4,9-11,accrescent,beginning,dar,deciduous,deflexed,dia,drying,eaf,edicel,eed,elongate,exserted,fleshy,fruiting,greyish-re,hyaline,inflorescenc,lateral,lon,long,lower,main,membranous,middle,near,nflorescence,older,onto,pair,paler,papillae,prominent,proximal,raised,reddish-gold,reflexed,ruit,single-stemmed,slender,slightly,somewhat,soon,straight,tall,tan,terminal,thickened,thin,tub,ud,unifoliat,unit,vein,widest,woody,ympodial	2-5,arrangement,bud,coat,colour,connation,decurrency,embryo,feature,filament,form,greyish-red,growth,height,history,inflorescence,length,life,midpoint,minor,na,new,number,papilla,plant,prickle,ray,reproduction,seed,shape,size,spacing,texture,tuberculation,type,unifoliate,width,winging	0.25-0.5,0.5-1,0.5-2,0.8-1,0.8-3,1-1.5,1-2,10-30,2,3/4,4-15,4-6,acute,base,berry,broadly,closely,cm,cup-shaped,decurrent,deeply,deltoid,elliptic,flower,glabrous,globose,green,greenish-white,internodal,leaf,lobed,long-acuminate,long-styled,minutely,mm,narrowly,opposite,ovate,overlapping,ovoid-reniform,pale,papillose,pitted,poricidal,red-papillose,shallowly,shaped,short-styled,shrub,simple,small-capitate,spaced,strongly,tapering,tear-drop,tip,translucent,way,white,winged,x	2-5,greyish-red,na,unifoliate
362	wfo-0001030093	success	181	134	76	94	87	40	68	8	0.1-0.3,0.2-0.5,0.2-1,0.5-1.1,1-1.5,1-12,1-5,1.3-4.5,2-2.5,2.5-11,3-4,3.5-12,4-6,5-8,7-30,acuminate,acute,anther,anthesi,apex,attenuate,bark,base,berry,calyx,campanulate,clavate,cm,corolla,cuneate,deltoid,densely,ellipsoid,elliptic,erect,filament,flower,furcate,glabrous,globose,green,greenish-white,growth,hirsutulous,leaf,lobe,lobed,many,minor,minutely,mm,narrowly,nearly,new,obovate,often,opposite,orbicular,ovary,ovoid-reniform,paler,pedicel,petiole,pitted,plant,pore,poricidal,puberulent,pubescent,scar,shaped,shiny,shrub,simple,size,slightly,small,stem,stigma,style,surface,tapering,tear-drop,thickened,time,tip,tree,trichome,tube,uniseriate,white,woody,x,young	.2,.5,0,0.2,0.6-1.5,0.75-1,5-50-flowered,7-9,8-9,apar,becoming,beneath,branched,brownish-tan,case,closely,collection,commonly,continues,deflexed,dia,differing,difoliate,eaf,edicel,eed,especially,evenly,except,expanded,exserted,forest,free,fruiting,geminat,golden,greyish-brow,guyanese,hyaline,impressed,inundated,lateral,like,lon,long,long-styled,lower,main,major,margin,member,middle,nflorescence,occasionally,older,one,onto,open,pair,pale,papillo,persisting,population,portion,present,quite,reflexed,remaining,ruit,shoot,short-styled,slender,soon,southern,spaced,straight,tall,terminal,tiny,tub,ud,underside,unit,vein,widest,yellowish,ympodial	1.5-4,5-50,abaxial,adaxial,alternate,apart,arrangement,bud,coat,colour,connation,dry,feature,form,fruit,greyish-brown,hair,height,history,inflorescence,length,life,midpoint,na,number,papilla,papillose,perennial,prickle,ray,reproduction,seed,shape,spacing,specimen,texture,tuberculation,type,width,winging	0.1-0.3,0.2-0.5,0.2-1,0.5-1.1,1-1.5,1-12,1-5,1.3-4.5,2-2.5,2.5-11,3-4,3.5-12,4-6,5-8,7-30,acuminate,acute,attenuate,base,berry,campanulate,clavate,cm,cuneate,deltoid,densely,ellipsoid,elliptic,erect,furcate,glabrous,globose,green,greenish-white,hirsutulous,leaf,lobed,many,minutely,mm,narrowly,nearly,obovate,often,opposite,orbicular,ovoid-reniform,paler,pitted,poricidal,puberulent,pubescent,shaped,shiny,shrub,simple,slightly,small,tapering,tear-drop,thickened,time,tree,trichome,uniseriate,white,woody,x	1.5-4,5-50,alternate,apart,greyish-brown,na,papillose,perennial
363	wfo-0001030145	success	152	122	84	98	54	24	84	0	-2,-3,0.2-2,0.3-1-2.5,0.5,0.5-1,0.5-4,1,1-2,1-3,1-5,1.5-4.5,1.5-7,10-12,2-4,2.5-6.5,3,3-10,3-5,4-8,6-40,abaxially,absent,acute,adaxially,adpressed,also,apart,apex,basal,base,calyx,campanulate,chartaceous,cm,compound,connective,cuneate,deltate,densely,directed,distally,dunal,ellipsoidal,elliptic-ovate,entire,exceeding,fide,fleshy,flower,forked,fruit,glabrous,glandular,globose,hair,herb,lanceolate,leaf,less,lobe,long,margin,mm,moderately,narrowly,obtuse,pedicel,peduncle,petiole,pilose,pore,puberulent,rachi,reddish,remnant,shorter,shrub,simple,sinuate,slightly,somewhat,sparsely,stigma,style,subcordate,ternately,thecae,time,triangular,truncate,tube,unbranched,unknown,violet,wide,x,yellow	1-1.5,1.5,1.5-2,2-3,3-4,4-5,4-foliat,8-11,aggregate,ape,articulated,axe,beyond,blade,cell,color,cylindrical,diameter,eaf,eed,elliptic,exserted,larger,lateral,leaflet,leaving,lon,lower,near,nflorescence,nther,orolla,ovate-elliptic,pedicellar,presen,puberulen,radiu,ripe,ruit,slender,spaced,stamen,stone,subcoriaceous,tal,tem,terminal,tomento,toward,truncat,ud,unit,vary,ympodial	abaxial,adaxial,anther,arrangement,bud,colour,corolla,feature,form,growth,height,inflorescence,length,number,ovary,plant,ratio,seed,shape,size,spacing,stem,surface,texture	-2,-3,0.2-2,0.3-1-2.5,0.5,0.5-1,0.5-4,1,1-2,1-3,1-5,1.5-4.5,1.5-7,10-12,2-4,2.5-6.5,3,3-10,3-5,4-8,6-40,abaxially,absent,acute,adaxially,adpressed,also,apart,apex,basal,base,campanulate,chartaceous,cm,compound,cuneate,deltate,densely,directed,distally,dunal,ellipsoidal,elliptic-ovate,entire,exceeding,fide,fleshy,forked,glabrous,glandular,globose,hair,herb,lanceolate,less,lobe,long,mm,moderately,narrowly,obtuse,pilose,puberulent,reddish,shorter,shrub,simple,sinuate,slightly,somewhat,sparsely,style,subcordate,ternately,thecae,time,triangular,truncate,unbranched,unknown,violet,wide,x,yellow	
364	wfo-0001030146	success	210	111	59	79	131	32	56	3	0.5â1,0.6â0.7,0.6â2,0.9â1,1.5â2,1â1.5,2.5â9,2â5,4â4.5,5â8,6.5â16,60+,8â15,9â9.5,acuminate,acute,anther,anthesi,apex,base,berry,calyx,capitate,cm,connivent,corolla,cup-shaped,deltate,densely,ellipsoidal,elliptic,filament,flattened-reniform,flower,globose,green,growth,inflorescence,leaf,length,lengthening,lobe,lobed,loosely,minutely,mm,narrowly,new,nodding,papillose,pedicel,peltate,persistent,petiole,pitted,plant,pore,poricidal,pubescent,ripe,scar,short-stalked,simple,slit,small,stellate,stem,stigma,stout,style,surface,terminal,tip,tree,treelet,trichome,tube,white,â18	.1,.2,.5,0.2â0.4,0.5,1.2â1.5,16â20,1â1.1,20,20â30,3â4,3â6,40â50,4â30,5-merou,6â7,>,abaxial,abaxially,absent,adaxial,ag,almost,along,alyx,apar,appearing,ark,articulated,axe,beig,beneath,branched,branching,bright,brown,brownish,c.,cell,center,closely,coriaceous,covered,dark,deeply,dense,diameter,dichasia,discolorous,drying,eaf,echinoid,edge,eed,elongate,entire,erec,exserted,free,fresh,fruiting,fused,glabrous,golden,gradually,halfway,ilament,impressed,lamina,layer,less,like,long,lower,many,margin,midpoint,multangulate,narrowing,nflorescence,older,olive,orolla,pair,pale,part,peduncle,per,perfect,pericarp,plurifoliate,portion,primary,projection,pubescence,ray,reddish,reflexed,regularly,revolute,rhachi,ruit,scurfy,sessile,shiny,spaced,sparsely,strongly,subtended,tall,tan,tangled,tem,testal,thin,time,tiny,ud,undersurface,unevenly,unit,upper,vary,varying,vein,visible,way,wide,woody,yellow,ympodial	age,apart,arrangement,bud,coat,colour,connation,decurrency,embryo,feature,form,fruit,height,history,life,minor,na,number,ovary,papilla,prickle,reproduction,seed,shape,size,spacing,texture,tuberculation,type,width,winging,young	0.5â1,0.6â0.7,0.6â2,0.9â1,1.5â2,1â1.5,2.5â9,2â5,4â4.5,5â8,6.5â16,60+,8â15,9â9.5,acuminate,acute,anthesi,berry,capitate,cm,connivent,cup-shaped,deltate,densely,ellipsoidal,elliptic,flattened-reniform,globose,green,lengthening,lobed,loosely,minutely,mm,narrowly,nodding,papillose,peltate,persistent,pitted,poricidal,pubescent,ripe,short-stalked,simple,slit,small,stellate,stout,terminal,tip,tree,treelet,trichome,white,â18	age,apart,na
365	wfo-0001030147	success	156	80	40	54	102	26	37	3	0.5-2,1-5,1.0-2.2,10-19,14-35,15-30,2-10.5,2-13,2-3,2-5,3-5-7-8,4-5.5,4.2-7.5,4.5-10,5-8,8-38,branched,calyx,cm,conical,connate,corolla,cyme,diameter,dichasial,dichasially,ebracteate,finely,flower,forked,herbaceous,interjected,lateral,leaf,leaflet,long,mm,monochasial,mucilaginous,odd-pinnate,ovoid,pair,pedicel,peduncle,perennial,petiole,plant,pubescent,rotate,seed,size,style,terminal,yellow	0-5,1-4,1.0-2.0,2,2-10,2.5-7.5,3-6-foliat,4-3.,abaxiall,abaxially,acumen,acuminate,acute,adaxially,apex,apical,apically,articulate,attenuate,base,blue,cell,covering,cuneate,deep,dehiscent,digestion,diminishing,distal,dorsally,eaf,edge,eed,elliptical,emoval,enzyme,exceeding,filament,flat,folded,generally,globo,gradually,green,green-white,hair-like,half,honeycomb,introrse,living,lobe,lon,long-attenuate,lower,lunat,make,maturing,medium,narrowly,nflorescence,nther,oblique,obtuse,often,orolla,ovate,pattern,perfect,petiolule,plan,poricidally,proximal,purple,reveal,rounded,ruit,sessile,seudostipule,short,slit,specimen,stamen,stigma,straight,subequal,subsessile,tal,tem,testal,thick,throughou,throughout,tip,toward,tuber-bearing,typically,unit,vary,wall,wide,ympodial,Â¼	4-31,abaxial,adaxial,anther,arrangement,colour,connation,feature,form,fruit,globose,growth,height,history,inflorescence,length,life,na,number,ovary,reproduction,shape,stem,surface,texture,width	0.5-2,1-5,1.0-2.2,10-19,14-35,15-30,2-10.5,2-13,2-3,2-5,3-5-7-8,4-5.5,4.2-7.5,4.5-10,5-8,8-38,branched,cm,conical,connate,cyme,dichasial,dichasially,ebracteate,finely,forked,herbaceous,long,mm,monochasial,mucilaginous,odd-pinnate,ovoid,perennial,pubescent,rotate,yellow	4-31,globose,na
366	wfo-0001030151	success	174	137	84	90	84	47	80	4	0.2-0.5,0.5,1-17,1-2,1-5,1.5-2,10-25,15-35-50,2-25,2-6,2-7-compound,3-14,3-5,3.5-32,5-6,6-9,abundantly,acuminate,acute,adaxial,adaxially,apart,apex,apiculate,around,basal,base,blotch,calyx,cm,connate,cordate,cuneate,decurrent,deltate,directed,distally,except,flower,fruit,glabrous,glandular-puberulent,globose,hair,lanceolate,leaf,less,lilac-tinged,line,lobe,long,longitudinal,mm,narrowly,oblique,oblong,obovate,often,pedicel,petiole,pinnately,pore,probably,puberulent,pyriform,ring,ripe,sand-punctate,shallowly,simple,slender,slightly,sometimes,somewhat,sparsely,stellate,stigma,stripe,style,surface,tip,tree,triangular,truncate,tube,unbranched,white,x,yellow,yellow-green	-3,0.3-0.5,0.5-1,1,1-1.5,1-3,1.5-2.5,10-20,2-11,2-3,20-30,4-5,4-foliat,?,abaxially,absent,aggregate,ape,articulated,axe,beyond,blade,cell,channe,chartaceous,ciliat,compound,connective,cylindrical,diameter,eaf,eed,eglandular,elliptic,entire,exceeding,exserted,glabrate,glandular,leaflet,leaving,lon,lower,margin,membranaceous,near,nflorescence,nther,obtuse,orolla,pedicellar,peduncle,perfect,presence,purplish,rachi,radiu,remnant,ruit,sand-punctat,scattered,short,shorter,small,spaced,stalked,stamen,stone,tal,tem,thecae,time,toward,truncat,ud,unit,unknow,vary,vein,veiny,white-puberulent,whitish,wide,ympodial	alternate,anther,anthesi,arrangement,bud,channel,coat,colour,connation,corolla,decurrency,dry,embryo,feature,filament,form,growth,height,history,inflorescence,length,life,midpoint,minor,na,new,number,ovary,papilla,perennial,plant,prickle,ray,reproduction,scar,seed,shape,size,spacing,specimen,stem,texture,tuberculation,type,width,winging,young	0.2-0.5,0.5,1-17,1-2,1-5,1.5-2,10-25,15-35-50,2-25,2-6,2-7-compound,3-14,3-5,3.5-32,5-6,6-9,abundantly,acuminate,acute,adaxial,adaxially,apart,apex,apiculate,around,basal,blotch,cm,connate,cordate,cuneate,decurrent,deltate,directed,distally,except,glabrous,glandular-puberulent,globose,hair,lanceolate,less,lilac-tinged,line,lobe,long,longitudinal,mm,narrowly,oblique,oblong,obovate,often,petiole,pinnately,probably,puberulent,pyriform,ring,ripe,sand-punctate,shallowly,simple,slender,slightly,sometimes,somewhat,sparsely,stellate,stripe,style,tip,tree,triangular,truncate,unbranched,white,x,yellow,yellow-green	alternate,channel,na,perennial
367	wfo-0001030153	success	147	88	54	71	76	17	54	0	/3,0.2-1,0.8-0.9,1-10,1-2,1-2.5,1.3-1.5,1.5-2,2-8,2-lobed,3-50,3.5-10.5,5-6,acuminate,acute,anther,apart,apex,apparently,attenuate,bark,base,berry,calyx,clavate,cm,conical,corolla,dark,distinct,domatia,ellipsoid,elliptic,filament,flower,glabrous,globose,green,growth,internodal,lanceolate,lobed,minutely,mm,narrowly,new,older,ovary,papillate,pedicel,petiole,pit-like,poricidal,ripe,scar,simple,slightly,small,stem,stigma,style,surface,terminal,tip,tree,treelet,tube,way,white,yellowish,young	.1,.2,0.8-1.3,1-1.2,1-1.5,1.3-1.9,2.5-4,3-4,3-5,6-8,abaxially,absent,adaxially,age,anthesi,ape,apiculate,axil,branched,brittle,broadly,caly,campanulate,deltate,densely,diameter,dot,dry,eaf,enlarged,entire,erect,exerted,free,fruiting,glabrou,impressed,irregularly,known,lengthening,less,lobe,lower,margin,markedly,membranous,nflorescence,nodding,occasionally,ot,pair,paler,papillat,peduncle,perfect,plane,plurifoliat,pore,portion,primary,rachi,resinous,revolute,ruit,slit,spaced,specimen,straight,strongly,thin,time,ud,unit,vein,x,ympodial	abaxial,adaxial,arrangement,bud,colour,feature,form,fruit,inflorescence,leaf,length,number,shape,spacing,texture,type,width	/3,0.2-1,0.8-0.9,1-10,1-2,1-2.5,1.3-1.5,1.5-2,2-8,2-lobed,3-50,3.5-10.5,5-6,acuminate,acute,apart,apparently,attenuate,base,berry,clavate,cm,conical,dark,distinct,domatia,ellipsoid,elliptic,glabrous,globose,green,internodal,lanceolate,lobed,minutely,mm,narrowly,older,papillate,pit-like,poricidal,ripe,simple,slightly,small,stem,terminal,tip,tree,treelet,way,white,yellowish,young	
368	wfo-0001030167	success	141	114	78	89	52	25	75	3	.8,.9,0.1â0.2,0.5â0.6,0.5â0.7,0.6,0.7â1.2,0.8â1,1.2â2.5,1.5â2,1.5â7,12,14â19,15â20,17â58,1â1.2,1â1.5,2â3,2â4.5,4.5â8,4â10,4â4.5,4â5,8â10,acuminate,along,anther,apex,apically,base,branch,calyx,chartaceous,ciliate,clavate,cm,contiguously,densely,diameter,enlarged,extra-axillary,fertile,flattened,flower,fruit,glabrous,green,herbaceous,lanceolate,lobe,long,margin,membranaceous,membranous,minutely,mm,moderately,near,nearly,obtuse,ovate,ovoid,pedicel,peduncle,petal,petiole,pinnate,pointed,rachi,rounded,sand-punctate,simple,slightly,somewhat,sparsely,stellate,stigma,style,thinly,time,tip,tube,unbranched,venation,vine,weakly,white,wide,x	0.6â0.8,4â7,5-merous,abaxially,accrescent,acute,adaxially,alyx,apar,axe,berry,blade,c.,ciliat,climbing,eaf,eed,entire,filament,fruiting,gap,glabrou,immature,less,lower,m.,maturity,nflorescence,nternode,orolla,pair,penden,perfec,plurifoliat,reflexed,ruit,scar,secondary,seen,slender,spaced,subequal,symmetrical,tamen,tem,truncat,unit,unknown,vary,vegetation,vein,ympodial	abaxial,adaxial,apart,arrangement,corolla,feature,form,growth,inflorescence,internode,leaf,length,number,ovary,pendent,shape,size,spacing,staman,stem,surface,texture,truncate,type,width	.8,.9,0.1â0.2,0.5â0.6,0.5â0.7,0.6,0.7â1.2,0.8â1,1.2â2.5,1.5â2,1.5â7,12,14â19,15â20,17â58,1â1.2,1â1.5,2â3,2â4.5,4.5â8,4â10,4â4.5,4â5,8â10,acuminate,along,apex,apically,chartaceous,ciliate,clavate,cm,contiguously,densely,enlarged,extra-axillary,flattened,flower,fruit,glabrous,green,herbaceous,lanceolate,lobe,long,margin,membranaceous,membranous,minutely,mm,moderately,near,nearly,obtuse,ovate,ovoid,petal,pinnate,pointed,rounded,sand-punctate,simple,slightly,somewhat,sparsely,stellate,thinly,time,tube,unbranched,vine,weakly,white,wide,x	apart,pendent,truncate
369	wfo-0001030176	success	171	102	67	73	98	29	62	5	-4.25,.2,0.4-1.5,0.5-2,0.7-1.4,1,1.2,1.2-2.5,1.6,2-3,2.25-3.25,3-5,3-lobed,4-9,6-8,anther,attenuate,base,berry,bilobed,broad,broadly,calyx,cm,connivent,depressed-globose,especially,extra-axillary,few-branched,flattened-reniform,flower,fruit,glabrous,hair,herb,hermaphroditic,lanceolate-oblong,light,long,margin,midrib,mm,nearly,oblong,ovate,pale,partially,pedicel,peduncle,petiole,plant,pore,pubescent,rachi,rarely,recurved,ripe,rotate-stellate,simple,slightly,somewhat,sparsely,stigma,style,tip,tube,unbranched,violet,white,x,yellow,yellow-orange,young	-1.4,-6.25,.7,.75-1.5,0.5,0.6-0.9,0.7â0.8,1-2,1-5,1.5-2,1.5-2.5,1/3,1/6,2-foliate,2.5,2.5â7.5,2.5â9,2â3,3.75-5,5-merou,6â8,abaxially,accrescent,acute,adaxiall,adaxially,alyx,angulate,apart,apex,apparently,articulated,asymmetrically,axe,ba,basal,bi-lobed,blade,branch,capitat,chartaceous,ciliate,contact,covering,cylindrical,decumbent,dehiscent,diameter,downward,eaf,eed,erec,filament,forming,fruiting,geminat,hold,interlobal,juic,lance-ovate,lateral,line,lobe,lon,longitudinall,lower,major,mesocarp,minutely,near,nflorescence,node,numerous,often,orolla,patch,perfect,prostrate,recurve,rooting,round,ruit,sinus,soil,sometimes,spaced,tamen,tem,terminal,time,triangular,unit,vary,vein,white-puberulent,wide,winged,ympodial	2.5-7.5,2.5-9,arrangement,capitate,colour,corolla,feature,form,growth,height,history,inflorescence,leaf,length,life,longitudinally,number,ovary,perennial,reproduction,seed,shape,size,stem,surface,texture,type,width,winging	-4.25,.2,0.4-1.5,0.5-2,0.7-1.4,1,1.2,1.2-2.5,1.6,2-3,2.25-3.25,3-5,3-lobed,4-9,6-8,attenuate,base,berry,bilobed,broad,broadly,cm,connivent,depressed-globose,especially,extra-axillary,few-branched,flattened-reniform,flower,fruit,glabrous,hair,herb,hermaphroditic,lanceolate-oblong,light,long,midrib,mm,nearly,oblong,ovate,pale,partially,pore,pubescent,rarely,recurved,ripe,rotate-stellate,simple,slightly,somewhat,sparsely,tip,unbranched,violet,white,x,yellow,yellow-orange,young	2.5-7.5,2.5-9,capitate,longitudinally,perennial
370	wfo-0001030180	success	135	97	62	70	65	27	57	5	0.05-1,0.8-2,0.9-1.8,1-1.5,10-30-flowered,3-8,4.5-5,6,8.5-23,?,abruptly,anther,anthesi,apart,appearing,bark,base,berry,calyx,clavate,cm,corolla,dark,decurrent,dia,ellipsoid,fruit,furcate,glabrous,globose,green,leaf,linear,lobe,lobed,long,minutely,mm,narrowing,nearly,occasionally,opposite,ovary,papillate,papillose,pedicel,petiole,planar,pore,poricidal,puberulent,raised,scar,shaped,shrub,slightly,stem,stigma,style,surface,tear-drop,terminal,tip,trichome,tube,uniseriate,unknown,white,winged,young	.1,.5,.75,0.5-1,1.1-1.2,3-4,8-10,accrescent,apex,apiculate,attenuate,becoming,clu,deflexe,deltoid,eaf,edicel,eed,erect,exserted,filament,free,fruiting,glabrate,height,immature,inflorescenc,interpetalar,known,lateral,lenticellat,lon,long-acuminate,lower,main,middle,minute,nflorescence,older,overlapping,pair,peduncl,plurifoliat,portion,prominent,proximal,rounded,ruit,sinus,slender,soon,spaced,sparsely,straight,thin,ud,unevenly,unit,vein,widely,widest,woody,x,yellowish,ympodial	arrangement,bud,club,colour,connation,dry,feature,flower,form,growth,inflorescence,length,lenticellate,na,number,papilla,peduncle,plurifoliate,seed,shape,size,spacing,specimen,texture,type,width,winging	0.05-1,0.8-2,0.9-1.8,1-1.5,10-30-flowered,3-8,4.5-5,6,8.5-23,?,abruptly,anthesi,apart,appearing,base,berry,calyx,clavate,cm,dark,decurrent,dia,ellipsoid,furcate,glabrous,globose,green,leaf,linear,lobed,long,minutely,mm,narrowing,nearly,occasionally,opposite,papillate,papillose,planar,pore,poricidal,puberulent,raised,shaped,shrub,slightly,surface,tear-drop,terminal,tip,trichome,tube,uniseriate,unknown,white,winged	club,lenticellate,na,peduncle,plurifoliate
371	wfo-0001030189	success	185	125	70	87	98	38	67	3	/3,0.5-1.6,0.9-1.1,1,1-1.5,1-2,1.1-2.7-4,1.3-4.2,1.5-5,1/3,2-3,2.5-4,3.2-4.5,4-13,4-5.5,anther,apex,apparently,articulated,base,berry,branched,calyx,cm,connivent,cordate,deltate,densely,dull,elliptic,erect,filament,flattened-reniform,flower,fruit,glabrescent,lateral,leaf,length,lobe,lobed,long,maturity,mauve,midpoint,mm,moderately,oblong,obtuse,orange,ovate,pedicel,petiole,poricidal,porrect,purple,ray,recurved,red,rounded,scandent,scar,sessile,shrub,simple,sometimes,spherical,spreading,stalked,stellate-pubescent,stem,strongly,style,surface,tapering,terminal,tip,trichome,tube,unarmed,upper,variously,way,wide,woody,yellow,young	.2,0-1,0-15,0-30,0.1,0.1-0.2,0.2-0.3,0.2-0.5,1-3-cellular,1-4-cellula,1-4-cellular,1.5-2,1.5-4.5,1/,1/6-1/3-1/2,2,2-5.5,3-4,5-10,5-6,5-8,5-8-10,5-merous,6-10,6-12,8-18,abaxially,acut,alyx,apar,apically,appressed,bark,blade,chartaceous,concolorous,curved,diameter,drying,eaf,eed,elongating,entire,equal,evenly,faint,foliaceous,free,frui,fruiting,glabrescen,glabrous,gland-tipped,gray,green,infructescence,longer,lower,margin,mature,nflorescence,often,older,one,open,orolla,oung,pair,peduncle,per,perfec,pericarp,plurifoliat,portion,primary,red-brow,reflexed,ruit,shorter,slender,smooth,somewhat,spaced,sparsely,stalk,stellate,tamen,terete,tertiary,time,unarme,unit,vary,vein,venation,visible,yellow-green,ympodial	anthesi,apart,arrangement,bud,coat,colour,connation,corolla,decurrency,dry,feature,form,growth,height,history,inflorescence,life,minor,na,new,number,ovary,papilla,plant,pore,prickle,seed,shape,size,spacing,specimen,stigma,texture,true,tuberculation,type,width,winging	/3,0.5-1.6,0.9-1.1,1,1-1.5,1-2,1.1-2.7-4,1.3-4.2,1.5-5,1/3,2-3,2.5-4,3.2-4.5,4-13,4-5.5,apparently,articulated,base,berry,branched,cm,connivent,cordate,deltate,densely,dull,elliptic,erect,flattened-reniform,glabrescent,lateral,lobed,long,maturity,mauve,mm,moderately,oblong,obtuse,orange,ovate,poricidal,porrect,purple,recurved,red,rounded,scandent,sessile,shrub,simple,sometimes,spherical,spreading,stalked,stellate-pubescent,strongly,tapering,terminal,tip,trichome,upper,variously,way,wide,woody,yellow	apart,na,true
372	wfo-0001030219	success	191	102	53	54	137	48	36	17	1.5,60,acute,anther,apex,base,black,blue,branched,calyx,cm,connivent,decurrent,densely,elliptic,filament,flattened,flower,fruit,glabrous,globose,green,lanceolate,leaf,lilac,lobe,longitudinal,marking,mm,number,oblong,opening,ovate,pedicel,pentagonal,perennial,petiole,pitted,pore,pubescent,purple,rapidly,rounded,shallowly,shrub,size,sparsely,split,stigma,style,surface,tube,woody,x	0.1â0.3,0.2â2.3,0.4â1.0,0.5,0.5â,0.7â1.1,0.8â3.0,0â,1.0â1.2,1.0â1.5,1.0â2.0,1.0â2.2,1.3â2.9,1.4â2.8,1.6â,10,15,1â2.5,2.0â2.5,2.0â3.2,2.0â5.5,2.4â6.0,2â,2â2.5,2â3,2â4.5,3,4.5â5.5,4.8â11.5,4â5,4â7,5,5â,5â8,6â,6â10,6â8,7â11,8â18,9â10,9â12,abaxiall,abaxially,acut,adaxiall,adaxially,adnate,ag,along,anisophyllous,anthesi,apart,apical,apparently,appearing,arising,arranged,articulated,axe,ba,basal,blade,bractâlike,brown,cell,chartaceous,clavat,concave,convex,cylindrical,decreasing,deeply,diamete,diameter,difoliate,directed,distally,eaf,eed,equal,erect,geminat,glabrescent,hair,incised,indistinct,internode,long,lower,margin,moderately,multicellular,nflorescence,olive,opposed,oppositely,orolla,pair,pale,paler,peduncle,perfect,present,procumbent,redâpurple,regularly,ruit,serrate,sessile,sid,side,simple,smaller,spaced,stone,straight,stripe,strongly,tal,tamen,tem,time,two,unicellular,uniseriate,unit,vary,velutinous,white,wide,wing,winged,yellow,ympodial,â3.0,â7.0,â9.5	0.2-2.3,0.7-1.1,2-2.5,2-3,2.0-2.5,2.4-6.0,4.8-11.5,5-11,6-10,6-8,8-18,9-10,arrangement,berry,bud,clavate,colour,connation,corolla,decurrency,feature,form,growth,height,history,inflorescence,leaf-opposed,length,life,minor,na,new,opposite,ovary,papilla,plant,reproduction,scar,seed,shape,spacing,stem,texture,tip,type,width,winging,young	1.5,60,acute,black,blue,branched,cm,connivent,decurrent,densely,elliptic,flattened,glabrous,globose,green,lanceolate,lilac,longitudinal,marking,mm,oblong,opening,ovate,pentagonal,perennial,pitted,pubescent,purple,rapidly,rounded,shallowly,shrub,sparsely,split,woody,x	0.2-2.3,0.7-1.1,2-2.5,2-3,2.0-2.5,2.4-6.0,4.8-11.5,5-11,6-10,6-8,8-18,9-10,berry,clavate,leaf-opposed,na,opposite
373	wfo-0001030225	success	151	118	80	95	56	23	80	0	.5,0-45,0-5,1,1-4,1-6,10-15-30,10-30,2-18,2-3,2-6,3-11-compound,3-20,3-5,4-5,8-15,abaxially,acuminate,acute,apart,apex,apical,apically,basal,base,bilobed,calyx,campanulate,cm,conivent,connective,cordate,coriaceous,cuneate,cylindrical,deltate,densely,diameter,dilated,directed,distally,entire,exceeding,expanded,fleshy,flower,forked,fruit,glabrate,glabrous,gland,globose,immature,laterally,leaf,less,lobe,long,margin,mm,moderately,narrowly,oblong,obtuse,one,pedicel,peduncle,petiole,pinnately,pore,possibly,puberulent,purple,rachi,seen,shallowly,shrub,simple,small,sparsely,stellate,stigma,strongly,style,succulent,thecae,tip,tree,triangular,truncate,tube,two,unbranched,unknown,x	-1.5,-11,.5-2.5,0-20,1.5,1.5-2.5-7,2,2-2.5-4,3-4,3-foliat,absent,adaxially,ape,articulated,ature,axe,beyond,blade,color,compound,eaf,eed,elliptic-ovate,equal,especially,exserted,leaflet,leaving,lower,minutely,nflorescence,nther,orolla,papillose,perfect,prominent,puberulen,radiu,scar,see,slightly,somewhat,spaced,stalked,stamen,tal,tem,time,tomento,toward,ud,unit,unknow,vary,wide,ympodial	anther,arrangement,bud,colour,corolla,feature,form,growth,height,inflorescence,length,number,ovary,plant,seed,shape,size,spacing,stem,surface,texture,type,width	.5,0-45,0-5,1,1-4,1-6,10-15-30,10-30,2-18,2-3,2-6,3-11-compound,3-20,3-5,4-5,8-15,abaxially,acuminate,acute,apart,apex,apical,apically,basal,bilobed,campanulate,cm,conivent,cordate,coriaceous,cuneate,cylindrical,deltate,densely,diameter,dilated,directed,distally,entire,exceeding,expanded,fleshy,forked,glabrate,glabrous,gland,globose,immature,laterally,less,lobe,long,mm,moderately,narrowly,oblong,obtuse,one,pinnately,possibly,puberulent,purple,seen,shallowly,shrub,simple,small,sparsely,stellate,strongly,succulent,thecae,tip,tree,triangular,truncate,two,unbranched,unknown,x	
374	wfo-0001030250	success	169	136	88	103	66	33	82	6	.5,0.5-1,1-1.5,1-3,1.1-3.5,1.4-1.5,1.7-7,11.2-22,11.3,2-2.5,2.1-6,25,3-5,3.4-6.6,3.5-4,4-7,5-6,anther,anthesi,apart,apex,attenuate,bark,base,beginning,beneath,berry,broadly,bullate,calyx,capitate,cm,conical,corolla,cuneate,cup-shaped,dark,decurrent,deflexed,dia,dry,elliptic,elliptic-ovate,filament,glabrous,globose,green,greenish-white,greenish-yellow,horizontally,inflorescence,leaf,lobe,long,long-acuminate,maturity,minor,minutely,mm,n,node,occasionally,opposite,orbicular,orbiculate,ovary,ovoid-reniform,pale,papillose,pedicel,petiole,pit,pitted,pore,poricidal,projection,rim,scar,sea-green,seed,shallow,shape,shaped,shrub,simple,size,slender,slightly,specimen,spreading,stem,stigma,style,surface,tapering,tear-drop,tip,translucent-green,tube,white-lenticellate,winged,woody,x	/4,0-seeded,1.1-1.2,1.25-1.5,1.9-2.6,2.5-3.25,5-50-flowered,6-8,across,appearing,arching,brown,carinate-hooded,consisting,curved,differing,difoliate,eaf,edicel,eed,exerted,five,free,fresh,fruiting,geminat,glabrou,inflorescenc,irregularly,lateral,lobed,lon,lower,main,major,middle,nflorescence,older,one,pair,paler,papillo,pendulous,portion,prominent,proximal,raised,reflexed,ruit,smooth,soon,spaced,straight,tall,tan,translucent,two,ud,unit,usually,vein,way,white-lenticellat,wide,widest,ympodial	5-50,abaxial,adaxial,alternate,arrangement,bud,coat,colour,connation,embryo,feature,flower,form,fruit,growth,height,history,length,life,midpoint,na,number,papilla,perennial,plant,prickle,ray,reproduction,spacing,texture,tuberculation,type,width	.5,0.5-1,1-1.5,1-3,1.1-3.5,1.4-1.5,1.7-7,11.2-22,11.3,2-2.5,2.1-6,25,3-5,3.4-6.6,3.5-4,4-7,5-6,apart,apex,attenuate,base,beginning,beneath,berry,broadly,bullate,calyx,capitate,cm,conical,cuneate,cup-shaped,dark,decurrent,deflexed,dia,elliptic,elliptic-ovate,glabrous,globose,green,greenish-white,greenish-yellow,horizontally,inflorescence,leaf,long,long-acuminate,maturity,minutely,mm,n,node,occasionally,opposite,orbicular,orbiculate,ovoid-reniform,pale,papillose,pit,pitted,poricidal,projection,rim,sea-green,shallow,shaped,shrub,simple,slender,slightly,spreading,tapering,tear-drop,tip,translucent-green,tube,white-lenticellate,winged,woody,x	-3,5-50,alternate,di,na,perennial
375	wfo-0001030271	success	195	100	59	73	122	27	56	3	0.15-0.75,0.7-9.5,0.9-2.5,1-2,1-2.5,1-7,1.4-2.1,15-61,2-6,2.4-5.6,3-10,3-5,4-22,4-7,5-8,6-15,anther,axillary,berry,blue,bud,clavate,cm,coloration,connivent,coriaceous,corolla,dark,deep,diameter,elliptic,flower,fruit,glabrous,green,herb,homostylous,lanceolate,leaf,light,lilac,long,medium,mm,moniliform,mottled,mucilaginous,odd-pinnate,ovate,ovoid,pedicel,peduncle,pentagonal,petiole,plant,pore,poricidal,purple,rotate,seed,size,spot,stigma,straight,style,subtending,terminal,tip,tube,tuber,unwinged,wet,white	0-2,0.5-1.2,0.9-3.6,1-3,1-4,1-6,1.9-6.6,2-2.7,2-3,2-4,3.4-7.5,5-merou,5.6-12.3,abaxially,acumen,acute,adaxiall,adaxially,ag,along,alyx,apart,apex,apparently,arranged,articulated,asymmetric,attenuate,axe,base,basiscopic,bead,blade,brownish,capitat,cell,completely,condition,considerably,covering,decreasing,digestion,distal,dorsally,drying,eaf,edge,eed,enzyme,erect,exceeding,filament,flat,folded,forked,fresh,geminat,generally,glabrou,green-white,greenish,habi,hair-like,half,honeycomb-shaped,interjected,larger,lateral,leaflet,lengthening,like,linear,living,lobe,lower,make,middl,multiple,necklace,nflorescence,orbicular,orolla,pair,perfect,petiolulate,plurifoliate,removed,ripe,rosette,rounded,ruit,sessile,seudostipule,side,slightly,slit,sometimes,spaced,specimen,stamen,stolon,symmetric,tall,tamen,tem,testal,thick,throughout,tissue,toward,tri-,typically,unit,usually,vary,vein,wall,whitish,wide,x,yellow,ympodial	5-merous,abaxial,adaxial,arrangement,calyx,capitate,colour,connation,feature,form,growth,height,history,inflorescence,length,life,na,number,ovary,pseudostipule,reproduction,shape,spacing,stem,surface,texture,width	0.15-0.75,0.7-9.5,0.9-2.5,1-2,1-2.5,1-7,1.4-2.1,15-61,2-6,2.4-5.6,3-10,3-5,4-22,4-7,5-8,6-15,axillary,berry,blue,bud,clavate,cm,coloration,connivent,coriaceous,dark,deep,elliptic,glabrous,green,herb,homostylous,lanceolate,light,lilac,long,medium,mm,moniliform,mottled,mucilaginous,odd-pinnate,ovate,ovoid,pentagonal,poricidal,purple,rotate,spot,straight,subtending,terminal,tip,unwinged,wet,white	5-merous,capitate,na
376	wfo-0001030272	success	179	112	54	71	108	41	50	4	0.5-1,0.5-1.5,0.6-0.9,0.65-1,0.7-2.5,0.8-1.5,1,1-2.8,1.5-2.5,1.5-3,2-6.5,2.8-3.5,4-8,anther,apex,bark,base,berry,bright,calyx,cm,connivent,deltate,elliptic,erect,evenly,filament,flattened-reniform,flower,fruit,glabrescent,glandular,green,hair,lateral,leaf,length,less,lobe,lobed,long-attenuate,maturity,mauve,midpoint,minute,mm,narrow-deltate,obtuse,pedicel,petiole,poricidal,ray,red,rounded,scar,shrub,simple,spherical,spreading,stellate-pubescent,stem,style,surface,tapering,terminal,tip,tube,unarmed,unbranched,woody,young	-6,.3,.5,/4,0-20,0.05-0.1,0.05-1.5,0.5-2,1-1.5,1.2-1.8,1/3,1/3-2/3,10-20,2-2.5,2.5-3,2.5-3.5,3-8,3.5-5,4-10,4-15,4-6,5-7,5-merous,abaxially,acut,acute,almost,alyx,ame,apar,apically,apparently,articulated,ba,blade,c.,concolorous,densely,diameter,difoliate,drying,eaf,eed,elongating,entire,equal,free,fruiting,geminat,glabrescen,glabrous,gland,gra,infructescence,long,longer,lower,margin,mature,membranous,moderately,multangulate,near,nflorescence,older,one,open,orange-brown,orolla,oung,pair,peduncle,per,perfec,pericarp,porrect,portion,primary,red-brown,reduced,reflexe,ruit,sessile,shallowly,shorte,slender,smooth,sometimes,spaced,sparsely,stellate,straight,tamen,terete,tertiary,time,trichome,unarme,undulate,unit,upper,vary,vein,venation,visible,way,wide,ympodial	1.5,anthesi,apart,arrangement,bud,coat,colour,connation,corolla,decurrency,dry,embryo,feature,form,gray,growth,height,history,inflorescence,life,minor,na,new,number,ovary,papilla,plant,pore,prickle,reproduction,seed,shape,size,spacing,specimen,stigma,texture,tuberculation,type,width,winging	0.5-1,0.5-1.5,0.6-0.9,0.65-1,0.7-2.5,0.8-1.5,1,1-2.8,1.5-2.5,1.5-3,2-6.5,2.8-3.5,4-8,berry,bright,cm,connivent,deltate,elliptic,erect,evenly,flattened-reniform,glabrescent,glandular,green,hair,lateral,less,lobed,long-attenuate,maturity,mauve,minute,mm,narrow-deltate,obtuse,poricidal,red,rounded,shrub,simple,spherical,spreading,stellate-pubescent,tapering,terminal,unarmed,unbranched,woody,young	1.5,apart,gray,na
377	wfo-0001030287	success	148	107	71	81	67	26	68	3	-40,0-15,0.5-1,1-10,1-15,1-2,1-2.5,1-4,1-5.5,1.5-10,2,2-10,2-12,2-3-9-11,2.5-4,3,4-5,5-10,acute,apart,apex,base,bluish,branched,calyx,cm,compound,connivent,cylindrical,deltate,dendritically,densely,directed,eglandular,ellipsoidal,entire,flattened,flower,forked,glabrous,gland,glandular,hair,herb,lanceolate,leaf,lilac,lobe,long-stalked,margin,mm,moderately,narrowly,oblong,often,ovoid,pedicel,peduncle,petiole,pinnately,pore,puberulent,pubescent,purple,rachi,rugulose,scattered,shrub,simple,stellate,stigma,strongly,style,subcordate,tip,triangular,truncate,tube,unbranched,unknown,x	-foliat,-many,.5-2.5,1,1-3,1.5-2.5,1966,2-5,4-6,4.5-6,8-13,?,abaxially,adaxiall,adaxially,aggregate,articulated,axe,basiscopically,blade,cell,chartaceous,color,decurrent,dendritic,dendritic-pubescen,diameter,distall,down,eaf,eed,elliptic-ovate,fide,lateral,leaflet,leaving,lon,long,lower,membranaceous,nflorescence,nther,obtuse,orolla,pedicellar,presen,radiu,ruit,scar,slightly,smith,spaced,sparsely,sparser,stalked,stone,subcapitat,subcoriaceous,tal,tem,time,unit,upper,vary,wide,yellow,ympodial	anther,arrangement,colour,connation,corolla,dendritic-pubescent,distally,feature,form,fruit,growth,height,inflorescence,length,number,ovary,plant,seed,shape,size,spacing,stem,subcapitate,surface,texture,width	-40,0-15,0.5-1,1-10,1-15,1-2,1-2.5,1-4,1-5.5,1.5-10,2,2-10,2-12,2-3-9-11,2.5-4,3,4-5,5-10,acute,apart,apex,base,bluish,branched,cm,compound,connivent,cylindrical,deltate,dendritically,densely,directed,eglandular,ellipsoidal,entire,flattened,forked,glabrous,gland,glandular,hair,herb,lanceolate,lilac,long-stalked,mm,moderately,narrowly,oblong,often,ovoid,pinnately,puberulent,pubescent,purple,rugulose,scattered,shrub,simple,stellate,strongly,subcordate,tip,triangular,truncate,unbranched,unknown,x	dendritic-pubescent,distally,subcapitate
378	wfo-0001030300	success	232	131	75	92	140	39	71	4	0.5,0.5-0.6-0.9,0.5-4,0.7-0.8,0.9-1,1,1-2,1.4-2.4,2-locular,4-11,6-15,9-12,abaxially,almost,anther,anthesi,apex,articulated,articulation,base,bent,bifid,brittle,broadly,calyx,capitate,cell,cm,cordate,corolla,crenate,curved,densely,diameter,ellipsoidal,elliptical,elongate,entire,filament,flower,fruit,glabrous,globose,golden,green,hair-like,herb,imparipinnate,inflorescence,interrupted,irregularly,large,lateral,less,like,lobe,mm,obovate,occasionally,once-branched,orbicular,outgrowth,ovary,pedicel,pentagonal,perennial,petiole,plant,pore,pubescent,rounded,simple,slightly,sparsely,spathulate,stem,stigma,straight,strongly,style,surface,testa,tip,triangular,trichome,tube,uniseriate,wall,weak,yellow,yellowish-green,zygomorphic	-7,.5,0.1,0.1-0.15,0.15-1,0.2,0.2-0.5,0.2-1.5,0.4-0.5,0.4-1.5,0.4-4.5,0.5-0.6,0.5-1,0.5-5,0.6-0.7-1,0.6-0.8-1,0.7-1.2,0.7-1.5,0.8-1,0.8-3,0.8-4,1-1.3,1-2-celled,1-4,1-6,1-celled,1.2-2.2-7.5,1.5-2.5,1.5-3.5-13,2-2.1,2-2.5,2-3,2-4,2-foliate,3/4,4-celled,6-8-celled,absent,abundant,acute,adaxial,adaxially,although,always,apical,appearance,appendage,ba,basal,beyond,bract,bracteate,brown,coherent,column,crenat,deltate,developed,diamete,distal,eaf,edicel,eed,eglandular,even,exserted,face,finely,frequently,fruiting,give,glandular,glutinous-viscose,gree,halfway,head,interjected,internode,introrse,lamina,larger,leaflet,leave,lon,long,longer,margin,markedly,midvein,minute,moderately,multicellular,narrowly,nflorescence,node,oblique,pair,pale,papillae,partially,peduncle,petal,petiolule,pith,population,present,primary,pseudostipule,pubescence,reflexed,rest,ruit,secondary,silky,spreadin,spreading,staminal,sterile,tall,tem,terminal,tertiary,thick,two,ud,underlying,unicellular,unit,united,upper,usually,vein,velvety,well,wide,wider,winged,woody,yellowish,ympodial	2.2-7.5,3.5-13,arrangement,bud,coat,colour,connation,decurrency,dry,embryo,feature,form,growth,height,history,leaf,length,life,midpoint,minor,na,new,number,papilla,prickle,ray,reproduction,scar,seed,shape,size,spacing,specimen,texture,tuberculation,type,width,winging,young	0.5,0.5-0.6-0.9,0.5-4,0.7-0.8,0.9-1,1,1-2,1.4-2.4,2-locular,4-11,6-15,9-12,abaxially,almost,articulated,articulation,base,bent,bifid,brittle,broadly,capitate,cell,cm,cordate,crenate,curved,densely,ellipsoidal,elliptical,elongate,entire,glabrous,globose,golden,green,hair-like,herb,imparipinnate,interrupted,irregularly,large,lateral,less,like,mm,obovate,occasionally,once-branched,orbicular,outgrowth,pentagonal,perennial,pubescent,rounded,simple,slightly,sparsely,spathulate,stem,straight,strongly,testa,triangular,trichome,uniseriate,wall,weak,yellow,yellowish-green,zygomorphic	2.2-7.5,3.5-13,leaf,na
379	wfo-0001030311	success	182	112	62	56	126	56	43	19	.2,5-pinnate,acuminate,acute,anther,apex,base,berry,brown,calyx,cm,cordate,deltoid,densely,extra-axillary,filament,flattened,flower,fruit,glabrous,granular,green,half,herbaceous,lanceolate,lenticular,lobe,lower,membranous,minutely,mm,oblique,obtuse,ovoid-rhomboid,papillose,pedicel,petiole,pubescent,purplish,rounded,slender,slightly,sparsely,stellate,stem,stigma,style,surface,terrestrial,thickened,tip,tube,unbranched,vine,white,x	.5,.5â1.8,0.1,0.1â0.2,0.3â1.5,0.4â2,0.5â0.8,0.5â1,0.5â2,0.5â2.5,0.6â1,0.6â2.4,0.8â1.2,0.8â4,0.8â4.5,1.2â7,1.5â2,1.5â3,1.5â5.5,1.5â6,1.5â8,1.8â2,15â22,1â1.2,1â1.5,1â2,1â2.5,1â3,2.2â2.5,2.2â3,2.5â9,2â10,2â2.5,2â6,3â5,3â7,5â10,<,abaxially,accrescent,adaxial,adaxially,along,alyx,apar,apical,appearance,axe,basal,blade,c.,capitat,chartaceous,ciliat,ciliate,clavate,color,cuneate,dense,diameter,distal,eaf,eed,elliptical,entire,especially,falcate,fallen,fruiting,giving,glabrou,groov,groove,ground,hair,lateral,leaflet,like,log,lon,long,m.,margin,membranaceous,midvein,nflorescence,nternode,obovate,occasionally,orangish,orolla,pair,peduncle,petiolulate,petiolule,plurifoliat,present,proximal,pubescence,rachi,rhomboid,ruit,sand-punctate,scattered,sessile,short,shortly,side,smaller,spaced,strongly,tamen,tan,tem,thick,thinner,trailing,trichome,unit,upper,vary,vein,wide,wide-diameter,widely,ympodial	0.6-1,1-2.5,1-3,1.2-7,1.5-2,1.5-5.5,1.5-8,1.8-2,15-22,2-10,2.2-2.5,2.2-3,3-5,3-7,5-10,apart,arrangement,bud,capitate,colour,connation,corolla,decurrency,embryo,feature,form,growth,height,history,inflorescence,leaf,length,life,midpoint,minor,na,new,number,ovary,papilla,plant,plurifoliate,pore,prickle,ray,reproduction,scar,seed,shape,size,spacing,texture,type,width,winging,young	.2,5-pinnate,acuminate,acute,berry,brown,cm,cordate,deltoid,densely,extra-axillary,flattened,flower,fruit,glabrous,granular,green,half,herbaceous,lanceolate,lenticular,lower,membranous,minutely,mm,oblique,obtuse,ovoid-rhomboid,papillose,pubescent,purplish,rounded,slender,slightly,sparsely,stellate,terrestrial,thickened,tip,unbranched,vine,white,x	0.6-1,1-2.5,1-3,1.2-7,1.5-2,1.5-5.5,1.5-8,1.8-2,15-22,2-10,2.2-2.5,2.2-3,3-5,3-7,5-10,apart,capitate,na,plurifoliate
380	wfo-0001030311	success	201	104	66	73	128	31	61	5	.2,.5,0.5-1,0.6-1,1-2.5,1-3,1.2-7,1.5-2,1.5-5.5,1.5-8,1.8-2,15-22,2-10,2.2-2.5,2.2-3,3-5,3-7,5-10,5-pinnate,acute,adaxial,anther,apart,articulated,basally,base,brown,cm,connivent,cordate,deltoid,densely,directed,distally,filament,flower,fruit,glabrous,granular,green,hair,herb,large,lenticular,lobe,longitudinal,minutely,mm,oblong,opening,ovoid-rhomboid,pedicel,petiole,plurifoliate,pore,pubescent,purplish,simple,slender,slit,spaced,sparsely,stellate,stem,stigma,style,surface,tip,tube,unbranched,uniseriate,white,x	.5-1.8,0-2.5,0.1,0.4-2,0.5-0.8,0.5-2,0.6-2.4,0.8-1.2,0.8-4,0.8-4.5,1-1.2,1-1.5,1.5-3,1.5-6,2-2.5,2-6,2224,5-merou,8031,<,abaxially,absen,absent,accrescent,acuminate,adaxially,ag,aggregate,along,alyx,apex,apical,apparently,appearance,axe,ba,basal,blade,capitat,cell,chartaceous,ciliat,ciliate,clavate,color,cuneate,dense,diameter,dig,distal,eaf,eed,elliptical,entire,equal,especially,falcate,fallen,flattened,formation,g,geminat,gh,giving,groov,groove,ground,half,interjected,lateral,leaflet,like,log,lon,long,lower,m.,margin,membranaceous,midvein,nflorescence,node,oblique,obovate,obtuse,occasionally,orangish,orolla,pair,papillose,peduncle,perfect,petiolulate,petiolule,pittier,present,proximal,rachi,rhomboid,rooting,rounded,ruit,scattered,sessile,short,shortly,side,sinple,slightly,smaller,stone,strongly,tamayo,tamen,tan,tem,thick,thickened,thinner,trailing,unit,upper,vary,vein,wide,widely,yellow,ympodial	abaxial,age,arrangement,berry,calyx,capitate,colour,connation,corolla,feature,form,greyish,growth,history,inflorescence,leaf,length,life,number,ovary,papilla,perennial,reproduction,seed,shape,size,texture,type,width,winging,young	.2,.5,0.5-1,0.6-1,1-2.5,1-3,1.2-7,1.5-2,1.5-5.5,1.5-8,1.8-2,15-22,2-10,2.2-2.5,2.2-3,3-5,3-7,5-10,5-pinnate,acute,apart,articulated,basally,base,brown,cm,connivent,cordate,deltoid,densely,directed,distally,flower,fruit,glabrous,granular,green,hair,herb,large,lenticular,longitudinal,minutely,mm,oblong,opening,ovoid-rhomboid,plurifoliate,pubescent,purplish,simple,slender,slit,spaced,sparsely,stellate,tip,unbranched,uniseriate,white,x	age,berry,capitate,greyish,perennial
381	wfo-0001030335	success	153	123	76	88	65	35	73	3	.25,.5,0-5,0.05-0.2,0.1-0.5,0.25-0.5,0.5-1,1-1.5,1-2,1.1-1.4,1.1.5,2-4.5,2-5,2.5-3,3/4,5-6,7-13,acuminate,acute,anther,anthesi,apex,bark,base,berry,bi-lobed,bud,calyx,cm,conical,corolla,decurrent,deltoid,densely,dia,dry,elliptic,expanded,filament,filiform,gently,glabrous,globose,green,greyish-red,leaf,lenticellate,lightly,lobe,lobed,long,minute,minutely,mm,narrowly,onto,opposite,ovary,ovoid-reniform,papillose,pedicel,petiole,pitted,pore,poricidal,puberulent,ripe,shaped,shrub,simple,slightly,stem,stigma,style,surface,tapering,tear-drop,tip,trichome,tube,uniseriate,way,white,winged,woody,x,yellowish-green,young	.1,.75,0.7-1,1-3-flowered,2-2.2,2-2.5,5-7,along,aspec,ba,beneath,branch,dark,deciduous,deflexed,eaf,edicel,eed,erect,except,exserted,flattened,free,fruiting,geminate,giving,horizontally,lamina,lateral,like,lon,lower,main,material,middle,nflorescence,obovoid,occasionally,often,older,pair,pale,papillo,portion,prominent,puberulen,pubescent,raised,reflexed,ruit,soon,sparsely,spreading,straight,strongly,tall,tan,ud,underside,unifoliat,unit,vein,widest,yellow,ympodial	1-3,arrangement,coat,colour,connation,embryo,feature,flower,form,fruit,growth,height,history,inflorescence,length,life,midpoint,na,new,number,papilla,plant,prickle,ray,reproduction,seed,shape,size,spacing,specimen,texture,tuberculation,type,unifoliate,width	.25,.5,0-5,0.05-0.2,0.1-0.5,0.25-0.5,0.5-1,1-1.5,1-2,1.1-1.4,1.1.5,2-4.5,2-5,2.5-3,3/4,5-6,7-13,acuminate,acute,apex,base,berry,bi-lobed,calyx,cm,conical,decurrent,deltoid,densely,dia,elliptic,expanded,filiform,gently,glabrous,globose,green,greyish-red,leaf,lenticellate,lightly,lobed,long,minute,minutely,mm,narrowly,onto,opposite,ovoid-reniform,papillose,petiole,pitted,poricidal,puberulent,ripe,shaped,shrub,simple,slightly,tapering,tear-drop,tip,trichome,tube,uniseriate,way,white,winged,woody,x,yellowish-green,young	1-3,na,unifoliate
382	wfo-0001030336	success	262	113	68	84	178	29	63	5	-10,0.5,0.6-0.8,0.6-1.5,0.8-0.9,0.8-1.3,0.8-3,1-1.5,1-3,1.6-7,1.8-3.0,3-5,4,4-10-19,8-20,almost,anther,apex,berry,bifurcate,bright,calyx,capitate,cm,completely,conical,corolla,densely,developed,diameter,elliptic,elongate,entire,filament,flower,flushed,fruit,globose,grayish,green,greenish,hair-like,herb,imparipinnate,inflorescence,interrupted,lanceolate,leaf,leaflet,lobe,minutely,mm,obovate,once-branched,orbicular,outgrowth,ovary,pale,pedicel,peduncle,perennial,petiole,present,pseudostipule,puberulent,pubescent,purple,rotate,slightly,stellate,stem,stigma,style,surface,ten,tip,tube,uniformly,united,usually,velvety,white,yellow,young	-1.5,.5,0-2-9,0.1-0.3,0.1-0.5,0.1-0.7,0.1-1,0.15-0.2,0.15-0.9,0.2,0.2-0.25,0.2-0.8,0.2-1,0.2-1.5-2,0.3-0.4,0.3-1.1,0.5-0.7,0.5-1,0.5-1.5,0.8-1.2,1,1-1.4,1-celled,1.0-1.4,1.5-2,1.5-3.5,1.5-4-10,1.5-5,1.7-2.3,1/4-1/3,10,2-4,2-foliate,2-locular,2/3,4-8-16,4-celled,6,8-celled,absent,acute,adpressed,amongst,anthesi,apical,appearance,appearing,appendage,articulated,articulation,basal,base,basiscopically,bent,bluntly,bract,bracteate,branch,brown,cell,clavat,coat,column,cordate,crenate,curved,dark,darker,decurrent,deeply,diamete,distal,divided,eaf,edicel,eed,eglandular,entir,erect,essentially,exserted,extremely,first,fruiting,giving,glandula,glandular,half,halfway,head,interjected,internode,investing,large,larger,largest,lateral,leave,less,like,lobed,lon,long,longer,loosely,lower,margin,markedly,maturity,mere,middl,midvein,minute,mixed,mostly,narrowing,narrowly,nflorescence,node,oblique,occasionally,often,pair,papillate,part,petiolule,population,primary,proximal,rachi,range,reflexed,rest,rounded,ruit,scattered,secondary,sessile,shaggy,shorter,shrub,silky,simple,sinus,small,soft,sometimes,southern,sparse,spreadin,spreading,staminal,sterile,straight,stripe,strongly,surrounding,tall,tem,terminal,tertiary,testa,thick,trichome,truncate,two,ud,unicellular,uniseriate,unit,upper,wall,way,weak-walled,wide,winged,woody,ympodial	1.5-4,4-10,abaxial,adaxial,alternate,arrangement,bud,clavate,colour,connation,feature,form,growth,height,history,length,life,na,number,papilla,plant,pore,reproduction,seed,shape,size,texture,type,width	-10,0.5,0.6-0.8,0.6-1.5,0.8-0.9,0.8-1.3,0.8-3,1-1.5,1-3,1.6-7,1.8-3.0,3-5,4,4-10-19,8-20,almost,apex,berry,bifurcate,bright,capitate,cm,completely,conical,densely,developed,elliptic,elongate,entire,flushed,globose,grayish,green,greenish,hair-like,herb,imparipinnate,interrupted,lanceolate,minutely,mm,obovate,once-branched,orbicular,outgrowth,pale,perennial,present,puberulent,pubescent,purple,rotate,slightly,stellate,surface,ten,tube,uniformly,united,usually,velvety,white,yellow	1.5-4,4-10,alternate,clavate,na
383	wfo-0001030342	success	155	104	66	76	79	28	61	5	.2,0.8â1.5,1.2â3,1.5,1.5â13,1.5â2,1.5â5,1.5â7.5,10â25,1â1.5,1â2.5,1â3,1â7,2â2.5,2â4,3-pinnate,3â12,4â5,4â8,acuminate,acute,anther,apex,calyx,chartaceous,cm,cylindrical,deltoid,dense,diameter,entire,extra-axillary,filament,flattened,flower,fruit,glabrous,greenish,herbaceous,lanceolate,leaf,lenticular,lobe,long,margin,membranous,minutely,mm,mottled,often,ovoid-rhomboid,pedicel,peduncle,petiole,pointed,pubescent,rarely,revolute,scattered,slender,smooth,stellate,stem,stigma,style,surface,tip,trichome,truncate,tube,undulate,vine,wide-diameter,widely,x,yellowish	.5,0.1â0.2,0.3â1.2,0.5â1,0.5â3,0.5â5,0.8â4,1-5,1-6.5,1â1.2,1â5.5,1â6,2â,3,5-merous,6â7,abaxially,abundant,accrescent,adaxially,along,alyx,apar,apical,apiculate,axe,base,berry,blade,broadly,brown,c.,capitat,ciliat,cordate,cuneate,eaf,eed,elliptical,fruiting,glabrou,lateral,leaflet,light,like,lon,lower,m.,nflorescence,nternode,oblique,obtuse,orolla,perfec,petiolule,plurifoliat,proximal,pubescen,rachi,rhomboid,rounded,ruit,sand-punctate,side,slightly,spaced,sparsely,tamen,tem,terrestria,truncate-acuminat,unbranched,unit,vary,vein,white,wide,ympodial,â7	2â7,abaxial,adaxial,apart,arrangement,capitate,colour,corolla,feature,form,growth,history,inflorescence,internode,length,life,number,ovary,plurifoliate,reproduction,seed,shape,size,spacing,staman,terrestrial,texture,width	.2,0.8â1.5,1.2â3,1.5,1.5â13,1.5â2,1.5â5,1.5â7.5,10â25,1â1.5,1â2.5,1â3,1â7,2â2.5,2â4,3-pinnate,3â12,4â5,4â8,acuminate,acute,apex,chartaceous,cm,cylindrical,deltoid,dense,diameter,entire,extra-axillary,flattened,glabrous,greenish,herbaceous,lanceolate,leaf,lenticular,long,membranous,minutely,mm,mottled,often,ovoid-rhomboid,pointed,pubescent,rarely,revolute,scattered,slender,smooth,stellate,tip,trichome,truncate,undulate,vine,wide-diameter,widely,x,yellowish	2â7,apart,capitate,plurifoliate,terrestrial
384	wfo-0001030342	success	151	89	45	55	96	34	39	6	1-1.5,1-3,1-7,1.2-3,1.5-13,10-25,3-12,3-pinnate,4-5,4-8,anther,basally,calyx,cm,connivent,deltoid,entire,extra-axillary,filament,flower,fruit,glabrous,hair,herb,lanceolate,leaf,lenticular,lobe,longitudinal,margin,mm,oblong,pedicel,petiole,plurifoliate,pore,pubescent,sagittate,simple,slender,slit,smooth,stellate,stigma,style,surface,terrestrial,tip,truncate,tube,unbranched,undulate,uniseriate,white,x	-7,.2,.5,0.5-1,0.5-3,0.5-5,0.8-4,1-1.2,1-5,1-5.5,1-6,1-6.5,1.5-2,1.5-5,1.5-7.5,2-2.5,2-3,5-merou,6-7,abaxially,absent,abundant,accrescent,acuminate,acute,adaxially,ag,along,alyx,apart,apex,apical,apiculate,apparently,articulated,axe,ba,base,blade,broadly,brown,capitat,chartaceous,ciliat,cordate,cuneate,cylindrical,diameter,directed,distally,eaf,eed,elliptical,equal,fruiting,geminat,interjected,lateral,leaflet,light,long,lower,membraceous,minutely,nflorescence,node,oblique,obtuse,opening,orolla,peduncle,perfect,petiolule,proximal,pubescen,rachi,rarely,revolute,rhomboid,rooting,rounded,scattered,side,slightly,spaced,tamen,tem,trailing,truncate-acuminat,unit,vary,vein,wide,widely,yellow,ympodial	1.5,2,3-7,abaxial,adaxial,arrangement,capitate,colour,connation,corolla,feature,form,growth,height,history,inflorescence,length,life,na,number,ovary,papilla,perennial,plant,reproduction,seed,shape,size,spacing,stem,texture,type,width,young	1-1.5,1-3,1-7,1.2-3,1.5-13,10-25,3-12,3-pinnate,4-5,4-8,basally,cm,connivent,deltoid,entire,extra-axillary,glabrous,hair,herb,lanceolate,lenticular,longitudinal,mm,oblong,plurifoliate,pubescent,sagittate,simple,slender,slit,smooth,stellate,terrestrial,truncate,unbranched,undulate,uniseriate,white,x	1.5,2,3-7,capitate,na,perennial
385	wfo-0001030353	success	222	116	73	92	130	24	70	3	.7,0.5-0.9,0.8-1.2,1-2,1-6,1-7,1.8-2.2,1.8-3,1/2-2/3,1/5,2.5-4,2.8-3.7,3-4,3-5.5,4-4.5,5,6-8,abaxial,acute,adaxial,almost,anther,apart,apex,apparently,articulated,bark,base,berry,brown,calyx,cm,connivent,cuneate,densely,ellipsoid,elliptic,erect,evenly,filament,flattened-reniform,flower,fruit,fruiting,glabrescent,glabrous,green,lateral,leaf,length,lobe,lobed,long,long-styled,maturity,mauve,mm,moderately,multangulate,orange-brown,patch,pedicel,petiole,plant,poricidal,prickly,red-brown,reddish-green,scar,sessile,shape,short-styled,shrub,simple,small,stellate-pubescent,stem,style,surface,tapering,terminal,tip,tree,trichome,tube,unarmed,upper,way,white-gray,wide,yellow,young	-3,-5,-merous,.1-0.2,.2,.5,0,0-15,0-2,0-6,0.1-0.2,0.1-0.3,0.15-0.3,0.5-1.5,0.8,1-3,1-5,1.2-1.8,1/,1/3,1/6,1/6-1/4-1/2,10-15,11-16,2-10,2-7,20-200,3.5-4,4-5,4-5-6,5-6,6,6-15,7-10,8-15,abaxially,alyx,andromonoecious,apar,apically,apiculat,blade,broad-deltate,c.,chartaceous,conical,curved,deltate,development,diameter,discolorous,distal,distance,drying,eaf,eed,elongating,equal,extending,flattened,free,half,hermaphrodite,heterostylous,infructescence,less,longer,lower,lowermost,margin,mature,midpoint,midvein,narrow-deltate,nflorescence,older,one,open,orolla,oung,pair,peduncle,pendulous,per,pericarp,plurifoliat,pointed,porrect,portion,prickle,primary,ray,reflexed,retaining,rounded,ruit,shorter,side,smooth,sometimes,somewhat,spaced,sparsely,spreading,stalk,stalked,staminat,stellate,stout,straight,strongly,subentire,tamen,terete,tertiary,throughout,time,unarme,unbranched,unit,vary,vein,venation,visible,warty,weakly,whit,wo,woody,ympodial	/,arrangement,colour,connation,corolla,elongation,feature,form,growth,hair,height,inflorescence,na,number,ovary,papilla,seed,size,spacing,stigma,texture,type,white,width	.7,0.5-0.9,0.8-1.2,1-2,1-6,1-7,1.8-2.2,1.8-3,1/2-2/3,1/5,2.5-4,2.8-3.7,3-4,3-5.5,4-4.5,5,6-8,acute,almost,apart,apparently,articulated,base,berry,brown,cm,connivent,cuneate,densely,ellipsoid,elliptic,erect,evenly,flattened-reniform,glabrescent,glabrous,green,lateral,lobed,long,long-styled,maturity,mauve,mm,moderately,multangulate,orange-brown,patch,poricidal,prickly,red-brown,reddish-green,sessile,short-styled,shrub,simple,small,stellate-pubescent,tapering,terminal,tip,tree,trichome,unarmed,upper,way,white-gray,wide,yellow,young	/,na,white
386	wfo-0001030407	success	182	154	107	122	60	32	100	7	.2,.5,0.7-3.2,1-10,1-2,1.5-5,12-14,12-15,2-5,2-6.7,2-7,3-10.5,3-4,3-6.5,3-9,3.5-9.5,30-60,4-5,5,6-7,6.5-18.5,7-8,abaxially,acuminate,adaxially,anther,apart,apex,apparently,articulated,axillary,base,berry,blade,brownish,bud,cell,chartaceous,ciliate,cm,condition,conical,connivent,corolla,covering,densely,diameter,dorsally,drying,edge,elliptic-lanceolate,end,filament,flat,flower,folded,forked,fresh,fruit,glabrous,green,green-white,greenish,hair,hair-like,herb,lanceolate,lateral,leaf,leaflet,lengthening,light,like,lobe,long,make,margin,middle,minute,mm,mottled,mucilaginous,obtuse,odd-pinnate,one,ovate,ovoid,pedicel,peduncle,pentagonal,perfect,petiole,placed,plant,pore,poricidal,proximal,pubescent,purple,ripe,round,seed,size,slit,stigma,style,subtending,terminal,testal,thick,throughout,tip,tube,tuber,typically,unwinged,usually,wall,wet,whitish,wide,x	1-3,1-4,2-2.5,5-merou,absent,acumen,ag,alyx,axe,capitat,decreasing,digestion,distal,eaf,eed,enzyme,especially,exceeding,geminat,generally,glabrou,gradually,half,homostylous,honeycomb-shaped,interjected,larger,living,lower,nflorescence,orolla,pair,petiolule,plurifoliate,pubescen,ray,removed,ruit,secondary,semierec,seudostipule,spaced,specimen,stamen,ste,stolo,subequal,subsessile,symmetrical,tall,tamen,tem,thir,toward,tri-,unit,vary,white,yellow,ympodial	age,arrangement,articulation,calyx,capitate,colour,connation,feature,forkednes,form,growth,height,history,inflorescence,length,life,na,number,ovary,perennial,placement,pseudostipule,pubescence,reproduction,shape,spacing,stem,stolon,surface,texture,third,type	.2,.5,0.7-3.2,1-10,1-2,1.5-5,12-14,12-15,2-5,2-6.7,2-7,3-10.5,3-4,3-6.5,3-9,3.5-9.5,30-60,4-5,5,6-7,6.5-18.5,7-8,abaxially,acuminate,adaxially,apart,apparently,articulated,axillary,berry,brownish,bud,cell,chartaceous,ciliate,cm,condition,conical,connivent,covering,densely,dorsally,drying,elliptic-lanceolate,end,flat,folded,forked,fresh,glabrous,green,green-white,greenish,hair,hair-like,herb,lanceolate,lateral,lengthening,light,like,long,make,margin,middle,minute,mm,mottled,mucilaginous,obtuse,odd-pinnate,one,ovate,ovoid,pentagonal,perfect,placed,pore,poricidal,proximal,pubescent,purple,ripe,round,seed,slit,subtending,terminal,testal,thick,throughout,tip,typically,unwinged,usually,wall,wet,whitish,wide,x	age,capitate,na,perennial,stem,stolon,third
387	wfo-0001030420	success	159	118	63	71	88	47	60	3	-pubescent,0.5-1,0.5-1-1.5,0.5-4,0.5-8,1-2,1-7.5,1.5-5,10-15-25-30,2-14.5,2-3,2-3-lobed,2-9,4-7,5-15-20,acuminate,acute,also,apart,apex,basal,base,calyx,chartaceous,cm,connivent,cordate,deltate,densely,eglandular,eglandular-puberulent,ellipsoidal,elongated,flower,forked,fruit,glabrate,glandular-,lanceolate,leaf,lobe,long,mm,moderately,narrowly,obtuse,often,pedicel,petiole,pinnately,pore,puberulent,pubescent-pilose,purple,rarely,shrub,simple,small,sparsely,stellate,stigma,style,tip,tree,triangular,truncate,tube,unbranched,unknown,unlobed,x	-4,1-2-6-9,1-3,1-4,1-6,1.5-3,1/2,10-25-35,2-3-7,2-5,4-foliat,5-6,5-6-7,5-7-19,7-22,7/8,abaxially,absent,adaxially,aggregate,ape,articulated,axe,beyond,blade,cell,color,connective,cylindrical,dark,diameter,directed,distally,divided,eaf,eed,eglandular-pilo,elliptic-ovate,entire,equal,exserted,glabrous,glandular-puberulent,hair,leaving,lobed,lon,lower,margin,midrib,nearly,nflorescence,nther,orolla,ovate,pedicellar,peduncle,perfect,pilose,presen,puberulent-pubescent,pubescent,pubescent-pilo,rachi,radiu,remnant,ripe,ruit,shorter,sinus,spaced,stamen,stone,subcoriaceous,tal,tem,thecae,time,tomento,truncat,ud,unit,vary,vein,wide,yello,yellow,ympodial	2-7,anther,anthesi,arrangement,bud,coat,colour,connation,corolla,decurrency,dry,eglandular-pilose,embryo,feature,filament,form,growth,height,history,inflorescence,length,life,midpoint,minor,na,new,number,ovary,papilla,plant,prickle,ray,reproduction,scar,seed,shape,size,spacing,specimen,stem,surface,texture,tuberculation,type,width,winging,young	-pubescent,0.5-1,0.5-1-1.5,0.5-4,0.5-8,1-2,1-7.5,1.5-5,10-15-25-30,2-14.5,2-3,2-3-lobed,2-9,4-7,5-15-20,acuminate,acute,also,apart,apex,basal,chartaceous,cm,connivent,cordate,deltate,densely,eglandular,eglandular-puberulent,ellipsoidal,elongated,forked,glabrate,glandular-,lanceolate,lobe,long,mm,moderately,narrowly,obtuse,often,pinnately,puberulent,pubescent-pilose,purple,rarely,shrub,simple,small,sparsely,stellate,tip,tree,triangular,truncate,unbranched,unknown,unlobed,x	2-7,eglandular-pilose,na
388	wfo-0001030426	success	157	107	69	80	77	27	66	3	0.3-7,0.3-8,0.4-0.7,1-4,1-4.2,1.5-3,1.7-3.2,15-25-30,2,2-3,2.5-4,2.5-6,3-12,3-6,4-10,4-6.5,6-11.5,6-8,9,apical,apically,branched,calyx,cell,cm,connate,corolla,covering,cyme,dehiscent,diameter,dichasial,dichasially,distal,ebracteate,filament,flower,forked,generally,glandular,globose,hair-like,half,heart-shaped,herbaceous,interjected,introrse,lateral,leaf,leaflet,long,make,maturing,mm,monochasial,mucilaginous,odd-pinnate,often,ovoid,pedicel,peduncle,perennial,petiole,pilose,plant,poricidally,seed,short,size,slit,stellate,stigma,style,terminal,testal,thick,wall,white,wide,yellow	1.5-6.5,10,3-4,3-6-foliat,abaxially,absen,acumen,acute,adaxially,apex,apiculate,articulate,base,caudate,decurrent,digestion,diminishing,dorsally,eaf,edge,eed,elliptic-lanceolate,emoval,enzyme,exceeding,flat,folded,globo,gradually,green,green-white,honeycomb,lanceolate,larger,linear,linear-lanceolate,linear-oblong,living,lobe,lon,lower,nflorescence,nther,oblique,oblong,obtuse,orolla,pair,pattern,perfect,pinnatifi,plan,proximal,rachi,reveal,rounded,ruit,second,sessile,seudostipule,specimen,spot,stamen,straight,stripe,tal,tem,throughout,toward,tuber-bearing,typically,unit,vary,whit,without,ympodial,Â¼	abaxial,absent,adaxial,anther,arrangement,colour,connation,dehiscence,feature,form,fruit,growth,height,history,inflorescence,length,life,na,number,ovary,reproduction,shape,stem,surface,texture,wet,width	0.3-7,0.3-8,0.4-0.7,1-4,1-4.2,1.5-3,1.7-3.2,15-25-30,2,2-3,2.5-4,2.5-6,3-12,3-6,4-10,4-6.5,6-11.5,6-8,9,apical,apically,branched,cell,cm,connate,covering,cyme,dehiscent,diameter,dichasial,dichasially,distal,ebracteate,forked,generally,glandular,globose,hair-like,half,heart-shaped,herbaceous,introrse,lateral,long,make,maturing,mm,monochasial,mucilaginous,odd-pinnate,often,ovoid,perennial,pilose,plant,poricidally,seed,short,slit,stellate,testal,thick,wall,white,wide,yellow	absent,na,wet
389	wfo-0001030430	success	171	106	68	63	108	43	48	20	.2,0.25,anther,anthesi,apart,axillary,base,borne,calyx,capitate,clavate,cm,decurrent,densely,diameter,elliptic,erect,flattened,flower,fruit,glabrous,globose,green,hair,leaf,lobe,lobed,long,longitudinal,margin,mm,moderately,multicellular,oblong,occasionally,opening,ovate,pair,pedicel,peduncle,pentagonal,perennial,petiole,pitted,pubescent,regularly,shallowly,shaped,shoot,shrub,simple,slit,stigma,style,subglabrous,surface,tear-drop,terminal,tip,tube,unifoliate,uniseriate,x	.5,0.3,0.4,0.5,0.5â12,0.6,0.6â0.8,0.6â1.0,0.8â3.0,0.8â5.6,0.9â1.0,0â20,1.0â1.2,1.0â1.5,1.0â2.0,1.2â2.0,1.3â8.0,1.4â1.5,1.5â1.7,1.6â1.8,1.8â5.0,12â20,12â30,1â3,1â9,2.0â3.0,2.0â4.2,2â3,3.0â4.5,30â200,3â17,3â24,3â4,3â5,3â8,5,5.5â12,5â10,5â6,6â10,abaxially,abundant,acute,adaxiall,adaxially,ag,apex,apical,appressed,articulated,axe,ba,basal,blade,blue,branched,brittle,brown,bud,cell,chartaceous,connivent,convex,cylindrical,dentate,diamete,eaf,eed,equal,especially,few-seeded,filament,fleshy,geminat,indumentum,lon,lower,m.,nflorescence,orolla,pale,perfect,pore,poricidal,present,purple,rounded,ruit,serrate,side,spaced,stone,straight,tal,tamen,tem,time,toward,unit,vary,violet,white,wide,woody,yellow,ympodial,â2.7,â40	0-20,0.5-12,0.8-5.6,1-3,1.3-8.0,1.4-1.5,1.6-1.8,12-20,12-30,3-17,3-4,3-5,3-8,30-200,40,5-10,5-6,5.5-12,6-10,abaxial,adaxial,age,arrangement,colour,corolla,feature,form,growth,height,history,inflorescence,length,life,number,ovary,plant,seed,shape,size,spacing,stem,texture,width	.2,0.25,anthesi,apart,axillary,borne,capitate,clavate,cm,decurrent,densely,elliptic,erect,flattened,fruit,glabrous,globose,green,hair,lobe,lobed,long,longitudinal,mm,moderately,multicellular,oblong,occasionally,opening,ovate,pair,pentagonal,perennial,pitted,pubescent,regularly,shallowly,shaped,shoot,shrub,simple,slit,subglabrous,tear-drop,terminal,unifoliate,uniseriate,x	0-20,0.5-12,0.8-5.6,1-3,1.3-8.0,1.4-1.5,1.6-1.8,12-20,12-30,3-17,3-4,3-5,3-8,30-200,40,5-10,5-6,5.5-12,6-10,age
390	wfo-0001030441	success	178	143	94	107	71	36	90	4	+,.5,0.5,0.5-0.75,0.5-3,1,1-2-celled,10-40,2,2-10,2-3,2-5.5,2.5,4-5,5-14,5-7.5,6-11,<,acuminate,acute,along,anther,anthesi,apart,apex,attenuate,base,berry,branched,bright,c.,calyx,capitate,cell,closely,cm,corolla,decurrent,deltate,diameter,ellipsoid,eye,filament,flattened,flower,glabrous,glandular,globose,green,growth,hair,lateral,lengthening,lobe,lobed,long,making,many,margin,midvein,minutely,mm,new,occasionally,onto,open,papillose,pedicel,peduncle,petiole,plant,pore,poricidal,pubescent,red,reflexed,reniform,ridged,ripe,scar,shrub,simple,slightly,slit,spaced,spot,spreading,stellate,stem,stigma,style,surface,terminal,time,tip,triangular,trichome,tube,uniseriate,usually,vine,violet,wall,way,white,wide,woody	0.5-1,1-1.4,1-1.5,1.2-1.4,1.5-2,3-4,30,5-6,5-7,5-merou,>,ag,alyx,ark,articulated,brow,distall,eaf,eed,elliptic,entire,exerted,flexuous,free,fruiting,glabrou,glandula,ilament,impressed,irregularly,juicy,leaving,lon,lower,markedly,membranous,narrowly,nflorescence,older,orolla,otherwise,pair,pale,papillat,peg,per,perfect,pericarp,plurifoliat,portion,primary,ruit,scandent,shiny,short,shrubby,small,somewhat,spreadin,strongly,tem,thin,trailing,ud,undulate,unit,upper,vary,vein,yellow,ympodial	abaxial,adaxial,age,arrangement,bud,coat,colour,connation,distally,dry,embryo,feature,form,fruit,height,inflorescence,leaf,length,midpoint,na,number,ovary,papilla,papillate,prickle,ray,seed,shape,size,spacing,specimen,texture,tuberculation,type,width,young	+,.5,0.5,0.5-0.75,0.5-3,1,1-2-celled,10-40,2,2-10,2-3,2-5.5,2.5,4-5,5-14,5-7.5,6-11,<,acuminate,acute,along,anthesi,apart,attenuate,base,berry,branched,bright,c.,capitate,cell,closely,cm,decurrent,deltate,diameter,ellipsoid,eye,flattened,glabrous,glandular,globose,green,hair,lateral,lengthening,lobe,lobed,long,making,many,margin,midvein,minutely,mm,occasionally,onto,open,papillose,petiole,pore,poricidal,pubescent,red,reflexed,reniform,ridged,ripe,shrub,simple,slightly,slit,spaced,spot,spreading,stellate,terminal,time,tip,triangular,trichome,uniseriate,usually,vine,violet,wall,way,white,wide,woody	age,distally,na,papillate
391	wfo-0001030444	success	196	126	77	98	98	28	74	3	0-24,0.15-0.8,0.8-2,1,1-10,1-2,1-5,1.2-1.8,11-45,2-8,2.4-3.8,3-10,3-5,4-17,4-39,6.1-12.8,7.1-17.5,9.4-20.1,acuminate,acute,anther,apex,attenuate,axillary,base,berry,blue,bud,cell,ciliate,clavate,cm,coriaceous,corolla,covering,dark,deep,diameter,elliptic,filament,flower,forked,fruit,glabrous,green,hair-like,herb,interjected,lanceolate,lateral,leaf,leaflet,lengthening,light,lilac,lobe,long,make,margin,medium,mm,moniliform,mucilaginous,narrow,odd-pinnate,ovate,ovoid,pair,pedicel,peduncle,pentagonal,petiole,petiolulate,plant,pore,poricidal,purple,rotate,rough,rounded,seed,size,slit,sometimes,stigma,style,subtending,terminal,testal,thick,tip,touch,tube,tuber,unwinged,wall,wet,wing	1-4,1.1-2.7,2-3,2-6,2.3-3.6,3.7-6.8,4-7,5-merou,5.3-9,abaxiall,abaxially,acumen,adaxially,ag,along,alyx,apart,apparently,arranged,articulated,asymmetric,axe,basiscopic,bead,blade,brownish,capitat,condition,connivent,decreasing,digestion,distal,dorsally,dot,drying,eaf,edge,eed,enzyme,erec,exceeding,flat,folded,fresh,geminat,general,generally,glabrou,green-white,greenish,hal,half,high,homostylous,honeycomb-shaped,larger,like,linear,living,lower,multiple,necklace,nflorescence,orbicular,orolla,perfect,plurifoliate,removed,ripe,ruit,sessile,seudostipule,shortly,side,spaced,specimen,stamen,stolon,straight,subequal,symmetric,tall,tamen,tem,throughout,tissue,toward,tri-,typically,unit,usually,vary,white,whitish,wide,x,yellow,ympodial	abaxial,adaxial,age,arrangement,calyx,capitate,colour,feature,form,growth,height,history,inflorescence,length,life,na,number,ovary,pseudostipule,reproduction,shape,spacing,stem,surface,texture,type,width,young	0-24,0.15-0.8,0.8-2,1,1-10,1-2,1-5,1.2-1.8,11-45,2-8,2.4-3.8,3-10,3-5,4-17,4-39,6.1-12.8,7.1-17.5,9.4-20.1,acuminate,acute,attenuate,axillary,berry,blue,bud,cell,ciliate,clavate,cm,coriaceous,covering,dark,deep,elliptic,forked,glabrous,green,hair-like,herb,lanceolate,lateral,lengthening,light,lilac,long,make,medium,mm,moniliform,mucilaginous,narrow,odd-pinnate,ovate,ovoid,pentagonal,petiolulate,poricidal,purple,rotate,rough,rounded,seed,slit,sometimes,subtending,terminal,testal,thick,tip,touch,unwinged,wall,wet,wing	age,capitate,na
392	wfo-0001030445	success	226	123	67	84	142	39	64	3	0.2-0.5,0.6-2.2,1-1.3,1-7,1.1-4.3,1.3,1.3-1.8,1.3-2,1.6-2,15-35,2.1-5.2,2.2-2.9,3-5.4,4.1-8.7,5.9-15,6.1-9.1,8.2-18,acuminate,anther,apart,apex,around,articulated,base,berry,black,blunt-tipped,bud,calyx,capitate,cm,corolla,decurrent,deltoid-reniform,drying,elliptic,elliptical,elongated,ferruginous-granular,ferruginous-tomentose,filament,flower,free,fruit,glabrous,globose,green,greyish-tan,leaf,lobe,long,mm,oblong,oblong-lanceolate,obovate,orbicular,ovate,ovate-lanceolate,pedicel,petiole,pore,poricidal,pseudoterminal,pubescence,ray,reniform,reticulate-punctate,shrub,simple,small,stellate,stem,stigma,style,subcampanulate,sulcate,surface,tip,tomentose,tree,tube,x,yellowish,young	.1,.5,/5-2/3,0.1-0.7,0.2,0.2-0.4,0.2-0.7,0.3,0.4,0.5,0.6-3.5,0.7,0.8,1,1.5-2.1,1.7-2.4,1.8-3.5,10-14,10-16,14,2.2-3.5,2.4-4.7,3.1-5,3.4-5.6,3.5-4.2,4.2-10,5-125,5-merou,5.2-7.1,5.9-8.3,7.5-16,8.1-10,abaxial,abaxially,accrescent,acute,adaxially,ag,along,alyx,appressed,axillary,bark,blade,blunt-tippe,branch,branched,brown,brownish-yellow,bulbous-based,concentrated,cylindrical,diameter,directed,distally,eaf,earl,edge,eed,entire,erect,exserted,ferruginous,fruiting,geminate,glabrate,glabrescen,hair,high,homostylous,inserted,intermediate,lackin,lateral,lengthening,lobed,lon,longitudinal,lower,m.,main,many,margin,midrib,midvein,mostly,multangulat,multangulate,nflorescence,obscured,obtuse,older,open,orange,orangish-tan,orolla,peduncle,plurifoliate,porrect-stellat,porrect-stellate,pubescent,rachi,relatively,resorption,rounded,ruit,runk,semi-spherical,sessile,side,slightly,slit,somewhat,soon,spaced,sparse,sparsely,splitting,stalk,stamen,stout,suture,tamen,thick,thick-textured,thicknes,thin,thin-,time,tissue,tomentum,unarme,unit,vary,vein,vestigial-rayed,way,white,wide,yellow,yellowish-tan,ympodial	55-125,anthesi,arrangement,coat,colour,connation,decurrency,dry,embryo,feature,form,growth,height,history,inflorescence,length,life,midpoint,minor,na,new,number,ovary,papilla,plant,prickle,reproduction,scar,seed,shape,size,spacing,specimen,texture,tuberculation,type,unarmed,width,winging	0.2-0.5,0.6-2.2,1-1.3,1-7,1.1-4.3,1.3,1.3-1.8,1.3-2,1.6-2,15-35,2.1-5.2,2.2-2.9,3-5.4,4.1-8.7,5.9-15,6.1-9.1,8.2-18,acuminate,apart,around,articulated,base,berry,black,blunt-tipped,capitate,cm,decurrent,deltoid-reniform,drying,elliptic,elliptical,elongated,ferruginous-granular,ferruginous-tomentose,free,glabrous,globose,green,greyish-tan,long,mm,oblong,oblong-lanceolate,obovate,orbicular,ovate,ovate-lanceolate,poricidal,pseudoterminal,pubescence,reniform,reticulate-punctate,shrub,simple,small,stellate,subcampanulate,sulcate,tip,tomentose,tree,x,yellowish	55-125,na,unarmed
393	wfo-0001030447	success	276	139	85	102	174	37	81	4	.2,.3,/5,0.5-0.65,0.7-1,0.8-3.5,1-10,1.8-2.5,2-4,2.2-2.8,2.5-6.5,6-10,6-16,6.5-9,7-8,acute,age,anther,apart,apex,base,berry,calyx,cell,clavate,cm,corolla,cuneate,cupular,curved,diameter,drying,filament,flattened-reniform,flower,fruit,gently,glabrous,globose,lateral,leaf,length,lengthening,lobe,lobed,long,long-styled,longitudinal,maturity,midpoint,midvein,mm,moderately,narrow-deltate,obconical,oblique,often,orange,orange-brown,orange-red,outline,ovate,pale,pedicel,petiole,pit,pore,poricidal,porrect,prickle,purple,raised,ray,red-brown,rounded,scar,sessile,shortly,shrub,simple,slender,slit,small,sometimes,sparsely,stalked,stellate,stellate-pubescent,stem,stigma,straight,straw-yellow,style,surface,tapering,tip,translucent,trichome,tube,unbranched,white,Ã	.5,0,0.1,0.1-0.3,0.15-0.3,0.2,0.2-0.4,0.4-0.7,0.4-0.9,0.5,0.5-10,0.5-3,0.8-1.7,1,1-1.5,1-2,1-2.5,1-3,1-5,1-6,1.5,1.5-2.5,1.5-7,1/3,1/3-1/2,1/3-2/3,1/4-1/3,2.5-10,3,3-4.5,3-5,30-45Â°,4-8,5,5-15,5-merou,6,6-7,6-8,6-9,8,abaxially,accrescent,adaxially,always,alyx,apar,apical,apically,apparently,armed,articulated,axe,bark,beyond,blade,branche,broad-deltate,c.,characteristically,chartaceous,covering,dark,deltate,densely,development,difoliate,discolorous,distance,divided,eaf,eed,elongating,equal,erect,exserted,extending,filiform,fine,finely,finger-hair,flat,flattened,free,fruiting,geminat,glabrescent,herbaceous,infructescence,irregula,irregular,less,long-ovoi,longer,lower,margin,mature,minute,mostly,nflorescence,oblong,obtuse,older,one,open,opening,orange-translucent,orolla,oung,pair,papillo,peduncle,pendulous,per,perfect,pericarp,persisting,point,portion,primary,pronounced,prostrate,pubescent,rachi,reduced,rest,ri,ridge,ridged,ruit,shallow,shallowly,shiny,short-styled,shorter,side,sinus,smooth,somewhat,spaced,sparse,spherical,spreading,stalk,stout,stump,subsessile,tamen,terete,terminal,tertiary,thick,thin,throughout,time,toward,ud,unarmed,unequal,unit,usually,variously,vary,vein,venation,visible,weakly,wide,widest,woody,x,yellow,yellow-orange,ympodial	anthesi,arrangement,bud,coat,colour,connation,decurrency,dry,feature,form,growth,height,history,inflorescence,life,long-ovoid,minor,new,number,ovary,papilla,papillose,perennial,plant,reproduction,seed,shape,size,spacing,specimen,texture,tuberculation,type,unknown,width,winging,young	.2,.3,/5,0.5-0.65,0.7-1,0.8-3.5,1-10,1.8-2.5,2-4,2.2-2.8,2.5-6.5,6-10,6-16,6.5-9,7-8,acute,age,apart,berry,cell,clavate,cm,cuneate,cupular,curved,diameter,drying,flattened-reniform,flower,gently,glabrous,globose,lateral,length,lengthening,lobed,long,long-styled,longitudinal,maturity,midvein,mm,moderately,narrow-deltate,obconical,oblique,often,orange,orange-brown,orange-red,outline,ovate,pale,pit,poricidal,porrect,purple,raised,red-brown,rounded,sessile,shortly,shrub,simple,slender,slit,small,sometimes,sparsely,stalked,stellate,stellate-pubescent,straight,straw-yellow,tapering,tip,translucent,trichome,unbranched,white,Ã	long-ovoid,papillose,perennial,unknown
394	wfo-0001030453	success	127	113	61	73	54	40	56	5	.25,/4,0.25-0.5,1-1.3,1-1.5,1.5-1.6,1.5-2.5,4-5,9-14,acuminate,acute,anther,apex,arachnoid,arachnoid-pubescent,attenuate,bark,base,broadly,calyx,clavate,closely,cm,corolla,cup-shaped,dark,deflexed,delicate,deltate,dendritic,divided,ellipsoid,elliptic,filament,fine,flat,floccose,glabrous,later,leaf,less,lobe,minute,minutely,mm,narrowly,nearly,opposite,ovary,pedicel,petiole,pore,poricidal,pubescent,rounded,scar,shaped,shrub,simple,slender,spaced,sparsely,stem,stigma,style,surface,tear-drop,tip,trichome,tube,way,white,young	.5,0.8-1.5,3-3.5,9-12,abaxially,adaxially,along,anthesi,axi,densely,dia,eaf,edicel,eed,especially,exserted,free,glabrate,know,known,lateral,lon,long,lower,main,margin,middle,midrib,near,nflorescence,occasionally,older,overlappin,pair,papillat,papillose,planar,portion,reddish,reddish-brow,ruit,shiny,soon,straight,strongly,tall,tub,ud,unifoliat,unit,vein,wide,widest,ympodial	arrangement,bud,coat,colour,connation,decurrency,embryo,feature,flower,form,fruit,growth,height,history,inflorescence,length,life,midpoint,minor,na,new,number,overlapping,papilla,papillate,plant,prickle,ray,reddish-brown,reproduction,seed,shape,size,spacing,texture,tuberculation,type,unifoliate,width,winging	.25,/4,0.25-0.5,1-1.3,1-1.5,1.5-1.6,1.5-2.5,4-5,9-14,acuminate,acute,arachnoid,arachnoid-pubescent,attenuate,base,broadly,clavate,closely,cm,cup-shaped,dark,deflexed,delicate,deltate,dendritic,divided,ellipsoid,elliptic,fine,flat,floccose,glabrous,later,leaf,less,minute,minutely,mm,narrowly,nearly,opposite,poricidal,pubescent,rounded,shaped,shrub,simple,slender,spaced,sparsely,tear-drop,tip,trichome,way,white,young	na,overlapping,papillate,reddish-brown,unifoliate
395	wfo-0001030486	success	141	105	65	78	63	27	61	4	.5,0.8-2.2,1-1.5,1-5,1.1-1.4,1.5-2,10-14.5,2-3,2-5.5,3-3.5,3-5,3/4,4-4.5,4-6.5,6-7,acute,anther,apex,basal,base,berry,calyx,clavate,cm,corolla,dark,deltate,dia,drying,ellipsoid,elliptic,erect,f,filament,fleshy,glabrous,globose,green,internodal,later,leaf,lobe,lobed,minor,minutely,mm,older,opposite,ovary,ovoid-reniform,pale,papillose,pedicel,petiole,pitted,pore,poricidal,shaped,shrub,simple,size,slightly,small,stem,stigma,stout,style,surface,tapering,tear-drop,tip,treelet,tube,way,white,x,yellow-green,young	1.7-2,1/2,1/4,10-12,4.5-5,5-8-flowered,abaxially,adaxially,anthesi,ba,bark,beneath,brown,closely,clustered,completely,conical,deflexed,differing,difoliate,distal,dry,eaf,edicel,eed,exserted,free,fresh,fruiting,geminat,inflorescenc,lateral,lon,long,lower,m.,main,major,margin,material,middle,nflorescence,overlapping,pair,papillo,planar,portion,reddish,ruit,scar,shin,spaced,tall,tan,thickened,tub,ud,unit,usually,vein,widest,woody,ympodial	5-8,abaxial,adaxial,alternate,arrangement,bud,colour,feature,flower,form,fruit,growth,height,history,inflorescence,length,life,na,number,plant,reproduction,seed,shape,shiny,texture,type,width	.5,0.8-2.2,1-1.5,1-5,1.1-1.4,1.5-2,10-14.5,2-3,2-5.5,3-3.5,3-5,3/4,4-4.5,4-6.5,6-7,acute,basal,base,berry,calyx,clavate,cm,dark,deltate,dia,drying,ellipsoid,elliptic,erect,f,fleshy,glabrous,globose,green,internodal,later,leaf,lobed,minutely,mm,opposite,ovoid-reniform,pale,papillose,pitted,poricidal,shaped,shrub,simple,slightly,small,stout,tapering,tear-drop,tip,treelet,tube,way,white,x,yellow-green	5-8,alternate,na,shiny
396	wfo-0001030489	invalid_json	196	130	NA	96	100	34	NA	NA	-6.5,0.25-0.4,0.5-3,0.9-1.1,1-3,1.7-2,1.9-2.6,1/3-1/2,100,12-24,3-8,5,6-8,7-15,acuminate,acute,anther,apart,apex,apical-lateral,bark,base,berry,blunt-tipped,branched,broadly,bud,calyx,chartaceous,cinereous,cm,conical,corolla,dehiscing,deltoid,densely,dichotomously,elliptic,elongate,fleshy,flower,free,fruit,glabrate,globose,greenish,growth,hair,high,honeycombed,introrse,large,leaf,length,lobe,lobed,longitudinal,minutely,mm,oblong,obtuse,ovate-lanceolate,pale,pedicel,petiole,pore,probably,pseudo-terminal,pubescent,pulverulent,reniform,reticulate-punctate,ripe,shrub,simple,slit,small,smooth,somewhat,stellate-pubescent,stellate-rotate,stem,stigma,style,subglobose,suborbicular,tomentose,tree,tube,turn,way,white,x,yellow,yellowish,young	.5-2.8,.5-3,.75-5.25,0.6-0.9,0.75-0.9,1-1.3,1-3.75,1.1-1.3,1.2-1.5,1.2-1.6,1.6-2.1,1.75-2,1/5-1/2,2.1-2.9,3-6,4-8,4.5-9,5-6,abaxially,abruptly,absen,adaxiall,adaxially,ag,anthesi,apparently,appressed,appressed-pubescent,articulated,attenuate,axe,axillary,ba,becoming,blade,branch,brown,closely,continued,cylindrical,diameter,due,eaf,echinoi,echinoid,eed,entire,filament,glabrous,inserted,lateral,long,long-acuminate,long-exserted,lower,main,margin,midvein,minute,mostly,multangulate,narrowly,nflorescence,older,orolla,ovate,peduncle,perfect,plurifoliate,porrect-stellate,puberulent,pulverulen,rachi,ruit,runk,sessile,several,short,short-stalked,side,slender,spaced,sparingly,sparse,subcampanulate,subcapitat,tamen,terete,testa,thick,time,toward,unarme,unarmed,unit,usually,vary,vein,wide,ympodial	abaxial,adaxial,age,arrangement,characteristic,colour,feature,form,green,greyish,hairy,height,hermaphroditic,hirsute,history,inflorescence,life,number,ovary,papilla,perennial,plant,reproduction,seed,shape,size,spacing,subcapitate,surface,texture,tip,type,value,width	NA	NA
397	wfo-0001030509	success	218	137	98	110	108	27	95	3	-6,0-2,0-3,0.1-0.2,0.2,0.3-2.5,0.5-1.5,0.8-1.2,1-1.5,1-2,1-4,1-6,1.3-2,1.7-2,2-2.5,2-3,2-4.5,2-6,2.8-3,2/3-3/4,3-10,4.5-10,7-9,anther,apart,apically,articulated,bark,base,berry,calyx,cm,connivent,curved,densely,entire,erect,filament,flattened-reniform,flower,fruit,glabrescent,glabrous,gland,globular,gray,half,herb,inflated,lateral,leaf,length,lobe,lobed,long,mauve,midpoint,mm,moderately,narrow-deltate,narrow-oblong,occasional,occasionally,often,orange,orange-brown,ovate,pale,pedicel,perpendicular,petiole,plant,poricidal,porrect,prickle,prickly,purple,ray,reduced,scar,shorter,shrub,simple,spaced,sparsely,spherical,spreading,stalk,stalked,stellate,stellate-pubescent,stem,straight,style,surface,tapering,terete,terminal,tip,trichome,tube,unarmed,unbranched,upper,variously,way,wide,yellow,yellow-green,young	/3,0-0.3,0-10,0-100,0-15,0-5,0.1,0.1-0.25,0.1-0.3,0.6-1,0.8-4,1-3,1.5-2,1/,1/3-2/3,1/4,2-4.2,3-4,4.5-12,4.5-8,5-10,5-merous,7-15,8-16,abaxially,alyx,andromonoecious,apar,apex,apical,apparently,becoming,blade,broad-deltate,brow,chartaceous,cordate,cream,cuneate,dark,diameter,difoliate,discolorous,distal,distance,drying,eaf,eed,elongating,equal,extending,eye,free,fruiting,geminat,green,herbaceous,hermaphrodite,heterostylous,infructescence,long-acuminat,long-styled,longer,lower,lowermost,margin,marking,mature,maturity,midvein,naked,nflorescence,obtuse,older,one,open,orolla,oung,pair,peduncle,pendulous,per,pericarp,portion,primary,rounded,ruit,short-styled,shorte,side,slender,smooth,sometimes,staminat,subsessile,tamen,tertiary,time,unarme,unit,usually,vary,vein,venation,visible,weakly,woody,ympodial	abaxial,adaxial,arrangement,brown,colour,connation,corolla,feature,form,growth,height,inflorescence,long-acuminate,na,number,ovary,papilla,pore,seed,shape,size,spacing,stigma,texture,type,width,winging	-6,0-2,0-3,0.1-0.2,0.2,0.3-2.5,0.5-1.5,0.8-1.2,1-1.5,1-2,1-4,1-6,1.3-2,1.7-2,2-2.5,2-3,2-4.5,2-6,2.8-3,2/3-3/4,3-10,4.5-10,7-9,apart,apically,articulated,base,berry,cm,connivent,curved,densely,entire,erect,flattened-reniform,glabrescent,glabrous,gland,globular,gray,half,herb,inflated,lateral,length,lobed,long,mauve,midpoint,mm,moderately,narrow-deltate,narrow-oblong,occasional,occasionally,often,orange,orange-brown,ovate,pale,perpendicular,poricidal,porrect,prickle,prickly,purple,ray,reduced,shorter,shrub,simple,spaced,sparsely,spherical,spreading,stalk,stalked,stellate,stellate-pubescent,stem,straight,surface,tapering,terete,terminal,tip,trichome,unarmed,unbranched,upper,variously,way,wide,yellow,yellow-green	brown,long-acuminate,na
398	wfo-0001030516	success	172	96	56	71	101	25	54	2	0.4-1.5,1-7,1.1-3.5,1.1-4.1,1.5-2,1.8-2.4,2-3,3-8,3-9.8,4-22,4-6,4-7,4.2-10.7,6-15,8-9,9-22,9-32,branched,calyx,cell,cm,connate,corolla,covering,cyme,darker,diameter,dichasial,dichasially,ebracteate,flower,forked,globose,green,hair,hair-like,herbaceous,interjected,lateral,leaf,leaflet,light,long,mm,monochasial,odd-pinnate,ovoid,pedicel,peduncle,pentagonal,perennial,petiole,pilose,plant,puberulent,pubescent,rotate,seed,size,slightly,sometimes,stigma,stripe,style,terminal,testal,thick,triangular,wall,wide,yellow	1-2.5,1-4,1.7,2-12,2-2.,2-4,3-6,3-6-foliat,4-4,abaxially,acumen,acuminate,acute,adaxially,apex,apical,apically,articulate,base,cordate,covered,cuneate,decurrent,dehiscent,densely,digestion,diminished,distal,dorsally,eaf,edge,eed,elliptical,emoval,enzyme,exceeding,filament,first,flat,folded,generally,gland,globo,gradually,green-white,half,honeycomb,introrse,less,living,lobe,lon,long-attenuate,longer,lower,lunat,make,maturing,mucilaginous,nflorescence,nther,oblique,often,orolla,outline,ovate,pair,pattern,perfect,plan,poricidally,proximal,rarely,reveal,ruit,second,sessile,seudostipule,short,short-petiolate,short-stalked,slit,specimen,spreading,stamen,straight,tal,tem,throughout,time,toward,triangulat,tuber-bearing,type,typically,unit,vary,whit,ympodial,Â¼,â	2-21,abaxial,adaxial,anther,arrangement,colour,connation,feature,form,fruit,growth,height,history,inflorescence,length,life,na,number,ovary,reproduction,shape,stem,surface,texture,width	0.4-1.5,1-7,1.1-3.5,1.1-4.1,1.5-2,1.8-2.4,2-3,3-8,3-9.8,4-22,4-6,4-7,4.2-10.7,6-15,8-9,9-22,9-32,branched,cell,cm,connate,covering,cyme,darker,dichasial,dichasially,ebracteate,forked,globose,green,hair-like,herbaceous,lateral,light,long,mm,monochasial,odd-pinnate,ovoid,pentagonal,perennial,pilose,puberulent,pubescent,rotate,slightly,sometimes,stripe,testal,thick,triangular,wall,wide,yellow	2-21,na
399	wfo-0001030551	success	162	110	72	80	82	30	67	5	-5,0-2,0.5-1,0.6-1.5,1-10,1-2,1-2.5,1-3.5,1-4,10-20,2.5-4,20-25-30,3-12,3-5,3-8,abaxially,acuminate,acute,adpressed,also,apart,apex,basal,base,blue,calyx,campanulate,chartaceous,cm,concave,cordate,densely,dia,directed,ellipsoidal,entire,fading,flower,fruit,glandular-puberulent,globose,hair,lanceolate,laterally,lobe,long,margin,mm,moderately,narrowly,oblong-fusiform,obtuse,often,ovoid,pedicel,peduncle,petiole,pilose,pore,puberulent,puberulent-pubescent,pubescent-pilose,rachi,shrub,simple,sparsely,stellate,stigma,style,subcoriaceous,tip,triangular,triangular-elliptic,truncate,tube,unbranched,unknown,violet,x,yellowish	1,1-2-6-12,1-5,1.5-2-3,1.5-2.5,1.5-2.5-5,13.,2,3-4-7,4-10-40,4-5,4-5-6,4-foliat,5-17,5-6,9-20,abruptly,absent,adaxially,aggregate,ape,articulated,axe,beyond,bilobe,blade,broad,cell,clavate,color,connective,diameter,dilated,distally,eaf,ed,equal,et,exceeding,exserted,fleshy,glabrous,leaving,lon,lower,martinelli,narrow,narrowed,nflorescence,nther,orolla,ovate,ovate-elliptic,papillose,pedicellar,perfect,puberulen,pubescent-pilo,radiu,remnant,ripe,round,ruit,seen,shorter,slightly,small,spaced,stamen,stone,tal,tem,thecae,time,tomento,ud,unit,unknow,vary,wide,widening,ympodial	-12,1-6,10-40,4-6,abaxial,adaxial,anther,arrangement,bilobed,bud,colour,corolla,feature,form,growth,height,inflorescence,leaf,length,number,ovary,plant,seed,shape,size,spacing,stem,surface,texture,width	-5,0-2,0.5-1,0.6-1.5,1-10,1-2,1-2.5,1-3.5,1-4,10-20,2.5-4,20-25-30,3-12,3-5,3-8,abaxially,acuminate,acute,adpressed,also,apart,basal,base,blue,campanulate,chartaceous,cm,concave,cordate,densely,dia,directed,ellipsoidal,entire,fading,glandular-puberulent,globose,hair,lanceolate,laterally,lobe,long,mm,moderately,narrowly,oblong-fusiform,obtuse,often,ovoid,pilose,puberulent,puberulent-pubescent,pubescent-pilose,shrub,simple,sparsely,stellate,style,subcoriaceous,triangular,triangular-elliptic,truncate,unbranched,unknown,violet,x,yellowish	-12,1-6,10-40,4-6,bilobed
400	wfo-0001030570	success	170	123	79	89	81	34	76	3	0.3-0.5,1-3,1-4,1-5,1-8,1.5,10-25,15-35,2-5,2-7,2-7-lobed,2-8,2.5-22,20-30,3-10,3-5,4-25,4-5,4-7,acuminate,acute,apart,apex,apiculate,basal,base,calyx,campanulate,cm,connivent,cordate,directed,distally,eglandular,ellipsoidal,entire,flattened,flower,forked,fruit,glabrous,glandular-puberulent,globose,green,hair,lanceolate,leaf,lobe,lobed,long,margin,mm,narrowly,obtuse,occasionally,often,ovoid,pedicel,peduncle,petiole,pilose,pinnately,pore,pubescent,purplish,rachi,rarely,ripe,rounded,rugose,simple,sometimes,sparsely,stellate,stigma,style,submarginally,tip,tree,triangular,truncate,tube,unbranched,unequal,unknown,unlobed,white,x,yellow	.3-0.5-1,0-1-3,0.5-1,0.5-2-3,1,1-1.5,1-2,1-3-6,1.5-2.5,1/2,2-2.5,2-3,2-4,3-6,3.5-5,4-foliat,4/5,5-10-17,8-15-20,abaxially,absent,adaxially,aggregate,ape,articulated,axe,beyond,blade,cell,color,connective,cylindrical,diameter,dilated,divided,eaf,eed,elliptic-oblong,exceeding,exserted,fleshy,glabrat,leaving,lon,lower,midrib,near,nflorescence,nther,orolla,ovate,pedicellar,perfect,pilo,presen,punctate,purpl,radiu,remnant,ruit,shorter,sinus,slightly,small,somewhat,spaced,stamen,stone,subcoriaceous,tal,tem,thecae,time,tomento,truncat,ud,unit,vary,vein,wide,ympodial	1-6,abaxial,adaxial,anther,arrangement,bud,colour,connation,corolla,feature,filament,form,growth,height,hermaphroditic,history,inflorescence,length,life,number,ovary,papilla,perennial,plant,reproduction,seed,shape,size,spacing,stem,surface,texture,type,width	0.3-0.5,1-3,1-4,1-5,1-8,1.5,10-25,15-35,2-5,2-7,2-7-lobed,2-8,2.5-22,20-30,3-10,3-5,4-25,4-5,4-7,acuminate,acute,apart,apex,apiculate,basal,base,campanulate,cm,connivent,cordate,directed,distally,eglandular,ellipsoidal,entire,flattened,forked,glabrous,glandular-puberulent,globose,green,hair,lanceolate,lobe,lobed,long,mm,narrowly,obtuse,occasionally,often,ovoid,pilose,pinnately,pubescent,purplish,rarely,ripe,rounded,rugose,simple,sometimes,sparsely,stellate,submarginally,tip,tree,triangular,truncate,unbranched,unequal,unknown,unlobed,white,x,yellow	1-6,hermaphroditic,perennial
401	wfo-0001030581	success	187	119	64	71	116	48	49	15	.5,1,2,9,acute,anther,anthesi,apex,base,becoming,berry,black,calyx,capitate,central,cm,corolla,decurrent,ellipsoid,elliptic,filament,flattened-reniform,flower,fruit,glabrous,globose,green,growth,herb,inflorescence,intermodal,lateral,leaf,lobe,long,maturity,minute,minutely,mm,narrowly,new,once-branched,ovary,ovate,papillate,pedicel,petiole,pitted,plant,portion,pubescent,purplish,ridge,ripe,scar,simple,somewhat,spreading,stellate,stem,stigma,straight,style,surface,tube,turning,white,wide,winged,woody,yellow	.3,0.2â0.8,0.4â0.6,0.4â1.6,0.5,0.5â0.7,0.5â2.5,0.6â0.7,0.7â0.8,0.9â1,1-4-celled,1.2â1.5,1.8â8,1â2,1â2-celled,1â2.5,1â4-celled,20â50,2â3-celled,35â45,3â4,3â5,4.5â12,4â7,4â9,5-merous,5â6,5â8,abaxial,abaxially,adaxial,adaxially,aggregate,along,angle,angled,apar,appressed,articulated,basal,beyond,branched,bright,cell,clustered,cone,conical,densely,denser,diameter,difoliate,drop,eaf,eed,entire,exserted,florescence,free,fruiting,geminat,halfway,individual,lacking,later,leave,less,like,live,lobed,lon,lower,margin,markedly,near,occasionally,often,outline,pair,peduncle,pentagonal,per,perfect,primary,rachi,reflexe,reflexed,remaining,rounded,ruit,shallow,shiny,shorter,slightly,spaced,sparsely,sprawlin,stone,strongly,tall,tangled,tem,terete,testal,third,translucent,trichome,ud,uniseriate,unit,upper,usually,vein,yellowish,ympodial,â15,â5	0.5-2.5,0.6-0.7,0.9-1,1-2.5,1.2-1.5,1.8-8,15,20-50,3-4,3-5,4-9,4.5-12,5,apart,arrangement,bud,coat,colour,connation,decurrency,dry,feature,form,height,history,length,life,midpoint,minor,na,number,papilla,pore,prickle,ray,reproduction,seed,shape,size,spacing,specimen,texture,tip,tuberculation,type,width,winging,young	.5,1,2,9,acute,becoming,berry,black,capitate,central,cm,decurrent,ellipsoid,elliptic,flattened-reniform,fruit,glabrous,globose,green,herb,intermodal,lateral,long,maturity,minute,minutely,mm,narrowly,once-branched,ovate,papillate,pitted,portion,pubescent,purplish,ridge,ripe,simple,somewhat,spreading,stellate,straight,tube,turning,white,wide,winged,woody,yellow	0.5-2.5,0.6-0.7,0.9-1,1-2.5,1.2-1.5,1.8-8,15,20-50,3-4,3-5,4-9,4.5-12,5,apart,na
402	wfo-0001030583	success	166	133	78	100	66	33	74	4	.2,0.1-0.5,0.2-1,0.3-1,0.4-2.7,0.5-1,0.7-4.5,0.9-3.5,1,1-2,1-8,1.5-4,1/2,2.5-3,2.5-9,3-4,3/4,5-6,acute,anther,anthesi,apex,bark,base,berry,calyx,closely,cm,conical,corolla,deep,deflexed,dendritic,densely,dry,ellipsoid,elliptic,filament,flattened-reniform,flower,form,fruit,glabrous,globose,golden,green,immature,incrassate,leaf,lobe,lobed,long,long-triangular,margin,minor,minutely,mm,narrowly,occasionally,opposite,orange-red,ovary,overlapping,pale,papillose,pedicel,petiole,pitted,plant,pore,poricidal,prostrate,pubescent,ripe,rounded,scar,shaped,shrub,simple,size,small-capitate,spaced,spathulate,specimen,stem,stigma,stout,style,surface,tall,tear-drop,tip,trichome,tube,way,white,woody,x,yellow,young	.5,0.8-1,1-1.5,2.5,4-6,5-7,6-7,abaxial,abaxially,adaxially,along,ba,brow,cell,corky,crisped,cultivar,cultivated,dark,dia,differing,difoliate,eaf,edicel,eed,enlarged,erect,especially,free,frui,fruiting,geminat,included,irregular,lateral,leave,like,live,lon,long-rectangular,lower,main,major,midvein,nflorescence,often,older,outline,pair,papery,papillo,pericarp,planar,portion,rest,ruit,small,soon,tan,testal,thin,ud,uniseriate,unit,vein,ympodial	alternate,arrangement,brown,bud,coat,colour,connation,decurrency,embryo,feature,growth,height,history,inflorescence,length,life,midpoint,na,new,number,papilla,perennial,prickle,ray,reproduction,seed,shape,spacing,texture,tuberculation,type,width,winging	.2,0.1-0.5,0.2-1,0.3-1,0.4-2.7,0.5-1,0.7-4.5,0.9-3.5,1,1-2,1-8,1.5-4,1/2,2.5-3,2.5-9,3-4,3/4,5-6,acute,apex,base,berry,closely,cm,conical,deep,deflexed,dendritic,densely,ellipsoid,elliptic,flattened-reniform,glabrous,globose,golden,green,immature,incrassate,leaf,lobed,long,long-triangular,margin,minutely,mm,narrowly,occasionally,opposite,orange-red,overlapping,pale,papillose,pitted,poricidal,prostrate,pubescent,ripe,rounded,shaped,shrub,simple,small-capitate,spaced,spathulate,stout,tall,tear-drop,tip,trichome,way,white,woody,x,yellow	alternate,brown,na,perennial
403	wfo-0001030605	success	144	125	74	89	55	36	71	3	.5,0.1,0.3-0.5,1,1-4,1.5-5.5,1.7,12-19-flowered,2,2.5,5-12.5,7,abaxially,adaxially,almost,anther,anthesi,apart,area,berry,branched,brown,calyx,cm,commonly,conical,coriaceous,corolla,covered,dark,deflexed,dendritic-echinoid,densely,dia,difoliate,dry,ellipsoid,filament,glabrate,glabrous,globose,gold,green,growth,inflorescence,internodal,leaf,less,lobe,long,minutely,mm,nearly,new,obovate,occasionally,opposite,ovary,ovate,overlapping,ovoid-reniform,pedicel,petiole,pitted,pore,poricidal,pubescent,rarely,scar,shaped,shiny,shrub,simple,slender,smooth,somewhat,sparsely,stigma,style,surface,tear-drop,thickened,tip,trichome,tube,unifoliate,white,woody,x	.4,1.5-2,1/3-1/2,2-3,acute,along,ape,apex,apical,attenuate,base,beginning,beneath,branch,cinereous,cylindrical,drying,eaf,edicel,eed,entire,exerted,free,fruiting,geminat,inflorescenc,light,lobed,lower,margin,material,midrib,nflorescence,obtuse,olive,otherwise,papillate,papillosefruit,peduncle,portion,reflexed,revolute,rounded,scattered,slightly,soon,sparesly,tinged,tub,ud,unit,vein,way,yellow,ympodial	abaxial,adaxial,arrangement,bud,coat,colour,connation,embryo,feature,flower,form,fruit,geminate,hair,height,length,midpoint,na,number,papilla,papillose,plant,prickle,ray,seed,shape,size,spacing,specimen,stem,texture,tuberculation,type,width,winging,young	.5,0.1,0.3-0.5,1,1-4,1.5-5.5,1.7,12-19-flowered,2,2.5,5-12.5,7,abaxially,adaxially,almost,apart,area,berry,branched,brown,cm,commonly,conical,coriaceous,covered,dark,deflexed,dendritic-echinoid,densely,dia,difoliate,ellipsoid,glabrate,glabrous,globose,gold,green,internodal,leaf,less,long,minutely,mm,nearly,obovate,occasionally,opposite,ovate,overlapping,ovoid-reniform,pitted,poricidal,pubescent,rarely,shaped,shiny,shrub,simple,slender,smooth,somewhat,sparsely,style,tear-drop,thickened,tip,trichome,unifoliate,white,woody,x	geminate,na,papillose
404	wfo-0001030624	success	170	129	71	88	82	41	64	7	0.5-1.5,0.9-1,1-3,1.2-2,1.5-2,2-10,2.5-5.5,3-3.5,3.5-4,4.5-8,6-13,acute,anther,anthesi,apex,apiculate,attenuate,bark,base,berry,branch,calyx,clavate,cm,corolla,deflexed,dimorphic,dry,ellipsoid,elliptic,erect,extreme,falcate,filament,flattened-reniform,furcate,glabrate,glabrous,glandular,globose,green,hyaline,large,later,leaf,lobe,lobed,longitudinally,minor,minutely,mm,narrowly,nearly,occasionally,opposite,ovary,papillose,pedicel,petiole,pitted,planar,pore,poricidal,puberulent,round,scar,shining,shrub,simple,size,slender,small,somewhat,square,stem,stigma,style,surface,tip,tree,trunk,tube,white,woody,x,yellowish-green,yellowish-grey,young	.25,.5,0.5,0.5-1,1.2-1.8,2,2-3,25-40-flowered,3,7-9,apart,appearing,axil,ba,beginning,caly,cell,decurrent,dia,differing,difoliate,distal,eaf,edicel,eed,end,except,expanded,exserted,free,fruiting,geminat,greyish,incrassate,inflorescenc,lateral,like,lon,long,lower,main,major,margin,material,middle,midrib,near,nflorescence,older,one,outer,pair,pale,portion,prominent,raised,remaining,rugo,ruit,short,slightly,soon,spaced,straight,tall,tapering,thickened,three,ti,trichome,tuft,two,ud,unevenly,uniseriate,unit,vein,wall,widest,yellow,yellowish,ympodial	1,1.5,25-40,7,abaxial,adaxial,alternate,arrangement,bud,coat,colour,connation,embryo,feature,flower,form,fruit,growth,height,history,inflorescence,length,life,midpoint,na,number,papilla,plant,prickle,ray,reproduction,rugose,seed,shape,spacing,specimen,texture,tuberculation,type,width,winging	0.5-1.5,0.9-1,1-3,1.2-2,1.5-2,2-10,2.5-5.5,3-3.5,3.5-4,4.5-8,6-13,acute,anthesi,apiculate,attenuate,base,berry,clavate,cm,deflexed,dimorphic,ellipsoid,elliptic,erect,extreme,falcate,flattened-reniform,furcate,glabrate,glabrous,glandular,globose,green,hyaline,later,leaf,lobed,longitudinally,minutely,mm,narrowly,nearly,occasionally,opposite,papillose,pitted,planar,poricidal,puberulent,round,shining,shrub,simple,slender,small,somewhat,square,tip,tree,white,woody,x,yellowish-green,yellowish-grey	1,1.5,25-40,7,alternate,na,rugose
405	wfo-0001030638	success	177	113	62	83	94	30	58	4	0.5-1,0.5-1.5,0.7-1.5,1-1.2,1-1.5,1-2,1.4-1.7,1.5-2,2-5,2.5-4,3-10,3-13,8-9,acute,anther,anthesi,apex,apically,bark,base,berry,broadly,bud,calyx,closely,cm,corolla,cucullate,cup-shaped,dry,elliptic,exfoliating,filament,flattened,fruit,glabrate,glabrous,glandular,globose,green,inflorescence,later,leaf,lobe,lobed,minor,minutely,mm,nearly,obovate,opposite,ovary,pale,papillose,pedicel,petiole,pore,poricidal,rugose,scar,seed,shape,shaped,shrub,simple,size,spaced,stem,stigma,style,surface,tapering,tear-drop,terminal,thickening,tip,transversely,tree,tube,white,woody,x,young	0.1,0.5,0.5-0.7,0.5-2,1.6-2.2,2-3,2-7-flowered,4-6,8,8-11,along,appear,appearing,axi,axil,ba,beginning,beneath,blade,branched,conspicuously,corky,deflexed,deltoid,densely,dia,differing,difoliate,eaf,eed,entire,erect,extending,fleshy,free,fruiting,geminat,geminate,gre,impressed,irregular,known,lamina,large,lateral,less,like,lon,long,lower,main,major,margin,material,middle,near,nflorescence,occasionally,often,older,one,open,overlapping,ovoi,pair,paler,papillae,papillo,persistent,planar,portion,present,prominent,rather,red,red-glandular,reddish,rest,roundish,ruit,soon,speciman,straight,tall,thick,thickened,trichome,uniseriate,unit,usually,vein,wall,widest,ympodial	2-7,alternate,arrangement,coat,colour,connation,embryo,feature,flower,form,grey,growth,height,history,length,life,midpoint,na,number,papilla,plant,prickle,ray,reproduction,spacing,specimen,texture,tuberculation,type,width	0.5-1,0.5-1.5,0.7-1.5,1-1.2,1-1.5,1-2,1.4-1.7,1.5-2,2-5,2.5-4,3-10,3-13,8-9,acute,apically,base,berry,broadly,closely,cm,cucullate,cup-shaped,elliptic,exfoliating,flattened,glabrate,glabrous,glandular,globose,green,later,leaf,lobed,minutely,mm,nearly,obovate,opposite,pale,papillose,poricidal,rugose,shaped,shrub,simple,spaced,style,tapering,tear-drop,terminal,thickening,tip,transversely,tree,white,woody,x,young	2-7,alternate,grey,na
406	wfo-0001030661	success	180	140	89	102	78	38	85	4	.5,0.5-0.6,0.5-2,0.7-0.8,1-1.2-7,1-1.3,1-1.5,2-2.5,2-3-20,3-3.5,3-4,4-15,5-10,5-5.5,50-100+,acute,anther,anthesi,apex,attenuate,base,berry,branch,branched,calyx,capitate,clustered,cm,conical,connivent,corolla,deltate,ellipsoid,elliptic,erect,filament,flattened,flower,glabrescent,glabrous,globose,group,growth,inflorescence,lateral,leaf,lengthening,lobe,lobed,long,loosely,many,mature,minute,minutely,mm,narrowly,new,nodding,occasionally,onto,pedicel,petiole,pitted,platform,pore,poricidal,pubescent,red,reniform,scar,scattered,shrub,simple,slender,slightly,slit,small,sparsely,stellate,stem,stigma,strongly,style,surface,terminal,time,tinged,tip,tree,trichome,tube,uniseriate,usually,violet,way,white,winged,woody,x,Â½,Â¾	.2,0,0.5-0.75,1-.,1-1.2,1-1.4,1.5-2,1.5-7,12-16-24,4-6,5-merou,ag,along,alyx,ark,articulated,brow,brown,cell,dar,densely,denser,diameter,drying,eaf,eed,em,entire,erec,exserted,extending,free,fruiting,glabrou,ilament,insertion,lamina,lon,lower,margin,membranous,midrib,near,never,nflorescence,older,orolla,otherwise,pair,pale,papillo,peduncle,per,perfect,pericarp,planar,plurifoliat,point,portion,primary,rectangular,reddish,ruit,shiny,sleeve,spreading,tangled,testal,thin,twinin,ud,unit,upper,vary,vein,yellow,yellowish,ympodial	1-5,age,arrangement,bud,coat,colour,connation,decurrency,dry,feature,form,fruit,height,history,length,life,midpoint,minor,na,number,ovary,papilla,papillose,plant,prickle,ray,reproduction,seed,shape,size,spacing,specimen,texture,tuberculation,type,width,winging,young	.5,0.5-0.6,0.5-2,0.7-0.8,1-1.2-7,1-1.3,1-1.5,2-2.5,2-3-20,3-3.5,3-4,4-15,5-10,5-5.5,50-100+,acute,anthesi,attenuate,base,berry,branch,branched,capitate,clustered,cm,conical,connivent,deltate,ellipsoid,elliptic,erect,flattened,glabrescent,glabrous,globose,group,inflorescence,lateral,lengthening,lobed,long,loosely,many,mature,minute,minutely,mm,narrowly,nodding,occasionally,onto,pitted,platform,poricidal,pubescent,red,reniform,scattered,shrub,simple,slender,slightly,slit,small,sparsely,stellate,stem,strongly,surface,terminal,time,tinged,tip,tree,trichome,uniseriate,usually,violet,way,white,winged,woody,x,Â½,Â¾	1-5,age,na,papillose
407	wfo-0001030676	success	219	129	87	104	115	25	83	4	0.4,1-1.2,1-3,1.2-1.3,1.7-2,14-17,19-35,2.1-2.6,2.2-5.7,2.5-5.5,3-3.5,3-6,4-6,7-8,8-12,abruptly,anther,apart,apex,apical-lateral,articulated,bark,base,becoming,berry,blunt-tipped,brown,bud,calyx,chartaceous,cm,conical,corolla,deltoid,densely,echinoid,elongate,entire,filament,fleshy,flower,fruit,glabrescent,glabrous,globose,granular-tomentose,green,greenish,growth,hair,honeycombed,initially,introrse,large,lateral,leaf,length,lengthen,lobe,longitudinal,margin,mm,moderately,nearly,oblique,oblong,obtuse,often,ovate-lanceolate,pedicel,petiole,pore,probably,pseudo-terminal,pubescent,reniform,reticulate-punctate,ripe,scattered,short-attenuate,shrub,simple,slit,small,somewhat,stellate,stellate-pubescent,stem,stigma,style,subcampanulate,subglobose,suborbicular,testa,tip,tomentose,tree,tube,white,whitish,x,yellow,yellowish,young	-2.5,-3.9,-8.5,/10-1/5,0-100,0.6-1.2-1.6,1,1.1-1.4,1.1-1.9,1.3-1.5,1/4,11-14,16,2.1-2.3,2.4-3.1,2.75-3.25,3-5,4-6.5,7-10,7-9,8-10,abaxially,acute,adaxially,along,angled,anthesi,apparently,appearing,appressed-tomentose,axillary,ba,blade,branch,branched,closely,continued,crown,cylindrical,dehiscing,diameter,dichotomously,due,eaf,echinoi,eed,except,exserted,finely,flat-topped,forming,free,glabrescen,grooved,high,horizontal,inserted,lackin,lamina,lined,lobed,long,longitudinally,lower,main,midvei,midvein,minute,minutely,mostly,multangulate,nflorescence,oblong-elliptic,occasional,older,opening,openly,orolla,ovate,parallel,peduncle,perfect,plurifoliate,pulverulent,rachi,rather,ray,ridged,ruit,runk,scabrous,sessile,short-stalked,side,spaced,sparsely,spreading,strongly,subcapitat,tamen,tending,terete,thick,thin,time,tuft,unarme,unit,usually,vary,vein,velutinous,way,wide,ympodial	50-100,arrangement,colour,feature,form,height,history,inflorescence,life,na,number,ovary,papilla,plant,reproduction,seed,shape,size,spacing,subcapitate,surface,texture,type,unarmed,width	0.4,1-1.2,1-3,1.2-1.3,1.7-2,14-17,19-35,2.1-2.6,2.2-5.7,2.5-5.5,3-3.5,3-6,4-6,7-8,8-12,abruptly,apart,apex,apical-lateral,articulated,base,becoming,berry,blunt-tipped,brown,chartaceous,cm,conical,deltoid,densely,echinoid,elongate,entire,fleshy,glabrescent,glabrous,globose,granular-tomentose,green,greenish,hair,honeycombed,initially,introrse,large,lateral,lengthen,longitudinal,mm,moderately,nearly,oblique,oblong,obtuse,often,ovate-lanceolate,pore,probably,pseudo-terminal,pubescent,reniform,reticulate-punctate,ripe,scattered,short-attenuate,shrub,simple,slit,small,somewhat,stellate,stellate-pubescent,subcampanulate,subglobose,suborbicular,testa,tomentose,tree,white,whitish,x,yellow,yellowish	50-100,na,subcapitate,unarmed
408	wfo-0001030686	success	182	114	69	91	91	23	65	4	.5,1-1.1,1-1.2,1-2,1.2-1.5,1.5-4.5,1.6-3,15,2-2.5,2-6.5,2.5-8,3-3.5,5-12,5-25,5-30,5-6,abruptly,acuminate,acute,age,anther,apex,bark,base,berry,bifid,black,brown,calyx,cm,conical,corolla,cup-shaped,dark,deeply,densely,denser,diameter,dry,drying,elliptic,filament,flattened,flower,form,fruit,globose,height,internodal,leaf,leaf-opposed,lengthening,lepidote,lilac,lobe,lobed,midrib,minutely,mm,oblique,orange,ovary,pale,paler,papillose,pedicel,peduncle,petiole,pitted,plant,poricidal,pubescent,purple,seed,shallowly,simple,slit,somewhat,sparsely,spreading,stem,stigma,style,surface,tip,tree,tube,usually,woody,x,yellow	.2,.5-1,0.5-1,1-1.5,1.5-2,1972,2-3,2.5-4,8-9,?,abaxially,aborted,adam,adaxially,anthesi,apart,basal,beneath,branched,breast,brittle,bu,c.,centre,closely,darker,different,difoliate,discolorous,eaf,edicel,eed,empty,entire,erect,exerted,fide,fragrant,free,fruiting,geminat,glabrescen,glabrous,golden,half,heteromorphic,lamina,less,long,lower,many,margin,maturity,midvein,nflorescence,noddin,older,overlapping,pair,papillae,pericarp,planar,pore,portion,primary,pubescen,rachi,ruit,scar,scarious,shallow,shiny,short,slightly,space,spaced,stellate,strongly,styl,thin,time,tissue,trichome,ud,uniformly,unit,vein,visible,way,ympodial,â	abaxial,adaxial,arrangement,bud,colour,feature,glabrescent,growth,history,inflorescence,length,life,na,nodding,number,perennial,reproduction,shape,size,specimen,texture,type,width	.5,1-1.1,1-1.2,1-2,1.2-1.5,1.5-4.5,1.6-3,15,2-2.5,2-6.5,2.5-8,3-3.5,5-12,5-25,5-30,5-6,abruptly,acuminate,acute,age,berry,bifid,black,brown,cm,conical,cup-shaped,dark,deeply,densely,denser,drying,elliptic,flattened,globose,internodal,leaf-opposed,lengthening,lepidote,lilac,lobe,lobed,minutely,mm,oblique,orange,pale,paler,papillose,pitted,poricidal,pubescent,purple,shallowly,simple,slit,somewhat,sparsely,spreading,tip,tree,usually,woody,x,yellow	glabrescent,na,nodding,perennial
409	wfo-0001030709	success	214	147	95	110	104	37	92	3	-9,0-2,0-5,0.2-0.5,0.3-1.5,0.4,0.7-1,1-1.2,1-1.6,1-4.5,1-6,1.3-1.4,1.6-2.1,1.9-2.8,1/3-1/2,1/4,2-6,5-10,5-6,6-10,6-21,8-15,acuminate,acute,almost,ame,anther,apart,apex,apically,apparently,articulated,bark,base,berry,bright,broad-deltate,c.,calyx,cm,conical,connivent,cordate,cuspidate,diameter,elliptic,erect,filament,finely,flattened-reniform,flower,fruit,glabrescent,glabrous,inflorescence,lateral,leaf,length,lobe,lobed,long,maturity,mauve,middle,midpoint,mm,moderately,narrow-deltate,pedicel,pendulous,perpendicular,petiole,pitted,poricidal,porrect,prickle,prickly,purple,ray,red-orange,retrorse,scar,seed,shrub,simple,size,smooth,sometimes,sparsely,spherical,stalked,stellate,stellate-pubescent,stem,straight,style,surface,tapering,terete,terminal,tip,trichome,truncate,tube,upper,variously,way,wide,woody,yellow	0-2-8,0-20,0-30,0.1-0.2,0.15-0.5,0.8-4,0.9-1.5,1.4-2,1/2-2/3,1/4-1/3,10-14,10-50,2-4,2-5,2.3-3,2/3-3/4,3-5-9,4-5-merous,5-20,5-7,6-7,6-8,7-8,7-9,8-11,abaxially,adaxially,alyx,apar,ape,blade,branched,brow,chartaceous,deltate,discolorous,distance,drying,dull,eaf,edge,eed,elongating,equal,extending,free,fruiting,increasing,infructescence,lanceolate,lengt,lobing,lon,long-acuminat,longer,lower,margin,mature,midvein,nflorescence,occasionally,often,older,one,open,orange-brown,orolla,oung,pair,peduncle,per,perfect,pericarp,pit,plurifoliat,portion,prickl,primary,red-green,reflexed,rounded,ruit,secondary,short-styled,shorter,side,slender,spaced,spreading,stalk,tamen,tertiary,time,toward,unarmed,unit,usually,vary,vein,venation,visible,weakly,yellow-green,ympodial	anthesi,arrangement,brown,bud,coat,colour,connation,corolla,decurrency,dry,embryo,feature,form,growth,height,history,life,long-acuminate,minor,na,new,number,ovary,papilla,plant,pore,reproduction,shape,spacing,specimen,stigma,texture,tuberculation,type,width,winging,young	-9,0-2,0-5,0.2-0.5,0.3-1.5,0.4,0.7-1,1-1.2,1-1.6,1-4.5,1-6,1.3-1.4,1.6-2.1,1.9-2.8,1/3-1/2,1/4,2-6,5-10,5-6,6-10,6-21,8-15,acuminate,acute,almost,ame,apart,apically,apparently,articulated,base,berry,bright,broad-deltate,c.,cm,conical,connivent,cordate,cuspidate,diameter,elliptic,erect,finely,flattened-reniform,glabrescent,glabrous,lateral,length,lobed,long,maturity,mauve,middle,mm,moderately,narrow-deltate,pendulous,perpendicular,pitted,poricidal,porrect,prickle,prickly,purple,ray,red-orange,retrorse,seed,shrub,simple,smooth,sometimes,sparsely,spherical,stalked,stellate,stellate-pubescent,stem,straight,tapering,terete,terminal,tip,trichome,truncate,upper,variously,way,wide,woody,yellow	brown,long-acuminate,na
410	wfo-0001030714	success	177	124	92	106	71	18	89	3	.2,.5,/3,0.1-0.3,0.5,0.5-1.9-3,0.7-0.8,1-1.3,1-2.5,1.2-1.5,1.2-4,1.4-3.5,1.5-2,2-2.5,3-7,5-100,7-17,abaxial,acuminate,acute,adaxially,age,aid,along,anther,apex,bark,base,becoming,beneath,berry,blue,blue-black,branching,clavate,cm,cordate,corolla,dark,diameter,ellipsoid,elliptic,especially,except,filament,flattened,flower,fruit,glabrous,globose,greyish,growth,herbaceous,leaf-opposed,lengthening,liana,lobed,many,midrib,minute,minutely,mm,narrowly,new,ob-ellipsoid,ob-elliptic,oblique,occasionally,ovary,overall,pale,papillate,pedicel,peduncle,petiole,pitted,pore,poricidal,pubescent,reniform,ripe,scar,shape,simple,slightly,slit,sparsely,stellate,stem,stigma,style,surface,terminal,time,tip,trichome,truncate,tube,twining,uniseriate,vein,vine,violet,way,woody,x	0.3-0.4,0.5-0.8,0.8-1,1-1.2,1-1.5,1/3,2-2.6,20,3-3.5,5-6,>,abaxially,anthesi,apar,articulating,basal,calyx,campanulate,climbin,conical,cup,densely,denser,eaf,eed,entire,exserted,fide,free,grading,gradually,gree,howard,joined,leaving,like,lobe,long,lower,margin,membranous,narrow,nflorescence,nodding,node,older,pair,paler,papillat,pedice,peg,per,perfect,planar,plurifoliat,portion,primary,prominent,quadrate,ruit,spaced,strongly,submarginal,tapering,thickened,tub,ud,unit,widely,yellow,ympodial	adaxial,apart,arrangement,bud,climbing,colour,feature,form,green,inflorescence,leaf,length,seed,size,spacing,texture,type,width	.2,.5,/3,0.1-0.3,0.5,0.5-1.9-3,0.7-0.8,1-1.3,1-2.5,1.2-1.5,1.2-4,1.4-3.5,1.5-2,2-2.5,3-7,5-100,7-17,acuminate,acute,adaxially,age,aid,along,apex,base,becoming,beneath,berry,blue,blue-black,branching,clavate,cm,cordate,dark,diameter,ellipsoid,elliptic,especially,except,flattened,flower,glabrous,globose,greyish,herbaceous,leaf-opposed,lengthening,liana,lobed,many,midrib,minute,minutely,mm,narrowly,ob-ellipsoid,ob-elliptic,oblique,occasionally,overall,pale,papillate,pitted,pore,poricidal,pubescent,reniform,ripe,shape,simple,slightly,slit,sparsely,stellate,surface,terminal,time,tip,trichome,truncate,twining,uniseriate,vein,vine,violet,way,woody,x	apart,climbing,green
411	wfo-0001030733	success	130	124	69	81	49	43	62	7	/4,0.5-1,1-1.2,1-1.5,1-2,1.5-5,2-2.5,3-4,3-5,4-15,6-7,acuminate,acute,anther,anthesi,apex,bark,base,berry,bi-lobed,broadly,calyx,capitate,clearly,closely,cm,conical,corolla,decurrent,deltate,densely,ellipsoid,elliptic,embryo,erect,filament,glabrous,globose,green,later,leaf,lobe,lobed,long,minutely,mm,narrowly,onto,opposite,ovary,ovoid-reniform,pedicel,petiole,pore,poricidal,pubescent,rounded,scar,shaped,shrub,simple,smooth,somewhat,spaced,stem,stigma,style,surface,tear-drop,testa,tip,treelet,trichome,tube,uniseriate,visible,way,white,woody,x,young	.5,1.7-2.7,4.5-5,5-8-flowered,6-9,?,abaxially,adaxially,along,ape,brown,coriaceous,dark,denser,dia,eaf,eed,elongate,exserted,free,fruiting,grayish-brow,lamina,lateral,like,lon,lower,main,margin,middle,moderately,nflorescence,older,overlappin,pair,papillo,planar,portion,ruit,sparsely,strongly,tall,thick,ud,unifoliat,unit,vein,widest,ympodial	0.5,5-8,arrangement,bud,coat,colour,connation,decurrency,dry,feature,flower,form,fruit,grayish-brown,growth,height,history,inflorescence,length,life,midpoint,minor,na,new,number,overlapping,papilla,papillose,plant,prickle,ray,reproduction,seed,shape,size,spacing,specimen,texture,tuberculation,type,unifoliate,width,winging	/4,0.5-1,1-1.2,1-1.5,1-2,1.5-5,2-2.5,3-4,3-5,4-15,6-7,acuminate,acute,base,berry,bi-lobed,broadly,capitate,clearly,closely,cm,conical,decurrent,deltate,densely,ellipsoid,elliptic,erect,glabrous,globose,green,later,leaf,lobed,long,minutely,mm,narrowly,onto,opposite,ovoid-reniform,petiole,poricidal,pubescent,rounded,shaped,shrub,simple,smooth,somewhat,spaced,tear-drop,testa,tip,treelet,trichome,uniseriate,visible,way,white,woody,x	0.5,5-8,grayish-brown,na,overlapping,papillose,unifoliate
412	wfo-0001030772	success	154	120	65	84	70	36	62	3	.25,0.2-0.8-2,0.25-0.5,0.5-1,0.9-1,0.9-3.1,1-2,1-2.5,1.2-5,1.4-1.6,2-7,3-3.5,3-5,4.2-6.5,9-15,acute,anther,anthesi,apex,attenuate,bark,base,becoming,berry,bud,calyx,capitate,closely,cm,corolla,dark,deflexed,ellipsoid,elliptic,erect,filament,fruit,glabrous,globose,green,grey,later,leaf,lenticellate,lobe,lobed,long-acuminate,long-triangular,minor,minutely,mm,nearly,occasionally,opposite,ovary,overlapping,ovoid-reniform,pale,paler,papillose,pedicel,petiole,pitted,pore,poricidal,rounded,scar,shape,shaped,shrub,simple,size,spaced,stem,stigma,style,surface,tear-drop,tip,tube,white,woody,x,young	.05,.2,.5,0.75-1,1.5-2,5-10-flowered,5-6,8-10,acuminate,archin,ba,beginning,beneath,branch,dia,differing,difoliate,eaf,edicel,eed,extreme,free,fruiting,geminat,gently,impressed,inflorescenc,large,lateral,lon,long,lower,main,major,margin,methyl,middle,nflorescence,node,older,one,pair,papillo,per,portion,prominent,reflexed,ripe,ruit,salicylate,shining,slender,slightly,smelling,soon,straight,strongly,swollen,tall,tan,tapering,trichome,ud,uniseriate,unit,usually,vein,widest,wintergreen,ympodial	5-10,abaxial,adaxial,alternate,arrangement,coat,colour,connation,dry,embryo,feature,flower,form,growth,height,history,inflorescence,length,life,midpoint,na,new,number,papilla,plant,prickle,ray,reproduction,seed,spacing,specimen,texture,tuberculation,type,width,winging	.25,0.2-0.8-2,0.25-0.5,0.5-1,0.9-1,0.9-3.1,1-2,1-2.5,1.2-5,1.4-1.6,2-7,3-3.5,3-5,4.2-6.5,9-15,acute,attenuate,base,becoming,berry,bud,capitate,closely,cm,dark,deflexed,ellipsoid,elliptic,erect,glabrous,globose,green,grey,later,leaf,lenticellate,lobed,long-acuminate,long-triangular,minutely,mm,nearly,occasionally,opposite,overlapping,ovoid-reniform,pale,paler,papillose,pitted,poricidal,rounded,shaped,shrub,simple,spaced,tear-drop,tip,white,woody,x,young	5-10,alternate,na
413	wfo-0001030781	success	213	140	91	108	105	32	86	5	0-5,1-10,1-12,1-2,1.5-2,1.5-9,1.6-2.2,10-40,15-35,2-20,2.5-14,2.5-3.5,3-4,4-15,5-7,6-7,7.5-9,abaxially,adaxially,anther,axillary,base,borne,broadly,brown,bud,chartaceous,cm,connivent,corolla,cuneate,dark,deep,densely,diameter,digestion,dot,elliptic,end,enzyme,filament,finely,flower,fruit,glabrous,glandular,globose,gray-green,green,hair,herb,homostylous,honeycomb-shaped,interjected,lanceolate,lateral,leaf,leaflet,light,like,lobe,long,membranous,mm,obovate,odd-pinnate,ovate,ovate-lanceolate,ovoid,pair,pedicel,peduncle,pentagonal,pilose,plant,pore,poricidal,pubescent,purple,rarely,removed,rotate-pentagonal,scattered,seed,simple,singly,size,small,sometimes,somewhat,sparsely,stem,stigma,style,subovoid,subtending,terminal,tip,tube,tuber,typically,unwinged,violet,wall,white,wide,x,yellow	0.2-4,0.5-6,0.5-8,1-1.5,1-4,1-8,1.5-12,2-3,3-6,5-6,5-8,5-merou,abruptly,acumen,ag,along,alyx,apart,apex,apiculate,apparently,articulated,axe,berry,blade,brownish,caly,capitat,cell,ciliate,condition,covering,decreasing,decurrent,distal,dorsally,drying,eaf,edge,eed,erect,especially,exceeding,flat,folded,forked,fresh,geminat,generally,glabrou,gradually,green-white,greenish,hair-like,half,high,larger,lengthening,living,low-growin,lower,make,margin,midrib,minutely,mucilaginous,narrowed,nflorescence,orbicular,orolla,papillose,perfect,petiole,petiolulate,plurifoliate,pointed,puberulent,rachi,rounded,ruit,sessile,seudostipule,short,slightly,slit,spaced,specimen,stamen,ste,stolo,straight,tall,tamen,tem,testal,thick,throughout,toward,tri-,unit,usually,vary,wet,whitish,ympodial	5-merous,abaxial,adaxial,arrangement,calyx,capitate,coat,colour,connation,feature,form,growth,height,history,inflorescence,length,life,na,number,ovary,perennial,pilosity,presence,pseudostipule,reproduction,shape,spacing,stolon,surface,texture,tuberculation,type	0-5,1-10,1-12,1-2,1.5-2,1.5-9,1.6-2.2,10-40,15-35,2-20,2.5-14,2.5-3.5,3-4,4-15,5-7,6-7,7.5-9,abaxially,adaxially,axillary,borne,broadly,brown,bud,chartaceous,cm,connivent,cuneate,dark,deep,densely,digestion,dot,elliptic,end,enzyme,finely,glabrous,glandular,globose,gray-green,green,hair,herb,homostylous,honeycomb-shaped,lanceolate,lateral,light,like,long,membranous,mm,obovate,odd-pinnate,ovate,ovate-lanceolate,ovoid,pentagonal,pilose,poricidal,pubescent,purple,rarely,removed,rotate-pentagonal,scattered,simple,singly,small,sometimes,somewhat,sparsely,stem,subovoid,subtending,terminal,tip,typically,unwinged,violet,wall,white,wide,x,yellow	5-merous,capitate,na,perennial,stolon
414	wfo-0001030782	success	198	137	97	111	87	26	93	4	0-1,0-7,0.4-1.5,1-2,1-3,1.3-1.6,1.5-2,1.6-4.6,11-47,12-30,15,2,2-3,2.2-4,3-10,4-11.6,4-6,4.6-26,5-20,7-15.6,abaxially,acumen,acuminate,adaxially,anther,apex,axillary,base,blade,broadly,bud,cell,clavate,cm,connivent,coriaceous,corolla,covering,cuneate,dark,decreasing,deep,diameter,elliptic,filament,flower,forked,fruit,glabrescent,glabrous,globose,green,green-white,hair,hair-like,herb,homostylous,interjected,lanceolate,lateral,leaf,leaflet,lengthening,light,lilac,lobe,long,make,medium,mm,moniliform,mottled,mucilaginous,odd-pinnate,orbicular,ovate,ovoid,pentagonal,petiole,plant,poricidal,prominently,purple,rachi,ripe,rotate,scarce,seed,short,size,slit,stigma,straight,style,subtending,terminal,testal,thick,throughout,tip,toward,tube,tuber,usually,wall,wet,white,wide,winged,x,yellow	1-5,1-6,1.2-3.9,1.5-7.5,13-22,2.4-11.5,3-5,5-merou,6-8,abaxiall,acute,ag,along,alyx,apart,apparently,arranged,articulated,asymmetric,attenuate,axe,basiscopic,bead,berry,brownish,capitat,condition,digestion,distal,dorsally,drying,eaf,edge,eed,enzyme,exceeding,flat,folded,fresh,geminat,generally,glabrou,greenish,hal,half,high,honeycomb-shaped,inconspicuous,like,living,lower,multiple,necklace,nflorescence,orolla,pair,pedicel,peduncle,perfect,petiolulate,plurifoliate,pore,removed,rounded,ruit,second,sessile,seudostipule,side,smaller,sometimes,spaced,specimen,stamen,stolon,subequal,tal,tamen,tem,tissue,totally,tri-,typically,unit,vary,whitish,ympodial	5-merous,abaxial,adaxial,age,arrangement,calyx,capitate,colour,feature,form,growth,height,history,inflorescence,length,life,na,number,ovary,pseudostipule,reproduction,shape,stem,surface,texture,type	0-1,0-7,0.4-1.5,1-2,1-3,1.3-1.6,1.5-2,1.6-4.6,11-47,12-30,15,2,2-3,2.2-4,3-10,4-11.6,4-6,4.6-26,5-20,7-15.6,abaxially,acumen,acuminate,adaxially,axillary,base,broadly,bud,cell,clavate,cm,connivent,coriaceous,covering,cuneate,dark,decreasing,deep,elliptic,forked,glabrescent,glabrous,globose,green,green-white,hair,hair-like,herb,homostylous,lanceolate,lateral,leaf,lengthening,light,lilac,long,make,medium,mm,moniliform,mottled,mucilaginous,odd-pinnate,orbicular,ovate,ovoid,pentagonal,poricidal,prominently,purple,ripe,rotate,scarce,seed,short,size,slit,straight,subtending,terminal,testal,thick,throughout,tip,toward,usually,wall,wet,white,wide,winged,x,yellow	5-merous,age,capitate,na
415	wfo-0001030802	success	171	120	73	93	78	27	71	2	.3,.5,0.5-1,0.5-1.5,1,1-1.1,1-1.2,1-1.5,2-3,2-5,2.5-3,3-4,3-6,5-10-flowered,anther,anthesi,bark,base,berry,brown,bud,calyx,campanulate,cm,corolla,deflexed,dia,difoliate,dry,exudate,filament,filiform,flattened-reniform,fruit,glabrous,gland,glandular,globose,halfway,heart-shaped,internodal,irregularly,lamina,leaf,length,lobe,lobed,long,long-triangular,minutely,mm,older,ovary,ovoid,pale,papillate,pedicel,petiole,pitted,plant,pore,poricidal,pubescent,red,reddish,scar,shaped,shrub,simple,single-celled,somewhat,spaced,specimen,stem,stigma,strongly,style,subshrub,surface,tear-drop,tip,tipped,trichome,tube,unifoliate,uniseriate,variable,vein,white,widely,x,yellowish,young	.5mm,0,0.25-0.4,0.5-0.75,0.7-1cm,0.75-1,0.9-1,2-2.5,3-3.5x,4-5mm,4-6,abaxially,abrupt,acuminate,acute,adaxially,along,apex,appearing,basal,becoming,beginning,beneath,cordate,cucullate,deeply,densely,denser,eaf,edicel,eed,ellipsoid,evenly,except,exerted,free,fruiting,geminat,glandurla,hanging,incrassate,inflorescenc,invest,later,lateral,line,live,lower,m.,main,margin,markedly,material,midvein,near,nflorescence,obconic,pair,palmate,papillose,per,persistently,portion,prominent,pubescen,raised,ruit,slender,soon,stigm,straight,tapering,trichoem,ud,unit,woody,yellow,ympodial	4-5,abaxial,adaxial,arrangement,coat,colour,connation,feature,flower,form,growth,height,inflorescence,midpoint,na,number,papilla,prickle,ray,seed,shape,size,spacing,texture,tuberculation,type,width	.3,.5,0.5-1,0.5-1.5,1,1-1.1,1-1.2,1-1.5,2-3,2-5,2.5-3,3-4,3-6,5-10-flowered,anthesi,base,berry,brown,campanulate,cm,deflexed,dia,difoliate,exudate,filiform,flattened-reniform,glabrous,gland,glandular,globose,halfway,heart-shaped,internodal,irregularly,lamina,length,lobed,long,long-triangular,minutely,mm,ovoid,pale,papillate,pitted,poricidal,pubescent,red,reddish,shaped,shrub,simple,single-celled,somewhat,spaced,stigma,strongly,subshrub,surface,tear-drop,tip,tipped,trichome,unifoliate,uniseriate,variable,vein,white,widely,x,yellowish	4-5,na
416	wfo-0001030809	success	154	132	81	88	66	44	72	9	.5,0.5-1,1-1.5,1.4-1.5,1.5-2.4,1.5-3.5,2-2.5,2.3-5.5,4.5-5,5-8,6-8,8,9.9-12,acute,anther,anthesi,apex,appearing,bark,base,berry,branched,broadly,calyx,campanulate,clavate,cm,corolla,curl-tipped,deflexed,deltoid,dia,ellipsoid,elliptic,erect,falcate,filament,fruit,glabrous,globose,golden,green,hair,leaf,lobe,lobed,long,minor,minutely,mm,nearly,opposite,ovary,ovate,overtopping,pedicel,petiole,planar,pore,poricidal,round,scar,several,shining,shoot,simple,size,slender,slightly,small,stem,stigma,style,tapering,terminal,time,tip,tomentose,tree,triangular,trichome,tube,unequal,uniseriate,white,x,yellow-brown,young	0.2,1-1.25,1.2-1.4,20-60-flowered,across,along,also,apar,beneath,caly,curved,dark-papillo,deciduous,dense,densely,difoliate,distally,eaf,edicel,eed,especially,evenly,exserted,free,fruiting,geminat,hidden,interpetalar,known,large,lateral,leave,like,lon,long-papillose,lower,main,major,markedly,mature,membranous,middle,midrib,nflorescence,older,one,portion,present,pubescent,ruit,scattered,shinin,sinus,soon,spaced,straight,tall,three,two,ud,underside,unit,vein,wide,widest,ympodial	0.5,1,1.5,20-60,alternate,apart,arrangement,bud,coat,colour,connation,dark-papillose,decurrency,dry,embryo,feature,flower,form,growth,height,history,inflorescence,length,life,midpoint,na,new,number,papilla,perennial,plant,prickle,ray,reproduction,seed,shape,spacing,specimen,surface,texture,tuberculation,type,width,winging	.5,0.5-1,1-1.5,1.4-1.5,1.5-2.4,1.5-3.5,2-2.5,2.3-5.5,4.5-5,5-8,6-8,8,9.9-12,acute,anthesi,appearing,base,berry,branched,broadly,calyx,campanulate,clavate,cm,curl-tipped,deflexed,deltoid,dia,ellipsoid,elliptic,erect,falcate,glabrous,globose,golden,green,hair,leaf,lobe,lobed,long,minutely,mm,nearly,opposite,ovate,overtopping,planar,poricidal,round,several,shining,shoot,simple,size,slender,slightly,small,tapering,terminal,time,tip,tomentose,tree,triangular,trichome,tube,unequal,uniseriate,white,x,yellow-brown	0.5,1,1.5,20-60,alternate,apart,dark-papillose,na,perennial
417	wfo-0001030810	success	191	111	74	69	122	42	53	21	0.2,anther,axillary,bipinnate,blue,borne,branched,calyx,chartaceous,clavate,cm,colour,densely,diameter,elliptic,elliptical,erect,flattened,flower,fruit,glabrous,globose,green,greyish,hair,leaf,leafy,lobe,long,longitudinal,mm,moderately,multicellular,oblong,occasionally,opening,opposed,pedicel,peduncle,pentagonal,petiole,pinnate,pitted,plurifoliate,pubescent,shallowly,shaped,shoot,shrub,simple,size,slit,stem,stigma,style,subglabrous,surface,tardily,tear-drop,time,tip,tomentose,tube,unicellular,uniseriate,unknown,violet,woody,x	0.2â0.3,0.3,0.4,0.5â,0.5â0.8,0.6â1.0,0.7â1.4,0.8â5.5,0.95â2.0,0â,1,1.0â1.5,1.0â2.0,1.0â3.0,1.1â2.0,1.1â2.2,1.2â1.5,1.5â1.9,1â2,1â3,1â5,2.9â4.5,20â100,2â3,2â4,3.0â5.0,3.3â5.5,3.3â8.5,3.5â4.6,3â19,4â14,4â5,4â7,5,5â15,5â30,5â32,6â10,6â22,7â10,7â11,8â10,abaxially,absen,accrescent,acute,adaxiall,adaxially,ag,along,anthesi,apart,apex,articulated,axe,ba,base,blade,brown,cell,connivent,cylindrical,dark,decreasing,denser,divided,eaf,eed,equal,especially,filament,fleshy,geminat,half,hig,indumentum,irregular,lon,lower,m.,margin,midrib,midvein,narrow,nflorescence,obtu,older,orolla,oung,pair,pale,perfect,pinnae,pore,poricidal,primary,rarely,reflexed,rounded,ruit,secondary,shiny,side,sometimes,spaced,sparsely,stone,straight,tamen,unit,vary,white,wide,wing,yellow,ympodial,â2.5,â3,â3.4,â4.5,â5.0,â8	0.2-0.3,0.8-5.5,1-2,1.0-1.5,1.2-1.5,1.5-1.9,20-100,3,3.3-5.5,3.3-8.5,4-14,4-7,5-32,6-10,6-22,7-10,7-11,8-10,abaxial,adaxial,age,arrangement,corolla,feature,form,geminate,growth,height,history,inflorescence,length,life,na,number,ovary,plant,reproduction,seed,shape,texture,width,young	0.2,axillary,bipinnate,blue,borne,branched,chartaceous,clavate,cm,densely,diameter,elliptic,elliptical,erect,flattened,glabrous,globose,green,greyish,hair,leaf,leafy,long,longitudinal,mm,moderately,multicellular,oblong,occasionally,opening,opposed,pentagonal,pinnate,pitted,plurifoliate,pubescent,shallowly,shaped,shoot,shrub,simple,slit,subglabrous,tardily,tear-drop,time,tomentose,unicellular,uniseriate,unknown,violet,woody,x	0.2-0.3,0.8-5.5,1-2,1.0-1.5,1.2-1.5,1.5-1.9,20-100,3,3.3-5.5,3.3-8.5,4-14,4-7,5-32,6-10,6-22,7-10,7-11,8-10,age,geminate,na
418	wfo-0001030822	success	146	117	62	81	65	36	60	2	0.1-0.2,0.4-1,0.5-1.5,0.8-1,0.9-1,1.5-2,11-15.5,2-2.5,2-3.8,2-5,3-3.5,3-5,3.5-7,5-6,5-7,acute,anther,anthesi,apex,attenuate,base,berry,calyx,clavate,closely,cm,completely,corolla,decurrent,deflexed,elliptic-obovate,filament,filiform,flattened-reniform,flower,glabrous,globose,green,inflorescence,internodal,later,leaf,lobe,lobed,long-ellipsoid,minor,minutely,mm,nearly,occasionally,opposite,ovary,papillose,pedicel,petiole,pitted,planar,pore,poricidal,scar,shaped,shiny,shrub,simple,size,spaced,stem,stigma,strongly,style,surface,tear-drop,tip,tube,usually,white,winged,woody,x,yellowish-brown,young	.2,0-0.5,0.4,1-1.2,1-1.5,8-9,abaxially,adaxially,ba,beneath,broadly,clustered,cucullat,cucullate,cup,deltate,dia,differing,difoliate,eaf,edicel,eed,erect,exserted,fleshy,free,fruiting,geminat,incrassate,inflorescenc,lateral,lon,long,lower,main,major,margin,middle,minute,near,nflorescence,older,onto,open,pair,pale,papillo,perhaps,portion,present,red-papillose,revolute,ruit,slightly,somewhat,sparsely,tall,tan,tapering,ud,unit,vein,widest,yellowish,ympodial	0.2,arrangement,bark,bud,coat,colour,connation,decurrency,dry,embryo,feature,form,fruit,growth,height,history,length,life,midpoint,na,new,number,papilla,plant,prickle,ray,reproduction,seed,shape,spacing,specimen,texture,tuberculation,type,width,winging	0.1-0.2,0.4-1,0.5-1.5,0.8-1,0.9-1,1.5-2,11-15.5,2-2.5,2-3.8,2-5,3-3.5,3-5,3.5-7,5-6,5-7,acute,anthesi,attenuate,base,berry,clavate,closely,cm,completely,decurrent,deflexed,elliptic-obovate,filiform,flattened-reniform,glabrous,globose,green,internodal,later,leaf,lobed,long-ellipsoid,minutely,mm,nearly,occasionally,opposite,papillose,pitted,planar,poricidal,shaped,shiny,shrub,simple,spaced,strongly,tear-drop,tip,usually,white,winged,woody,x,yellowish-brown	0.2,na
419	wfo-0001030871	success	248	155	104	116	132	39	100	4	0-120,0.2-0.4,0.3-4,0.6-1.5,0.7-1.3,1-18,1.3-2,1.5-3,1.8-2.6,2-8,3-5,3.5-14,4.5-6.5,5-33,6-40,abruptly,acuminate,acute,adaxial,along,anther,anthesi,apex,apical-lateral,attenuate,base,becoming,berry,blunt-tipped,bud,calyx,campanulate,cm,continued,corolla,dehiscing,deltoid,dendritic-echinoid,directed,due,echinoid,elongate,entire,extend,filament,fleshy,flower,free,fruit,glabrescent,glabrous,granular-tomentose,greenish,growth,hair,honeycombed,introrse,large,lateral,leaf,length,lobe,long,long-stalked,longer,longitudinal,mixed,mm,mostly,multangulate,narrowly,nearly,oblong,obtuse,orbicular,ovate,ovate-lanceolate,partly,pedicel,petiole,pore,probably,purple,ray,reniform,reticulate-punctate,ripe,rotate-stellate,sessile,short,short-stalked,shrub,side,simple,slit,sometimes,stem,stigma,style,subglobose,suborbicular,sulcate,terete,terminal,tomentose,toward,tree,tube,unarmed,usually,violet,white,x,yellow,yellowish,young	.2-3,.8-3.5,.9-1.2,/30-1/5,0.4-1.8,0.7-2.5,1-1.3,1.3-3,1.4-2.7,1.5-6,1.8-3.5,1/2,1/2-3/4,1/4,1/4-1/3,11,2-3,2.8-4.5,3-32,3-4.4,3-6,30,4.8-9.5,5-7,7-12,9-13,abaxially,accrescent,adaxially,ag,apart,apparently,appressed,appressed-tomentose,articulated,axe,axillary,ba,bark,blade,branch,branched,brown,capitat,chartaceous,closely,conical,dark,decurrent,dendritic-echinoi,dendritic-multangulate,densely,diameter,distal,eaf,earl,early,echinoi,eed,elliptic,equal,erect,evident,exserted,fruiting,glabrescen,grayish,green,held,high,inserted,lobed,long-,lower,m.,main,margin,midvein,minute,multangulat,nflorescence,nodding,occasionally,often,older,open,orbicula,orolla,overlapping,pale,peduncle,perfect,plait,plurifoliate,porrect-stellate,present,prominent,pubescent,rachi,rather,reflexed,relatively,ruit,runk,scabridulous,short-,small,somewhat,soon,spaced,sparingly,sparsely,splitting,stamen,stellate-tomentose,striate,strongly,suture,tamen,testa,thick,thick-stalked,thin-stalked,time,unarme,unit,vary,vein,velutinous,way,wide,ympodial	age,arrangement,capitate,coat,colour,connation,decument,decurrency,dry,embryo,feature,form,height,history,inflorescence,life,midpoint,minor,na,new,number,ovary,papilla,plant,prickle,reproduction,scar,seed,shape,size,spacing,specimen,surface,texture,tip,tuberculation,type,width,winging	0-120,0.2-0.4,0.3-4,0.6-1.5,0.7-1.3,1-18,1.3-2,1.5-3,1.8-2.6,2-8,3-5,3.5-14,4.5-6.5,5-33,6-40,abruptly,acuminate,acute,adaxial,along,apex,apical-lateral,attenuate,becoming,berry,blunt-tipped,campanulate,cm,continued,dehiscing,deltoid,dendritic-echinoid,directed,due,echinoid,elongate,entire,extend,fleshy,free,glabrescent,glabrous,granular-tomentose,greenish,growth,hair,honeycombed,introrse,large,lateral,length,long,long-stalked,longer,longitudinal,mixed,mm,mostly,multangulate,narrowly,nearly,oblong,obtuse,orbicular,ovate,ovate-lanceolate,partly,petiole,pore,probably,purple,ray,reniform,reticulate-punctate,ripe,rotate-stellate,sessile,short,short-stalked,shrub,side,simple,slit,sometimes,stem,subglobose,suborbicular,sulcate,terete,terminal,tomentose,toward,tree,unarmed,usually,violet,white,x,yellow,yellowish	age,capitate,decument,na
420	wfo-0001030872	success	166	127	76	95	71	32	75	1	0.5,0.8-1,0.8-2,1-1.2,1-1.5,1-2,1.2-3,1.5-2,1.5-5,12-18,2-5,4-6,5.5-7,6-12.5,acuminate,acute,anther,anthesi,apex,area,bark,base,berry,black,broadly,brown,calyx,closely,cm,corky,corolla,crateriform,dark,deflexed,deltoid,dia,dry,ellipsoid-ovoid,elliptic,erect,filament,fleshy,glabrate,glabrous,globose,green,large,leaf,lenticel,lenticellate,less,like,live,lobe,lobed,material,minor,minutely,mm,nearly,oblique,opposite,ovary,ovate,pale,papillose,pedicel,petiole,pore,poricidal,puberulent,rather,red-glandular-puberulent,reddish-glandular,rounded,scar,shaped,simple,size,small,spaced,specimen,stem,stigma,strongly,style,tear-drop,tip,tree,treelet,tube,white,woody,x,young	.5,0.5-1,1.2-1.5,3-7,4-6-flowered,5-6,adaxial,age,along,appearing,beginning,caly,center,closed,completely,consisting,cucullate,darker,densely,difoliate,eaf,edicel,eed,exserted,free,fruiting,full,geminat,hooded,incurved,inflorescenc,known,lon,long,lower,major,margin,middle,nerve,nflorescence,older,one,overlapping,pair,paler,petal,planar,portion,primary,prominent,proximal,raised,reddish-glandular-puberulent,relative,rest,ridge,ruit,shining,shorter,side,slightly,soon,straight,styl,tall,tapering,thickened,ud,unit,widest,ympodial	arrangement,bud,coat,colour,connation,embryo,feature,flower,form,fruit,growth,height,history,inflorescence,length,life,midpoint,na,number,papilla,plant,prickle,ray,reproduction,seed,shape,spacing,surface,texture,tuberculation,type,width	0.5,0.8-1,0.8-2,1-1.2,1-1.5,1-2,1.2-3,1.5-2,1.5-5,12-18,2-5,4-6,5.5-7,6-12.5,acuminate,acute,area,base,berry,black,broadly,brown,closely,cm,corky,crateriform,dark,deflexed,deltoid,dia,ellipsoid-ovoid,elliptic,erect,fleshy,glabrate,glabrous,globose,green,large,leaf,lenticel,lenticellate,less,like,live,lobed,material,minutely,mm,nearly,oblique,opposite,ovate,pale,papillose,poricidal,puberulent,rather,red-glandular-puberulent,reddish-glandular,rounded,shaped,simple,small,spaced,stem,strongly,style,tear-drop,tip,tree,treelet,white,woody,x	na
421	wfo-0001030882	success	144	120	64	81	63	39	58	6	0.5-0.75,0.5-1,0.5-1.1,0.8-1.1,0.8-2.4,0.9-1.1,1-1.5,1-4,2,2-5.4,2-6,2.2-4.6,3/4,6.5-15.6,acuminate,anther,anthesi,apex,attenuate,bark,base,berry,calyx,capitate,closely,cm,corolla,deflexed,deltoid,elliptic,erect,filament,fruit,glabrous,globose,green,leaf,lobe,lobed,minor,minutely,mm,narrowly,nearly,occasionally,opposite,ovary,overlapping,ovoid,ovoid-reniform,pale,papillose,pedicel,petiole,pitted,pore,poricidal,scar,shaped,short,shrub,simple,size,small,spaced,stem,stigma,style,surface,tapering,tear-drop,tip,transversely,tree,truncate,tube,way,white,woody,x,young	.1,.5,0.75-1,1-1.3,1.6-2,3-3.5,8-12,?,accrescent,beginning,beneath,conical,crenulate,dia,differing,difoliate,eaf,edicel,eed,exserted,extreme,free,fruiting,geminat,inflorescenc,lateral,lightly,lon,long,lower,main,major,margin,middle,nflorescence,older,one,pair,paler,papillo,peelin,planar,portion,prominent,raised,ruguse,ruit,slender,slightly,soon,straight,tall,tan,terminal,thick,thickened,tub,ud,unit,vein,widest,yellowish,ympodial	0.1,3,5.5,arrangement,bud,coat,colour,connation,decurrency,dry,feature,flower,form,growth,height,history,inflorescence,length,life,midpoint,na,new,number,papilla,peeling,plant,prickle,ray,reproduction,rugose,seed,shape,spacing,specimen,texture,tuberculation,type,width,winging	0.5-0.75,0.5-1,0.5-1.1,0.8-1.1,0.8-2.4,0.9-1.1,1-1.5,1-4,2,2-5.4,2-6,2.2-4.6,3/4,6.5-15.6,acuminate,attenuate,base,berry,capitate,closely,cm,deflexed,deltoid,elliptic,erect,glabrous,globose,green,leaf,lobed,minutely,mm,narrowly,nearly,occasionally,opposite,overlapping,ovoid,ovoid-reniform,pale,papillose,pitted,poricidal,shaped,short,shrub,simple,small,spaced,tapering,tear-drop,transversely,tree,truncate,way,white,woody,x	0.1,3,5.5,na,peeling,rugose
422	wfo-0001030883	success	179	111	74	86	93	25	69	5	-3,.05,.5,0.5-3,0.5-5,1-1.1,1-1.3,1-1.5,1.5-2,18-44.5,2-5,3/4,5-6,9.5-27.5,anther,apart,bark,base,berry,calyx,cell,clavate,cm,collapsed,corolla,dark,dia,elliptic,epidermal,finely,fruit,glabrous,glandular,globose,green,inflorescence,large,leaf,less,like,lobed,long,long-acuminate,massive,minute,minutely,mm,occasionally,older,opposite,ovary,ovate,ovoid-reniform,papillate,papillose,pedicel,petiole,pitted,plant,poricidal,puberulent,reticulate,scar,seed,shaped,shrub,size,slender,stem,stigma,stout,strongly,style,surface,tapering,tear-drop,tip,trichome,tube,uniseriate,upper,wall,way,white,x,young	.1,1-1.2,1-4,1.5-3.5,10-18,20-50-flowered,3-3.5,3-4,accrescent,across,acuminate,acute,anthesi,apex,appearing,approximatately,arching,becoming,branched,brown,bu,collection,deflexed,differing,difoliate,dry,eaf,edicel,eed,erect,evenly,filament,fleshy,free,fruiting,furcate,geminat,geminate,hard,hollow,imbedded,laminar,later,lateral,lenticellat,little,live,living,lobe,lon,lower,main,malodorous,markedly,material,middle,midrib,narrowly,nflorescence,oblique,pair,pale,papillo,perpendicular,petaloid,placenta,pore,portion,present,proximal,pulp,quite,rather,reflexed,ruit,russet,slightly,sometimes,soon,spaced,straight,tall,tan,thick,time,triangular,two,ud,unit,vein,widest,woody,ympodial	20-50,abaxial,adaxial,alternate,arrangement,bud,colour,feature,flower,form,growth,height,history,length,lenticellate,life,number,perennial,reproduction,shape,spacing,texture,type,unknown,width	-3,.05,.5,0.5-3,0.5-5,1-1.1,1-1.3,1-1.5,1.5-2,18-44.5,2-5,3/4,5-6,9.5-27.5,apart,base,berry,calyx,cell,clavate,cm,collapsed,dark,dia,elliptic,epidermal,finely,glabrous,glandular,globose,green,large,leaf,less,like,lobed,long,long-acuminate,massive,minute,minutely,mm,occasionally,opposite,ovate,ovoid-reniform,papillate,papillose,pitted,poricidal,puberulent,reticulate,shaped,shrub,slender,stout,strongly,tapering,tear-drop,tip,trichome,tube,uniseriate,upper,wall,way,white,x,young	20-50,alternate,lenticellate,perennial,unknown
423	wfo-0001030884	success	218	151	111	123	95	28	105	6	0.3,0.4-3,0.5,0.8-1,0.9-5,1,1-1.5,1.5,1.5-2,2-5,4-13,5,5-30,6-25,6-8,7-8,9-11,abruptly,acute,along,anther,anthesi,apex,bark,base,berry,brown,c.,calyx,capitate,cm,connivent,dark,decurrent,densely,di-,diameter,elliptic,equal,extend,filament,flower,geminate,glabrous,green,greenish,growth,inflorescence,lateral,leaf,length,like,lobe,lobed,long,long-stalked,long-styled,long-triangular,mature,midpoint,minute,minutely,mixture,mm,moderately,new,node,occasionally,onto,ovary,ovoid-reniform,pale,pedicel,petiole,plant,pore,poricidal,porrect,present,prickly,pubescent,ray,red,reddish,reflexed,sagittate,scar,sessile,short,short-stalked,short-styled,shrub,simple,size,slender,sparsely,spherical,spreading,stellate,stem,stiff,stigma,strongly,style,surface,tannish,tapering,tip,treelet,trichome,trifoliate,tube,unicellular,unit,upward,varying,way,white,wide,wing,winged,yellow,young	.2,.5,.7,0.3-0.5,0.5-1.2,1-1.2,1-3,1.5-2.5,10,100,2,4-5,4.5-5,5-6,5-merous,5.5-7,6-10,>,abaxial,abaxially,adaxial,adaxiall,also,alyx,andromonoeciou,apar,arme,articulated,basal,blade,broad-based,conical,curved,differing,directed,discolorous,distal,eaf,eed,extending,flowering,free,fruiting,glandular,gray-tinged,gree,half,herbaceous,heterostylous,infructescence,leafy,lower,magnification,margin,midrib,nflorescence,older,one,open,orolla,oung,outlin,pair,papillat,peduncle,per,portion,prickle,primary,principal,reflexe,regularly,rest,ruit,scattered,shallowly,shap,similar,spaced,stellate-pubescent,still,tall,tamen,time,unarmed,uniformly,uniseriate,usually,vary,vein,visible,weakly,without,woody,ympodial	apart,armed,arrangement,bud,colour,connation,corolla,decurrency,feature,form,fruit,height,history,life,na,number,outline,papilla,papillate,reproduction,seed,shape,spacing,sympodial,texture,type,width,winging	0.3,0.4-3,0.5,0.8-1,0.9-5,1,1-1.5,1.5,1.5-2,2-5,4-13,5,5-30,6-25,6-8,7-8,9-11,abruptly,acute,along,anthesi,base,berry,brown,c.,capitate,cm,connivent,dark,decurrent,densely,di-,diameter,elliptic,equal,extend,flower,geminate,glabrous,green,greenish,lateral,leaf,length,like,lobed,long,long-stalked,long-styled,long-triangular,mature,midpoint,minute,minutely,mixture,mm,moderately,node,occasionally,onto,ovoid-reniform,pale,petiole,poricidal,porrect,present,prickly,pubescent,ray,red,reddish,reflexed,sagittate,sessile,short,short-stalked,short-styled,shrub,simple,size,slender,sparsely,spherical,spreading,stellate,stem,stiff,strongly,surface,tannish,tapering,tip,treelet,trichome,trifoliate,unicellular,unit,upward,varying,way,white,wide,wing,winged,yellow	apart,armed,na,outline,papillate,sympodial
424	wfo-0001030899	success	145	130	86	100	45	30	84	2	.5-2,0.3-0.5,0.5-1,1,1-1.5,1-3,1-6,1.5-2,10-13,10-20,2,2-3,2-3.5,2.5-3.5,20-25-45,3-12,3-4,3-5,3-foliate,3.5-4,4-5,5-10,5-6.5,6.5-31-45,7-27,abaxially,acuminate,acute,adaxially,apart,apex,basal,base,bronze,calyx,chartaceous,cm,connective,cordate,coriaceous,deeply,densely,desc,diameter,dilated,directed,distally,ellipsoidal,end,entire,ex,extrorse,flattened,flower,fruit,glabrous,glandular-puberulent,globose,green,inside,less,lobe,long,margin,mm,mucronate,narrowly,obconical,oblong,obtuse,outside,ovoid,pedicel,peduncle,petiole,pore,puberulent,pubescent,purple,rachi,radiu,remnant,shrub,simple,slightly,splotch,stellate,stigma,stripe,strongly,style,time,triangular,tube,unbranched,unit,upward,wide,x,yellow	0.5,1-2,8-11,?,absent,aggregate,ape,articulated,axe,beyond,blade,cell,connivent,eaf,eed,exceeding,exserted,leaving,light,lon,lower,nflorescence,nther,orang,orolla,ovate,pedicellar,peltifor,perfect,presen,puberulen,ruit,shorter,spaced,stamen,stone,tal,tem,thecae,tomento,ud,vary,vein,white,ympodial	abaxial,adaxial,anther,arrangement,bud,colour,corolla,feature,form,growth,height,inflorescence,leaf,length,number,ovary,peltiform,plant,ratio,seed,shape,size,spacing,stem,surface,sympodial,texture,theca,tomentose,width	.5-2,0.3-0.5,0.5-1,1,1-1.5,1-3,1-6,1.5-2,10-13,10-20,2,2-3,2-3.5,2.5-3.5,20-25-45,3-12,3-4,3-5,3-foliate,3.5-4,4-5,5-10,5-6.5,6.5-31-45,7-27,abaxially,acuminate,acute,adaxially,apart,apex,basal,base,bronze,chartaceous,cm,cordate,coriaceous,deeply,densely,desc,diameter,dilated,directed,distally,ellipsoidal,end,entire,ex,extrorse,flattened,glabrous,glandular-puberulent,globose,green,inside,less,lobe,long,mm,mucronate,narrowly,obconical,oblong,obtuse,outside,ovoid,puberulent,pubescent,purple,shrub,simple,slightly,splotch,stellate,stripe,strongly,time,triangular,unbranched,upward,wide,x,yellow	peltiform,tomentose
425	wfo-0001030902	success	158	112	72	81	77	31	67	5	-2,-20,0.6-1.5,1-6,1.5-13,1.5-2.5,10-15,15-50,2-3,2-5,2.5,2.5-4,3-13,3-20,3-4,30-50,4-22,4-7,5-7,5-9,6-24,acuminate,acute,angled,apart,apex,apiculate,basal,base,branched,brown-pilose,calyx,cm,connective,cordate,dark,deltate,densely,diameter,directed,distally,eglandular,ellipsoidal,entire,flattened,flower,forked,fruit,glabrescent,glabrous,globose,hair,laterally,lobe,long,margin,mature,mm,narrowly,oblong,obtuse,occasionally,orange,pedicel,peduncle,petiole,pore,rachi,rarely,simple,stellate,stigma,style,tip,tree,triangular,truncate,tube,unbranched,x,yellow	0-15,1-2,1.5-2,1.5-2-3-5,2,3.5-4,4,4-6,4-foliat,8-14,abaxially,absent,adaxially,aggregate,along,ape,apically,articulated,axe,beyond,blade,brow,cell,connivent,cylindrical,dilated,eaf,eed,equalling,exceeding,except,exserted,fleshy,glabrat,glandular,glandular-puberulen,leaving,lon,lower,nflorescence,nther,orolla,ovate,pedicellar,perfect,pinkish,presen,present,puberulence,purple,purplish,radiu,reddish,remnant,ruit,shorter,slightly,small,somewhat,spaced,sparse,sparsely,stamen,stone,subcapitat,subcoriaceous,tal,tem,thecae,time,tomento,ud,unit,vary,vein,wide,ympodial	alternate,anther,arrangement,bud,colour,corolla,feature,form,glabrate,growth,height,hermaphroditic,history,inflorescence,leaf,length,life,number,ovary,perennial,plant,reproduction,seed,shape,size,spacing,stem,subcapitate,surface,texture,width	-2,-20,0.6-1.5,1-6,1.5-13,1.5-2.5,10-15,15-50,2-3,2-5,2.5,2.5-4,3-13,3-20,3-4,30-50,4-22,4-7,5-7,5-9,6-24,acuminate,acute,angled,apart,apex,apiculate,basal,base,branched,brown-pilose,cm,cordate,dark,deltate,densely,directed,distally,eglandular,ellipsoidal,entire,flattened,forked,glabrescent,glabrous,globose,hair,laterally,lobe,long,mature,mm,narrowly,oblong,obtuse,occasionally,orange,rarely,simple,stellate,tip,tree,triangular,truncate,unbranched,x,yellow	alternate,glabrate,hermaphroditic,perennial,subcapitate
426	wfo-0001030914	success	186	124	71	97	89	27	68	3	0-0.25,0.5-1,0.7-1,1-1.5,1-2,1.5-3,1.5-8,2-10,2-2.5,2.5-11,2.5-3,3.5-17,5-17,5-25-flowered,7-8,9-35,acute,anther,anthesi,apex,attenuate,bark,base,berry,bud,calyx,campanulate,capitate,closely,cm,corolla,dark,decurrent,deflexed,deltoid,densely,dry,elliptic,erect,evenly,filament,flower,furcate,glabrate,glabrous,globose,golden,inflorescence,leaf,lemon-yellow,length,lobe,lobed,many,minor,minutely,mm,obovate,onto,opposite,ovary,ovoid-reniform,pale,papillose,pedicel,petiole,pitted,plant,pore,poricidal,puberulent,pubescent,reddish-brown,scar,shape,shaped,shrub,simple,size,small,spaced,specimen,stem,stigma,style,surface,tear-drop,time,tip,tree,trichome,tube,uniseriate,white,winged,x,young	.1,.5,/4,0.1-0.5,0.8-1,0.8-1.3,1.2-1.5,1.5-2,3-4,7-10,along,beneath,blade,constriction,dia,differing,difoliate,distal,eaf,edicel,eed,ellipsoid,equal,even,exserted,free,fruiting,geminat,green,greyish-brow,individual,later,lateral,like,live,lon,long,long-styled,lower,main,major,margin,middle,narowly,nflorescence,occasionally,often,older,one,otherwise,overlappin,pair,papillo,planar,portion,prominent,quite,raised,rest,ripe,rounded,ruit,short-styled,slender,slightly,sometimes,soon,sparsely,straight,tall,tan,tapering,thick,third,ti,trunk,tub,ud,unit,usually,variable,vein,way,weight,widest,within,woody,yellow,ympodial	arrangement,coat,colour,connation,feature,form,fruit,greyish-brown,growth,height,history,life,midpoint,na,narrowly,number,papilla,prickle,ray,reproduction,seed,spacing,texture,tuberculation,type,width,winging	0-0.25,0.5-1,0.7-1,1-1.5,1-2,1.5-3,1.5-8,2-10,2-2.5,2.5-11,2.5-3,3.5-17,5-17,5-25-flowered,7-8,9-35,acute,attenuate,base,berry,campanulate,capitate,closely,cm,dark,decurrent,deflexed,deltoid,densely,elliptic,erect,evenly,furcate,glabrate,glabrous,globose,golden,leaf,lemon-yellow,lobed,many,minutely,mm,obovate,onto,opposite,ovoid-reniform,pale,papillose,petiole,pitted,poricidal,puberulent,pubescent,reddish-brown,shaped,shrub,simple,small,spaced,tear-drop,time,tree,trichome,uniseriate,white,winged,x	greyish-brown,na,narrowly
427	wfo-0001030918	success	223	154	99	113	110	41	93	6	-9,0-10,0.1-0.25,0.3-1.5,0.6-2.5,0.7-1.2,0.7-1.7,1,1-1.5,1-2,1.5-5.5-6,1/2-2/3,1/3,2-10,2-2.5,2-7,2-8,2.8-3,3-15,3-6.5,3-7,4-7,5-8,acicular,acute,anther,apart,apex,apically,articulated,bark,base,berry,calyx,cell,cm,connivent,cuneate,curved,deltate,densely,diameter,elliptic,erect,evenly,filament,flattened,flattened-reniform,flower,fruit,glabrescent,glabrous,green,lateral,leaf,length,lobe,lobed,long,maturity,mauve,midpoint,mixture,mm,moderately,narrow-deltate,obtuse,occasionally,orange,orange-brown,outline,pale,pedicel,petiole,pit,poricidal,porrect,prickle,prickly,purple,raised,ray,red,red-brown,scar,seed,sessile,shrub,simple,small,smooth,sometimes,sparsely,spherical,spreading,stalked,stellate,stellate-pubescent,stem,straight,style,surface,tapering,terete,terminal,tip,trichome,tube,upper,way,wide,yellow,young	-4,-5,.5,.7,0-20,0-25,0-4,0-6,0.1,0.2-0.4,0.25-0.45,0.5-0.7,0.5-2,0.5-2.5-4.5,0.6,1-1.8-2.3,1-4,1.5-2,1.5-2.5-3.2,1/3-1/2,1/3-1/2-3/4,1/4-1/3,2-25-40,2-3,2-4,2/,3-4,3.5-6,5-7,5-merous,5.5-7,6-8,7-10-12,abaxial,abaxially,adaxial,alyx,ame,apar,apparently,blade,branched,brow,c.,caudat,chartaceous,dark,difoliate,discolorous,distance,drying,dull,eaf,elongated,elongating,equal,extending,faint,free,fruiting,geminat,green-brown,infructescence,lobing,longer,lower,margin,mature,midvein,nflorescence,oblong,older,one,open,orolla,oung,pair,peduncle,pendulous,per,perfec,pericarp,perpendicular,portion,prickl,primary,pubescent,reduced,reflexed,ruit,scandent,secondary,side,slender,somewhat,spaced,stalk,strongly,tamen,tertiary,time,unit,usually,vary,vein,venation,visible,weakly,woody,ympodial	0.5,0.5-2.5,anthesi,arrangement,brown,bud,caudate,coat,colour,connation,corolla,decurrency,dry,embryo,feature,form,growth,height,history,inflorescence,life,minor,new,number,ovary,papilla,perennial,plant,pore,reproduction,shape,size,spacing,specimen,stigma,texture,tuberculation,type,unknown,width,winging	-9,0-10,0.1-0.25,0.3-1.5,0.6-2.5,0.7-1.2,0.7-1.7,1,1-1.5,1-2,1.5-5.5-6,1/2-2/3,1/3,2-10,2-2.5,2-7,2-8,2.8-3,3-15,3-6.5,3-7,4-7,5-8,acicular,acute,apart,apically,articulated,base,berry,cell,cm,connivent,cuneate,curved,deltate,densely,diameter,elliptic,erect,evenly,flattened,flattened-reniform,glabrescent,glabrous,green,lateral,lobed,long,maturity,mauve,mixture,mm,moderately,narrow-deltate,obtuse,occasionally,orange,orange-brown,outline,pale,pit,poricidal,porrect,prickle,prickly,purple,raised,red,red-brown,sessile,shrub,simple,small,smooth,sometimes,sparsely,spherical,spreading,stalked,stellate,stellate-pubescent,straight,tapering,terete,terminal,tip,trichome,upper,way,wide,yellow,young	0.5,0.5-2.5,brown,caudate,perennial,unknown
428	wfo-0001030943	success	167	99	58	73	94	26	55	3	.5,1-1.2,1-1.5,1.8-2.2,10-25,12-15,2-6,3,3-4,4-6,7-13.5,acuminate,acute,age,anther,apex,base,becoming,berry,bi-lobed,calyx,cm,conical,corolla,cupulate,decurrent,dendritic,densely,echinoid,elliptic,flattened,flower,glabrous,globose,golden,golden-yellow,growth,lateral,leaf,lenticular,lobe,minutely,mm,narrowly,ovary,pedicel,petiole,pitted,planar,plurifoliate,poricidal,pubescent,purplish-black,shrub,slightly,slit-like,small,stem,stigma,style,surface,tapering,terminal,tip,tree,tree-like,triangular,trichome,tube,violet,x,yellow,young	0,0.5-1,0.5-3,1.1,1.5-2,1/2,3/4,4-4.5,4-5,7-8,8-10,abaxial,abaxially,absent,adaxial,adaxially,along,anthesi,apical,bark,basal,belo,black,branch,branching,dark,deflexed,denser,diameter,drying,eaf,edicel,eed,elongate,erect,ew,exserted,fide,filament,free,fruiting,glabrat,horizontal,im,inserted,large,lobed,lon,long,lower,m.,main,minute,monochasia,nflorescence,nodding,often,older,outline,overtopping,pair,pale,papillo,pearce,per,pericarp,pore,portion,raised,reddish-brown,ruit,scar,scattered,secondary,shoot,showy,sleeve,somewhat,sparsely,stamen,strongly,tall,thin,time,tub,ud,unit,upper,vein,way,wide,woody,yellowish-white,ympodial	.1,arrangement,bud,colour,decurrency,feature,form,fruit,height,history,inflorescence,length,life,na,new,number,papilla,papillose,plant,reproduction,seed,shape,size,texture,type,width	.5,1-1.2,1-1.5,1.8-2.2,10-25,12-15,2-6,3,3-4,4-6,7-13.5,acuminate,acute,age,becoming,berry,bi-lobed,cm,conical,cupulate,decurrent,dendritic,densely,echinoid,elliptic,flattened,glabrous,globose,golden,golden-yellow,lateral,lenticular,minutely,mm,narrowly,pitted,planar,plurifoliate,poricidal,pubescent,purplish-black,shrub,slightly,slit-like,small,tapering,terminal,tip,tree,tree-like,triangular,trichome,violet,x,yellow	.1,na,papillose
429	wfo-0001030959	success	164	114	63	76	88	38	60	3	.8,/5,0.5-1.5,0.7-1.2,1-10,1-7,1.5-2,10-15,2.5-4.5,4-8,5-9,9-12,almost,anther,apart,apex,apically,armed,articulated,bark,base,brown,cm,color,connivent,cuneate,deltate,densely,elliptic,erect,filament,flower,fresh,glabrous,glandular,hair,inflorescence,known,lateral,leaf,length,lobe,lobed,long,long-acuminate,minute,mm,narrow-deltate,part,pedicel,petiole,poricidal,porrect,present,prickle,prickly,scar,sessile,shrub,simple,spreading,stellate,stem,straight,straw,style,surface,tapering,tip,toward,trichome,tube,way,wide,yellow,youngest	.05,.2,0.5,1-2,1.2-1.8,1.5-3.5,1/5-1/10,2-4,2.5-4,2.5-5,4-6,5-6,5-merous,6-8,abaxially,alyx,ame,apar,apparently,blade,branched,brown-green,c.,concolorous,curved,diameter,difoliate,distributed,drying,eaf,eed,equal,evenly,free,geminat,gently,glabrescent,glabrou,green-brow,know,less,like,long-acuminat,longer,lower,margin,membranous,midpoint,nflorescence,numerous,older,one,open,orolla,oung,pair,peduncle,perfec,perpendicular,portion,prickl,primary,prominent,ray,ruit,scrambling,secondary,several,short,side,slender,spaced,sparsely,stellate-pubescent,subentire,tamen,terete,tertiary,time,unarmed,unit,usually,vary,vein,venation,visible,whole,ympodial	0.2,arrangement,bud,calyx,coat,colour,connation,corolla,decurrency,embryo,feature,form,fruit,green-brown,growth,height,history,life,minor,na,new,number,ovary,papilla,plant,pore,reproduction,seed,shape,size,spacing,stigma,texture,tuberculation,type,width,winging,young	.8,/5,0.5-1.5,0.7-1.2,1-10,1-7,1.5-2,10-15,2.5-4.5,4-8,5-9,9-12,almost,apart,apex,apically,armed,articulated,base,brown,cm,color,connivent,cuneate,deltate,densely,elliptic,erect,fresh,glabrous,glandular,hair,known,lateral,lobed,long,long-acuminate,minute,mm,narrow-deltate,part,poricidal,porrect,present,prickly,sessile,shrub,simple,spreading,stellate,straight,straw,tapering,tip,toward,trichome,way,wide,yellow,youngest	0.2,green-brown,na
430	wfo-0001030982	success	215	123	69	93	122	30	66	3	0.1-0.15,0.2-3,0.3-2,0.5-0.9,0.5-1,0.5-3,1-1.5,1-8,1.5,1.5-2,2/3,3-21,3-8,6-8,acuminate,acute,anther,anthesi,apex,base,beneath,berry,broadly,brownish,bud,calyx,capitate,closely,cm,conic,corolla,cucullate,cuneate,deflexed,distally,dry,drying,ellipsoid,elliptic,enlarged,filament,flattened-reniform,flower,foliage,form,fruit,glabrescent,glabrous,globose,green,growth,later,leaf,lobe,lobed,maturity,minor,minutely,mm,new,opposite,ovary,packed,papillate,papillose,pedicel,petiole,pitted,planar,plant,pore,poricidal,puberulent,pubescent,rhizomatous,sagittate,scar,seed,simple,size,sparsely,stem,stigma,strongly,style,subshrub,surface,tip,tube,way,white,x,young	-2-2.5,.1,.2,.5,0.05,0.05-0.5,0.1,0.5,1,1.5-3,4-12,4-5,abaxially,adaxially,age,angular,anisophyllous,ape,appressed,ba,brown,caducous,central,channelled,chartaceous,ciliate,conical,cream,curved,dark,deltate,diameter,differing,difoliate,distall,distichou,eaf,edicel,eed,entire,exerted,extension,external,fleshy,free,fresh,fruiting,geminate,glandular,glandular-papillose,golden-green,greenish,hilum,impressed,inconspicuously,internal,isostylous,larger,lengthening,less,like,live,long,lower,major,margin,materia,material,midvein,mostly,near,nflorescence,oblique,obovate,occasionally,often,olive,one,ovate,overlappin,pair,pale,papillae,papillat,peduncle,portion,primary,projection,prominent,prominently,reddish,reflexed,rest,revolute,ruit,separated,shoot,sigmoidally,sinuate,situated,slightly,slit,somewhat,stamen,straight,stripe,testa,tetramerous,tightly,time,transverse,trichome,tub,ud,uniseriate,unit,vegetative,vein,veined,weakly,yellowish,ympodial	3-2-2.5,arrangement,bark,coat,colour,connation,decurrency,distichous,embryo,feature,height,history,inflorescence,length,life,midpoint,na,number,papilla,prickle,ray,reproduction,shape,spacing,specimen,texture,tuberculation,type,width,winging	0.1-0.15,0.2-3,0.3-2,0.5-0.9,0.5-1,0.5-3,1-1.5,1-8,1.5,1.5-2,2/3,3-21,3-8,6-8,acuminate,acute,anthesi,base,beneath,berry,broadly,brownish,capitate,closely,cm,conic,cucullate,cuneate,deflexed,distally,drying,ellipsoid,elliptic,enlarged,flattened-reniform,foliage,glabrescent,glabrous,globose,green,later,leaf,lobed,maturity,minutely,mm,opposite,packed,papillate,papillose,pitted,planar,poricidal,puberulent,pubescent,rhizomatous,sagittate,simple,sparsely,strongly,subshrub,tip,way,white,x,young	3-2-2.5,distichous,na
431	wfo-0001030989	success	177	125	84	98	79	27	80	4	.5,0.5-1,1-1.5,1-10,12-15,15-27.5,2-3.5,3-20,3-4,3-5.5,3-7.5,4-5,4-8,5,5.5-7.9,6-13,6-6.5,9-10,abaxially,adaxially,anther,apart,axillary,berry,blade,brownish,bud,cell,chartaceous,ciliate,cm,condition,conical,connivent,corolla,covering,densely,diameter,drying,end,filament,flower,forked,fresh,fruit,glabrous,green,green-white,greenish,hair,hair-like,herb,homostylous,interjected,lanceolate,lateral,leaf,leaflet,light,like,long,make,margin,minute,mm,mucilaginous,occurring,odd-pinnate,ovoid,pedicel,peduncle,petiole,plant,pubescent,ripe,rotate,seed,singly,size,sparsely,stem,stigma,style,subtending,terminal,testal,thick,throughout,tuber,typically,unwinged,violet,wall,wet,whitish,wide,x,yellow	1-2,4-7,5-merou,acuminate,ag,alyx,apex,apparently,articulated,axe,base,capitat,decreasing,digestion,distal,dorsally,eaf,edge,eed,enzyme,erec,especially,flat,folded,geminat,generally,glabrou,gradually,half,honeycomb-shaped,larger,lengthening,living,lobe,lower,nflorescence,obtuse,orbicular,orolla,ovate,ovate-lanceolate,pair,pale,perfect,petiolule,plurifoliate,pore,poricidal,present,proximal,pubescen,ray,removed,ruit,secondary,semierect,seudostipule,slit,spaced,specimen,ste,stolo,subequal,subsessile,symmetrical,tall,tamen,tem,thir,tip,toward,tri-,triangular,tube,unit,usually,vary,wider,ympodial	5-merous,arrangement,calyx,capitate,colour,feature,form,growth,height,history,inflorescence,length,life,number,occurrence,ovary,perennial,pseudostipule,reproduction,shape,spacing,staman,stolon,surface,texture,type,width	.5,0.5-1,1-1.5,1-10,12-15,15-27.5,2-3.5,3-20,3-4,3-5.5,3-7.5,4-5,4-8,5,5.5-7.9,6-13,6-6.5,9-10,abaxially,adaxially,apart,axillary,berry,brownish,bud,cell,chartaceous,ciliate,cm,condition,conical,connivent,covering,densely,drying,end,forked,fresh,glabrous,green,green-white,greenish,hair,hair-like,herb,homostylous,lanceolate,lateral,light,like,long,make,margin,minute,mm,mucilaginous,occurring,odd-pinnate,ovoid,pubescent,ripe,rotate,seed,singly,sparsely,stem,subtending,terminal,testal,thick,throughout,typically,unwinged,violet,wall,wet,whitish,wide,x,yellow	5-merous,capitate,perennial,stolon
432	wfo-0001030991	success	203	132	78	95	108	37	75	3	.5,0.3-0.4,0.5-0.7,0.5-1,0.5-1.5,0.7-1.2,1-1.5,1-2.5,1-7,1.5,2.5-10,4-10,9-11,absent,acuminate,acute,anther,anthesi,apex,apparently,attenuate,base,berry,calyx,capitate,cm,conical,connivent,corolla,ellipsoid,ellipsoidal,elongate,filament,filiform,flattened,flower,furcate,fusiform,glabrous,globose,growth,herb,inflorescence,lateral,leaf,leaf-opposed,lengthening,lobe,lobed,loosely,minutely,mm,nearly,new,occasionally,packed,pedicel,petiole,pinnatifid,pitted,pore,poricidal,pubescent,red,reflexed,reniform,ripe,scar,short,shrub,simple,slit,small,somewhat,sparsely,spreading,stellate,stem,stigma,strongly,style,suffrutescent,surface,terminal,tightly,tip,trichome,tube,uniseriate,variably,violet,white,winged,x,young	0,0.1,0.2,0.2-0.7,0.5,0.5-3.5,0.6-0.8,1-1.6,1-2.2,10-20,2-plurifoliat,2.5-3,2/3,3-5-5.5,3-5-lobed,5-merou,<,abaxially,adaxiall,adaxially,ag,along,alyx,angled,appressed,arising,ark,articulated,ascending,basal,brown,bulbous,cell,color,densely,diameter,different,distally,drying,eaf,eed,elliptic,enlarged,entire,exerted,eye,free,frui,fruiting,glabrescen,grey,ilament,incised,lanceolate,leave,less,like,long-triangular,lower,margin,midrib,minute,narrowly,nflorescence,nodding,often,older,orolla,outline,pair,papillo,part,particularly,peduncle,pendant,per,perfect,pericarp,platfor,pointing,portion,primary,pseudoumbel,rectangular,rest,rootstoc,ruit,scattered,shallowly,shiny,sleeve,slightly,tangled,tem,testal,thin,twinin,ud,uniformly,unit,upper,vary,vein,weak,weight,woody,yellowish,ympodial	age,arrangement,bud,coat,colour,connation,decurrency,dry,embryo,feature,form,fruit,height,history,length,life,midpoint,minor,na,number,ovary,papilla,papillose,plant,prickle,ray,reproduction,seed,shape,size,spacing,specimen,texture,tuberculation,type,width,winging	.5,0.3-0.4,0.5-0.7,0.5-1,0.5-1.5,0.7-1.2,1-1.5,1-2.5,1-7,1.5,2.5-10,4-10,9-11,absent,acuminate,acute,anthesi,apparently,attenuate,base,berry,capitate,cm,conical,connivent,ellipsoid,ellipsoidal,elongate,filiform,flattened,furcate,fusiform,glabrous,globose,herb,inflorescence,lateral,leaf-opposed,lengthening,lobed,loosely,minutely,mm,nearly,occasionally,packed,pinnatifid,pitted,poricidal,pubescent,red,reflexed,reniform,ripe,short,shrub,simple,slit,small,somewhat,sparsely,spreading,stellate,strongly,suffrutescent,terminal,tightly,tip,trichome,uniseriate,variably,violet,white,winged,x	age,na,papillose
433	wfo-0001031005	success	231	116	76	94	137	22	73	3	.4,.5,0.1,0.3-0.5,1-2,1-2.5,1.5-4,10,2.5,2.5-4,3-10,3-6.5,5,5-8,6-12,abaxial,almost,along,anther,apically,apparently,base,berry,black,blue,brachyblast,branch,brown,calyx,capitate,clustered,cm,corolla,cupular,dark,dendritic,denser,diameter,dilated,drying,elliptic,elongated,evenly,eye,filament,flower,form,free,fruit,glabrous,greenish,leaf,length,liana,like,linear,lobe,lobed,long,midvein,mm,naked,oblong,obovate,occasional,orange-brown,ovate,ovoid,pedicel,petiole,pore,poricidal,pubescent,purple,ray,ridged,scar,seed,short,side,smooth,somewhat,stem,stigma,style,surface,terminal,tip,toward,trichome,tube,visible,x,young	/3-1/2,0-0.5,0.5-1.5,0.8,0.9,1,1-1.5,1-3,1.5-2.5,2-3.2,2.3-3,3-4,4-6,5-7,5Â°,abaxially,accrescent,acuminate,acute,adaxially,age,alyx,anthesi,apar,apex,articulated,attenuate,bark,branched,branching,chartaceous,clearly,clum,common,concolorous,conical,curved,datum,deeply,delineated,deltoid,dendritic-pubescent,density,detaching,developing,discolorous,divided,domatia,eaf,ellipsoi,entire,equal,extending,fertilisation,fine,flat,flattened,flexuous,forming,fruiting,immature,increasing,inside,junction,known,lateral,leave,lengthening,longitudinally,loop,lower,m.,main,margin,membranous,minute,much,network,nflorescence,nther,obscure,occasionally,often,older,onl,orolla,ou,outside,pair,peduncle,pendulous,perfec,pericarp,plurifoliat,pointed,portion,primary,prominent,protruding,rachi,raised,region,rest,ruit,secondary,simple,slender,smaller,smoot,sometimes,soon,sparsely,spread,spreading,standing,strongly,stump,surrounding,tangling,tearing,terete,tertiary,thick-chartaceous,thin,ud,unarmed,uneven,unit,usually,vary,vein,venation,weakly,well-developed,white,wide,ympodial	adaxial,apart,arrangement,bud,colour,connation,ellipsoid,feature,growth,height,inflorescence,na,number,ovary,papilla,plant,shape,size,spacing,texture,type,width	.4,.5,0.1,0.3-0.5,1-2,1-2.5,1.5-4,10,2.5,2.5-4,3-10,3-6.5,5,5-8,6-12,almost,along,apically,apparently,base,berry,black,blue,brachyblast,branch,brown,capitate,clustered,cm,cupular,dark,dendritic,denser,diameter,dilated,drying,elliptic,elongated,evenly,eye,free,glabrous,greenish,liana,like,linear,lobed,long,midvein,mm,naked,oblong,obovate,occasional,orange-brown,ovate,ovoid,poricidal,pubescent,purple,ray,ridged,short,side,smooth,somewhat,stem,terminal,tip,toward,trichome,visible,x	apart,ellipsoid,na
434	wfo-0001031007	success	205	130	74	91	114	39	70	4	0.2,0.5-10,0.75-1.5,1-1.5,1-3.5,1.2-1.5,1.3-2.5-5,15,2.5-5-12,3-4,4-7,5.5-6,50-100,6,7-10,8-10,<,abruptly,acute,anther,anthesi,apex,base,becoming,berry,bifid,black,broadly,brown,calyx,capitate,cm,connivent,corolla,cuneate,cup-shaped,deltate,dendritic,ellipsoid,elliptic,filament,flattened-reniform,flower,fruit,glabrous,globose,growth,inflorescence,irregularly,lax,lengthening,lilac,lobe,loose,loosely,minutely,mm,narrowing,narrowly,new,papillate,pedicel,petiole,pitted,pore,poricidal,pubescent,reddish,sagittate,scar,shrub,simple,slender,slit,sparsely,specimen,splitting,stellate,stellate-pentagonal,stem,stigma,style,surface,tangled,terminal,tip,trichome,tube,vine,woody,x	.5,0.5,0.5-1,1,1-1.2,1.5-2,1.6-2,1.9-3,1/3,11-14,4-6,4.5-5,5,5-merou,abaxiall,ag,alfway,almost,along,alyx,apar,apparently,ark,articulated,beginning,branched,branching,broad,c.,campanulate,cell,chartaceous,clustered,completely,dark,densely,diameter,dilated,drying,dull,eaf,eed,entire,exserted,extending,fleshy,free,fruiting,geminat,glabrescen,glabrou,herbarium,ilament,impressed,intramarginal,junction,lamina,leaving,lobed,long,looping,lower,m.,many,margin,markedly,matte,midvein,multi-celled,near,nflorescence,nodding,occasionally,often,older,orolla,outline,pale,papillat,peduncle,peg,per,perfect,pericarp,planar,plurifoliate,portion,primary,prominent,rat,revolute,round-rectangular,ruit,shiny,sleeve,slightly,spaced,spreading,stout,strongly,testal,thin,time,tiny,twining,ud,unit,upper,usually,vary,vein,way,yellow,ympodial	age,apart,arrangement,bark,bud,coat,colour,connation,decurrency,dry,embryo,feature,form,glabrescent,height,history,leaf,length,life,midpoint,minor,na,number,ovary,papilla,plant,prickle,ray,reproduction,seed,shape,size,spacing,texture,tuberculation,type,width,winging,young	0.2,0.5-10,0.75-1.5,1-1.5,1-3.5,1.2-1.5,1.3-2.5-5,15,2.5-5-12,3-4,4-7,5.5-6,50-100,6,7-10,8-10,<,abruptly,acute,base,becoming,berry,bifid,black,broadly,brown,capitate,cm,connivent,cuneate,cup-shaped,deltate,dendritic,ellipsoid,elliptic,flattened-reniform,glabrous,globose,irregularly,lax,lengthening,lilac,loose,loosely,minutely,mm,narrowing,narrowly,papillate,pedicel,pitted,poricidal,pubescent,reddish,sagittate,shrub,simple,slender,slit,sparsely,splitting,stellate,stellate-pentagonal,tangled,terminal,tip,trichome,vine,woody,x	age,apart,glabrescent,na
435	wfo-0001031007	success	204	130	74	92	112	38	70	4	0.2,0.5-10,0.75-1.5,1-1.5,1-3.5,1.2-1.5,1.3-2.5-5,15,2.5-5-12,3-4,4-7,5.5-6,50-100,6,7-10,<,abruptly,acute,anther,anthesi,apex,bark,base,becoming,berry,bifid,black,broadly,brown,calyx,capitate,cm,corolla,cuneate,cup-shaped,deltate,dendritic,ellipsoid,elliptic,filament,flattened,flower,fruit,glabrous,globose,growth,inflorescence,irregularly,lax,lengthening,lilac,lobe,long,loose,minutely,mm,narrowing,narrowly,new,papillate,pedicel,petiole,pitted,pore,poricidal,pubescent,reddish,reniform,sagittate,scar,shrub,simple,slender,slit,sparsely,specimen,splitting,stellate,stellate-rotate,stem,stigma,style,surface,tall,tangled,terminal,tip,trichome,tube,vine,wide,woody	.5,0.5,0.5-1,1,1-1.2,1.5-2,1.6-2,1.9-3,1/3,11-14,4-6,4.5-5,5,5-merou,8-10,abaxially,adaxial,ag,alfway,almost,along,alyx,apar,apparently,articulated,beginning,branched,branching,broad,c.,campanulate,cell,chartaceous,clustered,completely,dark,densely,diameter,dilated,drying,dull,eaf,eed,entire,exserted,extending,fleshy,free,fruiting,glabrescen,glabrou,herbarium,ilament,impressed,intramarginal,junction,lamina,leaving,lobed,looping,lower,m.,many,margin,markedly,matte,midvein,multi-celled,near,nflorescence,nodding,occasionally,often,older,orolla,outline,pale,papillat,peduncle,peg,per,perfect,pericarp,planar,plurifoliat,portion,primary,prominent,rat,revolute,round-rectangular,ruit,shiny,sleeve,slightly,spaced,spreading,stout,strongly,testal,thin,time,tiny,twinin,ud,unit,upper,usually,vary,vein,way,ympodial	age,apart,arrangement,bud,coat,colour,connation,decurrency,dry,embryo,feature,form,glabrescent,height,history,leaf,length,life,midpoint,minor,na,number,ovary,papilla,plant,prickle,ray,reproduction,seed,shape,size,spacing,texture,tuberculation,type,width,winging,young	0.2,0.5-10,0.75-1.5,1-1.5,1-3.5,1.2-1.5,1.3-2.5-5,15,2.5-5-12,3-4,4-7,5.5-6,50-100,6,7-10,<,abruptly,acute,base,becoming,berry,bifid,black,broadly,brown,capitate,cm,cuneate,cup-shaped,deltate,dendritic,ellipsoid,elliptic,flattened,glabrous,globose,irregularly,lax,lengthening,lilac,long,loose,minutely,mm,narrowing,narrowly,papillate,pedicel,pitted,poricidal,pubescent,reddish,reniform,sagittate,shrub,simple,slender,slit,sparsely,splitting,stellate,stellate-rotate,tall,tangled,terminal,tip,trichome,vine,wide,woody	age,apart,glabrescent,na
436	wfo-0001031036	success	150	125	68	85	65	40	63	5	.2,.25,.5,0.5-1,0.8-1.2,1-1.3,1-2.5,1.2-1.5,1.5-3,12-15,2-2.5,2.2-3.7,3-4,3-5,3.5-5.5,4.5-6.5,5-6,acute,anther,anthesi,apex,base,berry,bi-lobed,broadly,calyx,closely,cm,conical,corolla,decurrent,deflexed,dry,ellipsoid,elliptic,filament,filiform,flattened-reniform,glabrous,globose,green,greenish-white,leaf,lobe,lobed,margin,minor,minutely,mm,nearly,older,opposite,ovary,papillose,pedicel,petiole,pitted,pore,poricidal,sagittate,scar,shaped,shiny,shrub,simple,size,slightly,spaced,spathulate,stem,stigma,style,surface,tapering,tear-drop,thickened,tip,trichome,tube,uniseriate,white,winged,woody,x,young	0.8-1,10-20-flowered,7-8,abaxially,acuminate,adaxially,along,angle,arising,axil,ba,becoming,brown,crisped,dark,dia,differing,difoliate,drying,eaf,edicel,eed,enlarged,erect,exserted,fleshy,free,fresh,fruiting,geminat,knob-like,lamina,lateral,lon,long,lower,main,major,material,middle,nflorescence,oblique,onto,overlappin,pair,papillo,perhaps,planar,pointed,portion,rounded,ruit,short,sinus,soon,strongly,tall,tub,ud,unit,usually,vein,widest,yellowish,ympodial	10-20,abaxial,adaxial,alternate,arrangement,bud,coat,colour,connation,embryo,feature,flower,form,fruit,growth,hair,height,history,inflorescence,length,life,midpoint,na,number,overlapping,papilla,perennial,plant,prickle,ray,reproduction,seed,shape,spacing,specimen,texture,tuberculation,type,width,winging	.2,.25,.5,0.5-1,0.8-1.2,1-1.3,1-2.5,1.2-1.5,1.5-3,12-15,2-2.5,2.2-3.7,3-4,3-5,3.5-5.5,4.5-6.5,5-6,acute,base,berry,bi-lobed,broadly,closely,cm,conical,decurrent,deflexed,ellipsoid,elliptic,filiform,flattened-reniform,glabrous,globose,green,greenish-white,leaf,lobed,margin,minutely,mm,nearly,opposite,papillose,pitted,poricidal,sagittate,shaped,shiny,shrub,simple,slightly,spaced,spathulate,tapering,tear-drop,thickened,tip,trichome,uniseriate,white,winged,woody,x	10-20,alternate,na,overlapping,perennial
437	wfo-0001031064	success	179	121	80	96	83	25	76	4	.0-2.5,.5,0.5-0.7,1-1.2,1-2,1-3,1.2,1.7-4.2,10-12,10-12.5,10-17,2.5-3,3-5.5,3-7,3.5-4,5-10.5,5-6,6-16,7-16,anther,anticlinal,basal,base,berry,bright,cm,completely,conical,corolla,dark,densely,diameter,elongate,filament,fleshy,fruit,fruiting,glabrous,globose,green,half,highly,inflorescence,irregular,lateral,leaf,leaflet,lightly,lobed,lower,margin,minute,minutely,mm,near,nearly,nodding,node,obovate,ovary,ovate,ovoid-reniform,pair,papillate,pedicel,petiole,pinnate,poricidal,projection,pubescent,purple,rachi,rugose,scattered,short-pubescent,shrub,simple,sinuous,somewhat,sparsely,stem,stigma,style,surface,swollen,terminal,thickening,tip,translucent,trichome,tube,uniseriate,white,winged,without,x	.05,.5-1,0,0-15,0.5,0.5-0.8,1,1.5-2,2,3,4-5-celled,8-10-celled,abaxially,acroscopic,acuminate,adaxially,along,anthesi,apex,arising,attenuate,axil,bearing,blade,broader,calyx,cell,clavat,commentary,conspicuous,deltate,denser,distal,dr.,eaf,edicel,eed,epidermal,erec,exserted,flower,free,irregularly,lamina,leave,lenticel,like,lobe,lon,long,lost,narrower,nflorescence,occasionally,often,open,per,petiolule,planar,portion,prominent,pubescen,ruit,scar,see,side,single,sinus,slender,smaller,splitting,strongly,tal,tem,time,tub,ud,unifoliat,unit,usually,vein,wand-like,ympodial	abaxial,adaxial,arrangement,bud,clavate,colour,erect,feature,form,growth,height,history,length,life,na,number,plant,reproduction,seed,shape,size,texture,type,unifoliate,winging	.0-2.5,.5,0.5-0.7,1-1.2,1-2,1-3,1.2,1.7-4.2,10-12,10-12.5,10-17,2.5-3,3-5.5,3-7,3.5-4,5-10.5,5-6,6-16,7-16,anticlinal,base,berry,bright,cm,completely,conical,dark,densely,diameter,elongate,fleshy,glabrous,globose,green,half,highly,irregular,lightly,lobed,lower,margin,minute,minutely,mm,near,nearly,nodding,node,obovate,ovate,ovoid-reniform,pair,papillate,pinnate,poricidal,projection,pubescent,purple,rugose,scattered,short-pubescent,shrub,simple,sinuous,somewhat,sparsely,swollen,thickening,tip,translucent,trichome,uniseriate,white,winged,without,x	clavate,erect,na,unifoliate
438	wfo-0001031071	success	186	111	68	83	103	28	65	3	0.2-0.8,1-1.5,1-2,2-8,2.1-3,2.4-3.4,3-10,3-5,3-6,4-25,4-6,5-9.4,6-8,7-16.5,7-8,8-28,anther,apart,axillary,blade,bud,cell,clavate,cm,color,connivent,coriaceous,corolla,covering,dark,deep,diameter,distal,elliptic,filament,flower,forked,fruit,generally,glabrous,globose,green,hair-like,half,herb,homostylous,lanceolate,lateral,leaf,lobe,long,medium,mm,moniliform,mottled,narrowly,odd-pinnate,ovate,ovoid,pedicel,peduncle,pentagonal,petiole,plant,pore,poricidal,purple,rotate,seed,size,spot,stigma,style,subtending,terminal,testal,thick,tip,tube,tuber,wall,winged,x	0-10,0.4-2,1-3,1-7,1.5-2.2,2-3,2-5,3.8-5.4,5-merou,5.7-8.8,abaxiall,abaxially,acumen,acute,adaxially,ag,along,alyx,apex,apparently,arranged,articulated,asymmetric,attenuate,axe,base,basiscopic,bead,berry,blue,brownish,capitat,condition,decreasing,digestion,dorsally,drying,eaf,edge,eed,enzyme,erec,exceeding,flat,folded,fresh,geminat,glabrou,green-white,greenish,honeycomb-shaped,interjected,leaflet,lengthening,like,lilac,living,lower,make,middl,mucilaginous,multiple,necklace,nflorescence,orbicular,orolla,pair,perfect,petiolulate,plurifoliate,removed,ripe,round,ruit,sessile,seudostipule,short,side,slightly,slit,spaced,specimen,stamen,star,stolon,straight,subequal,tall,tamen,tem,throughout,tissue,toward,tri-,typically,unit,usually,vary,wet,white,whitish,yellow,ympodial	5-merous,abaxial,adaxial,arrangement,calyx,capitate,colour,connation,feature,form,growth,height,history,inflorescence,length,life,number,ovary,perennial,pseudostipule,reproduction,shape,spacing,stem,surface,texture,type,young	0.2-0.8,1-1.5,1-2,2-8,2.1-3,2.4-3.4,3-10,3-5,3-6,4-25,4-6,5-9.4,6-8,7-16.5,7-8,8-28,apart,axillary,bud,cell,clavate,cm,color,connivent,coriaceous,covering,dark,deep,diameter,distal,elliptic,forked,generally,glabrous,globose,green,hair-like,half,herb,homostylous,lanceolate,lateral,long,medium,mm,moniliform,mottled,narrowly,odd-pinnate,ovate,ovoid,pentagonal,plant,poricidal,purple,rotate,spot,subtending,terminal,testal,thick,tip,wall,winged,x	5-merous,capitate,perennial
439	wfo-0001031097	success	174	106	65	80	94	26	62	3	0.45,1-4,1-4.5,1.8-2.5,13-30,2-3,2-3.3,2-4,3-5,3.7-8.4,4-6,4-7,5-12,5-9,8-11,9-21,abaxial,abaxially,adaxially,apical,apically,branched,calyx,cm,connate,corolla,cyme,darker,deep,dehiscent,diameter,dichasial,dichasially,dotted,ebracteate,elliptical,filament,flower,forked,green,herbaceous,introrse,lateral,leaf,leaflet,light,lighter,long,maturing,medium,mm,monochasial,mottled,mucilaginous,obovate,odd-pinnate,often,ovoid,pedicel,peduncle,pentagonal,perennial,petiole,plant,poricidally,puberulent,pubescent,purple,rotate,seed,short,size,slit,stigma,strigose,style,terminal,violet,violet-blue,wide	0.5,1,1-3,1.5,1.6-5.5,1.8-2.6,3-6-foliat,3.5-6,5-11,acumen,acuminate,acute,along,apex,articulate,base,cell,covering,cuneate,decurrent,digestion,diminishing,distal,dorsally,eaf,edge,eed,emoval,enzyme,exceeding,flat,folded,frequently,generally,globo,gree,green-white,hair-like,half,highly,honeycomb,interjected,interpetalar,living,lobe,lon,lower,lunat,make,margin,narrow,nflorescence,noticeably,nther,oblique,orolla,ovate,pair,pattern,perfect,petal,petiolulate,petiolule,plan,proximal,rachi,rapidly,rarely,reveal,ruit,sessile,seudostipule,side,sometimes,specimen,stamen,straight,tal,tem,testal,thick,throughout,tissu,toward,tuber-bearing,typically,unit,vary,vbase,wall,without,yellow,ympodial,Â¼	adaxial,anther,arrangement,colour,connation,feature,form,fruit,globose,growth,height,history,inflorescence,length,life,na,number,ovary,reproduction,shape,stem,surface,texture,tip,wet,width	0.45,1-4,1-4.5,1.8-2.5,13-30,2-3,2-3.3,2-4,3-5,3.7-8.4,4-6,4-7,5-12,5-9,8-11,9-21,abaxially,adaxially,apical,apically,branched,cm,connate,cyme,darker,deep,dehiscent,dichasial,dichasially,dotted,ebracteate,elliptical,forked,green,herbaceous,introrse,light,lighter,long,maturing,medium,mm,monochasial,mottled,mucilaginous,obovate,odd-pinnate,often,ovoid,pentagonal,perennial,poricidally,puberulent,pubescent,purple,rotate,short,slit,strigose,violet,violet-blue,wide	globose,na,wet
440	wfo-0001031101	success	191	139	83	93	98	46	75	8	/2,0.5-0.8,0.5-3,0.7-0.8,1-2,1-3,1.4-1.7,1/4-1/2,10-30,2-6,2.5-3.5,2.5-3.8,acuminate,almost,anther,apex,apical,apically,apparently,articulated,bark,base,berry,bright,calyx,cm,connivent,deltate,dull,erect,evenly,filament,flattened-reniform,flower,glabrescent,glabrous,glandular,green,hair,herbaceous,lateral,leaf,length,lobe,lobed,long-acute,maturity,mauve,midpoint,minute,mm,moderately,multangulate,narrow-deltate,obtuse,orange-brown,orange-red,ovate,pale,pedicel,pendulous,petiole,poricidal,porrect,ray,red,rounded,scar,sessile,shrub,simple,sparsely,spherical,spreading,stalked,stellate,stellate-pubescent,stem,style,surface,tapering,terete,terminal,tip,trichome,tube,umbel,unarmed,variously,way,white,yellow,young	-20,-5,-8,/2-equal,0.05-0.2,0.1-0.2,0.1-0.3,0.3-0.5,0.6-0.8-1,0.8-1-2.3,1-2-5-8,1.3-2,1.3-2.5,1.5-3,1/3-1/2,2-2.8,2-4,2.5-4-10-16,3-10,3-15,3-8,3.5-4.5,4-5-merous,4-7,4.5-9,5-20-30,5-6,6-10-20,8-15-30,abaxial,abaxially,adaxial,alyx,ame,apar,ba,blade,branched,c.,concolorous,diameter,difoliate,drying,eaf,eed,elongating,entire,equal,filiform,free,frui,fruiting,geminat,green-brown,infructescence,long,long-acuminat,longer,lower,margin,mature,membranous,near,nflorescence,often,older,one,open,orolla,oung,pair,peduncle,per,perfec,pericarp,portion,primary,red-brow,resembling,ruit,scandent,smooth,spaced,stalk,stellate-pubescen,straight,tamen,tertiary,time,unarme,unit,vary,vein,venation,visible,wide,yellow-green,ympodial	0.6-0.8,0.8-2.3,1-5,2.5-10,anthesi,apart,arrangement,bud,coat,colour,connation,corolla,decurrency,dry,embryo,feature,form,fruit,growth,height,history,inflorescence,life,long-acuminate,minor,na,new,number,ovary,papilla,plant,pore,prickle,red-brown,reproduction,seed,shape,size,spacing,specimen,stigma,texture,tuberculation,type,width,winging	/2,0.5-0.8,0.5-3,0.7-0.8,1-2,1-3,1.4-1.7,1/4-1/2,10-30,2-6,2.5-3.5,2.5-3.8,acuminate,almost,apical,apically,apparently,articulated,base,berry,bright,cm,connivent,deltate,dull,erect,evenly,flattened-reniform,glabrescent,glabrous,glandular,green,hair,herbaceous,lateral,lobed,long-acute,maturity,mauve,minute,mm,moderately,multangulate,narrow-deltate,obtuse,orange-brown,orange-red,ovate,pale,pendulous,poricidal,porrect,red,rounded,sessile,shrub,simple,sparsely,spherical,spreading,stalked,stellate,stellate-pubescent,tapering,terete,terminal,tip,trichome,umbel,unarmed,variously,way,white,yellow,young	0.6-0.8,0.8-2.3,1-5,2.5-10,apart,long-acuminate,na,red-brown
441	wfo-0001031114	success	208	132	81	96	112	36	79	2	.2,0.5,0.5-1,0.7-1.5,1-10,1-2,1-4.5,1-8,2-17,2-3,2-7,2.5-3,25-50,3-10,3-4,4-10,4.5-6,acuminate,acute,anther,apart,apex,base,becoming,berry,branched,calyx,cm,connivent,deltate,densely,directed,distally,echinoid,elliptic-ovate,erect,especially,filament,first,flattened,fleshy,flower,fruit,globose,green,hair,introrsely,large,leaf,leaf-opposed,lobe,margin,membanaceous,midpoint,minor,mm,multangulate,nodding,oblong,obtuse,outline,ovate,pedicel,petiole,pore,porrect,pubescent,purple,ray,reniform,ripe,rounded,rugulose,shrub,simple,small,somewhat,stellate,stem,stigma,strongly,style,subcuneate,surface,thickened,tip,toward,tree,triangular,truncate,tube,white,white-pubescent,white-stellate,x,yellowish	.1,.5,0-0.3,0.3-0.5,0.8-1.2,1-1.5,1-7,1.5-2.5,1.5-4,10-15,2-4,2/3,3-5,3-7,4-5,4-8,5-10,5-8,5-merou,6-7,7-15,abaxially,absen,accrescent,adaxiall,adaxially,ag,alyx,apparently,articulated,axe,ba,blade,brown,capitat,chartaceous,covering,cylindrical,dark,diameter,differentiated,discolorous,distal,dried,eaf,eed,entire,equal,free,frui,fruiting,geminate,glabrous,highly,homostylous,impressed,interpetalar,juic,lacking,light,like,long,long-stalked,longitudinal,lower,major,nearly,nflorescence,often,one,opening,orolla,paired,part,peduncle,perfect,pericarp,plurifoliate,prominent,rachi,ruit,sessile,short,short-,short-stalked,side,slightly,slit,spaced,sparsely,stalk,ste,stellate-pubescent,straight,subcoriaceous,subcucullate,subtending,tall,tamen,tem,thin,time,tissue,unarme,unit,vary,vein,whitish,wide,without,yellow,ympodial	arrangement,bud,capitate,coat,colour,connation,corolla,decurrency,embryo,feature,form,growth,height,history,inflorescence,length,life,na,new,number,ovary,papilla,plant,prickle,reproduction,scar,seed,shape,size,spacing,texture,tuberculation,type,width,winging,young	.2,0.5,0.5-1,0.7-1.5,1-10,1-2,1-4.5,1-8,2-17,2-3,2-7,2.5-3,25-50,3-10,3-4,4-10,4.5-6,acuminate,acute,apart,apex,becoming,berry,branched,cm,connivent,deltate,densely,directed,distally,echinoid,elliptic-ovate,erect,especially,first,flattened,fleshy,flower,fruit,globose,green,hair,introrsely,large,leaf-opposed,margin,membanaceous,mm,multangulate,nodding,oblong,obtuse,outline,ovate,porrect,pubescent,purple,reniform,ripe,rounded,rugulose,shrub,simple,small,somewhat,stellate,strongly,subcuneate,thickened,tip,toward,tree,triangular,truncate,white,white-pubescent,white-stellate,x,yellowish	capitate,na
442	wfo-0001031116	success	191	115	75	91	100	24	73	2	.5,/4,0.3-0.5,0.7-1,1,1/2,10-14,15-25,2.7-3.2,30-100,4-7,8-11,abaxial,acuminate,adaxial,anther,apart,apex,apparently,bark,base,berry,bristle,calyx,caudate,cm,connivent,densely,dirty-white,dull,elliptic,erect,evenly,filament,flattened-reniform,flower,fruit,glabrescent,green,lateral,leaf,length,less,lobe,lobed,long,maturity,mauve,mm,moderately,narrow-deltate,obovate,obtuse,often,orange-brown,orange-red,pedicel,petiole,poricidal,recurved,reflexed,rounded,scar,sharply,shortly,shrub,simple,single,small,smooth,soft,sparsely,spherical,stellate,stellate-pubescent,stem,style,surface,tapering,terete,tip,tree,trichome,tube,unarmed,upper,way,weakly,wide,yellow,young	.2,.8,0,0-10,0.05-0.15,0.1,0.4-0.7,0.7-0.9,1-5,1/3-2/,1/6-1/4,2-5,3.5-4,30-50,4-10,5,5-15,5-merous,9-13,abaxially,almost,alyx,ame,apar,apically,arachnoid,articulated,attenuate,blade,branching,broad-deltate,brow,c.,clearly,collapsed,diameter,discolorous,drying,eaf,eed,elongated,elongating,epidermi,equal,flat,flexuous,fragile,free,fruiting,glabrous,glaucous-green,hair,infructescence,longer,lower,margin,mature,membranous,midpoint,minute,multangulate,nflorescence,obtu,older,one,open,orolla,oung,pair,peduncle,per,perfec,pericarp,perpendicular,plurifoliat,portion,primary,ray,red-brown,ruit,secondary,sessile,slender,sometimes,spaced,stalk,stalked,straight,subentire,tamen,tertiary,time,unarme,unit,vary,vein,venation,visible,woody,ympodial	arrangement,brown,colour,connation,corolla,embryo,feature,form,growth,inflorescence,na,new,number,ovary,papilla,prickle,seed,shape,size,spacing,stigma,texture,type,width	.5,/4,0.3-0.5,0.7-1,1,1/2,10-14,15-25,2.7-3.2,30-100,4-7,8-11,acuminate,apart,apex,apparently,base,berry,bristle,caudate,cm,connivent,densely,dirty-white,dull,elliptic,erect,evenly,flattened-reniform,glabrescent,green,lateral,less,lobed,long,maturity,mauve,mm,moderately,narrow-deltate,obovate,obtuse,often,orange-brown,orange-red,poricidal,recurved,reflexed,rounded,sharply,shortly,shrub,simple,single,small,smooth,soft,sparsely,spherical,stellate,stellate-pubescent,tapering,terete,tip,tree,trichome,unarmed,upper,way,weakly,wide,yellow,young	brown,na
443	wfo-0001031128	success	208	142	88	104	104	38	86	2	/4,0-30,0.5-0.7,0.5-0.8,0.5-1.5,0.5-5,0.6-1,1-2-5-6.5,1.2-2,1.5-3,2-9.5,20-50,3-4,3.5-4.5,5-19,8-23,acute,anther,apart,apex,apically,apparently,articulated,bark,base,berry,branched,bristle,brown,calyx,cm,connivent,cuneate,deltate,densely,diameter,dull,elliptic,erect,evenly,filament,flattened-reniform,flower,fruit,glabrescent,glabrous,glandular,green,hair,inflorescence,lateral,leaf,length,lobe,lobed,long,long-acuminate,maturity,mauve,midpoint,minute,mm,moderately,multangulate,narrow-deltate,near,orange-brown,pale,pedicel,petiole,poricidal,purple-black,ray,recurved,red,reflexed,scar,sessile,short-attenuate,shrub,simple,soft,spherical,spreading,stalked,stellate,stellate-pubescent,stem,style,surface,tapering,terete,terminal,tip,trichome,tube,unarmed,variously,way,weakly,white,wide,yellow,young	0,0-10,0.05-0.2,0.05-0.25,0.2,0.2-0.4,0.3-0.8,0.8-1.7,1,1-1.6,1.5-3.5,1/,1/6-1/3,10-35,2.3-3-4-4.5,2.5-10,2.5-3.5,20-60-100,4-5-merous,4-7,5-10-20,5-15,5-30,8-12,abaxial,abaxially,almost,alyx,apar,ape,blade,branching,concolorous,drying,eaf,eed,elongated,elongating,entire,equal,eye,filiform,flexuous,free,fruiting,gland,gra,infructescence,less,lon,long-acuminat,longer,lower,margin,mature,membranous,multangualte,naked,nflorescence,occasionally,often,older,one,open,orolla,oung,pair,peduncle,per,perfect,pericarp,perpendicular,plurifoliat,portion,primary,red-brown,reduced,ruit,secondary,shallowly,short-styled,side,single,smooth,spaced,stalk,staminate,straight,tamen,tertiary,time,unarme,undulate,unit,usually,vary,vein,venation,visible,whitish,woody,yellow-brown,yellow-green,ympodial	anthesi,arrangement,bud,coat,colour,connation,corolla,decurrency,dry,embryo,feature,form,gray,growth,height,history,life,minor,na,new,number,ovary,papilla,plant,pore,prickle,reproduction,seed,shape,size,spacing,specimen,stigma,texture,tuberculation,type,width,winging	/4,0-30,0.5-0.7,0.5-0.8,0.5-1.5,0.5-5,0.6-1,1-2-5-6.5,1.2-2,1.5-3,2-9.5,20-50,3-4,3.5-4.5,5-19,8-23,acute,apart,apex,apically,apparently,articulated,base,berry,branched,bristle,brown,cm,connivent,cuneate,deltate,densely,diameter,dull,elliptic,erect,evenly,flattened-reniform,glabrescent,glabrous,glandular,green,hair,lateral,lobe,lobed,long,long-acuminate,maturity,mauve,minute,mm,moderately,multangulate,narrow-deltate,near,orange-brown,pale,poricidal,purple-black,recurved,red,reflexed,sessile,short-attenuate,shrub,simple,soft,spherical,spreading,stalked,stellate,stellate-pubescent,tapering,terete,terminal,tip,trichome,unarmed,variously,way,weakly,white,wide,yellow,young	gray,na
444	wfo-0001031135	success	187	128	75	82	105	46	73	2	0-2,0.7-2,1-1.5,1-10,1-3,1-4,10-20,2,2-2.5,2-23,2-3.5,2-4,2-5,2-5-9-pinnate,2.5-28,3-4,3.5-12,acuminate,acute,adpressed,also,apart,apex,basal,base,calyx,campanulate,cm,compound,cordate,cuneate,darker,deflexed,deltate,densely,diameter,ellipsoidal,fading,flattened,flower,fruit,fusiform,green,hair,leaf,light,lobe,long,longitudinal,mm,oblong,obtuse,often,ovoid,pedicel,peltiform,petiole,pilose,pink,pinnatifid,pore,puberulent,purple,ripe,shrub,simple,sparsely,stigma,stripe,style,tip,tree,triangular,truncate,tube,unbranched,unlobed,white,whitish,x,yellow-green,yellowish	-7,0.5-2,1-2.5,1-3-10,1.5-2,1.5-3,1.5-9,2-3,3-5,4-5,4-foliat,5-11,5-30,7-15,abaxially,absent,adaxially,aggregate,along,ape,articulated,axe,basiscopically,beyond,biglandula,blade,broad,cell,chartaceous,color,connective,coriaceous,cylindrical,decurrent,dilated,directed,distally,eaf,eed,eglandular-pubescent,ellipsoida,elliptic,entire,equal,especially,exceeding,exserted,frequently,glabrous,glandular-,interstitial,irregularly,lateral,laterally,leaflet,leaving,lobed,lon,lower,margin,midrib,moderately,narrowed,nflorescence,nther,obconical,oblique,occasionally,orolla,ovate,papillose,pedicellar,peduncle,perfect,pilo,pinnately,present,pubescent,rachi,radiu,remnant,ruit,shorter,slightly,small,smaller,spaced,stamen,stone,strongly,subcoriaceous,tal,tem,thecae,time,tomento,toward,ud,unit,unknow,upper,vary,violet,wide,ympodial	anther,anthesi,arrangement,biglandular,bud,coat,colour,connation,corolla,decurrency,dry,embryo,feature,filament,form,growth,height,history,inflorescence,length,life,midpoint,minor,na,new,number,ovary,papilla,plant,prickle,ray,reproduction,scar,seed,shape,size,spacing,specimen,stem,surface,texture,tuberculation,type,width,winging,young	0-2,0.7-2,1-1.5,1-10,1-3,1-4,10-20,2,2-2.5,2-23,2-3.5,2-4,2-5,2-5-9-pinnate,2.5-28,3-4,3.5-12,acuminate,acute,adpressed,also,apart,apex,basal,base,campanulate,cm,compound,cordate,cuneate,darker,deflexed,deltate,densely,diameter,ellipsoidal,fading,flattened,fusiform,green,hair,light,lobe,long,longitudinal,mm,oblong,obtuse,often,ovoid,peltiform,pilose,pink,pinnatifid,puberulent,purple,ripe,shrub,simple,sparsely,stripe,style,tip,tree,triangular,truncate,unbranched,unlobed,white,whitish,x,yellow-green,yellowish	biglandular,na
445	wfo-0001031144	success	227	129	94	108	119	21	90	4	.2,.5,0.8-1.4,1-2-9-11,1-4,100,2-3.5-10-13,2-6,2.5-3,2/3,25,3-7,4-4.5,7-10,acuminate,acute,adaxially,anther,apart,apex,asymmetric,base,berry,branch,bright,brown,calyx,capitate,closer,cm,commonly,connivent,cordate,corolla,diameter,drying,ellipsoid,entire,flattened,flattened-reniform,flower,form,glabrous,globose,groove,growth,inflated,inflorescence,irregularly,later,lateral,leaf,less,lobed,long,loosely,margin,minute,minutely,mm,near,new,number,oblique,occasionally,often,open,pale,pedicel,petiole,pinnately,pinnatifid,pitted,plurifoliate,poricidal,pubescent,red,reddish,ripe,scar,seed,shiny,simple,slightly,spaced,sparsely,stellate-rotate,stem,stigma,style,surface,terete,terminal,tiny,tip,together,trichome,truncate,tube,uniseriate,usually,vine,violet,way,white,woody,x,Â½	0.2,0.5,1-1.5,1.1-2.5,2,2-3,3-4.5,4,4-20,4-6,5,5-9,5-merou,6,<,ag,alyx,anthesi,apicula,apiculae,appearing,ark,around,articulated,away,axi,basal,basiscopically,blac,branche,broadly,brow,cell,corresponding,cupped,curved,densely,divaricate,eaf,eed,elliptic,elongate,elongating,exserted,extending,filament,four,free,fruiting,geminat,ilament,lamina,larger,leaflet,leaving,lengthening,like,lobe,longer,longest,lower,many,markedly,membranous,mere,nflorescence,older,one,orolla,outline,pair,papillo,peduncle,peg,pendant,pentagonal,per,perfect,pericarp,pore,portion,primary,progress,quite,rim,ruit,sleeve,slit,small,smaller,sometimes,spreading,strongly,tan,tangle,tem,testal,thin,third,triangular,tuft,twinin,twining,two,ud,unequal,unit,upper,variable,vary,vein,wall,weight,widest,wing,wood,yellow,yellowish,ympodial	arrangement,bark,black,bud,coat,colour,feature,fruit,geminate,length,na,ovary,papillose,shape,size,spacing,texture,tuberculation,type,width,young	.2,.5,0.8-1.4,1-2-9-11,1-4,100,2-3.5-10-13,2-6,2.5-3,2/3,25,3-7,4-4.5,7-10,acuminate,acute,adaxially,apart,apex,asymmetric,base,berry,branch,bright,brown,capitate,closer,cm,commonly,connivent,cordate,diameter,drying,ellipsoid,entire,flattened,flattened-reniform,glabrous,globose,groove,inflated,inflorescence,irregularly,later,lateral,less,lobed,long,loosely,minute,minutely,mm,near,oblique,occasionally,often,open,pale,pinnately,pinnatifid,pitted,plurifoliate,poricidal,pubescent,red,reddish,ripe,shiny,simple,slightly,spaced,sparsely,stellate-rotate,surface,terete,terminal,tiny,tip,together,trichome,truncate,uniseriate,usually,vine,violet,way,white,woody,x,Â½	black,geminate,na,papillose
446	wfo-0001031152	success	232	148	99	110	122	38	94	5	-10,0.2-0.3,0.2-1.5,0.3-3,1-1.5,1-3,1-6,1.1-2.2,1.4-2.6,1.5-3.5,11,13-27,2.5-7.5,2.8-4,4-6,4-8,8-20,acuminate,acute,anther,anthesi,apart,apex,apical-lateral,attenuate,base,becoming,berry,blunt-tipped,brown,bud,calyx,cm,continued,corolla,decurrent,deltoid,due,extend,filament,fleshy,flower,free,fruit,globose,granular-tomentose,green,greenish,growth,hair,honeycombed,introrse,lanceolate,large,lateral,lavender,leaf,length,lilac,lobe,long,long-,longitudinal,mixed,mm,mostly,multangulate,narrowly,nearly,oblanceolate,oblong,obtuse,occasionally,orbicular,ovate,pale,pedicel,persistently,petiole,pore,porrect-stellate,probably,ray,reddish,reddish-brown,reniform,reticulate-punctate,ripe,rotate-stellate,scabrous,sessile,short-,shrub,simple,slit,stelliform,stem,stigma,style,suborbicular,surface,terminal,thick-stalked,tomentose,tree,tube,violet,x,yellow,young	-1.5,-5.5,.4,/100-1/16,0-100,0.3-1.3,1.1-3,1.2-1.8,1.3-4,1.5-3,1/2-2/3,1/2-3/4,2-5,2.7-3.7,2.7-4.5,2.7-6,3.7-7,4-19,4-7,5-6,6.5-10,9-13,abaxially,accrescent,adaxially,ag,along,apparently,articulated,axe,axillary,ba,basal,blade,blister,branch,branched,bullate,capitat,chartaceous,closely,conical,dehiscing,densely,diameter,directed,eaf,earl,eed,entire,evident,exserted,few-rayed,fruiting,glabrescen,glabrous,high,inserted,lackin,less,lobed,longer,lower,m.,main,margin,midvein,moderately,multangulat,nflorescence,one,open,openly,orolla,partly,peduncle,perfect,pitted,plurifoliate,pubescent,rachi,rather,relatively,ruit,runk,short-stalked,side,slightly,somewhat,soon,spaced,sparingly,sparsely,splitting,stamen,stellate-pubescent,stipitate-glandular,stout-stalked,strongly,suture,swelling,tamen,terete,testa,thick,thin,thin-,thin-stalked,time,touching,toward,unarme,unarmed,unit,usually,variously,vary,vein,way,wide,yellowish,ympodial	30-100,age,arrangement,capitate,coat,colour,connation,decurrency,dry,feature,form,height,history,inflorescence,life,midpoint,minor,new,number,ovary,papilla,perennial,plant,prickle,reproduction,scar,seed,shape,size,spacing,specimen,texture,tip,tuberculation,type,unknown,width,winging	-10,0.2-0.3,0.2-1.5,0.3-3,1-1.5,1-3,1-6,1.1-2.2,1.4-2.6,1.5-3.5,11,13-27,2.5-7.5,2.8-4,4-6,4-8,8-20,acuminate,acute,apart,apex,apical-lateral,attenuate,base,becoming,berry,blunt-tipped,brown,cm,continued,decurrent,deltoid,due,extend,fleshy,flower,free,fruit,globose,granular-tomentose,green,greenish,growth,hair,honeycombed,introrse,lanceolate,large,lateral,lavender,lilac,long,long-,longitudinal,mixed,mm,mostly,multangulate,narrowly,nearly,oblanceolate,oblong,obtuse,occasionally,orbicular,ovate,pale,persistently,petiole,pore,porrect-stellate,probably,reddish,reddish-brown,reniform,reticulate-punctate,ripe,rotate-stellate,scabrous,sessile,short-,shrub,simple,slit,stelliform,stem,suborbicular,terminal,thick-stalked,tomentose,tree,violet,x,yellow	30-100,age,capitate,perennial,unknown
447	wfo-0001031202	success	198	159	116	131	67	28	113	3	.1,.5,0-0.5,0-1,0.5-1,0.6-1.1,0.8-1,1-1.5,1-5,1.5-9,15-40,2-3,2-8,2.5-13,2.5-3.5,2.5-4,2/3,20-100-flowered,6-25,9-20,abrupt,acute,anther,anthesi,apart,apex,axi,bark,base,berry,broadly,bud,calyx,capitate,cm,completely,complex,cordate,corky,corolla,cup-shaped,decurrent,densely,dia,dry,enclosed,erect,exserted,filament,fleshy,flower,fruit,furcate,glabrate,glabrous,globose,golden,green,inflorescence,irregularly,later,lateral,leaf,like,lobe,lobed,long,long-ellipsoid,many,margin,minor,minute,minutely,mm,narrowing,obovate,occasional,occasionally,opposite,orbicular,ovary,overtopping,ovoid-reniform,papillose,pedicel,petiole,pitted,planar,plant,pore,poricidal,puberulent,pubescent,quite,raised,reddish-brown,rounded,scar,scattered,sessile,shape,shaped,shoot,shrub,size,slender,slightly,small,spaced,sparsely,specimen,stem,stigma,style,surface,tapering,tear-drop,terminal,time,tip,tree,trichome,tube,uniseriate,variable,way,white,winged,woody,x,young	0.1-0.3,0.5,1-1.7,1.5-2,1.5-2.5,3.5-4,9-11,accrescent,along,apiculate,beneath,condition,deflexed,deltoid,differing,difoliate,distal,due,eaf,edicel,eed,extremely,free,frui,fruiting,geminat,greenish-white,greyi,hard,large,live,lon,long-styled,longer,lower,main,major,material,middle,nflorescence,often,older,one,pair,pale,paler,papillo,portion,prominent,ruit,short-styled,straight,tall,tan,thick,thickened,thicker,third,tub,ud,unit,usually,vein,weight,whitish,widest,ympodial	arrangement,coat,colour,connation,embryo,feature,form,greyish,growth,height,history,length,life,midpoint,na,number,papilla,perennial,prickle,ray,reproduction,seed,spacing,texture,tuberculation,type,width,winging	.1,.5,0-0.5,0-1,0.5-1,0.6-1.1,0.8-1,1-1.5,1-5,1.5-9,15-40,2-3,2-8,2.5-13,2.5-3.5,2.5-4,2/3,20-100-flowered,6-25,9-20,abrupt,acute,anthesi,apart,axi,base,berry,broadly,bud,calyx,capitate,cm,completely,complex,cordate,corky,corolla,cup-shaped,decurrent,densely,dia,dry,enclosed,erect,exserted,fleshy,furcate,glabrate,glabrous,globose,golden,green,inflorescence,irregularly,later,lateral,leaf,like,lobe,lobed,long,long-ellipsoid,many,margin,minute,minutely,mm,narrowing,obovate,occasional,occasionally,opposite,orbicular,overtopping,ovoid-reniform,papillose,pitted,planar,poricidal,puberulent,pubescent,quite,raised,reddish-brown,rounded,scattered,sessile,shaped,shoot,shrub,slender,slightly,small,spaced,sparsely,specimen,stem,tapering,tear-drop,terminal,time,tip,tree,trichome,tube,uniseriate,variable,way,white,winged,woody,x,young	greyish,na,perennial
448	wfo-0001031207	success	217	127	72	89	128	38	70	2	-4,-7,/5,0.25-0.5,0.5-1,0.6-0.9,0.6-1.2,0.7-2,0.85-1.4,1-5,1.5-5,1/4-1/3,2-3,2.1-2.3,2.8-3,anther,apart,apex,articulated,base,berry,bristly,calyx,cell,cm,cordate,densely,diameter,erect,evenly,filament,flattened-reniform,flower,fruit,gray,green,herb,herbaceous,lanceolate,lateral,leaf,length,lobe,lobed,long,maturity,mauve,midpoint,mm,moderately,narrow-deltate,oblong,obtuse,orange-brown,outline,ovate,pale,pedicel,pendulous,petiole,pit,poricidal,prickle,prickly,raised,ray,red,scandent,scar,shrub,simple,small,smooth,sometimes,spherical,spreading,stellate-pubescent,stem,style,surface,tapering,terminal,tip,tube,upper,way,white,wide,young	-11,.1,0-0.5,0-10,0-20,0-5,0-8,0.1-0.2,0.1-0.3-0.4,0.1-0.5,0.2,0.2-0.3,0.3-0.5,0.8,0.9-1.6,1,1-3,1-4,1.4-2,1/,1/3,1/3-equal,1/4-1/3-1/2,2-4,2.5-3-5,3-5,3.5-7,5-8,5-merous,6-8,6.5-8,9-5,abaxially,acuminat,acute,alyx,ame,apar,apically,apparently,bark,blade,branched,bristle,broad-deltate,brow,c.,chartaceous,concolorous,curved,dark,difoliate,discolorous,distance,drying,dull,eaf,eed,elongated,elongating,equal,extending,eye,filiform,free,fruiting,geminat,gently,glabrescent,glabrous,infructescence,less,like,longer,lower,margin,mature,midvein,multangulate,naked,nflorescence,occasionally,older,one,open,orolla,oung,pair,peduncle,per,perfec,pericarp,perpendicular,persistent,porrect,portion,prickl,primary,reflexed,rounded,ruit,sessile,shorter,side,spaced,stalk,stalked,stellate,straight,subentire,tamen,terete,tertiary,time,toward,trichome,unarmed,unit,usually,variously,vary,vein,venation,visible,weakly,yellow,yellow-green,ympodial	0.1-0.3,anthesi,arrangement,bud,coat,colour,connation,corolla,decurrency,dry,embryo,feature,form,growth,height,history,inflorescence,life,minor,na,new,number,ovary,papilla,plant,pore,reproduction,seed,shape,size,spacing,specimen,stigma,texture,tuberculation,type,width,winging	-4,-7,/5,0.25-0.5,0.5-1,0.6-0.9,0.6-1.2,0.7-2,0.85-1.4,1-5,1.5-5,1/4-1/3,2-3,2.1-2.3,2.8-3,apart,articulated,base,berry,bristly,cell,cm,cordate,densely,diameter,erect,evenly,flattened-reniform,gray,green,herb,herbaceous,lanceolate,lateral,lobed,long,maturity,mauve,mm,moderately,narrow-deltate,oblong,obtuse,orange-brown,outline,ovate,pale,pendulous,pit,poricidal,prickly,raised,red,scandent,shrub,simple,small,smooth,sometimes,spherical,spreading,stellate-pubescent,tapering,terminal,tip,upper,way,white,wide,young	0.1-0.3,na
449	wfo-0001031218	success	154	128	73	81	73	47	71	2	-5,0.5,0.5-1,1-2,1-4,15-25,2-22,2.5-3,4-28,4-7,4-8,40-100+,5-37,5.5-7,6-10,6-7,6-9,8-20,acuminate,acute,apart,apex,apiculate,basal,base,branched,calyx,cm,connivent,cordate,coriaceous,dark,densely,directed,distally,eglandular,ellipsoidal,flattened,flower,fruit,glabrous,glandular,glandular-puberulent,globose,greenish-purple,hair,introrse,lanceolate,lavender,less,lobe,long,minutely,mm,mottled,narrowly,oblique,obtuse,orange,ovate,ovate-elliptic,ovoid,pedicel,petiole,pore,puberulent,pubescent,ripe,simple,sometimes,sparsely,stellate,stigma,style,tip,tree,triangular,tube,violet,x,yellow	1-3,10-19,2-2.5,2-3,3,3-14,3-5,4-5,4-foliat,40,5-7,8-17,abaxially,adaxially,aggregate,ape,articulated,axe,beyond,blade,cell,connective,cylindrical,diameter,eaf,eed,eglandular-pilose,entire,equal,especially,exceeding,exserted,glabrou,leaving,lon,lower,margin,moderately,nflorescence,nther,orolla,papillo,pedicellar,peduncle,perfect,presen,present,purpl,purple,rachi,radiu,remnant,ruit,shorter,slightly,small,spaced,stamen,stone,subcoriaceous,succulent,tal,tem,thecae,time,tomento,toward,truncat,ud,unit,vary,wide,ympodial	anther,anthesi,arrangement,bud,coat,colour,connation,corolla,decurrency,dry,embryo,feature,filament,form,growth,height,history,inflorescence,leaf,length,life,midpoint,minor,na,new,number,ovary,papilla,plant,prickle,ray,reproduction,scar,seed,shape,size,spacing,specimen,stem,surface,texture,truncate,tuberculation,type,width,winging,young	-5,0.5,0.5-1,1-2,1-4,15-25,2-22,2.5-3,4-28,4-7,4-8,40-100+,5-37,5.5-7,6-10,6-7,6-9,8-20,acuminate,acute,apart,apex,apiculate,basal,branched,cm,connivent,cordate,coriaceous,dark,densely,directed,distally,eglandular,ellipsoidal,flattened,glabrous,glandular,glandular-puberulent,globose,greenish-purple,hair,introrse,lanceolate,lavender,less,lobe,long,minutely,mm,mottled,narrowly,oblique,obtuse,orange,ovate,ovate-elliptic,ovoid,puberulent,pubescent,ripe,simple,sometimes,sparsely,stellate,tip,tree,triangular,violet,x,yellow	na,truncate
450	wfo-0001031225	success	163	124	71	93	70	31	67	4	.5,0.2-0.75,0.5,0.5-1,0.7-6,0.75-1,1-1.5,1-3,1-5,1.5-5,2,3-9,3/4,5-6,7-9,9-16,acute,anther,anthesi,apart,apex,bark,base,berry,broadly,bud,calyx,closely,cm,corolla,cup-shaped,deltoid,dry,elliptic,erect,filament,furcate,glabrate,glabrous,globose,green,growth,inflorescence,leaf,lobe,lobed,long,minor,minutely,mm,often,older,opposite,outline,ovary,ovate,ovoid-reniform,papillose,pedicel,petiole,pitted,plant,pore,poricidal,pubescent,red-papillose,rounded,scar,shape,shaped,shrub,size,slender,small,spaced,specimen,stem,stigma,style,surface,tapering,tear-drop,tip,tree,trichome,tube,unevenly,uniseriate,way,white,woody,x,young	.25,/3,0.1-0.75,0.2,0.8-1,1-1.7,2.5-3,5-50-flowered,6-8,along,beginning,characteristic,conspicuous,darker,decurrent,dia,differentiated,differing,difoliate,eaf,edicel,eed,ellipsoid,exserted,flattene,fragrant,free,fruiting,geminat,greyish-brow,inflorescenc,lateral,less,like,live,lon,lower,main,major,margin,middle,minute,much,narrowly,nflorescence,one,pair,pale,papillo,portion,prominent,proximal,raised,reflexed,rest,rhomboidal,ruit,slightly,soon,straight,strongly,sweetly,swelling,tall,tan,ud,unit,vein,widest,ympodial	5-50,abaxial,adaxial,alternate,arrangement,coat,colour,connation,feature,flower,form,fruit,greyish-brown,hair,height,history,length,life,midpoint,na,number,papilla,prickle,ray,reproduction,seed,spacing,texture,tuberculation,type,width	.5,0.2-0.75,0.5,0.5-1,0.7-6,0.75-1,1-1.5,1-3,1-5,1.5-5,2,3-9,3/4,5-6,7-9,9-16,acute,apart,base,berry,broadly,calyx,closely,cm,cup-shaped,deltoid,elliptic,erect,furcate,glabrate,glabrous,globose,green,leaf,lobed,long,minutely,mm,often,opposite,outline,ovate,ovoid-reniform,papillose,pitted,poricidal,pubescent,red-papillose,rounded,shaped,shrub,slender,small,spaced,tapering,tear-drop,tip,tree,trichome,tube,unevenly,uniseriate,way,white,woody,x,young	5-50,alternate,greyish-brown,na
451	wfo-0001031231	success	174	91	55	67	107	24	52	3	.5,0.5-1.5-2,1-2,1.5-2,13,2.5-3,37/2,37/3,4-8,5-7,8-10,acuminate,acute,almost,anther,apex,axillary,base,berry,branch,branched,calyx,campanula,campanulate,cm,colour,corolla,discoidal,ellipsoid,equal,flower,fork,globose,green,juvenile,leaf,long,marbled,mature,mm,oblong,occasionally,ovary,pedicel,pentagonal,pinnatisect,plant,poricidal,purple,rh,ripening,rotate,rounded,rugose-ruminate,seed,shrub,simple,soft,sometimes,stigma,stout,style,surface,tinged,tip,violet,wooded	1-1.5,1-3,1-4,2-3,2-4,25-35,3-4,80-110,absent,acumen,adherent,along,anthesi,aromatic,aspect,axi,basal,becoming,beyond,blunt,bluntly,brown,cell,clonal,cluster,dark,declinate,developed,dia,eaf,eed,elliptic,entire,erect,exceeding,except,exerted,expanded,facetted,filament,fleshy,flowering,folded,general,glabrous,glandular,gree,greyish,habit,hair,herbarium,interacuminal,lanceolate,lasting,len,lengthening,less,lobe,lon,loosely,lower,margin,mauve,midrib,minute,nflorescence,often,pedice,pedicellate,peduncle,petal,plurifoliat,pore,projecting,rarely,readily,recurve,ripe,ruit,sessile,several,shallow,shed,short,sinus,slightly,slit,small,specimen,stone,stonrgly,succulent,tissue,toward,translucent,triangular,tub,ud,unit,usually,variable,vigorous,well,without,x,year,ympodial	arrangement,bud,feature,form,fruit,growth,height,history,inflorescence,length,life,na,non-clonal,number,papilla,plurifoliate,reproduction,shape,size,stem,texture,tube,type,width	.5,0.5-1.5-2,1-2,1.5-2,13,2.5-3,37/2,37/3,4-8,5-7,8-10,acuminate,acute,almost,axillary,berry,branch,branched,campanula,campanulate,cm,discoidal,ellipsoid,equal,fork,globose,green,juvenile,long,marbled,mature,mm,oblong,occasionally,pentagonal,pinnatisect,poricidal,purple,rh,ripening,rotate,rounded,rugose-ruminate,shrub,simple,soft,sometimes,stout,tinged,tip,violet,wooded	na,non-clonal,plurifoliate
452	wfo-0001031252	success	170	121	77	93	77	28	74	3	0.2-1.5,0.3-1.1,1-2,1-3,1.3-1.9,1.75-5.2,12-20,16-33,2-3,2.5-7,2.8-3.6,3-10,3-5,3-6,5-17,5-9,5.5-6.5,7-18,acute,anther,apex,attenuate,axillary,base,brownish,bud,cell,ciliate,clavate,cm,condition,connivent,coriaceous,corolla,covering,cuneate,dark,deep,diameter,drying,elliptic,entire,flower,fresh,fruit,glabrous,globose,green,greenish,hair-like,herb,homostylous,lanceolate,lateral,light,lobe,margin,medium,mm,moniliform,mottled,ovate,ovoid,pedicel,peduncle,petiole,plant,pore,poricidal,purple,rotate,rounded,seed,serrate,simple,sometimes,stigma,straight,stripe,style,subtending,terminal,testal,thick,tip,tube,tuber,unwinged,wall,white,whitish,x,yellow	0.4-3,5-8,5-merou,abaxially,absent,acumen,adaxiall,adaxially,ag,along,alyx,apart,apparently,arranged,articulated,axe,bead,berry,blade,capitat,digestion,distal,dorsally,eaf,edge,eed,enzyme,erec,exceeding,filament,flat,folded,forked,geminat,generally,glabrou,green-white,hal,half,high,honeycomb-shaped,interjected,leaflet,lengthening,like,linear,living,long,lower,make,mucilaginous,multiple,necklace,nflorescence,orolla,perfect,plurifoliate,removed,ripe,ruit,seudostipule,slit,spaced,specimen,stamen,stolon,tall,tamen,tem,throughout,tri-,typically,unit,usually,vary,wet,ympodial	5-merous,abaxial,adaxial,arrangement,calyx,capitate,colour,connation,feature,form,growth,height,history,inflorescence,leaf,length,life,number,ovary,perennial,pseudostipule,reproduction,shape,size,spacing,stem,surface,texture	0.2-1.5,0.3-1.1,1-2,1-3,1.3-1.9,1.75-5.2,12-20,16-33,2-3,2.5-7,2.8-3.6,3-10,3-5,3-6,5-17,5-9,5.5-6.5,7-18,acute,attenuate,axillary,brownish,bud,cell,ciliate,clavate,cm,condition,connivent,coriaceous,covering,cuneate,dark,deep,drying,elliptic,entire,fresh,glabrous,globose,green,greenish,hair-like,herb,homostylous,lanceolate,lateral,light,medium,mm,moniliform,mottled,ovate,ovoid,poricidal,purple,rotate,rounded,serrate,simple,sometimes,straight,stripe,subtending,terminal,testal,thick,tip,unwinged,wall,white,whitish,x,yellow	5-merous,capitate,perennial
453	wfo-0001031257	success	200	110	60	73	127	37	56	4	0.7-1,0.75-2.5,1.1-1.2,1.5-1.7,11.5-15,2-4.5-6,4.5-6-12,5,7-10-16-22.5,7.5-9,acuminate,anther,anthesi,apex,attenuate,base,berry,blue-violet,bud,calyx,campanulate,cm,coarsely,coat,corolla,cotyledon,cuneate,curved,densely,dentate,ellipsoidal,embryo,filament,glabrous,globose,herb,honey-combed,inconspicuous,leaf,length,light,lobe,longitudinal,longitudinally,mm,narrowly,odorles,ovate,petiole,pore,poricidal,purple,reduced,rest,ridged,robust,seed,serrate,shorter,shrub,simple,slit,stem,stigma,style,tip,trans-ovoidal,triangular,tube,ventrifixed,viscid,white,x	0,0.4,0.5,0.5-0.8,1-1.2,1-1.3,1.5,1.5-2,1/10,2-,3,3.5-4-,3.5-5.7,4-10,4.5-5,5-,5-8.5-12,6-celled,8,8-celled,abaxially,abundant,accrescen,adaxially,ag,aggregate,antrorse,ascending,basal,bicellular,branch,broad,cell,connectival,cuticle,dark,deep,diamete,diameter,difoliate,directed,dorsally,eaf,edentate,eed,elliptical,endosperm,epidermal,erect,finely,flexuous,foliage,free,fruiting,geminat,glandular,hair-like,half,head,herbaceous,high,hollow,inserted,lamina,lateral,like,little,lon,long,long-stalked,longer,lower,many-seeded,margin,midvein,non-glandular,opening,orolla,outward,pair,papillate,patent,pericarp,portion,prolongation,pubescent,rarely,ree,ring,ruit,saddle-shape,scarce,scarcely,secondary,separated,short-stalked,single-celled,sinus,slightly,small,smooth,solitary,somewhat,spur-like,stalk,stone,strand,striate,subglobose,tem,thecae,thickened,thickening,time,tooth,trichome,unequal,unit,upward,vary,vein,verrucate,viscid-pubescen,wall,within,yellow,ympodial	age,arrangement,colour,connation,decurrency,feature,flower,form,fruit,growth,height,history,inflorescence,life,minor,na,new,number,ovary,papilla,pedicel,plant,prickle,reproduction,saddle-shaped,scar,shape,size,spacing,surface,texture,tuberculation,type,viscid-pubescent,width,winging,young	0.7-1,0.75-2.5,1.1-1.2,1.5-1.7,11.5-15,2-4.5-6,4.5-6-12,5,7-10-16-22.5,7.5-9,acuminate,anthesi,attenuate,berry,blue-violet,bud,campanulate,cm,coarsely,cotyledon,cuneate,curved,densely,dentate,ellipsoidal,embryo,glabrous,globose,herb,honey-combed,inconspicuous,light,longitudinal,longitudinally,mm,narrowly,odorles,ovate,poricidal,purple,reduced,rest,ridged,robust,serrate,shorter,shrub,simple,slit,tip,trans-ovoidal,triangular,ventrifixed,viscid,white,x	age,na,saddle-shaped,viscid-pubescent
454	wfo-0001031270	success	234	126	79	99	135	27	76	3	+,0.4-1.5,0.5-1,1-1.2,1-4,1.2-1.6,10,10-12,2-2.5,2-3,2-7,2.5-3,3-10,5-10,5-15,6-17,6-50,acute,anther,anthesi,apart,apex,base,beginning,berry,bipinnatifid,bright,brown,calyx,capitate,clavate,cm,connivent,densely,depressed-spherical,elliptic,filament,flower,glandular-pubescent,growth,herb,inflorescence,later,lateral,leaf,leaf-opposed,length,lobe,long,long-styled,loosely,minute,minutely,mm,narrowly,new,ovoid,pedicel,petiole,pinnatifid,pitted,plant,pore,poricidal,prickle,prickly,pubescent,red,reddish,reniform,ripe,rounded,scar,shallowly,short-styled,shrub,simple,size,slender,slightly,sparsely,spherical,spreading,stellate,stem,stigma,straight,straw-colored,style,surface,tapering,terete,tip,truncate,tube,upward,white,wide,yellow	.5,1,1-3,1.5,1.5-2,1/3,100,2-20,2-4,3-20,3-5,4-5,5,5-6,5-merous,7-12,8,9-10,>,abaxial,abaxially,accrescent,adaxial,adaxiall,along,alyx,arme,articulated,associated,bark,basal,blade,brow,c.,cell,celled,colored,conical,consistently,curved,deeply,diameter,differentiated,difoliate,directed,distal,eed,ellipti,entire,equal,erect,few-rayed,free,frui,fruiting,geminat,glabrous,gland,glandular,green,heavily,heterostylous,infructescence,investing,leafy,like,live,lobed,lon,longer,lower,margin,membranous,midpoint,midvein,mixture,multangulate,multiseriate,nflorescence,obovate,occasionally,often,older,orolla,oung,outline,pair,pale,papillo,peduncle,per,pericarp,portion,primary,rachi,ray,reflexed,rest,ruit,scattered,secondary,sessile,shallow,shining,short-stalked,single,sinuate,small,stalk,staminat,strongly,tall,tamen,tan,testal,thin,thus,tightly,tissue,trichome,uniseriate,unit,usually,vary,varying,vein,way,well,wice,wid,wing,woody,yellowish,ympodial,Â½	arrangement,bud,coat,colour,connation,corolla,decurrency,embryo,feature,form,fruit,height,minor,na,number,ovary,papilla,papillose,seed,shape,spacing,texture,tuberculation,type,width,winging,young	+,0.4-1.5,0.5-1,1-1.2,1-4,1.2-1.6,10,10-12,2-2.5,2-3,2-7,2.5-3,3-10,5-10,5-15,6-17,6-50,acute,anthesi,apart,beginning,berry,bipinnatifid,bright,brown,capitate,clavate,cm,connivent,densely,depressed-spherical,elliptic,flower,glandular-pubescent,herb,later,lateral,leaf-opposed,long,long-styled,loosely,minute,minutely,mm,narrowly,ovoid,pinnatifid,pitted,poricidal,prickly,pubescent,red,reddish,reniform,ripe,rounded,shallowly,short-styled,shrub,simple,slender,slightly,sparsely,spherical,spreading,stellate,straight,straw-colored,tapering,terete,tip,truncate,upward,white,wide,yellow	fruit,na,papillose
455	wfo-0001031283	success	51	53	32	34	17	19	29	3	0.1-0.15-0.25,0.4-0.5,0.5-0.7,0.7,2.2-2.8,30-40,acute,apex,base,brown,calyx,cell,cm,diameter,erect,hair-like,lateral,long,mm,narrowly,obovate,outgrowth,pale,pubescent,shrub,somewhat,sprawling,surface,testa,thick,wall,wide,winged,woody	.7-2.3,appearance,eed,elongating,fide,fruit,give,lo,lobe,markedly,moore,pleasant,silky,small,smelling,spreadin,tall	1.7-2.3,colour,feature,form,growth,height,history,length,life,na,plant,reproduction,seed,shape,size,spreading,stem,texture,width	0.1-0.15-0.25,0.4-0.5,0.5-0.7,0.7,2.2-2.8,30-40,acute,brown,cell,cm,erect,hair-like,lateral,long,mm,narrowly,obovate,outgrowth,pale,pubescent,shrub,somewhat,sprawling,testa,thick,wall,wide,winged,woody	1.7-2.3,na,spreading
456	wfo-0001031287	success	147	79	43	56	91	23	41	2	0.5-1.5,0.9-1,1,1-1.2,1-5,1.5-2,1.5-5.5,3-4,4-5,5-14,6-7,anther,bark,berry,bi-lobed,calyx,cm,conical,corolla,dark,dendritic,densely,elliptic,erect,fleshy,glabrous,globose,green,greenish-white,leaf,lobed,minutely,mm,ovary,ovoid-reniform,papillose,pedicel,petiole,pitted,poricidal,pubescent,red-papillose,shaped,shrub,simple,stem,stigma,style,surface,tear-drop,tip,trichome,tube,white,x,young	.5,1-1.3,1-1.5,2-2.5,3-5,4-6,4.5-5,6-10-flowered,abaxially,acute,adaxially,anthesi,apar,ape,apex,attenuate,axil,base,bearing,branch,connective,coriaceous,deflexed,deltate,dia,difoliate,divergently,eaf,edicel,eed,ellipsoid,elongate,enlarged,exserted,filament,free,frui,fruiting,geminate,internodal,knob,lamina,later,lateral,lobe,lon,long,lower,main,many,margin,membranous,middle,nearly,nflorescence,occasionally,older,onto,pair,pale,papillo,planar,plurifoliate,pointed,pore,portion,reddish-brow,reflexed,rounded,ruit,scar,shoot,short,sinus,small,somewhat,spaced,strongly,tan,thick,thin,tub,tuft,ud,unevenly,unit,vein,widest,winged,woody,ympodial	6-10,abaxial,adaxial,arrangement,colour,feature,flower,form,fruit,growth,hair,height,inflorescence,length,number,plant,reddish-brown,seed,shape,size,texture,type,width	0.5-1.5,0.9-1,1,1-1.2,1-5,1.5-2,1.5-5.5,3-4,4-5,5-14,6-7,berry,bi-lobed,cm,conical,dark,dendritic,densely,elliptic,erect,fleshy,glabrous,globose,green,greenish-white,lobed,minutely,mm,ovoid-reniform,papillose,pitted,poricidal,pubescent,red-papillose,shaped,shrub,simple,tear-drop,trichome,white,x	6-10,reddish-brown
457	wfo-0001031300	success	216	132	77	92	124	40	74	3	-4,-5,-6,.5,/4,0.2-0.4,0.2-0.5,0.3,0.5-0.9,0.5-2,0.7-0.9,0.7-1.2-2.2,1-2,1-4,1.3-2,1.5-3.5,2-3,2-5.5,2-6,2.2-2.3,2.2-2.7,acute,anther,apart,apex,apically,articulated,attenuate,base,berry,calyx,cell,cm,connivent,curved,deltate,densely,dull,erect,filament,flattened,flattened-reniform,flower,fruit,glabrous,lateral,leaf,length,lobe,lobed,long,maturity,midpoint,mm,moderately,near,oblanceolate,orange,outline,pale,pedicel,petiole,pit,poricidal,prickle,prickly,pubescent,raised,ray,red,rounded,scar,shrub,simple,small,smooth,sparsely,spherical,spreading,stellate,stellate-pubescent,stem,style,surface,tapering,tip,trichome,tube,way,white,wide,yellow-orange	0-15,0-20,0-3,0-8,0.1,0.1-0.5,0.1-0.6,0.15-0.7,0.2-0.7,0.2-1,0.3-0.6,0.3-1.3,0.5-1.5,0.5-18,0.6-0.8,0.6-1,0.6-1.2,0.8-1.5,1-5,1.2-1.7,1/2-3/4,1/3-1/2,1/6-1/4,10-30,2-3-4,2-4,2.5-3.2,3-4,4.5-6,5-15,5-merous,6-8,abaxially,absent,also,alyx,apar,apparently,ba,bark,blade,branched,brow,brown-green,bulbous,caudat,chartaceous,concolorous,creeping,diameter,difoliate,distance,drying,eaf,eed,elongating,equal,extending,eye,filiform,free,fruiting,geminat,geniculate,glabrescent,gray-green,hair,herbaceous,highly,infructescence,lon,longer,lower,margin,mature,membranous,midvein,minute,naked,nflorescence,oblong,obtuse,older,one,open,orange-brown,orange-green,orolla,oung,pair,peduncle,pendulous,per,perfec,pericarp,porrect,portion,prickl,primary,rarely,reduced,ruit,sessile,side,spaced,stalk,stalked,tamen,terete,tertiary,thin,time,uniradiate,unit,vary,vein,venation,visible,weakly,wider,winged,yellow,yellow-green,ympodial	anthesi,arrangement,bud,caudate,coat,colour,connation,corolla,decurrency,dry,embryo,feature,form,growth,height,history,inflorescence,life,minor,new,number,ovary,papilla,perennial,plant,pore,reproduction,seed,shape,size,spacing,specimen,stigma,texture,tuberculation,type,unknown,width,winging,young	-4,-5,-6,.5,/4,0.2-0.4,0.2-0.5,0.3,0.5-0.9,0.5-2,0.7-0.9,0.7-1.2-2.2,1-2,1-4,1.3-2,1.5-3.5,2-3,2-5.5,2-6,2.2-2.3,2.2-2.7,acute,apart,apex,apically,articulated,attenuate,base,berry,cell,cm,connivent,curved,deltate,densely,dull,erect,flattened,flattened-reniform,glabrous,lateral,lobed,long,maturity,mm,moderately,near,oblanceolate,orange,outline,pale,pit,poricidal,prickly,pubescent,raised,red,rounded,shrub,simple,small,smooth,sparsely,spherical,spreading,stellate,stellate-pubescent,tapering,tip,trichome,way,white,wide,yellow-orange	caudate,perennial,unknown
458	wfo-0001031310	success	203	126	82	101	102	25	79	3	.5,0-3,0-4,1-10,1-2,1-3,1-6,1.5-4,15-40,2-3,2.5-5.5,2.5-8.5,3-10,4-10,4-12,5-6,5.5-21,anther,apex,attenuate,axillary,base,blue,blue-purple,broadly,brown,brownish,bud,chartaceous,cm,condition,connivent,corolla,cuneate,decurrent,diameter,drying,filament,flower,fresh,fruit,glabrous,globose,green,greenish,hair,herb,lanceolate,lateral,leaf,leaflet,less,light,like,lobe,long,membranous,mm,mottled,multicellular,narrowly,obtuse,odd-pinnate,ovate,ovate-elliptic,ovate-lanceolate,ovoid,pair,pale,pedicel,peduncle,petiole,petiolule,pilose,plant,pointed,pore,poricidal,pubescent,purple,rotate,seed,simple,size,slightly,sometimes,somewhat,sparsely,stem,stigma,streak,style,subtending,terminal,tip,tube,unwinged,white,whitish,x,yellow	0.5-3,1-5.5,4.5-4.8,5-7,5-merou,6-7,abaxially,absent,acumen,acuminate,adaxially,ag,along,alyx,apart,apparently,articulated,axe,berry,blade,borne,caly,cell,ciliate,conspicuously,covering,decreasing,digestion,distal,dorsally,eaf,edge,eed,elliptic,end,enzyme,erect-decumben,especially,exceeding,extremely,flat,folded,forked,geminat,generally,glabrou,gradually,green-white,hair-like,half,high,homostylous,honeycomb-shaped,interjected,larger,lengthening,living,lower,make,margin,midrib,minutely,mucilaginous,nflorescence,orolla,perfect,plurifoliate,puberulent,rachi,removed,rosette-forming,ruit,seudostipule,shortly,singly,slit,small,spaced,specimen,stamen,ste,stolo,straight,subellipsoi,subrosette-forming,tall,tamen,tem,testal,thick,throughout,tissue,toward,tri-,tuber,typically,unit,usually,vary,wall,wet,ympodial	abaxial,adaxial,arrangement,colour,connation,feature,form,growth,height,history,inflorescence,length,life,na,number,ovary,perennial,pseudostipule,reproduction,shape,spacing,staman,subellipsoid,surface,texture	.5,0-3,0-4,1-10,1-2,1-3,1-6,1.5-4,15-40,2-3,2.5-5.5,2.5-8.5,3-10,4-10,4-12,5-6,5.5-21,attenuate,axillary,blue,blue-purple,broadly,brown,brownish,bud,chartaceous,cm,condition,connivent,cuneate,decurrent,diameter,drying,fresh,glabrous,globose,green,greenish,hair,herb,lanceolate,less,light,like,long,membranous,mm,mottled,multicellular,narrowly,obtuse,odd-pinnate,ovate,ovate-elliptic,ovate-lanceolate,ovoid,pale,petiolule,pilose,pointed,poricidal,pubescent,purple,rotate,simple,slightly,sometimes,somewhat,sparsely,stem,streak,subtending,terminal,tip,unwinged,white,whitish,x,yellow	na,perennial,subellipsoid
459	wfo-0001031316	success	207	128	71	88	119	40	68	3	-2,/3,0.3-1,0.4-0.6,0.5-2,0.6-1,0.8-1.2,0.8-1.8,0.9-1.3,1-5,1.3-3.5,1.5-2,2.5-8,3-8,3.8-5,6-20,acuminate,acute,almost,anther,apex,apically,bark,base,berry,blue-mauve,bright,calyx,cm,connivent,cream,dark,densely,dull,erect,filament,flattened-reniform,flower,fruit,glabrescent,glabrous,gray,green,lateral,leaf,length,lobe,lobed,marking,maturity,midpoint,mm,moderately,multangulate,narrow-deltate,obtuse,orange,orange-brown,ovate,pale,pedicel,petiole,poricidal,purple,ray,red-brown,scar,sessile,shrub,simple,spherical,spreading,stalked,stellate,stellate-pubescent,stem,style,surface,tapering,terminal,tip,trichome,tube,variously,way,white,yellow,young	.1,0.05-0.1,0.05-0.15,0.1-0.2,0.4-0.8,1.2-2.1,1.5-2-3,1.5-3.5,1.5-5,1/3-1/2,1/3-2/3,2-20,2-3,2-4,3-10,3.5-3.8,4,4-7,4-9,5-10,5-15,5-6,5-8,5-merous,8-11,8-12,8-25,abaxial,abaxially,adaxial,alyx,ame,apar,apparently,articulated,becoming,blade,branched,broad,c.,colored,concolorous,contrast,curved,diameter,difoliate,discolorous,drying,eaf,eed,elongating,entire,eye,fifth,foliaceou,four,free,fruiting,geminat,glabrou,hair,held,herbaceous,infructescence,inward,long,long-acuminat,longer,lower,lowermost,margin,mature,membranous,minute,naked,nflorescence,older,one,open,orolla,oung,pair,peduncle,pendulous,per,perfec,pericarp,porrect,portion,primary,red-brow,reflexed,ruit,slender,smooth,sometimes,spaced,sparsely,stalk,stellate-pubescen,strongly,tamen,terete,tertiary,time,unarme,unarmed,unequal,unit,usually,vary,vein,venation,visible,white-green,whitish,wide,yellow-green,ympodial	anthesi,apart,arrangement,bud,coat,colour,connation,corolla,decurrency,dry,embryo,feature,form,growth,height,history,inflorescence,life,long-acuminate,minor,na,new,number,ovary,papilla,plant,pore,prickle,reproduction,seed,shape,size,spacing,specimen,stigma,texture,tuberculation,type,width,winging	-2,/3,0.3-1,0.4-0.6,0.5-2,0.6-1,0.8-1.2,0.8-1.8,0.9-1.3,1-5,1.3-3.5,1.5-2,2.5-8,3-8,3.8-5,6-20,acuminate,acute,almost,apically,base,berry,blue-mauve,bright,cm,connivent,cream,dark,densely,dull,erect,flattened-reniform,glabrescent,glabrous,gray,green,lateral,lobed,marking,maturity,mm,moderately,multangulate,narrow-deltate,obtuse,orange,orange-brown,ovate,pale,poricidal,purple,red-brown,sessile,shrub,simple,spherical,spreading,stalked,stellate,stellate-pubescent,tapering,terminal,trichome,variously,way,white,yellow,young	apart,long-acuminate,na
460	wfo-0001031333	success	194	118	76	89	105	29	72	4	+,.5,0.1-0.5,1-1.5,1-4,1-5,1.2-2,1.5,1.5-1.7,1.5-2,2,2.7-7,30-40,5-8,7-10,7-9,?,almost,anther,anthesi,apart,base,berry,bilobed,branched,brown,calyx,capitate,cm,conical,cupped,densely,diameter,ellipsoidal,elliptic,filament,flattened,flower,fruting,glabrescent,glabrous,globose,green,greenish,growth,immature,inflorescence,lengthening,lobe,many,minute,minutely,mm,narrowly,nodding,ovate,pale,pedicel,pentagonal,petiole,pitted,planar,pore,poricidal,pubescent,reniform,scar,simple,slightly,slit,somewhat,sparsely,stellate,stem,stigma,style,surface,terminal,time,tip,trichome,tube,twining,uniseriate,vine,white,whitish,woody,x	0.5,1/2,2-3,2.5-3,3-4,3/4,5-7,5-merou,50,<,>,abaxially,acuminate,acute,adaxiall,adaxially,adjacent,ag,alyx,apex,appearing,ark,articulated,branche,broadly,cell,clustered,collection,composed,crea,denser,eaf,eed,entire,exserted,free,glabrescen,golden,half,high,ilament,lamina,leaving,less,like,lobed,long,lower,m.,margin,matte,membranous,mere,near,new,nflorescence,occasionally,older,orolla,outline,pair,papillat,peduncle,peg,penden,per,perfect,pericarp,plurifoliat,portion,primary,pubescent-papillate,quadrate,rest,rhachi,ruit,sinus,small,soon,splitting,ste,striped,strongly,tangled,tem,testal,thickened,thin,trailing,triangular,truncate,ud,undersurface,undulation,unequal,unevenly,unit,upper,vary,vein,venation,way,yellow,yellowish,ympodial	abaxial,adaxial,age,arrangement,bark,bud,colour,corolla,cream,feature,form,fruit,hair,leaf,length,none,number,ovary,papilla,papillate,seed,shape,size,spacing,texture,type,width,winging,young	+,.5,0.1-0.5,1-1.5,1-4,1-5,1.2-2,1.5,1.5-1.7,1.5-2,2,2.7-7,30-40,5-8,7-10,7-9,?,almost,anthesi,apart,base,berry,bilobed,branched,brown,capitate,cm,conical,cupped,densely,diameter,ellipsoidal,elliptic,flattened,glabrescent,glabrous,globose,green,greenish,immature,lengthening,many,minute,minutely,mm,narrowly,nodding,ovate,pale,pentagonal,pitted,planar,poricidal,pubescent,reniform,simple,slightly,slit,somewhat,sparsely,stellate,terminal,time,tip,trichome,twining,uniseriate,vine,white,whitish,woody,x	age,cream,none,papillate
461	wfo-0001031333	success	194	126	76	91	103	35	71	5	+,.5,0.1-0.5,1-1.5,1-4,1-5,1.5-2,1/2,2.7-7,3/4,30-40,7-10,7-9,?,acuminate,acute,anther,anthesi,apart,apex,bark,base,berry,bilobed,branched,broadly,brown,calyx,capitate,cm,conical,corolla,cream,densely,ellipsoid,elliptic,filament,flattened,flower,glabrescent,glabrous,globose,green,greenish,growth,immature,inflorescence,lengthening,lobe,lobed,long,many,minute,minutely,mm,narrowly,new,nodding,ovate,pale,pedicel,petiole,pitted,pore,poricidal,pubescent,reniform,rotate-stellate,scar,simple,slit,somewhat,sparsely,stellate,stem,stigma,style,surface,terminal,time,tip,trichome,truncate,tube,uniseriate,vine,way,white,whitish,wide,woody	0.5,1-5-2,1.5,1.5-1.7,2,2-3,2.5-3,3,3-4,5-7,5-8,5-merou,50,<,>,abaxially,adaxiall,adaxially,adjacent,ag,almost,alyx,appearing,articulated,branche,cell,clustered,composed,cupped,denser,diameter,eaf,eed,entire,exserted,free,fruiting,glabrescen,golden,half,high,ilament,lamina,leaving,less,like,lower,m.,margin,matte,membranous,mere,near,nflorescence,occasionally,older,orolla,outline,pair,papillat,peduncle,peg,penden,per,perfect,pericarp,planar,plurifoliat,portion,primary,pubescent-papillate,quadrate,rest,rhachi,ruit,sinus,slightly,small,soon,spaced,splitting,striped,strongly,tangled,testal,thickened,thin,trailing,triangular,tub,twinin,ud,undersurface,undulation,unequal,unevenly,unit,upper,vary,vein,venation,yellowish,ympodial	4-5,age,arrangement,bud,coat,colour,connation,decurrency,dry,feature,form,fruit,leaf,length,midpoint,minor,na,number,ovary,papilla,papillate,prickle,ray,seed,shape,size,spacing,specimen,texture,tuberculation,twining,type,width,winging,young	+,.5,0.1-0.5,1-1.5,1-4,1-5,1.5-2,1/2,2.7-7,3/4,30-40,7-10,7-9,?,acuminate,acute,anthesi,apart,base,berry,bilobed,branched,broadly,brown,capitate,cm,conical,cream,densely,ellipsoid,elliptic,flattened,glabrescent,glabrous,globose,green,greenish,immature,lengthening,lobed,long,many,minute,minutely,mm,narrowly,nodding,ovate,pale,pitted,poricidal,pubescent,reniform,rotate-stellate,simple,slit,somewhat,sparsely,stellate,terminal,time,tip,trichome,truncate,uniseriate,vine,way,white,whitish,wide,woody	4-5,age,na,papillate,twining
462	wfo-0001031359	success	166	119	66	83	83	36	60	6	.25,.5,0.5-1,0.5-6,1-4,1.1-1.6,1.2-1.6,1.2-2.5,1.5-2,1.6-2.8,12-21,2.5-3,3-3.5,3.6-8.8,5-angled,5.3-7.5,6-7,acuminate,anther,anthesi,apart,apiculate,attenuate,bark,base,berry,bi-lobed,broadly,brown,calyx,cm,corolla,dark,deflexed,dull,elliptic,filament,flattened-reniform,glabrous,globose,green,leaf,lobe,lobed,long,minor,minutely,mm,narrowly,nearly,obovoid,opposite,outline,ovary,papillae,papillose,pedicel,petiole,pitted,plant,pore,poricidal,round,rusty,scar,shaped,shiny,shrub,simple,size,specimen,stem,stigma,style,surface,tear-drop,tip,triangular,tube,white,x,yellow-orange,young	.02,/4,0.75-1,1.3-1.6,1.9-2.3,5-30-flowered,5-7,angle,apex,appearing,axil,ba,beginning,beneath,curled,dia,differing,difoliate,distal,dried,eaf,edicel,eed,evenly,extending,free,fruiting,geminat,incrassate,inflorescenc,internodal,interpetalar,lamina,lateral,live,lon,lower,main,major,margin,membraneous,middle,near,nflorescence,occasionally,often,older,one,originating,pair,paler,papillo,pit,planar,portion,reflexed,ridged,ripe,ruit,sinus,slender,slightly,somewhat,spaced,straight,strongly,tall,tan,tapering,trichome,tub,tuft,ud,undulate,uniseriate,unit,vein,way,white-lenticellat,widest,woody,yellow,ympodial	5-30,abaxial,adaxial,alternate,arrangement,bud,coat,colour,connation,dry,embryo,feature,flower,form,fruit,greyish,growth,hair,height,hirsute,inflorescence,length,midpoint,na,number,papilla,prickle,ray,seed,shape,spacing,texture,tuberculation,type,white-lenticellate,width	.25,.5,0.5-1,0.5-6,1-4,1.1-1.6,1.2-1.6,1.2-2.5,1.5-2,1.6-2.8,12-21,2.5-3,3-3.5,3.6-8.8,5-angled,5.3-7.5,6-7,acuminate,apart,apiculate,attenuate,berry,bi-lobed,broadly,brown,cm,dark,deflexed,dull,elliptic,flattened-reniform,glabrous,globose,green,leaf,lobed,long,minutely,mm,narrowly,nearly,obovoid,opposite,outline,papillae,papillose,pitted,poricidal,round,rusty,shaped,shiny,shrub,simple,tear-drop,tip,triangular,white,x,yellow-orange	5-30,alternate,greyish,hirsute,na,white-lenticellate
463	wfo-0001031362	success	138	99	69	78	60	21	63	6	.2,.5,0.4-0.5,0.5-1,1-1.5,1-3,1-3-flowered,1-4,1.5-2,2-2.5,3-6,?,anther,apex,bark,base,berry,brown,calyx,cell,cm,conical,corolla,dendritic,densely,dia,filament,flattened-reniform,glabrous,globose,golden,incrassate,internodal,lanceolate,leaf,like,lobe,lobed,long,long-triangular,margin,minutely,mm,nearly,nodding,opposite,orange-red,outline,ovary,papillose,pedicel,petiole,pitted,poricidal,pubescent,pubesent,rectangular,red,rest,rounded,shaped,shrub,simple,slender,small-capitate,sparsely,stem,stigma,style,subshrub,surface,tear-drop,tip,trichome,tube,white,x,young	.3,0.7-1,1-1.1,3-4,abaxially,acute,adaxially,along,anthesi,appearance,attenuate,branch,bushy,closely,denser,eaf,edicel,eed,ellipsoid,erect,exceeding,exserted,flattened,free,fruiting,giving,golden-brow,inflorescenc,lamina,lateral,lon,lower,main,middle,nflorescence,older,overlappin,packed,pair,pale,papillo,pericarp,planar,plurifoliat,pore,portion,ruit,scar,shiny,somewhat,spaced,straight,tan,thin,ud,unit,vein,widest,woody,ympodial	abaxial,adaxial,arrangement,colour,feature,flower,form,fruit,golden-brown,growth,inflorescence,length,na,number,plurifoliate,seed,shape,size,texture,type,width	.2,.5,0.4-0.5,0.5-1,1-1.5,1-3,1-3-flowered,1-4,1.5-2,2-2.5,3-6,?,apex,base,berry,brown,cell,cm,conical,dendritic,densely,dia,flattened-reniform,glabrous,globose,golden,incrassate,internodal,lanceolate,leaf,like,lobed,long,long-triangular,margin,minutely,mm,nearly,nodding,opposite,orange-red,outline,papillose,pitted,poricidal,pubescent,pubesent,rectangular,red,rest,rounded,shaped,shrub,simple,slender,small-capitate,sparsely,subshrub,tear-drop,tip,trichome,white,x	-1.5,di,golden-brown,inflorescence,na,plurifoliate
464	wfo-0001031400	success	160	88	48	64	96	24	46	2	0.25-0.8,0.4-1.7,0.6-1.8,0.7-6,0.8-1.1,1-4,1.2-2,1.5-5,10-11,2-3,2-5,2-9,4-13,4-17,4-6.5,4-7,4-7-25,5-12.5,7-28,abaxial,branched,calyx,cm,connate,corolla,cyme,deeply,diameter,dichasial,dichasially,ebracteate,filament,flower,forked,globose,herbaceous,interjected,lateral,leaf,leaflet,long,mm,monochasial,mucilaginous,odd-pinnate,ovoid,pedicel,peduncle,perennial,petiole,plant,puberulent,seed,size,stellate,stigma,style,subglabrous,terminal,tone,violet,white,wide,yellow	-3,1,1-2,2,3-6-foliat,6-23,abaxially,abruptly,absen,acumen,acute,adaxially,apex,apical,apically,apiculate,articulate,base,cell,covering,cuneate,dark,decurrent,dehiscent,digestion,diminishing,distal,dorsally,eaf,edge,eed,emoval,enzyme,exceeding,flat,folded,forming,generally,globo,green,green-white,hair-like,half,honeycomb,introrse,linear,linear-lanceolate,living,lobe,lon,lower,lunat,make,maturing,nflorescence,nther,oblique,oblong,occasionally,often,orolla,pair,pattern,perfect,plan,poricidally,proximal,rachi,reveal,ruit,sessile,seudostipule,short,side,slit,specimen,stamen,straight,stripe,structure,tal,tem,testal,thick,throughout,tip,toward,trilobe,tuber-bearing,typically,unit,vary,wall,without,ympodial,Â¼	absent,adaxial,anther,arrangement,colour,connation,feature,form,fruit,growth,height,history,inflorescence,length,life,na,number,ovary,reproduction,shape,stem,surface,texture,width	0.25-0.8,0.4-1.7,0.6-1.8,0.7-6,0.8-1.1,1-4,1.2-2,1.5-5,10-11,2-3,2-5,2-9,4-13,4-17,4-6.5,4-7,4-7-25,5-12.5,7-28,branched,cm,connate,cyme,deeply,diameter,dichasial,dichasially,ebracteate,forked,globose,herbaceous,long,mm,monochasial,mucilaginous,odd-pinnate,ovoid,perennial,puberulent,stellate,subglabrous,tone,violet,white,wide,yellow	absent,na
465	wfo-0001031401	success	182	113	58	80	102	33	56	2	0.5,0.6-1.2,1-1.4,1-6,1.1-3,1.5-2,2-5,2.5-4,3,5-9,7-9,8-10,abaxial,adaxial,age,anther,anthesi,berry,bi-lobed,calyx,cm,conical,corolla,deltoid,dendritic,elliptic,filament,flattened,flower,free,fruit,globose,golden,growth,leaf,lenticular,less,lobe,lobed,long-triangular,matted,minutely,mm,narrowly,new,occasionally,ovary,pedicel,petiole,pitted,plurifoliate,pore,poricidal,pubescent,purplish-black,pyramidal,roundish,shrub,slit-like,small,specimen,stem,stigma,strongly,style,surface,tapering,terminal,tip,tree,tree-like,trichome,tube,violet,white,winged,woody,x,yellow,young	0.8-1.2,1,1-1.5,1/2,2-2.4,3.5-4,3/4,5,5-7,abaxially,acute,adaxially,along,apex,apical,appearing,attenuate,axi,bark,basal,base,becoming,black,blade,branch,branching,brown,clearly,dark,deciduous,deflexed,densely,denser,diameter,dichasial,differentiated,drying,eaf,ecuador,ecuadorian,edicel,eed,ew,exserted,finely,fork,fruiting,glabrous,golden-yellow,impressed,inserted,lateral,long,lower,m.,mesophyll,monochasia,near,nflorescence,noddin,nodding,node,often,older,outline,overtopping,pair,papillo,per,pericarp,planar,portion,prominently,puberulent,pubescen,raised,reddish-brown,rounded,ruit,scar,secondary,shiny,shoot,short,sleev,sometimes,somewhat,sparsely,stamen,ste,tall,thin,time,tub,ud,unit,usually,vein,visible,way,wide,ympodial	arrangement,bud,coat,colour,connation,dry,embryo,feature,form,hair,height,history,inflorescence,length,life,midpoint,na,number,papilla,papillose,plant,prickle,ray,reproduction,seed,shape,size,spacing,texture,tuberculation,type,width,winging	0.5,0.6-1.2,1-1.4,1-6,1.1-3,1.5-2,2-5,2.5-4,3,5-9,7-9,8-10,age,berry,bi-lobed,cm,conical,deltoid,dendritic,elliptic,flattened,free,globose,golden,lenticular,less,lobed,long-triangular,matted,minutely,mm,narrowly,occasionally,pitted,plurifoliate,poricidal,pubescent,purplish-black,pyramidal,roundish,shrub,slit-like,small,strongly,tapering,terminal,tip,tree,tree-like,trichome,violet,white,winged,woody,x,yellow	na,papillose
466	wfo-0001031480	success	233	114	78	93	140	21	76	2	/3,0.5-2,0.8-1,1-1.3,1-1.5,1-3,1.7-2.2,1.8-3,1/3,2-2.7,2-6,3-10,3-7,3.5-7,4-6,6-13,abaxial,acute,adaxial,anther,apart,apex,apically,articulated,base,berry,bright,calyx,cell,cm,cuneate,deltate,densely,diameter,ellipsoid,erect,flattened-reniform,flower,fruit,glabrescent,glabrous,glandular,hair,lateral,leaf,length,lobed,long,long-styled,maturity,mauve,minutely,mm,moderately,obtuse,outline,pale,pedicel,petiole,pit,plant,poricidal,prickly,pubescent,purple,raised,red,red-brown,reticulate,scandent,scar,shrub,simple,small,smooth,sparsely,spherical,spreading,stellate,stellate-pubescent,stem,style,surface,tapering,terminal,tip,truncate,tube,unarmed,upper,way,wide,young	0-0.5,0-1,0-2,0-30,0-5,0.1-0.25,0.1-0.3,0.1-0.4,0.15-0.3,0.2-0.35,0.4,0.4-0.8,0.5-3-10,0.6-0.8,0.7,0.8,1-2,1-4,1.5-2.2,1/2,1/4,1/6-1/5,2-3,2-5,2-6-30,3,3-6,4-5,5-8,5-merous,6-8,7-8,8-12,abaxially,acuminat,alyx,andromonoecious,apar,apparently,ba,bark,blade,branched,branching,broad-deltate,cream,curved,dark,difoliate,discolorous,distal,distance,drying,dull,eaf,eed,elongate,elongating,entire,equal,extending,eye,faint,filament,flattened,free,fruiting,geminat,green,hermaphrodite,heterostylous,inconspicuous,infructescence,lobe,longer,lower,lowermost,margin,marking,mature,midpoint,midvein,naked,near,nflorescence,often,older,one,open,orange-brown,orolla,oung,ovate,pair,peduncle,pendulous,per,pericarp,persistent,porrect,portion,prickle,primary,ray,red-brow,red-green,red-yellow-green,reduced,rounded,ruit,sessile,shallowly,short-styled,shorter,side,slender,slightly,somewhat,spaced,stalk,stalked,staminat,straight,tamen,terete,tertiary,thick-chartaceous,time,trichome,unarme,unit,variously,vary,vein,venation,visible,weakly,woody,yellow,ympodial	acuminate,arrangement,colour,corolla,feature,form,growth,height,history,inflorescence,life,na,number,ovary,seed,shape,size,spacing,texture,type,width	/3,0.5-2,0.8-1,1-1.3,1-1.5,1-3,1.7-2.2,1.8-3,1/3,2-2.7,2-6,3-10,3-7,3.5-7,4-6,6-13,acute,apart,apically,articulated,base,berry,bright,cell,cm,cuneate,deltate,densely,diameter,ellipsoid,erect,flattened-reniform,flower,glabrescent,glabrous,glandular,hair,lateral,lobed,long,long-styled,maturity,mauve,minutely,mm,moderately,obtuse,outline,pale,pit,poricidal,prickly,pubescent,purple,raised,red,red-brown,reticulate,scandent,shrub,simple,small,smooth,sparsely,spherical,spreading,stellate,stellate-pubescent,tapering,terminal,tip,truncate,unarmed,upper,way,wide	acuminate,na
467	wfo-0001031483	success	154	120	67	80	74	40	63	4	.5,/2,0.5-2,1-2,1.1-2.5,1.7-5.5,11-20.5,2-2.5,2-3,2.5-3.2,3-4,6-10,acuminate,acute,almost,anther,anthesi,apart,apex,attenuate,base,berry,calyx,clavate,cm,corky,corolla,deflexed,deltoid,dry,filament,filiform,flower,fusiform,glabrous,green,indistinct,leaf,lenticellate,linear,lobe,lobed,minor,minutely,mm,oblanceolate,oblong,obovate,obovoid,opposite,orbiculate,ovary,ovoid-reniform,pale,papillose,pedicel,petiole,pore,poricidal,rounded,scar,shape,shaped,short-triangular,shrub,simple,slender,slightly,stem,stigma,style,subshrub,tapering,tear-drop,tip,tube,turbinate,way,white,x	0,0.5,1,1.2-1.4,1/3,3-8-flowered,7-10,across,anew,ba,bearing,beginning,beneath,blade,ca,caly,continuous,cork,decurrent,dia,difoliate,distal,eaf,edicel,eed,end,evenly,exserted,free,fresh,fruiting,geminat,indistinc,internode,larger,lateral,lea,less,long,lower,main,major,markedly,nflorescence,often,pair,paler,papillo,per,planar,pointed,portion,prominent,quite,raised,ruit,short,somewhat,soon,spaced,straight,strongly,tall,tan,third,ud,unit,variable,vein,widest,wing,winged,woody,ympodial	3-8,alternate,arrangement,bark,bud,coat,colour,connation,decument,decurrency,embryo,feature,form,fruit,growth,height,history,inflorescence,length,life,midpoint,na,new,number,papilla,plant,prickle,ray,reproduction,seed,size,spacing,specimen,surface,texture,tuberculation,type,width,winging,young	.5,/2,0.5-2,1-2,1.1-2.5,1.7-5.5,11-20.5,2-2.5,2-3,2.5-3.2,3-4,6-10,acuminate,acute,almost,apart,attenuate,base,berry,calyx,clavate,cm,corky,deflexed,deltoid,filiform,fusiform,glabrous,green,indistinct,leaf,lenticellate,linear,lobed,minutely,mm,oblanceolate,oblong,obovate,obovoid,opposite,orbiculate,ovoid-reniform,pale,papillose,poricidal,rounded,shaped,short-triangular,shrub,simple,slender,slightly,stem,subshrub,tapering,tear-drop,tip,tube,turbinate,way,white,x	3-8,alternate,decument,na
468	wfo-0001031492	success	175	122	64	87	88	35	62	2	0.5,0.7-1.3,0.9-1.1,1-1.3,1-1.5,1.3-2,1.5-2.5,10-15,2-10,2-3,3-4,3-5,4-10,6-8,absent,acuminate,acute,anther,anthesi,apex,attenuate,bark,base,berry,bi-lobed,calyx,cm,conical,corolla,decurrent,deltoid,densely,dull,echinoid,elliptic,filament,flattened,flower,free,fruit,glabrous,globose,golden,grey,growth,lateral,leaf,lenticular,lightly,lobe,lobed,medium,minutely,mm,narrowly,ovary,pedicel,petiole,pitted,pore,poricidal,pubescent,purplish-black,pyramidal,remaining,scar,shrub,size,slit-like,sometimes,sparsely,stem,stigma,style,surface,tapering,terminal,tip,tree,tree-like,trichome,tube,violet,winged,woody,x,young	.5,/4,08,1.5-1.8,2-5,20,4-4.5,8-11,8-9,abaxially,adaxially,age,apical,appearing,axe,ba,basal,becoming,beneath,bitter,branching,dark,dbh,deciduous,dendritic,denser,diameter,distinguishable,drying,eaf,edicel,eed,erect,ew,exserted,fruiting,inserted,juice,lamina,long,lower,m.,monochasia,nflorescence,nodding,occasionally,older,overtopping,pair,papillo,per,pericarp,planar,plurifoliate,portion,predominantly,prominent,rather,reddish-brown,ruit,scarcely,scattered,secondary,shiny,shoot,short,sleeve,slightly,somewhat,stamen,ste,sticky,strongly,sunken,tall,thin,time,tub,ud,undersurface,unit,upper,upturned,vein,way,wide,ympodial,younger	arrangement,bud,coat,colour,connation,decurrency,dry,embryo,feature,form,height,history,inflorescence,length,life,midpoint,minor,na,new,number,papilla,papillose,plant,prickle,ray,reproduction,seed,shape,spacing,specimen,texture,tuberculation,type,width,winging	0.5,0.7-1.3,0.9-1.1,1-1.3,1-1.5,1.3-2,1.5-2.5,10-15,2-10,2-3,3-4,3-5,4-10,6-8,absent,acuminate,acute,attenuate,berry,bi-lobed,cm,conical,decurrent,deltoid,densely,dull,echinoid,elliptic,flattened,free,glabrous,globose,golden,grey,lateral,lenticular,lightly,lobed,medium,minutely,mm,narrowly,pitted,poricidal,pubescent,purplish-black,pyramidal,remaining,shrub,size,slit-like,sometimes,sparsely,tapering,terminal,tree,tree-like,trichome,violet,winged,woody,x	na,papillose
469	wfo-0001031503	success	139	110	73	83	56	27	71	2	-10,-15,-30,-7,0.3-3,0.5-1,0.5-4,1-3,1-5,1-7,1.5-8,2.5-10,3-15-25,3-4,3-5,3-6,7-10,abruptly,acuminate,acute,angled,apart,apex,base,branched,calyx,chartaceous,cm,cuneate,curled,cylindrical,decurrent,deltate,densely,diameter,directed,distally,eglandular,entire,flower,forked,glabrous,globose,hair,lanceolate,lobe,margin,mm,moderately,narrowed,narrowly,often,orange,pedicel,peduncle,petiole,pore,puberulent,pubescent,rachi,rarely,reddish,ripe,rounded,rugose-pubescent,shrub,simple,slightly,sparsely,stellate,stigma,style,subclavate,tip,triangular,truncate,tube,unbranched,unequal,uniseriate,white,x,yellow	1-1.5-7,1-2.5,1.5-2,1.5-3,1.7-3.5-6,10-19,2-3,5613,6-7,6-many-foliat,7-15,abaxially,absen,adaxially,aggregate,articulated,axe,ba,blade,cell,connivent,distall,eaf,eed,elliptic,except,fide,gland,long,lower,mostly,nflorescence,nther,obtuse,occasionally,orolla,ovate,perfect,present,radiu,ruit,spaced,stalked,stone,subcapitat,tal,tem,time,toward,unit,usually,vary,vein,venturi,wide,ympodial	1.5-7,abaxial,adaxial,anther,arrangement,colour,corolla,feature,form,fruit,growth,height,inflorescence,leaf,length,number,ovary,plant,seed,shape,size,spacing,stem,subcapitate,surface,texture,width	-10,-15,-30,-7,0.3-3,0.5-1,0.5-4,1-3,1-5,1-7,1.5-8,2.5-10,3-15-25,3-4,3-5,3-6,7-10,abruptly,acuminate,acute,angled,apart,apex,base,branched,chartaceous,cm,cuneate,curled,cylindrical,decurrent,deltate,densely,diameter,directed,distally,eglandular,entire,forked,glabrous,globose,hair,lanceolate,mm,moderately,narrowed,narrowly,often,orange,puberulent,pubescent,rarely,reddish,ripe,rounded,rugose-pubescent,shrub,simple,slightly,sparsely,stellate,subclavate,tip,triangular,truncate,unbranched,unequal,uniseriate,white,x,yellow	1.5-7,subcapitate
470	wfo-0001031586	success	166	94	58	73	93	21	55	3	.25,0.1-1,0.5-1,1-1.2,1-2,1.3-5,1.5-2,2,3-11,abrupt,absent,acute,anther,apex,attenuate,bark,base,broadly,bud,calyx,capitate,cm,completely,conical,corolla,cream-colored,elliptic,filament,flower,glabrous,globose,green,greenish,inflorescence,leaf,lobed,long,minor,minutely,mm,nearly,onto,open,opposite,ovary,pale,papillate,pedicel,petiole,pore,poricidal,ridged,shaped,shiny,shrub,simple,size,slender,somewhat,soon,sparsely,stem,stigma,style,surface,tapering,tear-drop,tip,truncate,tube,white,yellow,young	0.5-0.8,1,1-1.5-2,1.4-2.5,2-2.5,5-10,5-6,7-10-flowered,anthesi,apart,apparently,appearing,becoming,beneath,borne,branch,bright,campanulate,closer,cucullate,deflexed,deltate,dia,differing,difoliate,distance,drying,eaf,edicel,eed,ellipsoid,exerted,exfoliatin,fleshy,free,fresh,geminate,gree,inflorescenc,know,known,later,lateral,leave,lobe,lower,main,major,margin,material,may,mucro,near,new,nflorescence,notched,occasionally,older,olive,one,overtopping,pair,paler,papillose,planar,portion,present,prominent,raised,remaining,rounded,ruit,scar,shap,shin,small,sometimes,spaced,straight,swollen,tall,thick,thickened,trichome,trunk,ud,uniseriate,unit,vein,widely,x,yellowish,ympodial	7-10,arrangement,colour,exfoliating,feature,form,fruit,growth,height,history,length,life,na,number,plant,reproduction,seed,shape,texture,type,width	.25,0.1-1,0.5-1,1-1.2,1-2,1.3-5,1.5-2,2,3-11,abrupt,absent,acute,attenuate,base,broadly,calyx,capitate,cm,completely,conical,cream-colored,elliptic,glabrous,globose,green,greenish,leaf,lobed,long,minutely,mm,nearly,onto,open,opposite,pale,papillate,petiole,poricidal,ridged,shaped,shiny,shrub,simple,slender,somewhat,soon,sparsely,tapering,tear-drop,tip,truncate,tube,white,yellow	7-10,exfoliating,na
471	wfo-0001031587	success	142	116	78	85	57	31	70	8	0.8-1,1-1.5,1.7-2,10-15,12-16,17-30,2,2/3,3-4,5,6-8,abaxially,acute,anther,apex,attenuate,bark,base,bi-lobed,broadly,calyx,closely,cm,conical,corolla,decurrent,deflexed,deltate,dendritic,densely,drying,elliptic,elliptic-ovoid,exserted,filament,fleshy,glabrous,globose,golden-red,included,inflorescence,irregular,later,leaf,like,lobe,lobed,long,minor,minutely,mm,mostly,oblique,ovary,pale,pedicel,petiole,pore,poricidal,pubescent,reddish-grey,scar,shape,shaped,size,soft,somewhat,spaced,stem,stigma,style,surface,tear-drop,thick,thickened,tip,tree,trichome,tube,verrucose,way,white,winged,x,young	.5,1.5-2,2-2.5,2-9-celled,6-7,7-9,adaxially,along,anthesi,apart,axi,clavate,cone,denser,dia,differing,eaf,edicel,eed,erect,evenly,fide,free,furcate,know,known,lamina,lateral,loose,lower,lowered,main,major,middle,ocasionally,occasional,older,overlappin,pair,papillate,papillo,parallel,perpendicular,persisten,portion,rarely,rect,rest,ruit,simple,steinbach,tall,tub,ud,uniseriate,vein,widest	1.5,alternate,arrangement,bud,colour,connation,feature,flower,form,fruit,growth,height,history,length,life,na,number,occasionally,overlapping,papilla,papillose,perennial,persistent,plant,reproduction,seed,spacing,texture,type,width,winging	0.8-1,1-1.5,1.7-2,10-15,12-16,17-30,2,2/3,3-4,5,6-8,abaxially,acute,attenuate,base,bi-lobed,broadly,calyx,closely,cm,conical,corolla,decurrent,deflexed,deltate,dendritic,densely,drying,elliptic,elliptic-ovoid,exserted,fleshy,glabrous,globose,golden-red,included,irregular,later,leaf,like,lobed,long,minutely,mm,mostly,oblique,pale,pore,poricidal,pubescent,reddish-grey,shape,shaped,soft,somewhat,spaced,stem,tear-drop,thick,thickened,tip,tree,trichome,tube,verrucose,way,white,winged,x,young	1.5,alternate,na,occasionally,overlapping,papillose,perennial,persistent
472	wfo-0001031589	success	221	146	100	114	107	32	98	2	-6,-6.5,.5,0-10,0.1-0.5,0.2-0.5,0.2-3,0.4,0.5-1,0.55-0.7,0.8-2.3,1-1.8,1-5,1.2-1.5,1.5-5,1.7-2.5,1.8-2.9,1/3,1/3-1/4,2-3.5,2.5-4.5,2.5-6,acute,anther,apart,apex,apically,apparently,articulated,attenuate,base,berry,bright,broadly,calyx,cell,cm,connivent,cream,dark,deltate,densely,diameter,elliptic,erect,filament,flattened-reniform,flower,fruit,glabrous,green,lateral,leaf,length,lobe,lobed,long,long-obovate,longer,marking,maturity,mauve,mm,moderately,multangulate,narrow-cuneate,often,outline,pale,pedicel,petiole,pit,plant,poricidal,porrect,prickle,prickly,raised,reflexed,rounded,sessile,shiny,shrub,simple,small,smooth,solitary,sometimes,somewhat,sparsely,spherical,spreading,stalked,stellate,stellate-pubescent,stem,straight,style,subsessile,surface,tapering,terete,time,tip,trichome,tube,upper,way,white,wide,winged,yellow,yellow-orange,young	-15,/6,0,0-1,0-3,0-30,0.1,0.15-0.3,0.2-0.4-0.5,0.6-1.2,0.7,0.9-1.3,0.9-1.6,1,1/3-1/2,10-30,2-10,2-3-4,2.8-4,3-4,3-5,3/4,4-6.5,4/5,5-8,5-merous,6-8,8-14,8-30,abaxially,alyx,ame,bark,blade,brow,brown-green,c.,caudat,chartaceous,concolorous,density,difoliate,discolorous,distance,drying,dull,eed,elongating,equal,extending,eye,free,fruiting,geminat,glabrescent,gray-green,higher,infructescence,lengt,lon,lower,margin,mature,membranous,midpoint,midvein,naked,narrow,nflorescence,oblong,obovate,occasionally,older,orange-brown,orange-green,orolla,oung,pair,part,pendulous,per,perfec,pericarp,portion,prickl,primary,ray,ruit,scandent,shorter,side,spaced,stalk,stout,subentire,tamen,tertiary,unit,vary,vein,venation,visible,weakly,whole,woody,yellow-green,ympodial	arrangement,bud,caudate,coat,colour,connation,corolla,decurrency,embryo,feature,form,growth,height,inflorescence,minor,na,new,number,ovary,papilla,pore,scar,seed,shape,size,spacing,stigma,texture,tuberculation,type,width,winging	-6,-6.5,.5,0-10,0.1-0.5,0.2-0.5,0.2-3,0.4,0.5-1,0.55-0.7,0.8-2.3,1-1.8,1-5,1.2-1.5,1.5-5,1.7-2.5,1.8-2.9,1/3,1/3-1/4,2-3.5,2.5-4.5,2.5-6,acute,apart,apically,apparently,articulated,attenuate,base,berry,bright,broadly,cell,cm,connivent,cream,dark,deltate,densely,diameter,elliptic,erect,flattened-reniform,glabrous,green,lateral,lobed,long,long-obovate,longer,marking,maturity,mauve,mm,moderately,multangulate,narrow-cuneate,often,outline,pale,pit,poricidal,porrect,prickle,prickly,raised,reflexed,rounded,sessile,shiny,shrub,simple,small,smooth,solitary,sometimes,somewhat,sparsely,spherical,spreading,stalked,stellate,stellate-pubescent,straight,subsessile,tapering,terete,time,tip,trichome,upper,way,white,wide,winged,yellow,yellow-orange,young	caudate,na
473	wfo-0001031609	success	153	106	49	61	92	45	46	3	1-10,1-6,1.3-3,10-25,3-24,3-5,4,4-5,4-6,4.5-60,acute,apex,apiculate,around,base,brownish,calyx,campanulate,cm,connivent,cuneate,deltate,ellipsoidal,elliptic,flattened,flower,forked,fruit,glabrous,globose,green,inflorescence,leaf,lobe,margin,mm,obovate,obtuse,orange,pedicel,petiole,pore,puberulent,reticulate,scar,shallowly,shrub,simple,small,stellate,stigma,style,succulent,tip,tree,triangular,truncate,tube,unbranched,x,yellow	.5,/4,0-30,0.4-3,0.5-1,0.5-3,1.5-2,1.5-3,2,2-3,2-3-9-lobed,2.5-4,20-25,3-foliat,5-25,5/6,8-20,abaxially,absen,absent,adaxially,aggregate,ape,articulated,axe,barely,beyond,bilobe,blade,branch,brow,cell,connective,conspicuous,contiguous,dark,dia,diameter,dilated,directed,distally,divided,eaf,eed,elliptic-ovate,emerging,entire,equal,exceeding,exserted,fleshy,glabrou,laterally,leaving,lobed,long,lower,midrib,minutely,nearly,nflorescence,nther,obconical,occasionally,orolla,papillose,pedicellar,peduncle,pinnately,point,rachi,radiu,ripe,rounded,ruit,sinus,stamen,stone,strongly,succulen,tal,tem,thecae,time,tomento,two,ud,unit,unlobed,vary,wide,ympodial	10-30,anther,anthesi,arrangement,bilobed,bud,coat,colour,connation,corolla,decurrency,dry,embryo,feature,filament,form,growth,height,history,length,life,midpoint,minor,na,new,number,ovary,papilla,plant,prickle,ray,reproduction,seed,shape,size,spacing,specimen,stem,surface,texture,tuberculation,type,width,winging,young	1-10,1-6,1.3-3,10-25,3-24,3-5,4,4-5,4-6,4.5-60,acute,apex,apiculate,around,brownish,campanulate,cm,connivent,cuneate,deltate,ellipsoidal,elliptic,flattened,forked,glabrous,globose,green,margin,mm,obovate,obtuse,orange,puberulent,reticulate,shallowly,shrub,simple,small,stellate,succulent,tree,triangular,truncate,unbranched,x,yellow	10-30,bilobed,na
474	wfo-0001031615	success	154	117	74	87	67	30	69	5	.5,0.5,0.8-1,0.9-1.1,1-1.6,1.5,1.5-5,11-15.5,2-3,2-4.2,3.8-6.1,4-6.5,5-6,6-8,acuminate,acute,anther,apex,attenuate,base,berry,bilobed,calyx,capitate,closely,cm,corolla,decurrent,deep,deflexed,deltoid,dia,distal,elliptic,expanded,exserted,filament,flattened-reniform,fruit,furcate,glabrous,glandular,globose,green,inflorescence,leaf,less,lobe,lobed,long,minor,minutely,mm,nearly,occasionally,older,opposite,ovary,packed,pedicel,petiole,pitted,pore,poricidal,scar,scarcely,shaped,shiny,shrub,simple,size,slender,small,stem,stigma,style,surface,tapering,tear-drop,tip,tree,tube,white,winged,woody,x,young	0,0.5-1,1.3-1.8,5-20-flowered,8-10,anthesi,arising,axil,ba,bark,becoming,brown,caly,dark,dark-papillo,differing,difoliate,eaf,edicel,eed,free,fruiting,geminat,impressed,incrassate,interpetalar,lamina,lateral,lon,lower,main,major,margin,maroo,middle,minute,nflorescence,one,overlappin,pair,paler,papillae,papillose,per,portion,prominent,reflexed,ruit,sinus,slightly,somewhat,straight,subumbellate,tall,terminal,thickened,thin,trichome,tuft,ud,unicellular,uniseriate,unit,urceolate,vein,widest,ympodial	5-20,arrangement,bud,colour,dark-papillose,decurrency,dry,feature,flower,form,growth,height,history,length,life,maroon,na,number,overlapping,papilla,plant,reproduction,seed,shape,spacing,specimen,texture,type,width,winging	.5,0.5,0.8-1,0.9-1.1,1-1.6,1.5,1.5-5,11-15.5,2-3,2-4.2,3.8-6.1,4-6.5,5-6,6-8,acuminate,acute,attenuate,base,berry,bilobed,calyx,capitate,closely,cm,decurrent,deep,deflexed,deltoid,dia,distal,elliptic,expanded,exserted,flattened-reniform,furcate,glabrous,glandular,globose,green,inflorescence,leaf,less,lobed,long,minutely,mm,nearly,occasionally,opposite,packed,petiole,pitted,poricidal,scarcely,shaped,shiny,shrub,simple,slender,small,tapering,tear-drop,tip,tree,tube,white,winged,woody,x	5-20,dark-papillose,maroon,na,overlapping
475	wfo-0001031618	success	184	86	49	66	118	20	49	0	0-3,0.5-1.5,1-1.5,1-1.5-2,1.5-2,1.5-3.5,10-18,2-2.5,2-3,3-4,3-8,4-5,5,5-12,acute,anther,apex,base,calyx,capitate,cell,clonal,cm,corolla,cuneate,cyme,discoidal,ellipsoid,equal,filament,finely,glabrous,glandular,habit,hair,leaf,long,minute,mm,narrowly,obovoid,ovary,ovoid,pedicel,peduncle,petiole,pinatisect,reticulate,rotate,rounded,rugose,scorpioid,shrub,simple,soft-wooded,somewhat,stem,stigma,stone,surface,tapering,terete,unequal,variable,x,young	1-7,10-lobed,13,3,40-60,90-110,acuman,almost,also,anthesi,appearance,appearing,aspect,axil,becoming,berry,beyond,blunt,bluntly,branch,broadly,c.,cluster,column,conical,covering,cut,darker,developed,dia,eaf,eed,elliptic,emarginate,enlarged,erect,except,exerted,extending,facetted,fleshy,floral,flower,fork,forked,frui,general,giving,greatly,gree,green,greyish,growing,half,interacuminal,lanceolate,lasting,lavender-purple,lengthening,less,lobe,lobed,lon,loosely,lower,marbled,maturity,mauve,may,mid-vein,midrib,nflorescence,oblong,occasional,occur,often,ovate-lanceolate,pal,pale,pedicellate,petal,plurifoliat,point,pore,poricidal,purple,rarely,reddish-brown,rhachi,ripe,ruit,sessile,several,shallowly,side,single,sinus,slit,sometimes,specimen,stout,stripe,strongly,styl,succulent,tinged,tip,tissue,triangular,tub,ud,unit,vigorous,way,well,year,ympodial,younger	arrangement,bud,diameter,feature,form,fruit,growth,height,history,inflorescence,length,life,plant,reproduction,seed,shape,size,style,texture,type	0-3,0.5-1.5,1-1.5,1-1.5-2,1.5-2,1.5-3.5,10-18,2-2.5,2-3,3-4,3-8,4-5,5,5-12,acute,capitate,clonal,cm,cuneate,cyme,discoidal,ellipsoid,equal,finely,glabrous,glandular,habit,hair,long,minute,mm,narrowly,obovoid,ovoid,pinatisect,reticulate,rotate,rounded,rugose,scorpioid,shrub,simple,soft-wooded,somewhat,tapering,terete,unequal,variable,x	
476	wfo-0001031646	success	169	103	70	82	87	21	68	2	-pinnate,.2,0.2-0.8,0.5-2,0.8-1.5,1-1.8,1-10,1-6,1.2-2.5,1.5-3.5,15-25,18-38,2-10,2-2.5,2-3,2.5-10,20,4-18,4-20,5-6,5-7,5-7.5,7-8,8-15,anther,apart,base,blue,branched,calyx,cm,covered,darker,densely,diameter,ellipsoidal,elliptic-lanceolate,flattened,flower,fruit,glabrous,globose,green,hair,highly,immature,leaf,leaflet,maroon,mature,mm,multicellular,obliquely,oblong,ovate-lanceolate,pedicel,peduncle,petiole,pubescence,pubescent,rachi,red,rotate-pentagonal,rugulose,scandent,shrub,simple,size,smooth,spreading,stem,stigma,stout,style,surface,tawny,tube,uniseriate,vine,violet,x,yellow	.5,1.5-4,1962,3.5-4,4-5,4-8,4-foliate,5-merou,abaxially,absen,absent,accrescent,acuminate,acut,acute,adaxially,aggregate,alyx,apex,apical,apparently,articulated,axe,ba,basally,berry,blade,brown,cell,chartaceous,ciliat,climbing,connivent,correll,cuneate,cylindrical,decreasing,directed,distall,eaf,eed,elliptic,entire,equal,fide,filament,fruiting,geminat,glandular,high,homostylous,hyaline,interjected,lateral,light,lobe,long,lower,margin,nflorescence,oblique,obtuse,orolla,ovate-lanceolat,part,perfect,petiolule,pore,present,pubescen,rounded,ruit,seudostipule,shortly,slightly,small,spaced,stone,tamen,tem,tip,toward,tree,truncat,unit,vary,ympodial	abaxial,adaxial,arrangement,colour,corolla,feature,form,geminate,growth,inflorescence,length,number,ovary,pseudostipule,seed,shape,spacing,staman,texture,truncate,width	-pinnate,.2,0.2-0.8,0.5-2,0.8-1.5,1-1.8,1-10,1-6,1.2-2.5,1.5-3.5,15-25,18-38,2-10,2-2.5,2-3,2.5-10,20,4-18,4-20,5-6,5-7,5-7.5,7-8,8-15,apart,base,blue,branched,cm,covered,darker,densely,diameter,ellipsoidal,elliptic-lanceolate,flattened,flower,fruit,glabrous,globose,green,hair,highly,immature,maroon,mature,mm,multicellular,obliquely,oblong,ovate-lanceolate,pubescence,pubescent,red,rotate-pentagonal,rugulose,scandent,shrub,simple,smooth,spreading,stout,tawny,uniseriate,vine,violet,x,yellow	geminate,truncate
477	wfo-0001031651	success	199	118	85	100	99	18	83	2	-3,-3.5,.6,.7,/5,0.2-0.5,0.3-0.8,0.3-1.5,0.6-1,0.6-1.3,0.7-1,1-2,1-4,1.2-2,1.2-3,1.5-2,1/5,1/6-1/4,2-10,2-3.5,4-5,4-6,4.5-7,abaxial,acute,adaxial,anther,apart,apically,articulated,bark,base,berry,blade,brown,calyx,cell,cm,curved,dark,deltate,densely,diameter,dull,elliptic,erect,filiform,flattened-reniform,flower,fruit,glabrescent,glabrous,gray,herb,lanceolate,lateral,leaf,length,lobe,lobed,long,maturity,mm,oblong,orange-brown,outline,ovate,pedicel,petiole,pit,poricidal,prickle,prickly,purple,raised,red,scar,shrub,simple,small,smooth,spherical,spreading,stellate,stellate-pubescent,straight,style,surface,tapering,terminal,tip,toward,tube,unarmed,upper,way,weakly,white,wide,yellow	.1,/3,0-20,0.1,0.1-0.15,0.1-0.2,0.1-0.25,0.15-0.2,0.3-0.5,1-1.7,1.3-1.6,2-3,2/3-3/,3-5,5-merous,abaxially,absent,acuminat,alyx,ame,apar,apex,apparently,branched,c.,chartaceous,concolorous,cordate,difoliate,discolorous,drying,eaf,eed,elongating,entire,equal,eye,faint,filament,free,fruiting,geminat,gra,herbaceous,infructescence,longer,lower,margin,mature,midpoint,naked,nflorescence,obtuse,older,one,open,orolla,oung,pair,peduncle,pendulous,per,perfec,pericarp,persistent,porrect,portion,prickl,primary,ray,red-green,reflexed,rounded,ruit,scandent,shorter,sometimes,spaced,stalk,stalked,stem,subentire,subsessile,tamen,terete,tertiary,thick,thick-stalked,time,trichome,unarme,unit,variously,vary,vein,venation,visible,yellow-green,ympodial	acuminate,arrangement,colour,corolla,feature,form,growth,height,inflorescence,number,ovary,plant,seed,shape,size,spacing,texture,width	-3,-3.5,.6,.7,/5,0.2-0.5,0.3-0.8,0.3-1.5,0.6-1,0.6-1.3,0.7-1,1-2,1-4,1.2-2,1.2-3,1.5-2,1/5,1/6-1/4,2-10,2-3.5,4-5,4-6,4.5-7,acute,apart,apically,articulated,base,berry,blade,brown,cell,cm,curved,dark,deltate,densely,diameter,dull,elliptic,erect,filiform,flattened-reniform,glabrescent,glabrous,gray,herb,lanceolate,lateral,leaf,length,lobed,long,maturity,mm,oblong,orange-brown,outline,ovate,pit,poricidal,prickle,purple,raised,red,shrub,simple,small,smooth,spherical,spreading,stellate,stellate-pubescent,straight,tapering,terminal,tip,toward,upper,way,white,wide,yellow	acuminate,shape
478	wfo-0001031656	success	154	115	58	81	73	34	55	3	0.5,1-1.5,1-2,1-2.5,1.5-2,1.5-5,10-20,2.5-3.5,3-5,4-9,5-ribbed,6-8,acuminate,acute,anther,anthesi,apex,bark,base,berry,calyx,capitate,closely,cm,corolla,ellipsoid,elliptic,erect,filament,flower,fruit,glabrous,globose,green,greyish,leaf,lobe,lobed,long-acuminate,minor,minute,minutely,mm,oblique,opposite,ovary,ovate,pale,paler,papillose,pedicel,petiole,planar,plant,pore,poricidal,red-papillose,reflexed,rounded,scar,sessile,shaped,shrub,size,slightly,spaced,specimen,stem,stigma,style,surface,tear-drop,thickened,tip,transversely,tube,visible,white,woody,x,young	.5,/4,0.5-1,1.2-1.5,3-3.5,5-7,also,arising,ba,bright,cork,densely,dia,differing,difoliate,directly,drying,eaf,edicel,eed,enclosing,extremely,fleshy,free,fruiting,geminat,hooded,known,lateral,live,lon,long,lower,main,major,margin,matte,mature,middle,nflorescence,node,often,older,one,pair,papillo,peelin,persistent,portion,prominent,proximal,rather,reddish,rib,ridged,ruit,shiny,somewhat,straight,strongly,swollen,tall,terminal,thick,top,ud,unit,upper,vein,way,wide,widest,ympodial	arrangement,bud,coat,colour,connation,corky,decurrency,dry,embryo,feature,form,growth,height,history,inflorescence,length,life,midpoint,na,new,number,papilla,peeling,prickle,ray,reproduction,seed,shape,spacing,texture,tuberculation,type,width,winging	0.5,1-1.5,1-2,1-2.5,1.5-2,1.5-5,10-20,2.5-3.5,3-5,4-9,5-ribbed,6-8,acuminate,acute,berry,capitate,closely,cm,ellipsoid,elliptic,erect,glabrous,globose,green,greyish,leaf,lobed,long-acuminate,minute,minutely,mm,oblique,opposite,ovate,pale,paler,papillose,planar,poricidal,red-papillose,reflexed,rounded,sessile,shaped,shrub,slightly,spaced,tear-drop,thickened,tip,transversely,visible,white,woody,x	corky,na,peeling
479	wfo-0001031667	success	153	101	62	74	79	27	59	3	0.6-1,0.6-1.5,1-1.5,1-4,1.4-3,1.5-2,10-13,12-35,2-3,2.5-5,3-13,3-5,5-15,5-9,6-10,8-13,8-15,apical,branched,calyx,cell,cm,connate,corolla,covering,cyme,dehiscent,diameter,dichasial,dichasially,ebracteate,filament,flower,forked,globose,hair-like,herbaceous,interjected,introrse,irregularly,lateral,leaf,leaflet,lobed,long,make,maturing,mm,monochasial,mucilaginous,odd-pinnate,often,ovoid,pedicel,peduncle,perennial,petiole,pilose,plant,poricidally,seed,short,size,slit,stellate,stigma,style,terminal,testal,thick,wall,white,wide,yellow	2-5,2-6,3-6-foliat,3-8,4-1.,abaxially,abruptly,acumen,acuminate,acute,adaxially,apex,apically,apiculate,articulate,base,caudate,cordate,cuneate,dark,digestion,diminishing,distal,dorsally,eaf,edge,eed,elliptic-lanceolate,emoval,enzyme,exceeding,flat,folded,generally,globo,green,green-white,half,honeycomb,lanceolate,living,lobe,lon,lower,lunat,nflorescence,nther,oblique,oblong,orolla,pair,pattern,perfect,petiolate,petiolule,plan,proximal,reveal,rounded,ruit,sessile,seudostipule,specimen,spot,stamen,straight,stripe,tal,tem,throughout,toward,tuber-bearing,typically,unit,vary,whit,without,ympodial,Â¼	4-10,abaxial,adaxial,anther,arrangement,colour,connation,feature,form,fruit,growth,height,history,inflorescence,length,life,na,number,ovary,reproduction,shape,stem,surface,texture,tip,wet,width	0.6-1,0.6-1.5,1-1.5,1-4,1.4-3,1.5-2,10-13,12-35,2-3,2.5-5,3-13,3-5,5-15,5-9,6-10,8-13,8-15,apical,branched,cell,cm,connate,covering,cyme,dehiscent,diameter,dichasial,dichasially,ebracteate,forked,globose,hair-like,herbaceous,introrse,irregularly,lateral,lobed,long,make,maturing,mm,monochasial,mucilaginous,odd-pinnate,often,ovoid,perennial,pilose,poricidally,seed,short,slit,stellate,testal,thick,wall,white,wide,yellow	4-10,na,wet
480	wfo-0001031672	success	157	114	71	85	72	29	69	2	0-2,0.3-0.5,0.5,0.5-1.5,1,1-10,1-2,1-5,1.5-2,1.5-2.5,1.5-3.5,1.5-5,10-20,15-20,15-50,2-12,2-28,4,4-34,6,9-lobed,acuminate,acute,adaxially,apart,apex,apiculate,basal,base,calyx,chartaceous,cm,connective,cordate,densely,diameter,directed,distally,entire,flattened,fleshy,flower,fruit,glabrous,glandular-puberulent,globose,hair,lanceolate,leaf,lobe,lobed,long,margin,mature,mm,moderately,narrowly,occasionally,ovoid,pedicel,peduncle,petiole,pilose,pinnately,pore,puberulent,purple,rachi,rounded,simple,sparsely,stellate,stigma,style,subcoriaceous,tip,tree,triangular,truncate,tube,unbranched,unlobed,white,x,yellow	0,0.5-1,1-1.5,1-1.5-2.5,3-4-foliat,3/4,4.5-5,4/5,5-6,abaxially,absent,aggregate,ape,articulated,aublet,axe,beyond,blade,cell,ciliat,cylindrical,divided,eaf,eed,exceeding,exserted,fide,green,greenish-brown,leaving,lon,lower,membranaceous,midrib,near,nflorescence,nther,obtuse,often,one,orolla,ovate,pedicellar,perfect,pilo,presen,present,pubescent,radiu,remant,represented,ruit,shorter,sinus,slightly,small,spaced,stamen,stone,tal,tem,thecae,time,toward,truncat,ud,unit,vary,whitish,wide,yello,ympodial	abaxial,adaxial,anther,arrangement,bud,colour,corolla,feature,form,growth,height,hermaphroditic,history,inflorescence,length,life,number,ovary,perennial,plant,reproduction,seed,shape,size,spacing,stem,surface,texture,width	0-2,0.3-0.5,0.5,0.5-1.5,1,1-10,1-2,1-5,1.5-2,1.5-2.5,1.5-3.5,1.5-5,10-20,15-20,15-50,2-12,2-28,4,4-34,6,9-lobed,acuminate,acute,adaxially,apart,apex,apiculate,basal,chartaceous,cm,cordate,densely,directed,distally,entire,flattened,fleshy,glabrous,glandular-puberulent,globose,hair,lanceolate,lobe,lobed,long,mature,mm,moderately,narrowly,occasionally,ovoid,pilose,pinnately,puberulent,purple,rounded,simple,sparsely,stellate,subcoriaceous,tip,tree,triangular,truncate,unbranched,unlobed,white,x,yellow	hermaphroditic,perennial
481	wfo-0001031684	success	161	122	72	87	74	35	67	5	.25,/4,0.1,0.4-1.5,0.5-0.7,0.5-0.8,0.5-1,1-1.2,1-5,2,2-9,3-30,4-17,acuminate,acute,anther,anthesi,apex,bark,base,berry,calyx,clavate,cm,corolla,curly,decurrent,densely,dia,elliptic,extremely,filament,filiform,flower,glabrous,globose,green,inflorescence,internodal,leaf,less,lobe,lobed,long,long-triangular,minor,minutely,mm,opposite,ovary,ovoid-reniform,papillose,pedicel,persistently,petiole,pitted,planar,pore,poricidal,pubescent,reflexed,scar,shaped,short,shrub,size,slender,slightly,small,stem,stigma,style,surface,tapering,tear-drop,tip,tipped,tree,trichome,tube,unifoliate,uniseriate,way,white,winged,x,young	.5,.75,0.7-1,0.75-1,10-100,3-3.5,5-7,along,apar,bearing,beneath,black,borne,branched,causing,deflexed,denser,differing,difoliate,drying,eaf,edicel,eed,elongated,except,expanded,exserted,free,fruiting,geminate,gre,greatly,irregularly,lateral,like,lon,lower,main,major,middle,midrib,nflorescence,obconic,occasionally,older,one,pair,pale,papillo,portion,present,previously,pulled,raised,reflexe,rest,ruit,single,siz,soon,spaced,sparsely,straight,tall,tan,time,ud,unevenly,unit,varying,vein,widely,widest,ympodial	apart,arrangement,bud,coat,colour,connation,decurrency,dry,feature,form,fruit,grey,growth,height,history,length,life,midpoint,na,new,number,papilla,plant,prickle,ray,reproduction,seed,shape,spacing,specimen,texture,tuberculation,type,width,winging	.25,/4,0.1,0.4-1.5,0.5-0.7,0.5-0.8,1-1.2,1-5,2,2-9,3-30,4-17,acuminate,acute,anthesi,base,berry,calyx,clavate,cm,curly,decurrent,densely,dia,elliptic,extremely,filiform,glabrous,globose,green,internodal,leaf,less,lobed,long,long-triangular,minutely,mm,opposite,ovoid-reniform,papillose,persistently,petiole,pitted,planar,poricidal,pubescent,reflexed,shaped,short,shrub,slender,slightly,small,tapering,tear-drop,tip,tipped,tree,trichome,tube,unifoliate,uniseriate,way,white,winged,x	.5-1,apart,di,grey,na
482	wfo-0001031695	success	183	122	86	98	85	24	85	1	0.5-1,0.5-2,1-2,1-9,1.5-8,10-35,2.5-5,20-30,3-10,3-17,3-19,3-7,30-40,4-10,4-5,4-6,5,5-20,6-10,6-20,abruptly,acuminate,acute,also,apart,apex,apiculate,basal,base,branched,broadened,calyx,campanulate,chartaceous,cm,connivent,cordate,deep,densely,diameter,directed,ellipsoidal,entire,flattened,flower,fruit,glabrescent,glabrous,glandular-puberulent,greenish,hair,hard,lateral,laterally,lavender,leaf,lobe,lobed,long,margin,mm,moderately,narrowly,oblique,oblong,obtuse,occasionally,often,ovate,pedicel,peduncle,petiole,pilose,pilose-hirsute,pore,puberulent,puberulent-pubescent,pubescent,purple,purplish,rachi,shrub,simple,sometimes,somewhat,sparsely,stigma,style,subcoriaceous,tip,tree,triangular,tube,unbranched,unequal,unlobed,x,yellow	1,1-3,1.5-2,1/2,1/3,10-15-20,2-3,2-4,2-5,3-4-6,4-foliat,5-7,6-8,7-10-15,?,abaxially,adaxially,aggregate,ape,apically,articulated,axe,beyond,blade,capitat,cell,color,connective,cylindrical,d,dark,dilated,divided,eaf,eed,eglandular,eglandular-pilose,exceeding,exserted,fleshy,glabrate,green,immature,lanceolate,leaving,lilac,lon,lower,midrib,mottled,nflorescence,nther,orolla,ovoid,pedicellar,perfect,pilo,pilose-hirsut,presen,present,radiu,remnant,ripe,rounded,ruit,shorter,sinus,slight,slightly,small,spaced,stamen,stone,stripe,swelling,tal,tem,thecae,time,tomento,unit,unknown,vary,wide,ympodial	abaxial,adaxial,anther,arrangement,capitate,colour,corolla,feature,form,growth,height,inflorescence,length,number,ovary,plant,seed,shape,size,spacing,stem,surface,texture,width	0.5-1,0.5-2,1-2,1-9,1.5-8,10-35,2.5-5,20-30,3-10,3-17,3-19,3-7,30-40,4-10,4-5,4-6,5,5-20,6-10,6-20,abruptly,acuminate,acute,also,apart,apex,apiculate,basal,base,branched,broadened,campanulate,chartaceous,cm,connivent,cordate,deep,densely,diameter,directed,ellipsoidal,entire,flattened,glabrescent,glabrous,glandular-puberulent,greenish,hair,hard,lateral,laterally,lavender,lobe,lobed,long,mm,moderately,narrowly,oblique,oblong,obtuse,occasionally,often,ovate,pilose,pilose-hirsute,puberulent,puberulent-pubescent,pubescent,purple,purplish,shrub,simple,sometimes,somewhat,sparsely,subcoriaceous,tip,tree,triangular,unbranched,unequal,unlobed,x,yellow	capitate
483	wfo-0001031698	success	56	46	27	29	27	17	23	4	2-2.5,2.5,2.5-3,4-4.5,bark,base,cm,difoliate,dull,elliptic,flattened,glabrous,green,leaf,minutely,mm,pale,papillae,pedicel,pitted,reddish-brown,reniform,rugose,shrub,stem,surface,unit,x,young	ape,branch,decurrent,deflexed,dia,eaf,eed,fide,fruiting,geminat,incrassate,long,maguire,margin,older,otherwise,paler,persistin,repandly,stout,strongly,tall,wing,winged,woody,yellowish,ympodial	1,apex,arrangement,colour,diameter,feature,form,geminate,growth,height,length,plant,seed,shape,size,sympodial,texture	2-2.5,2.5,2.5-3,4-4.5,base,cm,difoliate,dull,elliptic,flattened,glabrous,green,minutely,mm,pale,papillae,pitted,reddish-brown,reniform,rugose,shrub,unit,x	1,apex,geminate,sympodial
484	wfo-0001031707	success	178	109	68	80	98	29	63	5	/4,1-1.2,1-1.3,1-1.5,1-3,1.2-1.8,1.2-2,1.5-6,2,2-10,2-4,2-6,6-7,8-12,9-15,almost,anther,apical,apically,axillary,base,berry,calyx,capitate,cm,corolla,dense,densely,diameter,distinct,elliptic,erect,flattened,flower,glabrous,globose,green,greenish,lanceolate,lateral,leaf,leaflet,lobe,lobed,mm,narrowly,obovate,ovary,pair,pedicel,petiole,pink,pinnate,plant,pointed,poricidal,pubescent,quadrate,round,sagittate,scattered,simple,slightly,smooth,sparsely,stigma,style,surface,terminal,ternate,tip,trichome,tube,type,uniseriate,vine,way,white,woody,x	-3,.5,0.5-1,1.5-1.7,1.5-2,1/3,16-20,2-3,24,3,4-5,4-6,5-10-celled,80-140,abaxially,absent,acuminate,acute,adaxially,along,anthesi,apex,attenuate,axil,basal,basiscopically,bearing,brown,c.,cateniform,cell,clavat,climbing,conical,conspicuously,cucullate,distal,drying,eaf,edicel,eed,endrophilum,enlarged,epidermal,exserted,filament,flap-like,flat,fleshy,four-lobed,free,fruiting,high,horizonta,inflorescenc,less,like,lon,long,lower,margin,minutely,narrower,nflorescence,oblique,occasionally,open,papillate,penden,per,petiolule,planar,portion,primary,quite,raised,reddish,regular,rest,ruit,scar,smaller,somewhat,spaced,stout,strongly,tem,thickening,time,tub,ud,unifoliat,unit,usually,vein,white-lenticellate,widely,ympodial	0.5,8,abaxial,adaxial,arrangement,clavate,coat,colour,feature,form,fruit,growth,height,history,horizontal,inflorescence,length,life,na,number,reproduction,seed,shape,size,stem,texture,tuberculation,width,young	/4,1-1.2,1-1.3,1-1.5,1-3,1.2-1.8,1.2-2,1.5-6,2,2-10,2-4,2-6,6-7,8-12,9-15,almost,apical,apically,axillary,base,berry,capitate,cm,dense,densely,distinct,elliptic,erect,flattened,glabrous,globose,green,greenish,lanceolate,leaflet,lobe,lobed,mm,narrowly,obovate,pair,pink,pinnate,pointed,poricidal,pubescent,quadrate,round,sagittate,scattered,simple,slightly,smooth,sparsely,ternate,tip,trichome,uniseriate,vine,way,white,woody,x	0.5,8,clavate,horizontal,na
485	wfo-0001031723	success	218	140	85	100	118	40	81	4	-1.5,0.1-0.2,0.2-1,0.4-1,0.55-0.9,0.6-1,0.7-1,1-3,1-5,1.5-10,1.5-2.5,2-3.5,2-7,2.5-4.5,2/3-3/4,3-15,acuminate,acute,anther,apart,apex,apically,bark,base,berry,brown,calyx,cm,conical,connivent,cuneate,dark,deltate,densely,dull,erect,evenly,filament,flattened-reniform,flower,fruit,glabrescent,glabrous,gray,green,hair,lateral,leaf,length,lobe,lobed,long,longer,marking,maturity,mauve,midpoint,minute,mm,moderately,narrow-deltate,obtuse,orange,orange-brown,ovate,pale,pedicel,petiole,poricidal,prickle,prickly,ray,recurved,red,reflexed,rounded,scar,shrub,simple,sometimes,spherical,spreading,stellate,stellate-pubescent,stem,straight,style,surface,tapering,terminal,time,tip,tube,unarmed,way,weakly,white,wide,yellow,young	-15,-6,-8,-merous,0-2,0.05-0.2,0.1-0.3,0.1-0.5,0.15,0.4,0.4-0.9,0.4-1-2.5-5,0.8-1.5,1-15-45,1-2,1-2-5.5-6.5,1-3-10,1-5-40,1.2-2,1.5-4-10-16,1/3-1/2,1/6-1/4-1/3-1/2,10-30,2-4-11,2.5-5,2/3,4-10-30,4-20,4-5,4-6,5-9,8-20,abaxial,abaxially,acut,adaxial,alyx,ame,apar,apparently,articulated,ba,blade,branched,branching,brow,c.,chartaceous,curved,diameter,discolorous,drying,eaf,eed,elongated,elongating,entire,equal,eye,filiform,finely,free,fruiting,gently,gland,gland-tipped,glandular,herbaceous,inflated,infructescence,lower,margin,mature,multangulate,naked,near,nflorescence,older,one,open,orolla,oung,pair,peduncle,per,perfec,pericarp,perpendicular,plurifoliat,porrect,portion,primary,ruit,secondary,sessile,smooth,spaced,sparsely,stalk,stalked,strongly,subentire,tamen,terete,tertiary,trichome,unarme,unit,usually,variously,vary,vein,venation,visible,whitish,woody,yellow-green,ympodial	0.4-2.5-5,2-11,4-30,anthesi,arrangement,bud,coat,colour,connation,corolla,decurrency,dry,embryo,feature,form,growth,height,history,inflorescence,life,minor,na,new,number,ovary,papilla,plant,pore,reproduction,seed,shape,size,spacing,specimen,stigma,texture,tuberculation,type,width,winging	-1.5,0.1-0.2,0.2-1,0.4-1,0.55-0.9,0.6-1,0.7-1,1-3,1-5,1.5-10,1.5-2.5,2-3.5,2-7,2.5-4.5,2/3-3/4,3-15,acuminate,acute,apart,apex,apically,base,berry,brown,cm,conical,connivent,cuneate,dark,deltate,densely,dull,erect,evenly,flattened-reniform,glabrescent,glabrous,gray,green,hair,lateral,lobed,long,longer,marking,maturity,mauve,minute,mm,moderately,narrow-deltate,obtuse,orange,orange-brown,ovate,pale,poricidal,prickly,recurved,red,reflexed,rounded,shrub,simple,sometimes,spherical,spreading,stellate,stellate-pubescent,straight,tapering,terminal,time,tip,unarmed,way,weakly,white,wide,yellow,young	0.4-2.5-5,2-11,4-30,na
486	wfo-0001031729	success	159	132	79	89	70	43	72	7	-0.5,-2,..,0.5,0.5-1,0.6-1-2.5,1-1.5,1-1.5-2,1-2,1.5,11-30-45,2-2.5,2-3,2.5-,3-4,3.5-4,4.1-16,5-6,5-7,abruptly,acuminate,anther,anthesi,apex,attenuate,base,branched,calyx,cm,conical,corolla,cucullate,dark,darker,dry,drying,elliptic,filament,flattened,flower,fruit,glabrous,globose,green,greenish,later,less,lobe,lobed,long,markedly,middle,mm,mottling,narrowly,nearly,obovate,occasionally,ovary,ovate-reniform,pair,pale,papillate,pedicel,petiole,pink,point,pointed,purplish,reddish,scar,short,shrub,single,small,somewhat,stem,stigma,stripe,surface,tan,time,tip,triangular,trichome,tube,white,x,young	0.5-4,1.0-1.3,1.5-2,12-13,2.5-5,3-celled,5-10-20,50,8-9,along,apicula,apiculate-deltate,beneath,branc,branch,brittle,brow,c.,cell,curve,deltate,diameter,eaf,edicel,eed,elongate,erec,flattened-capitat,fruiting,glandular,gradually,lower,membranous,minute,minutely,never,nflorescence,noddin,open,outer,outline,papillae,papillose,peduncle,per,pericarp,planar,plurifoliat,primary,quadrate,regularly,ruit,scattered,single-stemmed,sinuate,smooth,striate,testa,thin,thing,toward,tuft,ud,unit,usually,vein,wall,wand-like,widening,ympodial	1,arrangement,brown,bud,coat,colour,connation,curved,embryo,erect,feature,flattened-capitate,form,growth,height,history,inflorescence,leaf,length,life,midpoint,minor,na,new,number,papilla,plant,plurifoliate,pore,prickle,ray,reproduction,seed,shape,size,spacing,specimen,style,texture,tuberculation,type,width,winging	-0.5,-2,..,0.5,0.5-1,0.6-1-2.5,1-1.5,1-1.5-2,1-2,1.5,11-30-45,2-2.5,2-3,2.5-,3-4,3.5-4,4.1-16,5-6,5-7,abruptly,acuminate,anther,attenuate,base,branched,cm,conical,cucullate,dark,darker,drying,elliptic,flattened,glabrous,globose,green,greenish,later,less,lobed,long,markedly,middle,mm,mottling,narrowly,nearly,obovate,occasionally,ovate-reniform,pair,pale,papillate,pink,point,pointed,purplish,reddish,short,shrub,single,small,somewhat,stripe,tan,time,tip,triangular,trichome,white,x,young	1,brown,curved,erect,flattened-capitate,na,plurifoliate
487	wfo-0001031738	success	230	132	78	98	132	34	75	3	0.2-0.3,0.7-1,0.7-1.1,1-1.5,1-4,1.4-1.7,1.5-4,1/2-2/3,1/3,20-200,3-7,3.5-4.5,4-5,4-8,6-15,7-12.5,8-18,acute,anther,apart,apex,apically,apparently,articulated,auriculate,bark,base,berry,calyx,cell,cm,connivent,cordate,curved,deltate,densely,erect,evenly,filament,flattened,flattened-reniform,flower,fruit,glabrescent,glabrous,green,lateral,leaf,length,lobe,lobed,lower,maturity,midpoint,mm,narrow-deltate,orange,orange-brown,outline,ovate,pale,pedicel,petiole,pit,poricidal,prickle,prickly,pubescent,raised,ray,reflexed,scar,shrub,simple,small,smooth,sparsely,spherical,spreading,stellate-pubescent,stem,straight,strongly,style,surface,tapering,terete,terminal,tip,tree,tube,unarmed,upper,way,weakly,white,yellow,young	-5,-merous,.5,0-15,0-2,0-3,0.1-0.25,0.25-0.8,0.3-1,0.9-2.1,1-1.8,1-3,1.5-2-4-5,1/,1/3-2/3,1/4-1/3,1/6-1/4,10-15,15-40,2-3-4,2.3-3,3-4,3-6,3.5-3.8,4,4-10,4-6,5,5-6,5-8,7-12,8-10,8-10-15,abaxial,abaxially,acuminat,adaxial,adaxially,almost,always,alyx,andromonoecious,apar,blade,branched,chartaceous,dark,diameter,discolorous,distal,distance,drying,dull,eaf,eed,elongating,equal,extending,free,frequently,fruiting,gray,held,hermaphrodite,heterostylous,infructescence,inside,lobing,long,long-styled,longer,lowermost,margin,mature,midvein,multangulate,nflorescence,oblong,obovate,often,older,one,open,orolla,oung,pair,peduncle,per,pericarp,plant,plurifoliat,poorly,porrect,portion,prickl,primary,prominent,resin,rounded,ruit,secondary,sessile,short-styled,shorter,side,sometimes,spaced,stalk,stalked,staminat,stellate,sticky,stout,tamen,tertiary,time,trichome,truncate,unit,usually,variously,vary,vein,venation,visible,white-brow,wide,woody,yellow-green,yellow-orange,yellowish,ympodial	acuminate,anthesi,arrangement,bud,coat,colour,connation,corolla,decurrency,dry,embryo,feature,form,growth,inflorescence,minor,na,new,number,ovary,papilla,pore,seed,shape,size,spacing,specimen,stigma,texture,tuberculation,type,white-brown,width,winging	0.2-0.3,0.7-1,0.7-1.1,1-1.5,1-4,1.4-1.7,1.5-4,1/2-2/3,1/3,20-200,3-7,3.5-4.5,4-5,4-8,6-15,7-12.5,8-18,acute,apart,apically,apparently,articulated,auriculate,base,berry,cell,cm,connivent,cordate,curved,deltate,densely,erect,evenly,flattened,flattened-reniform,glabrescent,glabrous,green,lateral,lobed,lower,maturity,mm,narrow-deltate,orange,orange-brown,outline,ovate,pale,pit,poricidal,pubescent,raised,reflexed,shrub,simple,small,smooth,sparsely,spherical,spreading,stellate-pubescent,straight,strongly,tapering,terete,terminal,tip,tree,upper,way,white,yellow,young	acuminate,na,white-brown
488	wfo-0001031752	success	166	139	99	111	55	28	97	2	-10,-pubescent,0.5-1,1,1-2,1-3,1-4,1.5-10.5-44,1.5-3,1.5-3.5-6,15-25,15-40-100,2-5,20-35,3-11.5,3-4,3-7,3.5-15-47,3.5-5,5-23,5-8,abaxially,acuminate,acute,adaxially,apex,apiculate,basal,base,calyx,chartaceous,ciliate,cm,connective,connivent,cuneate,cylindrical,darker,deltate,densely,directed,distally,ellipsoidal,entire,equal,exceeding,flattened,fleshy,flower,fruit,fusiform,glabrate,glabrescent,glabrous,glandular-puberulent,green,immature,lanceolate,less,light,linear,lobe,margin,membranaceous,mm,moderately,narrowly,near,nearly,obtuse,older,ovoid,pedicel,peduncle,petiole,pink,pore,present,puberulent,pubescent,purplish,rachi,ripe,rounded,rugose,shrub,simple,slightly,small,sparsely,stellate,stigma,stripe,style,subcordate,subcoriaceous,swelling,thecae,tip,tomentose,tree,triangular,truncate,tube,unbranched,unit,white,wide,x,yellow,young	0.5-1.5,1-1.5,1-1.5-2.5-3,1.5-2,2-2.5,2-3,3-4-foliat,5-6,8-15,9-16,aggregate,apart,ape,articulated,axe,beyond,blade,cell,ciliat,diameter,eaf,eed,elliptic,exserted,gland,glandular-puberulen,leaving,lon,long,lower,nflorescence,nther,oblong,often,olde,orolla,ovate,pedicellar,perfect,presen,purpl,radiu,remnant,ruit,spaced,stalked,stamen,stone,tal,tem,time,truncat,ud,vary,ympodial	3-4-foliate,abaxial,adaxial,anther,arrangement,bud,colour,corolla,feature,form,growth,height,inflorescence,leaf,length,number,ovary,plant,purple,seed,shape,size,spacing,stem,surface,sympodial,texture,width	-10,-pubescent,0.5-1,1,1-2,1-3,1-4,1.5-10.5-44,1.5-3,1.5-3.5-6,15-25,15-40-100,2-5,20-35,3-11.5,3-4,3-7,3.5-15-47,3.5-5,5-23,5-8,abaxially,acuminate,acute,adaxially,apex,apiculate,basal,base,chartaceous,ciliate,cm,connivent,cuneate,cylindrical,darker,deltate,densely,directed,distally,ellipsoidal,entire,equal,exceeding,flattened,fleshy,fusiform,glabrate,glabrescent,glabrous,glandular-puberulent,green,immature,lanceolate,less,light,linear,lobe,membranaceous,mm,moderately,narrowly,near,nearly,obtuse,older,ovoid,pink,present,puberulent,pubescent,purplish,ripe,rounded,rugose,shrub,simple,slightly,small,sparsely,stellate,stripe,subcordate,subcoriaceous,swelling,thecae,tip,tomentose,tree,triangular,truncate,unbranched,white,wide,x,yellow,young	3-4-foliate,purple
489	wfo-0001031756	success	186	129	73	89	97	40	70	3	-5,.5,/2,0-5,0.4-1.6,0.5-1,0.5-1.3,0.6-1.2,0.7-1.7,0.8-1,1-3,1-4,1.5-3.5,1.8-2.5,2-6,3-15,3-7,anther,apart,apex,apically,articulated,bark,base,berry,broad-deltate,calyx,cm,color,conical,connivent,cordate,deltate,diameter,erect,evenly,filament,finely,flattened-reniform,flower,fruit,glabrescent,glabrous,gray,green,known,leaf,lobe,lobed,long,mature,mauve,midpoint,mm,ovate,pale,pedicel,petiole,pitted,poricidal,porrect,prickle,prickly,ray,red-brown,rounded,scar,shrub,simple,spherical,spreading,stalked,stellate-pubescent,stem,straight,style,surface,tapering,terminal,tip,trichome,truncate,tube,unarmed,variously,way,white,wide,young	.1,.8,0,0-1,0-2,0.02-0.2,0.1,0.15-0.25,0.2,0.6-1.6,00,1-1.8,1-2,1.5-2,1/2,1/3,10,3-5,4-5,4.5,5-merous,6-9,7-10,9-14,abaxially,accrescent,acut,alyx,apar,apparently,blade,branched,chartaceous,concolorous,curved,densely,drying,eaf,eed,elongating,enclosing,entire,equal,eye,free,fruiting,fully,glabrou,herbaceous,inflated,infructescence,invested,longer,lower,margin,moderately,naked,nflorescence,older,one,open,orange-brown,orolla,oung,pair,peduncle,pendulous,per,perfec,pericarp,perpendicular,plurifoliat,portion,prickl,primary,ruit,scandent,sessile,shoot,short,shorter,slender,small,smooth,spaced,sparsely,stalk,stellate,tamen,terete,time,unit,vary,vein,visible,yellow-green,ympodial	acute,anthesi,arrangement,bud,coat,colour,connation,corolla,decurrency,dry,embryo,feature,form,growth,height,history,inflorescence,length,life,minor,new,number,ovary,papilla,perennial,plant,pore,reproduction,seed,shape,size,spacing,specimen,stigma,texture,tuberculation,type,unknown,width,winging	-5,.5,/2,0-5,0.4-1.6,0.5-1,0.5-1.3,0.6-1.2,0.7-1.7,0.8-1,1-3,1-4,1.5-3.5,1.8-2.5,2-6,3-15,3-7,apart,apically,articulated,base,berry,broad-deltate,cm,color,conical,connivent,cordate,deltate,diameter,erect,evenly,finely,flattened-reniform,glabrescent,glabrous,gray,green,known,lobed,long,mature,mauve,mm,ovate,pale,pitted,poricidal,porrect,prickly,red-brown,rounded,shrub,simple,spherical,spreading,stalked,stellate-pubescent,straight,tapering,terminal,tip,trichome,truncate,unarmed,variously,way,white,wide,young	acute,perennial,unknown
490	wfo-0001031786	success	207	121	75	90	117	31	72	3	/3,0.2-2.5,0.5-1.5,0.7-1,0.7-1.6,0.7-4,0.8-1.2,1-3,1-4,1-6,1.2-1.6,2-13,2-3,2-7,2-8,2.5-3.5,3-5.5,4-5,almost,anther,apart,articulated,base,becoming,berry,calyx,cell,chartaceous,cm,connivent,curved,deep,deltate,elliptic,erect,filament,flattened-reniform,flower,fruit,glabrous,gray,herb,lateral,leaf,length,lobe,lobed,long,mauve,membranous,minute,mm,orange,orange-brown,outline,ovate,pedicel,petiole,pit,poricidal,prickle,prickly,raised,red,reflexed,scar,shiny,shrub,simple,small,smooth,sometimes,sparsely,spherical,spreading,stellate-pubescent,stem,stigma,straight,style,surface,tapering,terete,tip,trichome,tube,way,white,yellow-orange,young	.4,.5,/2,0-2,0-20,0-3,0-5,0.1,0.1-0.4,0.2-0.3,0.25-0.5,0.8,1,1-2,1.5-1.9,1.5-2.5,1/3-1/2,3-4,5-7,5-merous,6-8,8-12,abaxially,acut,acute,alyx,ame,apar,apex,apically,apparently,bark,blade,branched,c.,clavat,concolorous,cuneate,dark,densely,diameter,distance,drying,eaf,eed,elongating,equal,evenly,extending,eye,filiform,flattened,free,fruiting,glabrescent,gray-brow,green,herbaceous,inconspicuous,infructescence,lon,longer,lower,margin,mature,maturity,midpoint,midvein,naked,nflorescence,obtuse,older,one,open,orolla,oung,pair,pale,peduncle,pendulous,per,perfec,pericarp,plurifoliat,porrect,portion,prickl,primary,ray,red-brown,rounded,ruit,scandent,sessile,shorter,side,slightly,spaced,stalk,stalked,stellate,tamen,tertiary,thick,time,truncate,unarmed,unit,variously,vary,vein,venation,visible,weakly,wide,woody,ympodial	0.5,abaxial,adaxial,arrangement,clavate,coat,colour,connation,corolla,embryo,feature,form,growth,hair,height,inflorescence,na,number,ovary,papilla,plant,pore,seed,shape,size,spacing,texture,tuberculation,type,width,winging	/3,0.2-2.5,0.5-1.5,0.7-1,0.7-1.6,0.7-4,0.8-1.2,1-3,1-4,1-6,1.2-1.6,2-13,2-3,2-7,2-8,2.5-3.5,3-5.5,4-5,almost,apart,articulated,base,becoming,berry,cell,chartaceous,cm,connivent,curved,deep,deltate,elliptic,erect,flattened-reniform,glabrous,gray,herb,lateral,lobed,long,mauve,membranous,minute,mm,orange,orange-brown,outline,ovate,pit,poricidal,prickly,raised,red,reflexed,shiny,shrub,simple,small,smooth,sometimes,sparsely,spherical,spreading,stellate-pubescent,straight,tapering,terete,tip,trichome,way,white,yellow-orange	0.5,clavate,na
491	wfo-0001031793	success	188	141	91	103	85	38	89	2	-4,.5,1-1.5,1-8,1.5-4,10-15,13-20,15-20,2-3,2-5,3-8,3/4,40,8-11,abundant,acumen,acuminate,acute,aging,almost,anther,apex,articulated,base,berry,black,branched,broadly,brownish,calyx,capitate,central,cm,cuneate,densely,elliptic,erect,evident,extra-axillary,filament,flattened,flower,forked,fruit,glandular,globose,hair,inflorescence,interpetalar,larger,leaf,linear,lobe,long,midpoint,minutely,mm,oblique,oblong-lanceolate,obtuse,often,orange-yellow,orbicular-ovate,pedicel,petiole,pore,porocidal,porrect,prickle,pubescent,reduced,reticulation,rounded,rusty,scarcely,shallow,shrub,side,similar,simple,size,small,stellate,stellate-pubescent,stem,stigma,stout,style,surface,testa,thickened,tip,tissue,tree,triangular,tube,unbranched,upward,well-developed,white,woody,yellow,yellow-brown	0,1,1-2,1-3,1.5-2,1/3,1/4,1/5,20,26,3-4,4,5-merous,7,absent,accrescent,adult,alyx,apparently,armed,aspect,axe,ba,bilobe,blade,branche,broad,brown,chartaceous,cut,diameter,difoliate,distal,eaf,eed,elongatin,erec,extreme,ferrugineous,fruiting,geminat,general,homostylou,lobing,lon,lower,main,many,margin,maturing,midrib,mostly,mucilaginous,nflorescence,older,orolla,ovate,peduncle,per,perfect,principal,rachi,reddish,ruit,scattered,sessile,single,sinus,smaller,sparsely,stellate-pubescen,stipitate,tall,tamen,tem,triangular-acuminat,trichome,unarmed,unit,usually,uvenile,vary,way,x,ympodial	anthesi,arrangement,bilobed,bud,coat,colour,connation,corolla,decurrency,dry,embryo,feature,form,growth,height,history,length,life,minor,na,new,number,ovary,papilla,plant,ray,reproduction,scar,seed,shape,spacing,specimen,texture,tuberculation,type,width,winging,young	-4,.5,1-1.5,1-8,1.5-4,10-15,13-20,15-20,2-3,2-5,3-8,3/4,40,8-11,abundant,acumen,acuminate,acute,aging,almost,apex,articulated,base,berry,black,branched,broadly,brownish,capitate,central,cm,cuneate,densely,elliptic,erect,evident,extra-axillary,flattened,flower,forked,fruit,glandular,globose,hair,interpetalar,larger,linear,lobe,long,midpoint,minutely,mm,oblique,oblong-lanceolate,obtuse,often,orange-yellow,orbicular-ovate,porocidal,porrect,pubescent,reduced,reticulation,rounded,rusty,scarcely,shallow,shrub,side,similar,simple,size,small,stellate,stellate-pubescent,stout,testa,thickened,tip,tissue,tree,triangular,unbranched,upward,well-developed,white,woody,yellow,yellow-brown	bilobed,na
492	wfo-0001031829	success	138	104	65	88	50	16	63	2	.25,.5,0.5-2.1,0.7-1,1-2,1.5-2,1.5-2.5,1.5-3.5,1.5-4.5,2-4,3/4,4-4.5,4-8.5,7-10,adaxial,anther,anthesi,bark,base,berry,branched,broadly,calyx,capitate,cm,conical,corolla,crystalline,deflexed,densely,denser,elliptic,epidermi,filament,fruiting,globose,greenish-brown,growth,immature,inflorescence,large-celled,lateral,leaf,leathery,lobe,lobed,long,major,margin,minor,minutely,mm,occasionally,opposite,ovary,pair,papillose,pedicel,petiole,planar,pore,poricidal,pubescent,revolute,shaped,shrub,simple,size,soft,somewhat,sparsely,stem,stigma,style,surface,tapering,tear-drop,thick,tip,trichome,tube,uniseriate,vein,waxy,way,white,x,young	1,1.3-1.5,3-5-flowered,abaxially,absent,acute,adaxially,along,ape,apex,apiculae,bae,dia,differing,difoliate,drying,eaf,edicel,eed,erect,exserted,free,geminat,glabrat,glabrous,green,known,like,lon,lower,main,minute,nflorescence,often,older,overlappin,packed,papillo,portion,quadrate,ruit,scar,tall,tub,tuft,ud,unit,woody,yellowish,ympodial	abaxial,arrangement,colour,feature,form,fruit,glabrate,height,length,na,plant,seed,shape,texture,thicknes,type	.25,.5,0.5-2.1,0.7-1,1-2,1.5-2,1.5-2.5,1.5-3.5,1.5-4.5,2-4,3/4,4-4.5,4-8.5,7-10,anthesi,base,berry,branched,broadly,capitate,cm,conical,crystalline,deflexed,densely,denser,elliptic,globose,greenish-brown,immature,large-celled,leaf,leathery,lobed,long,margin,minutely,mm,occasionally,opposite,pair,papillose,planar,pore,poricidal,pubescent,revolute,shaped,shrub,simple,soft,somewhat,sparsely,tapering,tear-drop,thick,tip,trichome,uniseriate,waxy,way,white,x	glabrate,na
493	wfo-0001031832	success	232	153	105	113	119	40	99	6	0.1-0.3,0.2-0.6,0.2-1.5,0.3-3,0.7-1.6,0.7-2,0.8-1.2,1-12,1.2-2,1.5-4,1.8-4,2-6,3-6.5,5-21,8-25,9,acuminate,anther,anthesi,apart,apex,apical-lateral,attenuate,base,becoming,berry,blunt-tipped,brown,brownish,bud,calyx,cm,connate,continued,corolla,deltoid,due,entire,extend,ferrugineous,few-rayed,filament,fleshy,flower,forming,fruit,globose,granular-tomentose,greenish,growth,hair,honeycombed,introrse,lanceolate,large,lateral,leaf,length,lobe,long,longitudinal,mixed,mm,mostly,multangulate,nearly,oblanceolate,oblong,obovoid,obtuse,occasionally,orbicular,ovate,pale,pedicel,petiole,pore,porrect-stellate,probably,pubescent,ray,reniform,reticulate-punctate,ripe,rotate-stellate,rough,scabrous,sessile,short-,short-stalked,shrub,simple,slit,smooth,stem,stigma,style,subcampanulate,suborbicular,surface,terete,terminal,testa,thick-stalked,tree,tube,unarmed,violet,white,x,yellow,yellowish,young	-8,.5-1,/50-1/10,0-150,0.3-0.8,0.7-1.5,1.1-2.4,1.2-1.6,1.2-2.5,1.3-4.2,1.7-4,1/2-3/4,14,2-3.6,2-4,2.5-6.5,2.8-4.8,3-7,3.5-7,4-20,4-7,5.5-10,7-10,abaxially,accrescent,acute,adaxially,ag,apice,apparently,articulated,axe,axillary,ba,bark,basal,blade,blister,branch,branched,bullate,capitat,chartaceous,closely,conical,dark,decurrent,dehiscing,diameter,directed,eaf,eed,evident,exserted,free,fruiting,glabrescen,glabrescent,glabrous,green,half,high,indument,inserted,lackin,line,lobed,long-,longer,lower,m.,main,margin,midvein,minute,nflorescence,older,orolla,partly,peduncle,perfect,persistent,pitted,plurifoliate,porrect-stellat,pubescence,rachi,rather,relatively,ruit,runk,side,sometimes,somewhat,soon,spaced,sparingly,sparse,splitting,stamen,stellate-pubescent,stipitate-glandular,suture,swelling,tamen,thick,time,toward,translucent,unarme,unit,usually,vary,vein,way,weakly,whitish,wide,ympodial	20-150,age,arrangement,capitate,coat,colour,connation,decument,decurrency,dry,embryo,feature,form,height,history,inflorescence,life,midpoint,minor,na,new,number,ovary,papilla,plant,prickle,reproduction,scar,seed,shape,size,spacing,sparing,specimen,texture,tip,tuberculation,type,width,winging	0.1-0.3,0.2-0.6,0.2-1.5,0.3-3,0.7-1.6,0.7-2,0.8-1.2,1-12,1.2-2,1.5-4,1.8-4,2-6,3-6.5,5-21,8-25,9,acuminate,apart,apex,apical-lateral,attenuate,base,becoming,berry,blunt-tipped,brown,brownish,cm,connate,continued,deltoid,due,entire,extend,ferrugineous,few-rayed,fleshy,flower,forming,fruit,globose,granular-tomentose,greenish,growth,hair,honeycombed,introrse,lanceolate,large,lateral,length,long,longitudinal,mixed,mm,mostly,multangulate,nearly,oblanceolate,oblong,obovoid,obtuse,occasionally,orbicular,ovate,pale,petiole,pore,porrect-stellate,probably,pubescent,reniform,reticulate-punctate,ripe,rotate-stellate,rough,scabrous,sessile,short-,short-stalked,shrub,simple,slit,smooth,stem,subcampanulate,suborbicular,terete,terminal,testa,thick-stalked,tree,tube,unarmed,violet,white,x,yellow,yellowish	20-150,age,capitate,decument,na,sparing
494	wfo-0001031834	success	150	118	60	78	72	40	56	4	.5,0.5,0.5-1,0.5-3,0.5-3.5,0.6-1.4,0.8-1,0.8-1.3,0.9-1.4,1,1.5,1.9-6.5,2.9-7,6-7,6.5-14,acuminate,acute,anther,anthesi,apex,attenuate,base,berry,calyx,campanulate,cm,corolla,decurrent,deflexed,deltoid,few-flowered,filament,flattened-reniform,fruit,glabrous,globose,green,greenish-yellow,hooked,leaf,less,lobe,lobed,long,minor,minute,minutely,mm,opposite,ovary,ovate,papillose,pedicel,petiole,pitted,planar,pore,poricidal,pubescent,scar,shaped,shrub,simple,slender,sparsely,stem,stigma,style,surface,tapering,tear-drop,tip,trichome,tube,white,woody,x,young	1.5-4,1.6-2,2/3,accrescent,across,apar,apically,apiculate,appear,bi-cellular,borne,covered,deciduou,deciduous,depression,dia,difoliate,eaf,edicel,eed,expanded,eye,free,fruiting,geminat,glabrou,hook,incrassate,lamina,larger,leaving,like,lon,lower,major,margin,markedly,middle,mound-like,multicellular,naked,nflorescence,often,pale,papillo,persistent,portion,proximal,ruit,scabrous,short,slightly,small,soon,spaced,speck,straight,tall,tan,tufted,ud,unevenly,uni-,uniseriate,unit,upper,usually,vein,way,widest,yellow,ympodial	alternate,apart,arrangement,bark,bud,coat,colour,connation,decurrency,dry,embryo,feature,flower,form,growth,height,history,inflorescence,length,life,midpoint,na,new,number,papilla,perennial,plant,prickle,ray,reproduction,seed,shape,size,spacing,specimen,texture,tuberculation,type,width,winging	.5,0.5,0.5-1,0.5-3,0.5-3.5,0.6-1.4,0.8-1,0.8-1.3,0.9-1.4,1,1.5,1.9-6.5,2.9-7,6-7,6.5-14,acuminate,acute,attenuate,berry,campanulate,cm,decurrent,deflexed,deltoid,few-flowered,flattened-reniform,glabrous,globose,green,greenish-yellow,hooked,leaf,less,lobed,long,minute,minutely,mm,opposite,ovate,papillose,pitted,planar,poricidal,pubescent,shaped,shrub,simple,slender,sparsely,tapering,tear-drop,trichome,white,woody,x	alternate,apart,na,perennial
495	wfo-0001031842	success	161	133	84	95	66	38	78	6	0.1-0.5,0.5-1,0.5-2,0.7-1,1-1.5,1-1.8,1-3.5,2-10,2-3,2.5-6,3-8,3/4,4.5-6,7-9,9-15,acute,anther,anthesi,apart,apex,attenuate,bark,base,berry,bi-lobed,calyx,capitate,cm,corolla,cup-shaped,cusp,decurrent,deeply,difoliate,dry,ellipsoid,elliptic,exsertion,filament,flattened-reniform,glabrous,globose,green,later,lateral,leaf,leaf-opposed,lobe,lobed,minor,minutely,mm,near,new,often,onto,opposite,ovary,overtopping,pale,papillose,pedicel,petiole,pitted,pore,poricidal,quadrate,reddish-resinous,scar,shaped,shiny,shoot,shrub,simple,size,slender,somewhat,specimen,stem,stigma,strongly,style,surface,tapering,tear-drop,terminal,tip,tree,tube,unit,way,white,woody,x,young	.1,.4,.5,.75,0.6-1,1,1.5-2,10-12,10-20,10-30-flowered,2.5-3,axil,ba,bearing,beginning,beneath,brown,dark,deflexed,densely,dia,differing,eaf,edicel,eed,exserte,free,fruiting,geminat,incrassate,inflorescenc,irregularly,lon,long,lower,main,major,margin,middle,nflorescence,older,one,pair,paler,papillo,portion,prominent,pubescent,reddish,reflexed,ruit,soon,spaced,sparsely,straight,tall,time,trichome,tuft,ud,uniseriate,vein,widest,yellowish,yellowish-whit,ympodial	0.5,10-30,arrangement,bud,coat,colour,connation,decurrency,embryo,feature,flower,form,fruit,geminate,growth,height,history,inflorescence,length,life,midpoint,na,number,papilla,plant,prickle,ray,reproduction,seed,shape,spacing,sympodial,texture,tuberculation,type,width,winging,yellowish-white	0.1-0.5,0.5-1,0.5-2,0.7-1,1-1.5,1-1.8,1-3.5,2-10,2-3,2.5-6,3-8,3/4,4.5-6,7-9,9-15,acute,apart,apex,attenuate,base,berry,bi-lobed,calyx,capitate,cm,corolla,cup-shaped,cusp,decurrent,deeply,difoliate,ellipsoid,elliptic,exsertion,flattened-reniform,glabrous,globose,green,later,lateral,leaf,leaf-opposed,lobed,minutely,mm,near,new,often,onto,opposite,overtopping,pale,papillose,petiole,pitted,poricidal,quadrate,reddish-resinous,shaped,shiny,shoot,shrub,simple,slender,somewhat,strongly,tapering,tear-drop,terminal,tip,tree,tube,unit,way,white,woody,x,young	0.5,10-30,geminate,na,sympodial,yellowish-white
496	wfo-0001031843	success	245	136	99	117	128	19	95	4	.3,0.2-2,0.5-1,0.6-1.2,0.7-2,1-7,1.2-2,1.5,1.5-2,1.8-2.5,1/6-1/4,2-3,2.5,4-12,5-10,5-12,6-9,abaxially,adaxially,almost,along,anther,anthesi,appressed,around,bark,basal,base,berry,branch,brown,calyx,canaliculate,capitate,cm,completely,conical,corolla,cupular,curved,dark,deeply,density,diameter,discoid,distributed,drying,erect,evenly,filament,fine,finely,flat,glabrous,green,honeycomb,leaf,length,liana,lobe,lobed,longitudinally,main,margin,midvein,mm,network,oblong,obovate,orange,orange-brown,ovate,pair,part,partly,pattern,pedicel,peduncle,petiole,pitted,pore,poricidal,present,primary,pubescent,raised,rarely,red,reddish,ridged,scar,seed,shiny,shrub,side,slender,sometimes,spheroidal,stem,stigma,straight,style,surface,terminal,tertiary,thick-chartaceous,tip,trichome,tube,unarmed,variable,vein,venation,violet,visible,x,young	.2,.5,.6,0-4,0.4-0.5,0.5-1.5,0.7-1.2,0.8-2,1-2,1.2-2.2,1mm,2-4,3-4,3-7,45-60Â°,accrescent,acuminate,age,always,alyx,apar,apex,apically,apice,apparently,articulated,attenuate,becoming,black,branched,branching,broadly,caudate,clearly,collapsing,cuspidate,delineated,deltoid,dendritic,detaching,dilated,discolorous,domatia,dull,eaf,eed,ellipsoi,entire,equal,even,eye,fertilisation,flexuous,flower,forming,free,fruiting,hand,inner,largely,leave,len,lengthening,lignified,like,long,loop,looping,lower,m.,much,multiseriate,naked,never,nflorescence,nther,oblique,obscure,older,opening,orange-yellow,orolla,outline,papillo,pendulous,perfec,pericarp,pit,plurifoliat,portion,prominent,pronounced,protruding,rachi,recurve,reveal,ribbed,rounded,ruit,see,shallowly,shortly,simple,sinus,slightly,small,smaller,smooth,soon,sparsely,spreading,strongly,stump,surfac,tearing,thickened,thin,tuft,twice,ud,unit,vary,weakly,white,wide,wider,without,ympodial	apart,arrangement,bud,colour,ellipsoid,feature,form,fruit,growth,inflorescence,number,ovary,papillose,prominence,shape,size,spacing,texture,true	.3,0.2-2,0.5-1,0.6-1.2,0.7-2,1-7,1.2-2,1.5,1.5-2,1.8-2.5,1/6-1/4,2-3,2.5,4-12,5-10,5-12,6-9,abaxially,adaxially,almost,along,anthesi,appressed,around,basal,base,berry,branch,brown,canaliculate,capitate,cm,completely,conical,corolla,cupular,curved,dark,deeply,density,diameter,discoid,distributed,drying,erect,evenly,fine,finely,flat,glabrous,green,honeycomb,length,liana,lobed,longitudinally,mm,network,oblong,obovate,orange,orange-brown,ovate,pair,part,partly,pattern,peduncle,petiole,pitted,poricidal,present,pubescent,raised,rarely,red,reddish,ridged,shiny,shrub,side,slender,sometimes,spheroidal,stem,straight,terminal,thick-chartaceous,trichome,variable,vein,violet,visible,x,young	apart,ellipsoid,papillose,true
497	wfo-0001031852	success	152	81	39	53	99	28	35	4	0.1-1,1-4,1-4.2,1-9,1.3-2.5,1.4-3,2-3,2-5.5,2.6-9.5,3-9,3.5-10,4-4-5-8,4-6,5-15,7-12-35,9-11,branched,calyx,cm,conical,connate,corolla,cyme,diameter,dichasially,filament,flower,forked,green,herbaceous,interjected,lateral,leaf,leaflet,light,mm,mucilaginous,odd-pinnate,ovoid,pedicel,peduncle,perennial,petiole,plant,pubescent,seed,size,stellate,stigma,style,terminal,white,yellow	0.5-1.3,0.5-3,1-2-3,1.5-3,3-4,3-6-foliat,4-10,abaxially,abruptly,absen,acumen,acuminate,acute,adaxially,apex,apical,apically,apiculate,articulate,attenuate,base,cell,covering,decurrent,dehiscent,dichasial,digestion,diminishing,distal,dorsally,eaf,ebracteate,edge,eed,elliptic,elliptic-lanceolate,emoval,enzyme,exceeding,flat,folded,generally,globo,green-white,hair-like,half,honeycomb,introrse,lanceolate,living,lobe,lon,long,lower,lunat,make,maturing,monochasial,nflorescence,nther,oblique,oblong,often,orolla,ovate-elliptic,pair,pattern,perfect,plan,poricidally,proximal,rachi,reveal,ruit,sessile,seudostipule,short,shortly,slit,specimen,stamen,straight,tal,tem,testal,thick,throughou,throughout,toward,tuber-bearing,typically,unit,vary,wall,white-crea,wide,without,ympodial,Â¼	abaxial,absent,adaxial,anther,arrangement,colour,connation,feature,form,fruit,globose,growth,height,history,inflorescence,length,life,na,number,ovary,reproduction,shape,stem,surface,texture,type,white-cream,width	0.1-1,1-4,1-4.2,1-9,1.3-2.5,1.4-3,2-3,2-5.5,2.6-9.5,3-9,3.5-10,4-4-5-8,4-6,5-15,7-12-35,9-11,branched,cm,conical,connate,cyme,dichasially,forked,green,herbaceous,light,mm,mucilaginous,odd-pinnate,ovoid,perennial,pubescent,stellate,white,yellow	absent,globose,na,white-cream
498	wfo-0001031864	success	140	106	68	79	61	27	64	4	.2,.25,.5,0.2-0.5,0.5-4,0.7-0.8,0.8-1,1-1.8,1-2,1-5,1-6.5,1.5,1.5-10,15-60,2-3,2.5-6,3-3.5,3-pinnate,5-15,5-9,abaxially,acuminate,acute,adaxially,anther,apex,calyx,chartaceous,ciliate,clavate,cm,deltoid,dense,densely,diameter,entire,extra-axillary,fine,flattened,fleshy,flower,fruit,glabrous,hair,herbaceous,lenticular,lobe,long,margin,middle,mm,ovoid-deltoid,papillose,pedicel,peduncle,petiole,pointed,pubescence,pubescent,rachi,rotate,scattered,short,slender,slightly,sparsely,stem,stigma,style,surface,tip,trichome,tube,unbranched,vine,violet,wide-diameter,widely,x	0.4-3,0.5-13.5,0.6-3.5,0.6-4,1-1.2,1-3,1.2-1.5,1.5-2.5,2,5-merous,7.5-8,accrescent,alyx,apar,apical,apiculate,axe,base,berry,blade,c.,capitat,color,cuneate,eaf,eed,emarginate,filament,fruiting,glabrou,lateral,leaflet,like,lon,lower,m.,minutely,moderately,near,nflorescence,nternode,oblique,orolla,perfec,petiolule,plurifoliat,pubescenc,rounded,ruit,sand-punctate,spaced,tamen,tem,terrestria,truncate,typical,unit,unknown,vary,vein,ympodial	abaxial,adaxial,apart,arrangement,capitate,colour,corolla,feature,form,growth,history,inflorescence,internode,leaf,length,life,number,ovary,plurifoliate,reproduction,seed,shape,size,spacing,terrestrial,texture,width	.2,.25,.5,0.2-0.5,0.5-4,0.7-0.8,0.8-1,1-1.8,1-2,1-5,1-6.5,1.5,1.5-10,15-60,2-3,2.5-6,3-3.5,3-pinnate,5-15,5-9,abaxially,acuminate,acute,adaxially,apex,chartaceous,ciliate,clavate,cm,deltoid,dense,densely,diameter,entire,extra-axillary,fine,flattened,fleshy,glabrous,hair,herbaceous,lenticular,long,middle,mm,ovoid-deltoid,papillose,pointed,pubescence,pubescent,rotate,scattered,short,slender,slightly,sparsely,tip,trichome,unbranched,vine,violet,wide-diameter,widely,x	apart,capitate,plurifoliate,terrestrial
499	wfo-0001031864	success	148	115	61	71	77	44	58	3	.25,0.4-3,0.5-13.5,1-1.2,1-3,1-5,1-6.5,15-60,2-3,2.5-6,3-3.5,3-pinnate,5-15,5-9,abaxially,acute,anther,apart,apex,basally,base,blue-purple,calyx,cm,color,connivent,cordate,cuneate,deltoid,diameter,directed,distally,emarginate,extra-axillary,filament,flower,fruit,glabrous,hair,herb,large,lenticular,lobe,longitudinal,mm,oblique,oblong,opening,pedicel,plurifoliate,pore,pubescent,rotate,rounded,short,slender,slit,sparsely,stigma,style,surface,terrestrial,tip,trailing,truncate,tube,unbranched,unknown,weakly,woody,x	.2,.5,0.5-4,0.6-3.5,0.6-4,1-1.8,1-2,1.2-1.5,1.5,1.5-2.5,2,3-5-celled,5-merou,7.5-8,absent,accrescent,acuminate,adaxially,ag,alyx,apical,apiculate,apparently,articulated,axe,ba,blade,capitat,center,ciliate,clavate,dense,densely,eaf,eed,entire,equal,etiole,fine,fleshy,fruiting,geminat,interjected,lateral,leaflet,long,lower,m.,margin,minutely,near,nflorescence,node,orolla,papillose,peduncle,perfect,petiolule,pubescenc,pubescence,rachi,rooting,scattered,simple,slightly,somewhat,spaced,tamen,tem,thick,uniseriate,unit,vary,widely,wiry,yellow,ympodial	age,anthesi,arrangement,bud,capitate,coat,colour,connation,corolla,decurrency,dry,embryo,feature,form,growth,height,inflorescence,leaf,length,midpoint,minor,na,new,number,ovary,papilla,petiole,plant,prickle,ray,reproduction,scar,seed,shape,size,spacing,specimen,stem,texture,tuberculation,type,width,winging,young	.25,0.4-3,0.5-13.5,1-1.2,1-3,1-5,1-6.5,15-60,2-3,2.5-6,3-3.5,3-pinnate,5-15,5-9,abaxially,acute,apart,basally,blue-purple,cm,color,connivent,cordate,cuneate,deltoid,diameter,directed,distally,emarginate,extra-axillary,glabrous,hair,herb,large,lenticular,longitudinal,mm,oblique,oblong,opening,plurifoliate,pubescent,rotate,rounded,short,slender,slit,sparsely,surface,terrestrial,tip,trailing,truncate,unbranched,unknown,weakly,woody,x	age,capitate,na
500	wfo-0001031871	success	185	131	88	102	83	29	84	4	0.4-2,0.6-1.2,1-2,1.4-2.1,1.5-2,1.5-2.1,14-22,2-4,2.9-6,3-10,3.5-4,4-6,5.4-12.3,6-12,6-7,6.5-20.5,7-9,7.5-23,acute,anther,apex,attenuate,axillary,base,blade,brownish,bud,cell,chartaceous,clavate,cm,condition,connivent,corolla,covering,dark,deep,diameter,dot,drying,elliptic,end,flower,forked,fresh,fruit,glabrous,globose,green,green-white,greenish,hair-like,herb,homostylous,lanceolate,lateral,leaflet,lobe,long,make,medium,mm,mottled,mucilaginous,narrowly,odd-pinnate,one,ovate,ovoid,petiole,petiolulate,placed,plant,pore,poricidal,purple,ripe,rotate,rounded,seed,size,stigma,straight,style,subglabrous,subtending,terminal,testal,thick,throughout,tiny,tip,tube,tuber,typically,wall,wet,white,whitish,wide,winged,x	1.5-11,1.6-2.7,2-3,3-4,3-5,33-40,36-44,4-7,5-merou,abaxially,acumen,adaxiall,adaxially,ag,alyx,apart,apparently,articulated,asymmetric,axe,basiscopic,berry,capitat,digestion,distal,dorsally,eaf,edge,eed,enzyme,erec,exceeding,filament,flat,folded,geminat,generally,glabrou,hair,hal,half,high,honeycomb-shaped,interjected,lengthening,linear,living,lower,nflorescence,orbicular,orolla,pair,pedicel,peduncle,perfect,plurifoliate,pubescent,removed,round,ruit,sessile,seudostipule,short,side,slit,sometimes,spaced,specimen,stamen,stolo,subequal,subglabrou,symmetric,tall,tamen,tem,tissue,tri-,unit,usually,vary,yellow,ympodial	5-merous,abaxial,adaxial,arrangement,calyx,capitate,colour,connation,feature,form,growth,height,history,inflorescence,leaf,length,life,na,number,ovary,placement,pseudostipule,reproduction,shape,stem,stolon,surface,texture,type	0.4-2,0.6-1.2,1-2,1.4-2.1,1.5-2,1.5-2.1,14-22,2-4,2.9-6,3-10,3.5-4,4-6,5.4-12.3,6-12,6-7,6.5-20.5,7-9,7.5-23,acute,attenuate,axillary,brownish,bud,cell,chartaceous,clavate,cm,condition,connivent,covering,dark,deep,dot,drying,elliptic,end,forked,fresh,glabrous,globose,green,green-white,greenish,hair-like,herb,homostylous,lanceolate,lateral,long,make,medium,mm,mottled,mucilaginous,narrowly,odd-pinnate,one,ovate,ovoid,petiolulate,placed,poricidal,purple,ripe,rotate,rounded,seed,straight,subglabrous,subtending,terminal,testal,thick,throughout,tiny,tip,typically,wall,wet,white,whitish,wide,winged,x	5-merous,capitate,na,stolon
501	wfo-0001031876	success	140	107	52	66	74	41	48	4	.1,.5,0.5,0.8-1,1-1.5,1-1.6,1.5-2.2,27-35,9-15,acute,anther,anthesi,apex,bark,base,berry,calyx,closely,cm,corolla,cup-like,decurrent,elliptic,erect,filament,flower,glabrous,globose,granular,green,leaf,less,lightly,lobe,lobed,long-acuminate,minutely,mm,nearly,oblanceolate,oblique,opposite,ovary,papillose,pedicel,petiole,pore,poricidal,reflexed,scar,shaped,shrub,simple,slightly,spaced,stem,stigma,style,tapering,tear-drop,tip,tube,white,winged,woody,young	0-flowered,1,1-4,3,5,?,across,apiculate,arc,arising,ba,bearing,beneath,bright,convergence,corky,dia,differing,eaf,edicel,eed,family,free,fruiting,glabrou,greenish-yellow,immature,irregularity,known,lateral,lenticellat,long,lower,main,major,margin,melastomataceae,member,middle,minute,nflorescence,often,otherwise,overlappin,pair,parallel,perpendicular,persistent,point,portion,present,primary,prominent,raised,recurved,resemble,ruit,running,secondary,slender,straight,styl,tall,time,ud,unifoliat,unit,vein,venation,wide,widest,x,yellow,ympodial	0,arrangement,bud,coat,colour,connation,decurrency,dry,embryo,feature,form,fruit,growth,height,history,inflorescence,length,life,midpoint,minor,na,new,number,overlapping,papilla,plant,prickle,ray,reproduction,seed,shape,size,spacing,specimen,surface,texture,tuberculation,type,unifoliate,width,winging	.1,.5,0.5,0.8-1,1-1.5,1-1.6,1.5-2.2,27-35,9-15,acute,anthesi,base,berry,closely,cm,cup-like,decurrent,elliptic,erect,glabrous,globose,granular,green,leaf,less,lightly,lobed,long-acuminate,minutely,mm,nearly,oblanceolate,oblique,opposite,papillose,poricidal,reflexed,shaped,shrub,simple,slightly,spaced,tapering,tear-drop,tip,white,winged,woody	0,na,overlapping,unifoliate
502	wfo-0001031877	success	213	135	78	93	120	42	70	8	0.3-1.2,0.6-1.2,0.8-0.9,1-1.5,1-3,1-4,1.5,2,2.5,3-6,6-8,abruptly,acuminate,acute,anther,anthesi,apex,basally,base,berry,bright,calyx,capitate,clavate,cm,conical,connivent,corolla,ellipsoid,ellipsoidal,filament,flattened,flower,fruit,furcate,glabrous,globose,greenish,growth,hastate,later,lateral,lengthening,lobe,lobed,long-acuminate,loosely,minute,minutely,mm,nearly,new,occasionally,often,pale,pedicel,petiole,pitted,plant,plump,pore,poricidal,pubescent,purple,red,reniform,ripe,scar,scrambler,seed,simple,slender,slightly,slit,somewhat,stellate,stem,stigma,style,surface,terminal,tinged,tip,triangular,trichome,truncate,tube,uniseriate,vine,weak,white,x,young	+,.3,.5,0.2,0.3-1,0.3-1-3.5,0.5,0.5-1,1,1.1-1.8-5,1.5-1.9,1.5-2,2-6-10,3-5,3.5-4,5-merou,abaxially,adaxiall,adaxially,ag,along,alyx,angled,apar,apparently,ark,articulated,ascending,basal,brown,cell,deep,deflexed,deltate,densely,diameter,distal,dried,eaf,eed,enlarged,entire,erect,especially,exposed,exserted,eye,fleshy,free,fruiting,green,ilament,impressed,internal,irregularly,lamina,like,line,linear,long,lower,margin,material,mature,midvein,nflorescence,older,orolla,outline,pair,papillate,papillo,parallel,part,peduncle,per,perfect,pericarp,plurifoliat,pointing,portion,primary,prominently,pubescence,purplish,rectangular,reddish,reflexed,rest,rounded,ruit,semi-woody,shiny,short,shorte,silky,sinuate,sleeve,sometimes,spaced,sparsely,spreadin,strongly,subshru,tem,testal,thin,twinin,ud,uniformly,unit,upper,usually,vary,vein,visible,wall,woody,yello,ympodial	1-3.5,1.1-5,age,apart,arrangement,bark,bud,coat,colour,connation,decurrency,dry,embryo,feature,form,height,history,inflorescence,leaf,length,life,midpoint,minor,na,number,ovary,papilla,papillose,plurifoliate,prickle,ray,reproduction,shape,size,spacing,specimen,texture,tuberculation,type,width,winging,yellow	0.3-1.2,0.6-1.2,0.8-0.9,1-1.5,1-3,1-4,1.5,2,2.5,3-6,6-8,abruptly,acuminate,acute,basally,base,berry,bright,capitate,clavate,cm,conical,connivent,ellipsoid,ellipsoidal,flattened,furcate,glabrous,globose,greenish,hastate,later,lateral,lengthening,lobed,long-acuminate,loosely,minute,minutely,mm,nearly,occasionally,often,pale,pitted,plump,poricidal,pubescent,purple,red,reniform,ripe,scrambler,simple,slender,slightly,slit,somewhat,stellate,terminal,tinged,tip,triangular,trichome,truncate,uniseriate,vine,weak,white,x	1-3.5,1.1-5,age,apart,na,papillose,plurifoliate,yellow
503	wfo-0001031880	success	180	127	86	107	73	20	84	2	.5,0.5-1,0.5-2,0.7-0.8,1,1-1.3,1-1.5,1-2,1.5,2-3,2-9,2.5-8,3-foliate,3-lobed,4,4-8,5-6,6-9,7-9,age,anther,anthesi,apart,berry,broadly,brown,calyx,capitate,cell,cm,conical,corolla,cup-shaped,curved,dark,densely,diameter,ellipsoid,elliptic,enlarged,exerted,filament,flattened,fleshy,flower,fruit,fruiting,glabrous,gland,glandular,globose,green,herb,heteromorphic,hollow,inflorescence,internodal,leaf,lengthening,less,lobe,long,lower,mature,minutely,mm,narrowly,nodding,orange,ovary,ovoid,pale,papillose,pedicel,peduncle,petiole,pitted,pore,poricidal,pubescent,purple,red,reddish,reflexed,scar,shallowly,slightly,slit,spreading,stem,stigma,straight,strongly,style,subshrub,surface,testal,tip,triangular,trichome,tube,upper,upward,wall,x,yellow,â5	2,2-4,3-3.5,3-4-pluri-foliate,5,abaxially,acuminate,acute,adaxially,apex,basal,base,bearing,becoming,c.,ciliate,color,cordate,crenate,crowded,eaf,edicel,eed,entire,erect,flush,free,gland-tipped,growing,horn,irregularly,lamina,lon,longest,margin,markedly,maturit,mid-length,middle,near,nflorescence,ovate,pair,papillo,pericarp,plan,portion,primary,pubescen,rachi,ruit,shortest,simple,single,slender,sometimes,spaced,sparse,sparsely,terminal,thin,toothed,truncate,ud,unicellula,uniseriate,unit,unlobed,vein,widely,widest,woody,ympodial	abaxial,adaxial,arrangement,bud,colour,feature,form,growth,height,length,maturity,number,plant,position,seed,shape,size,spacing,texture,unicellular	.5,0.5-1,0.5-2,0.7-0.8,1,1-1.3,1-1.5,1-2,1.5,2-3,2-9,2.5-8,3-foliate,3-lobed,4,4-8,5-6,6-9,7-9,age,anthesi,apart,berry,broadly,brown,calyx,capitate,cm,conical,cup-shaped,curved,dark,densely,diameter,ellipsoid,elliptic,enlarged,exerted,flattened,fleshy,fruit,glabrous,glandular,globose,green,herb,heteromorphic,hollow,internodal,leaf,lengthening,less,long,mature,minutely,mm,narrowly,nodding,orange,ovoid,pale,papillose,pitted,pore,poricidal,pubescent,purple,red,reddish,reflexed,shallowly,slightly,slit,spreading,straight,strongly,subshrub,tip,triangular,upward,wall,x,yellow,â5	maturity,unicellular
504	wfo-0001031881	success	168	118	60	84	84	34	56	4	.5,0.4-1,0.5-0.7,0.5-1,1-1.3,1-1.5,1-7,1.2-6,1.5-2.5,10-30,2,2-9,3-19,5-6,7-14,acute,anther,anthesi,apex,attenuate,bark,base,broadly,bud,calyx,campanulate,capitate,cm,corolla,deflexed,deltoid,densely,dry,elliptic,erect,filament,fleshy,fruit,glabrous,globose,golden-pubescent,green,inflorescence,leaf,lightly,lobe,lobed,minor,minutely,mm,obovate,opposite,orbicular,ovary,ovoid-reniform,papillose,pedicel,petiole,pitted,planar,pore,poricidal,puberulent,scar,shape,shaped,shrub,size,slightly,small,stem,stigma,style,surface,tapering,tear-drop,tip,tree,tube,white,winged,woody,x,young	0.1-0.5,0.2,0.2-0.6,1/3,10-12,3.5-4,3/4,absent,along,apar,apparent,axil,ba,beneath,branch,branched,brown,constriction,dark,decurrent,dia,differing,difoliate,distal,drying,eaf,edicel,eed,either,ellipsoid,evenly,exserted,free,fruiting,geminat,golden,golden-puberulent,greyish-brow,incrassate,inflorescenc,junction,lateral,like,lon,long,lower,main,major,margin,material,maturity,middle,midrib,minute,nflorescence,occasionally,older,one,pair,papillo,portion,puberulen,pubescent,rest,rounded,ruit,simple,slender,somewhat,soon,spaced,sparsely,straight,strong,tall,trichome,ud,uniseriate,unit,usually,vein,way,widest,ympodial	alternate,apart,arrangement,coat,colour,connation,decurrency,embryo,feature,flower,form,greyish-brown,growth,height,history,length,life,midpoint,na,new,number,papilla,plant,prickle,ray,reproduction,seed,spacing,specimen,texture,tuberculation,type,width,winging	.5,0.4-1,0.5-0.7,0.5-1,1-1.3,1-1.5,1-7,1.2-6,1.5-2.5,10-30,2,2-9,3-19,5-6,7-14,acute,attenuate,broadly,campanulate,capitate,cm,deflexed,deltoid,densely,elliptic,erect,fleshy,glabrous,globose,golden-pubescent,green,leaf,lightly,lobed,minutely,mm,obovate,opposite,orbicular,ovoid-reniform,papillose,pitted,planar,poricidal,puberulent,shaped,shrub,slightly,small,tapering,tear-drop,tree,white,winged,woody,x	alternate,apart,greyish-brown,na
505	wfo-0001031886	success	168	143	104	119	49	24	98	6	-1.2,-9,.5,0.1,0.5-1,1-1.5,1-4,1.2-2.5,1.5-2,2,2-2.5,2-3,2-4,2-5,2.0-2.5,20-30,3-6,3.0,4,4-15-25,5-6,5-ridged,absent,acuminate,anther,anthesi,anticlinal,apex,attenuate,axillary,basal,base,berry,bright,broadly,brown,bud,calyx,capitate,cm,commonly,completely,conical,corolla,deltate,diameter,distinctly,dry,either,elliptic,equal,exserted,filament,fleshy,flower,free,fruit,fruiting,glabrous,green,greenish,half,irregular,lanceolate,lateral,leaflet,lobe,long,lower,margin,minutely,mm,near,node,oblique,occasionally,open-conical,ovary,ovoid-reniform,papillae,papillate,papillose,pedicel,petiole,petiolule,pinnate,poricidal,portion,projection,raised,reddish,ripe,rugose,scar,scattered,seed,shape,shrub,simple,sinuous,smaller,smelling,somewhat,sparse,specimen,stigma,strongly,style,surface,thickening,tip,triangular,trichome,tube,uniseriate,white,wintergreen,without,x	-4,0,10-40,5-10,6-20,6-8,9-10,abaxially,abruptly,adaxially,along,arising,axil,beak,bearing,cell,clavat,eaf,earl,edicel,eed,em,epidermal,erec,le,lobed,narrowed,nearly,nflorescence,noddin,pair,per,primary,purple,rachi,reflexed,ruit,similar,single,terminal,time,tub,ud,unifoliat,unit,usually,vein,woody,ympodial	1,arrangement,clavate,colour,connation,erect,exsertion,feature,form,growth,height,inflorescence,leaf,length,less,nodding,number,plant,size,spacing,stem,texture,type,unifoliate	-1.2,-9,.5,0.1,0.5-1,1-1.5,1-4,1.2-2.5,1.5-2,2,2-2.5,2-3,2-4,2-5,2.0-2.5,20-30,3-6,3.0,4,4-15-25,5-6,5-ridged,absent,acuminate,anticlinal,apex,attenuate,axillary,berry,bright,broadly,brown,calyx,capitate,cm,commonly,completely,conical,deltate,diameter,distinctly,dry,either,elliptic,equal,exserted,filament,fleshy,free,glabrous,green,greenish,half,irregular,lanceolate,lateral,long,lower,margin,minutely,mm,near,node,oblique,occasionally,open-conical,ovoid-reniform,papillae,papillate,papillose,pinnate,poricidal,portion,projection,raised,reddish,ripe,rugose,scattered,shrub,simple,sinuous,smaller,smelling,somewhat,sparse,specimen,strongly,thickening,tip,triangular,trichome,tube,uniseriate,white,wintergreen,without,x	1,clavate,erect,less,nodding,unifoliate
506	wfo-0001031895	success	160	123	66	86	74	37	65	1	-1.5,0.5,0.5-2,1-1.5,1.5-6,2-2.5,2.5-3,3-10,3-4,3-8,4,4-5,4.5-16.5,5,5-8,acute,anther,anthesi,apex,attenuate,bark,base,berry,bluish,broadly,calyx,capitate,cm,completely,corolla,cup-shaped,dark,deltate,diameter,ellipsoid,elliptic,emarginated,erect,exfoliating,filament,fleshy,flower,glabrous,globose,green,growth,irregular,leaf-opposed,less,lobe,lobed,minutely,mm,new,occasionally,once-branched,ovary,ovoid,papillate,part,patch,pedicel,peeling,petiole,pitted,pore,poricidal,reniform,scar,shrub,simple,small,stem,stigma,stout,style,surface,tip,tree,tube,violet,way,white,woody,x,Â¼-1/2	0.5-1,1.5-2,1.5-3,3.5-6,5-6,6-7,6-9,age,apparently,articulating,beneath,blac,campanulate,cell,conical,densely,drying,eaf,eed,enlarging,entire,erec,exerted,expand,fragrant,free,fruiting,glabrou,immature,inflorescenc,intensely,leafy,leaving,lengthening,lower,margin,matte,nflorescence,older,overlapping,pair,pale,papillat,peduncle,peg,perfect,pericarp,planar,plurifoliat,portion,primary,reddish,revolute,ruit,shiny,shoot,short,sinuate,slender,slightly,slit,somewhat,straight,strongly,tan,terminal,testal,thick,thin,tub,ud,unit,vein,ympodial	arrangement,bud,coat,colour,connation,decurrency,dry,embryo,feature,form,fruit,height,history,inflorescence,leaf,length,life,midpoint,minor,na,number,papilla,plant,prickle,ray,reproduction,seed,shape,size,spacing,specimen,texture,tuberculation,type,width,winging,young	-1.5,0.5,0.5-2,1-1.5,1.5-6,2-2.5,2.5-3,3-10,3-4,3-8,4,4-5,4.5-16.5,5,5-8,acute,attenuate,base,berry,bluish,broadly,capitate,cm,completely,cup-shaped,dark,deltate,diameter,ellipsoid,elliptic,emarginated,erect,exfoliating,fleshy,glabrous,globose,green,irregular,leaf-opposed,less,lobed,minutely,mm,occasionally,once-branched,ovoid,papillate,part,patch,peeling,pitted,poricidal,reniform,shrub,simple,small,stout,tip,tree,violet,way,white,woody,x,Â¼-1/2	na
507	wfo-0001031897	success	264	122	73	90	174	32	71	2	.5,0-1,0.1-0.5,0.2-0.4,0.5-1,0.5-3,0.6,0.8-1.5,1-2,1.1,1.3-2,1.5-8,13,2-4,6-9,acute,age,almost,along,anther,anthesi,apex,apically,aristate,attenuate,base,berry,black,brachyblast,branch,calyx,clavate,clearly,clustered,cm,connate,corolla,cuneate,delineated,dilated,distributed,dry,drying,elliptic,epiphyte,evenly,extending,filament,flower,free,fruit,glabrous,lamina,lanceolate,leaf,lengthening,lobe,lobed,long,mauve,mm,obconical,oblong,occasionally,orange-brown,ovate,ovoid,pedicel,petiole,pore,poricidal,ribbed,ridged,scar,shrub,slightly,smooth,sometimes,stem,stigma,style,surface,terminal,tip,tube,unarmed,white,winged,x,young	.1,.8,0.15,0.4-1.1,0Â°,1,1-1.5,1-2.5,1.5,1.7-3,2/3,4-5,462.,5-6,8,abaxial,abaxially,absent,accrescent,adaxial,adaxially,alyx,apar,apparently,appearing,appendage,arising,articulated,axillary,bark,bendy,boiteau,branched,brown,cell,chartaceous,concolorous,condensed,conical,coriaceous,covering,curved,dark,datum,dehiscing,dendritic,dense,densely,developed,developing,development,diameter,divided,domatia,dorsal,dorsifixed,dull,eaf,earliest,ed,enlarged,entire,equal,erect,even,except,eye,faint,filiform,fine,foliaceous,fruiting,green,grey,hair,immature,indistinc,inner,inside,known,larger,lateral,least,light,like,linear,longitudinal,longitudinally,looped,lower,m.,main,margi,margin,membranous,midvein,minute,minutely,multicellular,multiseriate,naked,never,nflorescence,nther,oblon,obtuse,occasional,one,orange,orolla,outside,overlapping,pair,papillose,part,partly,peduncle,pendulous,perfec,pericarp,persisting,plant,plurifoliat,pointed,portion,primary,prominent,pronounced,protruding,pubescent,raised,rarely,reach,reddish,revolute,ridge,ruit,secondary,see,seen,shoot,short,side,simple,sinus,slender,smaller,smoot,sparse,sparsely,stump,subulate,sunk,tearing,terete,tertiary,thick,thin,toward,trichome,ud,unbranched,unicellular,unit,usually,vary,vein,venation,visible,weakly,well-developed,wide,wrinkle,ympodial	arrangement,bud,coat,colour,connation,decurrency,embryo,feature,form,growth,inflorescence,length,midpoint,minor,na,new,number,ovary,papilla,prickle,ray,seed,shape,size,spacing,specimen,texture,true,tuberculation,type,width,winging	.5,0-1,0.1-0.5,0.2-0.4,0.5-1,0.5-3,0.6,0.8-1.5,1-2,1.1,1.3-2,1.5-8,13,2-4,6-9,acute,age,almost,along,apically,aristate,attenuate,base,berry,black,brachyblast,branch,clavate,clearly,clustered,cm,connate,cuneate,delineated,dilated,distributed,dry,drying,elliptic,epiphyte,evenly,extending,free,glabrous,lamina,lanceolate,lengthening,lobed,long,mauve,mm,obconical,oblong,occasionally,orange-brown,ovate,ovoid,petiole,poricidal,ribbed,ridged,shrub,slightly,smooth,sometimes,terminal,tip,white,winged,x,young	na,true
508	wfo-0001032157	success	136	117	63	79	57	38	60	3	.5,0.25,0.5-1,0.6-1,1-3,2-5,2.2,3-6,5-8,9-17,acute,anther,anthesi,apart,apex,bark,base,becoming,beneath,berry,bi-lobed,calyx,cm,completely,corolla,crystalline,deflexed,deltoid,dry,elliptic,filament,glabrous,globose,golden,green,leaf,less,live,lobe,lobed,longitudinal,minor,minutely,mm,nearly,opposite,ovary,ovoid-reniform,paler,papillose,pedicel,peeling,petiole,pitted,plant,pore,poricidal,reddish,rounded,scar,shaped,shiny,shrub,simple,size,slender,stem,stigma,strip,style,surface,tapering,tear-drop,tip,tube,white,woody,x,young	.75,0.75-1,1.9-2.2,2-3,5-15-flowered,5-9,7-9,beginning,caly,decurrent,dia,differing,difoliate,eaf,edicel,eed,evenly,exserted,free,frui,fruiting,geminat,glabrou,incrassate,inflorescenc,lateral,living,lon,long,lower,main,major,margin,middle,nflorescence,obscure,older,one,pair,papillo,persistent,portion,raised,reflexed,ruit,slightly,soon,spaced,straight,tall,translucen,ud,unit,vein,widest,yellowish,ympodial	5-15,abaxial,adaxial,alternate,arrangement,bud,coat,colour,connation,embryo,feature,flower,form,fruit,growth,hair,height,history,inflorescence,length,life,midpoint,na,new,number,papilla,prickle,ray,reproduction,seed,shape,spacing,specimen,texture,tuberculation,type,width,winging	.5,0.25,0.5-1,0.6-1,1-3,2-5,2.2,3-6,5-8,9-17,acute,apart,base,becoming,beneath,berry,bi-lobed,calyx,cm,completely,crystalline,deflexed,deltoid,dry,elliptic,glabrous,globose,golden,green,leaf,less,live,lobed,longitudinal,minutely,mm,nearly,opposite,ovoid-reniform,paler,papillose,peeling,pitted,plant,poricidal,reddish,rounded,shaped,shiny,shrub,simple,slender,strip,tapering,tear-drop,tip,tube,white,woody,x	5-15,alternate,na
509	wfo-0001032161	success	146	133	81	95	51	38	77	4	.5,0.4-1.2,0.5-1,0.7-4,0.75-1,1-1.5,1-11,1-3,1.2-1.3,2-7,2.5-3,3.5-4,?,acute,adaxially,anther,anthesi,apex,area,bark,base,berry,branched,calyx,closely,cm,conical,corolla,dark,deflexed,delicate,deltate,dendritic,densely,drying,ellipsoid,elliptic,filament,filiform,glabrous,globose,golden,green,inflorescence,internodal,later,leaf,like,lobe,lobed,long,merely,minute,minutely,mm,mustard,nearly,obovate,occasionally,opposite,ovary,ovoid-reniform,papillose,pedicel,persistent,petiole,pitted,plant,pore,poricidal,pubescent,quadrate,scar,shaped,shiny,shrub,simple,spaced,sparsely,stem,stigma,style,sulcate,surface,tear-drop,thin,tip,trichome,tube,uniseriate,usually,white,x,yellow,yellowish	0.8-1,1.4-2,2-8-flowered,abaxially,adaxiall,apical,ba,beneath,brownish-blac,color,coriaceous,dia,difoliate,eaf,edicel,eed,exserted,free,fruiting,giving,hanging,lamina,lower,many,margin,middle,nflorescence,older,overlappin,pale,pericarp,plurifoliate,portion,projection,reflexed,rest,revolute,ruit,shoot,short,strongly,styl,tall,tan,tub,ud,unit,vein,widest,ympodial,young	2-8,abaxial,adaxial,arrangement,brownish-black,bud,coat,colour,connation,dry,embryo,feature,flower,form,fruit,growth,height,history,length,life,midpoint,na,number,overlapping,papilla,prickle,ray,reproduction,seed,shape,size,spacing,specimen,texture,tuberculation,type,width,winging	.5,0.4-1.2,0.5-1,0.7-4,0.75-1,1-1.5,1-11,1-3,1.2-1.3,2-7,2.5-3,3.5-4,?,acute,adaxially,area,base,berry,branched,closely,cm,conical,dark,deflexed,delicate,deltate,dendritic,densely,drying,ellipsoid,elliptic,filiform,glabrous,globose,golden,green,internodal,later,leaf,like,lobed,long,merely,minute,minutely,mm,mustard,nearly,obovate,occasionally,opposite,ovoid-reniform,papillose,persistent,pitted,poricidal,pubescent,quadrate,shaped,shiny,shrub,simple,spaced,sparsely,stem,style,sulcate,tear-drop,thin,tip,trichome,uniseriate,usually,white,x,yellow,yellowish	2-8,brownish-black,na,overlapping
510	wfo-0001032165	success	197	115	57	81	116	34	51	6	.25,0.25-0.5,0.3-1,1-1.2,1-1.5,1-2,1.5-4,10-25,2-2.5,3-6,3.5-8.5,4-6,5-15,5-6,5-7,5-9.5,acute,anther,anthesi,apex,bark,base,berry,broadly,bud,calyx,capitate,closely,cm,corolla,cup-shaped,deltoid,densely,dry,elliptic,erect,filament,glabrous,globose,golden-puberulent,golden-pubescent,green,greyish-brown,inflorescence,leaf,lobe,lobed,minor,minutely,mm,obovate,orbicular,ovary,ovoid-reniform,pale,papillose,pedicel,petiole,pitted,plant,pore,rounded,scar,shape,simple,size,spaced,specimen,stem,stigma,style,surface,tear-drop,terminal,tip,tree,tube,white,woody,x,young	.5,0.1,0.1-0.3,0.75-1,2.5-3.5,3-4,5-30-flowered,8-9,abaxial,adaxial,along,apparent,appearing,ba,beginning,beneath,brown,center,continued,cucullate,dark,deciduous,decurrent,denser,dia,differing,difoliate,distal,due,dull,eaf,edged,edicel,eed,ellipsoid,end,entire,even,expansion,exserted,exsertion,free,fruiting,geminat,golden,immature,inflorescenc,later,lateral,less,like,live,lon,long,lower,main,major,margin,markedly,medial,middle,midrib,minute,near,nearly,nflorescence,node,occasionally,older,once-furcate,one,onto,opposite,overlapping,pair,paler,papillo,planar,poricidal,portion,presence,prominent,puberulent,purplish,rather,rest,ridge,ripe,ruit,shaepd,single,slender,slightly,slow,small,smoot,stout,straight,stripe,strongly,swollen,tall,tapering,thickened,time,tinged,trichome,tub,ud,uniseriate,unit,vein,widest,winged,yellowish,ympodial	5-30,alternate,arrangement,coat,colour,connation,decurrency,feature,flower,form,fruit,growth,height,history,length,life,midpoint,na,new,number,papilla,perennial,prickle,ray,reproduction,seed,shaped,smooth,spacing,texture,tuberculation,type,width,winging	.25,0.25-0.5,0.3-1,1-1.2,1-1.5,1-2,1.5-4,10-25,2-2.5,3-6,3.5-8.5,4-6,5-15,5-6,5-7,5-9.5,acute,berry,broadly,capitate,closely,cm,cup-shaped,deltoid,densely,elliptic,erect,glabrous,globose,golden-puberulent,golden-pubescent,green,greyish-brown,lobed,minutely,mm,obovate,orbicular,ovoid-reniform,pale,papillose,pitted,rounded,simple,spaced,tear-drop,terminal,tree,white,woody,x	5-30,alternate,na,perennial,shaped,smooth
511	wfo-0001032167	success	163	115	79	85	78	30	74	5	.5,0.5-1,0.5-2.5,0.75-3,1,1-2,1-5,1-7,1.5,10-20,10-35,12-20,2-4,2-7,2-foliate,3-6,4-10,5-15,7-10,abundant,acute,anther,apex,base,berry,brown,calyx,cell,cm,cordate,decurrent,densely,diameter,dm,drying,elliptic,elliptic-ovoid,filament,flower,forming,fruit,geniculate,glabrous,globose,growth,hair,herb,immature,interpetalar,lobe,long,maturing,mm,moderately,netlike,oblong,obtuse,often,one-celled,pedicel,per,petiole,projection,pubescent,purple,raised,rotate,rounded,seed,semitransparent,sparsely,stigma,straight,style,surface,tissue,triangular,tube,two-celled,unit,usually,wall,white,x,yellow	0.5-1.5,1-2-celled,1-2.5,1-3,3-7,4-6,abaxially,absent,adaxiall,adaxially,along,appressed,axe,blade,chartaceous,ciliate,closely,common,connected,curved,dehiscing,dense,denser,eaf,eed,emarginat,entire,explosively,few-,flat,flattened,frui,geminat,growt,held,larger,linear-lanceolate,longer,lower,lowermost,lying,many-branched,margin,maturit,membranaceous,mesocarp,near,nearly,new,nfloresence,notch,older,orolla,peduncle,placenta,pressure,pubescen,rachi,ruit,shorter,slightly,small,smaller,sometimes,staman,stamen,tal,tamen,tem,twisted,unbranched,upper,vary,vein,watery,wid,woody,ympodial	abaxial,adaxial,arrangement,colour,connation,corolla,emarginate,feature,form,geminate,height,inflorescence,leaf,length,na,number,ovary,papilla,plant,pore,shape,size,stem,sympodial,texture,tip,type,wide,width,young	.5,0.5-1,0.5-2.5,0.75-3,1,1-2,1-5,1-7,1.5,10-20,10-35,12-20,2-4,2-7,2-foliate,3-6,4-10,5-15,7-10,abundant,acute,apex,base,berry,brown,cell,cm,cordate,decurrent,densely,diameter,dm,drying,elliptic,elliptic-ovoid,flower,forming,fruit,geniculate,glabrous,globose,hair,herb,immature,interpetalar,long,maturing,mm,moderately,netlike,oblong,obtuse,often,one-celled,per,petiole,projection,pubescent,purple,raised,rotate,rounded,semitransparent,sparsely,straight,tissue,triangular,two-celled,unit,usually,wall,white,x,yellow	emarginate,geminate,na,sympodial,wide
512	wfo-0001032176	success	177	133	87	105	72	28	83	4	.5,0.5-0.7,0.5-1,0.8-1,0.8-6,1-1.2,1-10,1.5-1.6,1.5-2.5,1/2,100,3-3.5,3-4,3-7,5-6-celled,6,6-10,7,anther,apex,attenuate,axillary,base,beak,becoming,berry,branched,calyx,cm,conical,copiously,corolla,cucullate,densely,diameter,drying,ellipsoid,elliptic,exserted,filament,filiform,flower,fruiting,glabrous,globose,green,greenish,grey-brown,greyish,herb,leaf,leaflet,lengthening,lobe,lobed,long-papillose,lower,minute,minutely,mm,nearly,nodding,node,obtuse,occasionally,onto,ovary,ovoid-reniform,pair,pale,papillose,pedicel,petiole,pinnate,pore,poricidal,projection,pubescent,rachi,reflexed,rooting,rounded,seed,simple,sinuous,size,slightly,slit,somewhat,soon,sparsely,stem,stigma,strait,strongly,style,thickening,tip,trichome,tube,uniseriate,white,winged,without,x	0,0.42,0.5,0.5-0.75,1.5-6,2-3,2.5-10,3-15,adaxially,adhering,along,anthesi,apart,apical,arising,attaining,axil,basal,capitat,cateniform,cell,containing,creeping,denser,eaf,edicel,eed,epidermal,equal,especially,fallen,free,hangin,inflorescenc,lateral,lengt,like,log,long,margin,nflorescence,obovate,often,open,per,petiolule,portion,quadrate,rest,ruit,scar,separate,single,smaller,spaced,tem,terminal,tightly,time,tree,truncate,trunk,tub,ud,ultimate,unevenly,unifoliat,unit,vein,wall,whit,ympodial	arrangement,branching,bud,capitate,cateniforme,coat,colour,exsertion,feature,form,fruit,growth,height,history,inflorescence,length,life,na,number,plant,reproduction,shape,surface,texture,tuberculation,type,unifoliate,winging	.5,0.5-0.7,0.5-1,0.8-1,0.8-6,1-1.2,1-10,1.5-1.6,1.5-2.5,1/2,100,3-3.5,3-4,3-7,5-6-celled,6,6-10,7,attenuate,axillary,base,becoming,berry,branched,calyx,cm,conical,copiously,cucullate,densely,ellipsoid,elliptic,exserted,filiform,glabrous,globose,green,greenish,grey-brown,greyish,herb,lengthening,lobed,long-papillose,lower,minute,minutely,mm,nearly,nodding,node,obtuse,occasionally,onto,ovoid-reniform,pair,pale,papillose,pinnate,poricidal,projection,pubescent,rachi,reflexed,rooting,rounded,simple,sinuous,slightly,slit,somewhat,soon,sparsely,strait,strongly,thickening,tip,tube,uniseriate,white,winged,without,x	capitate,cateniforme,na,unifoliate
513	wfo-0001032187	success	132	119	60	70	62	49	57	3	0.1â1.4,0.5,0.5â1,0.6â1.3,1.3â1.8,1.6â2.1,1.8â2.8,2â9-11,3.1â3.5-4.2,3â4-5,5â7-9,acuminate,acute,angular,anther,apex,appressed,base,berry,broadly,brown,changing,cm,corolla,cyme,dark,dull,eglandular,elliptic,filament,forked,glabrescent,globose,green,hair,herb,leaf,light,lobe,long,marked,mature,mm,obovate,occasionally,ovate,pedicel,pentagonal,petiole,plant,purple,rarely,ridge,simple,small,sparse,stage,stellate,stem,style,sub-glabrous,texture,tinged,tooth,triangular,truncate,well,yellowish,Â±,Ã	0.5-1.1â3.2,1.8â2,100,1â1.7-2.1,22,24.6â26.3,3â3.2-4,5-merous,7â11,9,adherent,alyx,ape,aromatic,blade,branch,brownish,consisting,di-foliate,dia,eaf,eed,entire,equal,erect,flowered,fully,geminat,granule,hite,hooked,hydrated,lower,many,margin,nflorescence,numerous,peduncle,penden,per,perfec,persistent,petiolate,pollen,predominantly,presen,protruding,ruit,running,sclerotic,short,soft,sometimes,spreading,straight,unit,widest,wing,yellow,ympodial,Â±1,Âµm	anthesi,arrangement,bark,bud,calyx,coat,colour,connation,decurrency,dry,embryo,feature,flower,form,fruit,growth,height,history,inflorescence,length,life,midpoint,minor,na,new,number,ovary,papilla,pendent,pore,prickle,ray,reproduction,scar,seed,shape,size,spacing,specimen,stigma,surface,tip,tube,tuberculation,type,white,width,winging,young	0.1â1.4,0.5,0.5â1,0.6â1.3,1.3â1.8,1.6â2.1,1.8â2.8,2â9-11,3.1â3.5-4.2,3â4-5,5â7-9,acuminate,acute,angular,appressed,berry,broadly,brown,changing,cm,cyme,dark,dull,eglandular,elliptic,forked,glabrescent,globose,green,hair,herb,light,long,marked,mature,mm,obovate,occasionally,ovate,pentagonal,purple,rarely,ridge,simple,small,sparse,stage,stellate,sub-glabrous,tinged,tooth,triangular,truncate,well,yellowish,Â±,Ã	na,pendent,white
514	wfo-0001032206	success	213	115	77	86	127	29	70	7	0.8â1.2,1.1â1.2,1/4â1/2,11â22,1â2.3,1â3,2.7â3.5,2â2.5,3.5â9,5â15,5â8,5â9,6â15-20,8â20,acute,anther,apex,apparently,bark,base,berry,broad-deltate,calyx,cm,connivent,cream,cuneate,dark,deltate,erect,filament,flattened-reniform,flower,foliaceous,fruit,glabrescent,glabrous,green,green-brown,lateral,leaf,length,lobe,lobed,long,long-styled,marking,maturity,mauve,midvein,mm,moderately,obtuse,orange-brown,ovate,pale,pedicel,pendent,petiole,plant,poricidal,porrect,purple,sessile,short-styled,shrub,sometimes,spherical,stalked,stellate,stellate-pubescent,stem,style,surface,tapering,tip,toward,trichome,truncate,tube,variously,white,wide,yellow,yellow-orange,young	..,.2,.5,0,0-5,0.2,0.2â0.4,0.2â0.5-0.8,0.5â1,00â200,0â20,0â30,0â5,1-2,1.2â2.2,1.5â2,1.5â2.5,1/3,1/4â1/3,1/6,10â80,1â2,1â4,2.5â3.3,2â3,2â8,30â80,3â4,4.5â5.8,4â6,5-merous,5â20,5â6,6â10,6â8,7â10,abaxially,accrescent,adaxially,alyx,andromonoecious,apar,apart,apically,approximately,armed,articulated,blade,bluntly,branched,brow,chartaceous,clearly,concolorous,covering,curved,diameter,discolorous,distal,distance,drying,eaf,eed,elliptic,equal,extending,flattened,free,fruiting,functionally,gently,hermaphroditic,heterostylous,infructescence,lengt,lobing,longer,lowermost,mal,margin,mature,midpoint,nflorescence,often,older,one,open,orolla,ower,pair,peduncle,pendulous,per,pericarp,plurifoliat,portion,prickle,primary,rarely,ray,reflexed,scar,secondary,side,slender,smooth,spaced,sparsely,spreading,stalk,stout,straight,tamen,tertiary,time,uit,unarmed,ung,unit,usually,vary,vein,venation,visible,weakly,woody,ympodial	/,0.5,0.5â1.5,10,abaxial,adaxial,arrangement,brown,colour,connation,corolla,feature,form,growth,height,inflorescence,na,number,ovary,papilla,plurifoliate,pore,seed,shape,size,stigma,texture,type,width	0.8â1.2,1.1â1.2,1/4â1/2,11â22,1â2.3,1â3,2.7â3.5,2â2.5,3.5â9,5â15,5â8,5â9,6â15-20,8â20,acute,apex,apparently,berry,broad-deltate,cm,connivent,cream,cuneate,dark,deltate,erect,flattened-reniform,foliaceous,glabrescent,glabrous,green,green-brown,lateral,length,lobed,long,long-styled,marking,maturity,mauve,midvein,mm,moderately,obtuse,orange-brown,ovate,pale,pendent,poricidal,porrect,purple,sessile,short-styled,shrub,sometimes,spherical,stalked,stellate,stellate-pubescent,tapering,tip,toward,trichome,truncate,variously,white,wide,yellow,yellow-orange,young	/,0.5,0.5â1.5,10,brown,na,plurifoliate
515	wfo-0001032209	success	252	137	84	102	150	35	80	4	0.5-1,1-1.5,1-2-celled,1-6,1.5-2.5,10-13,100,2,2-3-lobed,2-5,2.5-6-15-20,3-7,4-20-30+,acute,anther,anthesi,apart,apex,appearing,base,berry,bilobed,blue,broadly,calyx,capitate,cell,cm,colour,conical,connivent,cordate,corolla,deeply,dendritic,densely,diameter,ellipsoid,elliptic,filament,finely,flattened-reniform,flower,glabrous,globose,growth,hairy,inflorescence,lateral,leaf,length,lengthening,lobe,lobed,metallic,minute,minutely,mm,narrowly,nearly,new,occasionally,ovate,papillate,pedicel,petiole,pinnately,planar,pore,poricidal,puberulent,pubescent,purple,red,ripe,scar,simple,slit,sometimes,somewhat,spreading,stellate,stem,stigma,stout,style,surface,tapering,terminal,testa,tightly,tiny,tip,trichome,truncate,tube,vine,violet,wall,white,woody,x	.5,0.3,0.5,1,1-2,1.5,1.5-2,1.5-3-9-11,1.5-6,12-16,2-3,2/3,20-30,4,5-8,5-merou,6-8,absent,adaxial,ag,along,alyx,apiculae,apparently,arching,ark,articulated,axi,basal,berr,branch,branched,brown,bu,canopy,cast,chartaceous,climbing,conspicuously,coriaceous,cucullat,dark,deltate,denser,distally,distinct,dried,eaf,early,ecuador,eed,enlarged,entire,equal,erect,especially,evenly,exerted,fleshy,flowering,free,fruiting,geminat,giving,glabrescen,groove,hanging,hastate,held,hollow,ilament,keeled,lamina,large,leathery,leaving,less,like,long,longer,longest,lower,margin,markedly,material,mean,mere,middle,midrib,midvein,mixture,near,nflorescence,nipple,often,older,one,orolla,pair,papillae,papillat,part,particularly,peduncle,peg,pentagonal,per,perfect,pericarp,pinnatifid,plurifoliate,pointed,portion,primary,probably,pubescence,reddish,rest,rhachi,rim,ruit,sagittate,several,shiny,sleeve,small,spaced,sparser,tem,testal,thin,third,time,twinin,twining,ud,unequal,uniseriate,unit,upper,usually,variable,vary,vein,w,weight,widest,within,yellow,ympodial	-11,1.5-9,age,arrangement,bud,coat,connation,decurrency,dry,embryo,feature,form,fruit,history,life,midpoint,minor,na,number,ovary,papilla,prickle,ray,reproduction,seed,shape,size,spacing,specimen,texture,tuberculation,type,width,winging,young	0.5-1,1-1.5,1-2-celled,1-6,1.5-2.5,10-13,100,2,2-3-lobed,2-5,2.5-6-15-20,3-7,4-20-30+,acute,anthesi,apart,appearing,base,berry,bilobed,blue,broadly,capitate,cell,cm,conical,connivent,cordate,deeply,dendritic,densely,diameter,ellipsoid,elliptic,finely,flattened-reniform,glabrous,globose,hairy,lateral,lengthening,lobed,metallic,minute,minutely,mm,narrowly,nearly,occasionally,ovate,papillate,pinnately,planar,poricidal,puberulent,pubescent,purple,red,ripe,simple,slit,sometimes,somewhat,spreading,stellate,stout,tapering,terminal,testa,tightly,tiny,tip,trichome,truncate,vine,violet,wall,white,woody,x	-11,1.5-9,age,na
516	wfo-0001032232	success	137	115	60	74	63	41	56	4	.5,0.1,0.6-3,0.8-1,1-3,18.8-27.5,2,2-2.6,3/4,4.8-7.3,5-6,anther,anthesi,apex,attenuate,base,berry,calyx,clavate,closely,cm,corolla,cup-shaped,dark-papillose,decurrent,distally,elliptic,evenly,filament,filiform,flower,glabrous,globose,green,irregular,leaf,less,lightly,lobe,lobed,long,long-acuminate,minutely,mm,narrowly,opposite,ovary,ovoid-reniform,packed,pale,papillose,pedicel,petiole,pitted,pore,poricidal,rounded,scar,shaped,shrub,simple,sparsely,stem,stigma,style,subshrub,surface,tear-drop,tip,tube,way,wide,winged,woody	0.25,0.5,0.5-1,1.8-2,20-100-flowered,?,abruptly,age,ba,bark,becoming,deflexed,dia,eaf,edicel,eed,erect,erose,exfoliatin,free,fruiting,greenish-brown,immature,lateral,lenticellate,light,lower,main,margin,middle,midrib,minute,nflorescence,node,occasionally,onto,overlappin,pair,paler,papillo,portion,prominent,raised,reflexed,revolute,ruit,short-styled,slightly,somewhat,straight,tall,ti,translucent,tub,ud,umbonate,undulate,unifoliat,unit,vein,widening,widest,ympodial	20-100,arrangement,bud,coat,colour,connation,decurrency,dry,embryo,feature,form,fruit,growth,height,history,inflorescence,length,life,midpoint,minor,na,new,number,overlapping,papilla,plant,prickle,ray,reproduction,seed,shape,size,spacing,specimen,texture,tuberculation,type,unifoliate,width,winging,young	.5,0.1,0.6-3,0.8-1,1-3,18.8-27.5,2,2-2.6,3/4,4.8-7.3,5-6,attenuate,base,berry,clavate,closely,cm,cup-shaped,dark-papillose,decurrent,distally,elliptic,evenly,filiform,glabrous,globose,green,irregular,leaf,less,lightly,lobed,long,long-acuminate,minutely,mm,narrowly,opposite,ovoid-reniform,packed,pale,papillose,pitted,poricidal,rounded,shaped,shrub,simple,sparsely,subshrub,tear-drop,tip,way,wide,winged,woody	20-100,na,overlapping,unifoliate
517	wfo-0001032233	success	160	130	86	95	65	35	81	5	0.3-2,1-1.5,1-2,10-15,2-15,2-3,2-4,2-5.5,2-6,20-100+,25-40,3-15,3-4,3-4.5,3-5,3.5-4,4-18,4-5,5-16,5-6,6-25,8-12,acuminate,acute,adaxial,adaxially,almost,apex,basal,base,branched,calyx,chartaceous,cm,connective,connivent,convex,cordate,coriaceous,cylindrical,dark,densely,diameter,dilated,directed,distally,ellipsoidal,entire,flattened,fleshy,flower,fruit,glabrate,glabrescent,glabrous,globose,green,laterally,lobe,longitudinal,margin,mm,moderately,narrowly,oblong,obtuse,orange,ovoid,pedicel,peduncle,petiole,pore,puberulent,pubescent,purple,shallowly,simple,somewhat,sparsely,stellate,stigma,stripe,style,subcoriaceous,subpeltiform,tip,tree,triangular,truncate,tube,unbranched,white,x,yellow,yellow-green	0-2,1-3,1.5-2.5,157,2.5-4,4-7,4-foliat,abaxially,absen,absent,aggregate,apart,ape,articulated,axe,bent,beyond,biglandula,blade,brow,cell,eaf,eed,equal,especially,exceeding,exserted,fleischmann,glandular-puberulent,leaving,lon,long,lower,nflorescence,nther,orolla,ovate,pedicellar,perfect,present,projection,puberulen,rachise,radiu,remnant,ruit,shorter,slightly,small,spaced,stamen,stone,tal,tem,thecae,time,tomento,toward,ud,unit,vary,vein,wide,yellow-orange,ympodial	abaxial,alternate,anther,arrangement,biglandular,bud,colour,corolla,direction,feature,form,greyish,growth,hair,height,hermaphroditic,history,inflorescence,leaf,length,life,number,ovary,perennial,plant,rachi,reproduction,seed,shape,size,spacing,stem,surface,texture,width	0.3-2,1-1.5,1-2,10-15,2-15,2-3,2-4,2-5.5,2-6,20-100+,25-40,3-15,3-4,3-4.5,3-5,3.5-4,4-18,4-5,5-16,5-6,6-25,8-12,acuminate,acute,adaxially,almost,apex,basal,base,branched,chartaceous,cm,connivent,convex,cordate,coriaceous,cylindrical,dark,densely,diameter,dilated,directed,distally,ellipsoidal,entire,flattened,fleshy,glabrate,glabrescent,glabrous,globose,green,laterally,lobe,longitudinal,mm,moderately,narrowly,oblong,obtuse,orange,ovoid,puberulent,pubescent,purple,shallowly,simple,somewhat,sparsely,stellate,stripe,subcoriaceous,subpeltiform,tree,triangular,truncate,unbranched,white,x,yellow,yellow-green	alternate,biglandular,greyish,hermaphroditic,perennial
518	wfo-0001032259	success	201	115	57	74	127	41	52	5	0.1-0.3,0.45-0.6,0.5-0.8,0.7-1.1,1-2.5,1.5-4.5,2-4,2.2-3,20-60,5.5-8,7-16,9-22,acute,almost,anther,apex,bark,base,berry,branched,brown,calyx,cm,connivent,cordate,cuneate,dark,deltate,densely,dull,evenly,filament,flattened-reniform,flower,fruit,glabrescent,glabrous,green,lateral,leaf,length,lobe,maturity,mauve,midpoint,mm,orange,orange-brown,ovate,pedicel,petiole,poricidal,prickle,prickly,ray,recurved,red,scar,shrub,simple,spherical,stellate,stellate-pubescent,stem,style,surface,tapering,terminal,tip,tube,white,woody,yellow,young	-4,.5,/3,/4,0-10,0-2,0-20,0-4,0-5,0.1-0.2,0.15-0.3,0.5-1.5,0.8-1.3,0.9-1.2,1-1.8,1-2,1/2,1/3,1/4-1/3,1/6-1/5,10-30,15-40,2-2.5,2-5,3-4,3/,4,4-5,4-6,4-9,5,5-30,5-merous,7-8,abaxial,abaxially,acut,adaxial,alyx,apar,apart,apically,apparently,articulated,becoming,blade,broad-deltate,brownish,chartaceous,conical,diameter,difoliate,discolorous,distance,drying,eaf,eed,elongating,equal,erect,extending,flattened,free,fruiting,fully,geminate,gland,green-brow,hair,infructescence,lobed,long,longer,lower,margin,mature,midvein,minute,moderately,nflorescence,older,one,open,opening,orolla,oung,pair,peduncle,pendulous,per,perfec,pericarp,porrect,portion,prickl,primary,pubescent,reduced,rounded,ruit,sessile,shorter,side,slender,smooth,sometimes,spaced,sparsely,spreading,straight,strongly,tamen,terete,tertiary,time,toward,trichome,unarmed,unit,vary,vein,venation,visible,way,wide,yellow-green,ympodial	0.5,1,2,anthesi,arrangement,bud,coat,colour,connation,corolla,decurrency,dry,embryo,feature,form,green-brown,growth,height,history,inflorescence,life,minor,na,new,number,ovary,papilla,plant,pore,reproduction,seed,shape,size,spacing,specimen,stigma,texture,tuberculation,type,width,winging	0.1-0.3,0.45-0.6,0.5-0.8,0.7-1.1,1-2.5,1.5-4.5,2-4,2.2-3,20-60,5.5-8,7-16,9-22,acute,almost,berry,branched,brown,cm,connivent,cordate,cuneate,dark,deltate,densely,dull,evenly,flattened-reniform,glabrescent,glabrous,green,lateral,maturity,mauve,mm,orange,orange-brown,ovate,poricidal,prickly,recurved,red,shrub,simple,spherical,stellate,stellate-pubescent,tapering,terminal,white,woody,yellow,young	0.5,1,2,green-brown,na
519	wfo-0001032260	success	210	127	70	87	123	40	67	3	/5,0.2-0.5,0.5-2,0.5-5,0.6-0.8-1.5,0.7-1.5,0.8-1.1,1-1.7,1-3,1-5,1.5-4,2,2-5,2.5-3.5,3-10,3-5,3-8,acuminate,acute,anther,apart,apex,apically,articulated,bark,base,berry,calyx,cell,cm,connivent,cuneate,curved,deltate,densely,elliptic,erect,filament,flattened,flattened-reniform,flower,fruit,glabrescent,glabrous,green-brown,lateral,leaf,length,lobe,lobed,maturity,mauve,midpoint,mm,moderately,narrow-ovate,outline,ovate,pale,pedicel,petiole,pit,poricidal,prickle,prickly,purple,raised,ray,red,rounded,scandent,scar,shrub,simple,small,spherical,stellate,stellate-pubescent,stem,style,surface,tapering,terminal,tip,tube,way,yellow	-10,-3,-8,.1,0-0.5,0-10,0-10-30,0-20,0-5,0-5-20,0-8,0.1,0.1-0.3,0.1-0.4,0.15-0.3,0.4,0.5-0.8,0.7,1-6,1.2-1.7,1/2,1/3,1/3-1/2,1/3-1/5,2-20,2-4,2.5,2.5-3,3-9,4-5-merous,5-6-8,6-10,7-15,abaxial,abaxially,acuminat,adaxial,alyx,apar,apparently,blade,branched,broad-deltate,chartaceous,diameter,difoliate,discolorous,distance,drying,dull,eaf,eed,elongating,equal,extending,eye,free,fruiting,geminat,glabrou,gland,glaucous,globular,gray-brow,infructescence,lon,long,long-styled,longer,lower,margin,mature,midvein,naked,nflorescence,older,one,open,orange-brown,orolla,oung,pair,peduncle,pendulous,per,perfec,pericarp,porrect,portion,prickl,primary,pubescent,reduced,reflexed,ruit,sessile,shallowly,shorter,side,slender,smooth,spaced,sparsely,spreading,stalk,stalked,strongly,subentire,tamen,terete,tertiary,time,trichome,unit,variously,vary,vein,venation,visible,wide,woody,yellow-green,ympodial	1,anthesi,arrangement,bud,coat,colour,connation,corolla,decurrency,dry,embryo,feature,form,gray-brown,growth,height,history,inflorescence,life,minor,na,new,number,ovary,papilla,plant,pore,reproduction,seed,shape,size,spacing,specimen,stigma,texture,tuberculation,type,width,winging,young	/5,0.2-0.5,0.5-2,0.5-5,0.6-0.8-1.5,0.7-1.5,0.8-1.1,1-1.7,1-3,1-5,1.5-4,2,2-5,2.5-3.5,3-10,3-5,3-8,acuminate,acute,apart,apically,articulated,base,berry,cell,cm,connivent,cuneate,curved,deltate,densely,elliptic,erect,flattened,flattened-reniform,glabrescent,glabrous,green-brown,lateral,lobed,maturity,mauve,mm,moderately,narrow-ovate,outline,ovate,pale,pit,poricidal,prickly,purple,raised,red,rounded,scandent,shrub,simple,small,spherical,stellate,stellate-pubescent,tapering,terminal,tip,way,yellow	1,gray-brown,na
520	wfo-0001032264	success	183	123	70	87	96	36	64	6	.5,0.25-0.75,0.5-1,0.6-2.2,0.8-10,0.8-4,1.2-2,2-6,3,3-15,3-9,5-9,6-17,acuminate,acute,anther,anthesi,apex,apiculate,bark,base,berry,branched,broadly,bud,calyx,cm,corolla,cup-like,deflexed,dry,elliptic,filament,flattened-reniform,flower,glabrous,globose,green,inflorescence,leaf,lobe,lobed,long,minor,minutely,mm,narrowly,nearly,occasionally,opposite,ovary,ovoid,papillose,pedicel,petiole,pitted,plant,pore,poricidal,pubescent,rounded-deltoid,scar,several,shaped,short,shrub,simple,size,slender,small-capitate,stem,stigma,style,surface,tapering,tear-drop,time,tip,tree,trichome,tube,uniseriate,white,woody,x,yellowish-brown,young	.2,0.25-0.5,1-1.5,1.5-1.8,1.8-3,10-22,2-50-flowered,4.5-5,along,apar,appearing,ba,bullate,cell,cell-layer,closely,curling,deciduous,densely,dia,differing,difoliate,eaf,edicel,eed,epidermal,exserted,fleshy,free,fruiting,geminat,gnarled,greyi,habitat,hair,incrassate,lamina,large,larger,lateral,layer,like,live,lon,lower,main,major,margin,material,middle,minute,multiseriate,nflorescence,often,older,one,overlapping,pair,pale,papillo,parallel,peeling,planar,pointed,portion,primarily,prominent,quite,raised,red-papillose,reddish,reddish-tan,revolute,ruit,scattered,sheet,sheltered,small-celled,somewhat,soon,spaced,sparsely,straight,tall,thick,transversely,trunk,ud,unit,upper,vein,weak,whitish,wide,widest,ympodial	2-50,alternate,apart,arrangement,coat,colour,connation,decurrency,embryo,feature,form,fruit,greyish,growth,height,history,length,life,midpoint,na,new,number,papilla,perennial,prickle,ray,reproduction,seed,shape,spacing,specimen,texture,tuberculation,type,width,winging	.5,0.25-0.75,0.5-1,0.6-2.2,0.8-10,0.8-4,1.2-2,2-6,3,3-15,3-9,5-9,6-17,acuminate,acute,apiculate,base,berry,branched,broadly,calyx,cm,cup-like,deflexed,elliptic,flattened-reniform,glabrous,globose,green,leaf,lobed,long,minutely,mm,narrowly,nearly,occasionally,opposite,ovoid,papillose,pitted,poricidal,pubescent,rounded-deltoid,several,shaped,short,shrub,simple,slender,small-capitate,style,tapering,tear-drop,time,tip,tree,trichome,tube,uniseriate,white,woody,x,yellowish-brown	2-50,alternate,apart,greyish,na,perennial
521	wfo-0001032274	success	192	126	81	98	94	28	77	4	.5,0.5-0.7,0.5-1,1-1.2,1-1.5,1-3,1.5-2,2,3-10,3-6,3/4,5-7,acuminate,acute,anther,anthesi,apex,appearance,axillary,base,berry,calyx,capitate,clustered,cm,conical,corolla,densely,diameter,ellipsoid,elliptic,entire,filament,filiform,flattened-reniform,flower,fruiting,glabrous,globose,group,growth,inflorescence,lanceolate,leaf,lengthening,lobed,margin,markedly,minute,minutely,mm,new,nodding,occasionally,often,once-branched,pale,pedicel,peg,petiole,pitted,platform,plurifoliate,pore,poricidal,pubescent,purple,red,ridged,ripe,rounded,scar,shape,shiny,shoot,short,shrub,simple,size,slit,small,sometimes,stellate,stem,stigma,strongly,style,suckering,surface,terminal,tinged,tip,truncate,tube,violet,way,white,x	0,0.15-0.2,0.5,0.5-1.5,0.7-1.8,0.9-1,2-3.5,2-7,3-4,3-5,5-merou,<,ag,alyx,apiculate,apparently,arching,ark,articulated,ba,basal,borne,branch,brown,cell,connivent,deltate,dendritic,distal,eaf,eed,exserted,fleshy,free,geminat,glabrou,green,grey,highly,ilament,irregular,lax,less,like,lobe,long,loosely,lower,membranous,nflorescence,non-reproductive,obtusely,older,one,orolla,pair,papillo,peduncle,pendan,per,perfect,pericarp,platfor,portion,primary,puberulent,quadrate,reddish,reflexed,reproductive,ridge,ruit,sleeve,somewhat,sparsely,square,tem,testal,thin,trichome,twinin,two,ud,uniseriate,unit,upper,usually,variable,vary,vein,visible,woody,yellow,ympodial	age,arrangement,bud,coat,colour,feature,form,fruit,height,history,length,life,number,ovary,papilla,papillose,perennial,plant,reproduction,seed,spacing,texture,tuberculation,twining,type,width,winging,young	.5,0.5-0.7,0.5-1,1-1.2,1-1.5,1-3,1.5-2,2,3-10,3-6,3/4,5-7,acuminate,acute,anthesi,apex,appearance,axillary,base,berry,capitate,clustered,cm,conical,densely,diameter,ellipsoid,elliptic,entire,filiform,flattened-reniform,glabrous,globose,group,inflorescence,lanceolate,lengthening,lobed,markedly,minute,minutely,mm,nodding,occasionally,often,once-branched,pale,peg,pitted,platform,plurifoliate,poricidal,pubescent,purple,red,ridged,ripe,rounded,shiny,shoot,short,shrub,simple,slit,small,sometimes,stellate,strongly,suckering,terminal,tinged,tip,truncate,violet,way,white,x	age,papillose,perennial,twining
522	wfo-0001032276	success	152	125	71	82	70	43	63	8	-,0.25-1.5,0.3-1,0.5-1,1-1.5,1-2,2-2.5,2.5-4,3-3.5,5-7,9-18,acute,anther,anthesi,apart,apex,attenuate,bark,base,broadly,calyx,cm,corolla,cup-shaped,curly-tipped,decurrent,deltoid,dry,ellipsoid,elliptic,filament,filiform,glabrous,globose,green,later,leaf,lobe,lobed,long,long-pubescent,minute,minutely,mm,narrowly,nearly,obovoid,onto,opposite,ovary,ovoid-reniform,pedicel,petiole,pitted,plant,pore,poricidal,pubescent,scar,shaped,short,shrub,simple,somewhat,sparsely,stem,stigma,straw-colored,style,surface,tear-drop,tip,triangular,trichome,tube,unifoliate,uniseriate,white,winged,woody,x,young	.25,.5,0.5-0.75,0.8-1,1,1.8-2,3-6-flowered,7-8,along,ba,beneath,blade,brown,capitat,converging,dark,deflexed,densely,dia,eaf,edicel,eed,evenly,except,exserted,free,fruiting,geminate,greyish-gree,lamina,lateral,like,lower,main,margin,material,middle,nflorescence,node,non-reproductive,occasionally,older,pair,pale,papillose,perhaps,portion,prominent,raise,raised,reflexed,remaining,rest,ruit,slender,slightly,soon,spaced,straight,strongly,tall,tapering,tub,ud,unit,vein,widely,widest,yellow,ympodial	0.25,0.5,3,3-6,8,arrangement,bud,capitate,coat,colour,connation,decurrency,embryo,feature,flower,form,fruit,greyish-green,growth,height,history,inflorescence,length,life,midpoint,minor,na,new,number,papilla,prickle,ray,reproduction,seed,shape,size,spacing,specimen,texture,tuberculation,type,width,winging	-,0.25-1.5,0.3-1,0.5-1,1-1.5,1-2,2-2.5,2.5-4,3-3.5,5-7,9-18,acute,apart,attenuate,base,broadly,cm,cup-shaped,curly-tipped,decurrent,deltoid,ellipsoid,elliptic,filiform,glabrous,globose,green,later,leaf,lobed,long,long-pubescent,minute,minutely,mm,narrowly,nearly,obovoid,onto,opposite,ovoid-reniform,petiole,pitted,poricidal,pubescent,shaped,short,shrub,simple,somewhat,sparsely,straw-colored,tear-drop,tip,triangular,trichome,unifoliate,uniseriate,white,winged,woody,x,young	0.25,0.5,3,3-6,8,capitate,greyish-green,na
523	wfo-0001032277	success	163	105	71	80	83	25	66	5	.5,0.1-0.5,0.2-0.6,0.8-3,1-1.1,1-2,1-5,1/2,2-2.5,2-4,2-6-flowered,3-3.5,3-9,5-6,8-9,anther,anthesi,area,bark,base,berry,blunt,branched,bright,calyx,cm,corolla,cup-shaped,densely,dia,ellipsoid,elliptic,flattened-reniform,fruit,glabrous,globose,green,immature,inflorescence,internodal,lax,leaf,lobed,long,minutely,mm,number,older,opposite,ovary,papillose,pedicel,petiole,pitted,poricidal,pubescent,ripe,round,shrub,simple,slender,small,sparsely,stem,stigma,strict,style,surface,tapering,tip,translucent,trichome,tube,uniseriate,virgately,way,white,x,yellow,young	0.75-1,1-1.2,1-1.5,1.5-1.8,10-14,acute,along,apex,apiculate,appear,appearing,auriculate,ba,beneath,blade,closely,coriaceous,deltoid,drooping,dry,eaf,edicel,eed,erect,exserted,filament,free,fruiting,geminat,gre,impressed,incrassate,indentation,lateral,like,lobe,lower,main,margin,mature,middle,nflorescence,obscured,occasionally,overlapping,pair,pale,paler,papillae,partially,pore,portion,prominent,puberulent,pubescenc,raised,reddish,remaining,rest,revolute,rounded,ruit,scar,slende,spaced,specimen,spicy-fragrant,straight,strongly,styl,tall,truncate,trunk,tub,two,ud,unit,varying,vein,widest,woody,yellowish-tan,ympodial	abaxial,adaxial,arrangement,bud,colour,feature,flower,form,geminate,grey,greyish,growth,hair,height,history,length,life,plant,reproduction,seed,shape,size,texture,type,width	.5,0.1-0.5,0.2-0.6,0.8-3,1-1.1,1-2,1-5,1/2,2-2.5,2-4,2-6-flowered,3-3.5,3-9,5-6,8-9,anthesi,area,base,berry,blunt,branched,bright,calyx,cm,cup-shaped,densely,dia,ellipsoid,elliptic,flattened-reniform,glabrous,globose,green,immature,internodal,lax,leaf,lobed,long,minutely,mm,opposite,papillose,pitted,poricidal,pubescent,ripe,round,shrub,simple,slender,small,sparsely,strict,style,tapering,tip,translucent,trichome,tube,uniseriate,virgately,way,white,x,yellow	-9,di,geminate,grey,greyish
524	wfo-0001032304	success	249	173	125	133	116	40	118	7	0.2-0.3,0.5-3,0.5-4.5,1,1-3.5,1.1-2,1.2-2.3,1.3-2.1,10,3-10,3-15,3-20,3-4.5,3-6,4-7.5,7-27,acuminate,acute,adaxially,anther,anthesi,apart,apex,apical-lateral,articulated,axe,base,becoming,berry,blackish,blade,blunt-tipped,brownish,bud,calyx,campanulate,cm,conical,continued,corolla,dark,decurrent,dehiscing,deltoid,dendritic-echinoid,directed,due,echinoid,extend,few-,filament,fleshy,flower,free,fruit,glabrescent,glabrous,granular-tomentose,green,greenish,growth,hair,honeycombed,introrse,large,lateral,leaf,length,lobe,long,long-,long-attenuate,longitudinal,many,many-rayed,mixed,mm,mostly,multangulate,oblong,obtuse,occasionally,often,orbicular,ovate,ovate-lanceolate,overlapping,pale,pedicel,petiole,plant,pore,porrect-stellate,probably,ray,reniform,reticulate-punctate,ripe,rotate-stellate,scabridulous,seed,sessile,short,short-,short-stalked,shrub,simple,slit,small,stem,stigma,style,subglobose,suborbicular,terete,testa,thick-stalked,thin-,tomentose,touching,toward,tree,tube,unarmed,velutinous,violet,white,whitish,within,x,yellow,yellowish,young	-3,.6-1.2,.9-1.4,/20,0-120,0.3-1.5,0.9-1.3,1.2-3,1.5-3.2,1.6-1.9,1.8-4,1/2,1/3-1/2,1/5,1/8,18,2-4,2-4.2,2-5,2.5-19.5,2/3-3/4,21,3.2-3.8,3.2-5.5,44,5-6,5.5-9,7.5-12,9-13,abaxially,accrescent,ag,along,apparently,appressed-tomentose,ascending,axillary,ba,bark,branch,branched,broadly,brown,capitat,chartaceous,closely,dendritic,dendritic-echinoi,densely,diameter,distal,eaf,echinoi,elliptic,entire,especially,exserted,few-rayed,fruiting,glabrescen,high,inserted,juvenile,least,lobed,long-stalked,lower,m.,main,margin,midvein,multangulat,nflorescence,obscured,older,opaque,orolla,ovat,partly,peduncle,perfect,plurifoliate,present,pseudo-terminal,pubescent,rachi,rarely,rather,relatively,ruit,runk,side,somewhat,spaced,sparingly,spreading,stamen,stellate-tomentose,strongly,sulcate,suture,tamen,thick,thin,thin-stalked,time,tomentu,triangular-ovate,unarme,unit,usually,vary,vein,way,wide,ympodial	0.9-1.4,20-120,age,arrangement,capitate,coat,colour,connation,decurrency,dry,embryo,feature,form,height,history,inflorescence,life,midpoint,minor,new,number,ovary,papilla,perennial,prickle,pseudoterminally,reproduction,scar,shape,size,spacing,specimen,surface,texture,tip,tuberculation,type,unknown,width,winging	0.2-0.3,0.5-3,0.5-4.5,1,1-3.5,1.1-2,1.2-2.3,1.3-2.1,10,3-10,3-15,3-20,3-4.5,3-6,4-7.5,7-27,acuminate,acute,adaxially,apart,apex,apical-lateral,articulated,axe,base,becoming,berry,blackish,blade,blunt-tipped,brownish,campanulate,cm,conical,continued,dark,decurrent,dehiscing,deltoid,dendritic-echinoid,directed,due,echinoid,extend,few-,fleshy,flower,free,fruit,glabrescent,glabrous,granular-tomentose,green,greenish,growth,hair,honeycombed,introrse,large,lateral,long,long-,long-attenuate,longitudinal,many,many-rayed,mixed,mm,mostly,multangulate,oblong,obtuse,occasionally,often,orbicular,ovate,ovate-lanceolate,overlapping,pale,pedicel,petiole,pore,porrect-stellate,probably,ray,reniform,reticulate-punctate,ripe,rotate-stellate,scabridulous,sessile,short,short-,short-stalked,shrub,simple,slit,small,stem,subglobose,suborbicular,terete,testa,thick-stalked,thin-,tomentose,touching,toward,tree,unarmed,velutinous,violet,white,whitish,within,x,yellow,yellowish	0.9-1.4,20-120,age,capitate,perennial,pseudoterminally,unknown
525	wfo-0001032307	success	153	118	62	81	72	37	55	7	0.2-0.5,0.4-1.3,1-2,1.5-2,1.5-5,2-5,2.5-12,2.5-3,3.5-4,30,4-8,5-12,7-18,acute,anther,anthesi,apex,bark,base,berry,calyx,campanulate,capitate,cm,congested,corolla,dark,deltate,dendritic,densely,dia,ellipsoid,elliptic,erect,filament,flattened-reniform,fleshy,glabrous,globose,green,growth,inflorescence,later,lateral,leaf,lobe,lobed,long,loose,minutely,mm,new,ovary,pedicel,petiole,pitted,plant,pore,poricidal,pubescent,scar,shaped,shrub,small,stem,stigma,stout,style,surface,tear-drop,terminal,tip,tree,trichome,truncate,tube,type,white,wide,woody,young	.5,/3,1-1.5,10-20,2.5-3.5,5-25-flowered,?,abaxial,adaxial,along,apar,blade,body,branch,branched,brow,christmas-tree-like,eaf,edicel,eed,either,elongate,exserted,flat,free,fruiting,glabrate,immature,incrassate,inflorescenc,like,lon,lower,main,many,margin,middle,minute,nflorescence,older,pair,pale,papillae,papillo,petal,planar,plurifoliat,portion,prominent,reddish,reddish-brown,rest,ruit,spaced,sparsely,strongly,tall,tan,thick,thickened,time,tree-like,tub,ud,unevenly,upper,variable,vein,way,widest,within,ympodia	0.5,5-25,apart,arrangement,brown,bud,coat,colour,connation,dry,embryo,feature,flower,form,fruit,height,history,length,life,midpoint,na,number,papilla,papillose,plurifoliate,prickle,ray,reproduction,seed,shape,size,spacing,specimen,texture,tuberculation,width,winging	0.2-0.5,0.4-1.3,1-2,1.5-2,1.5-5,2-5,2.5-12,2.5-3,3.5-4,30,4-8,5-12,7-18,acute,berry,campanulate,capitate,cm,congested,dark,deltate,dendritic,densely,dia,ellipsoid,elliptic,erect,flattened-reniform,fleshy,glabrous,globose,green,later,lateral,lobed,long,loose,minutely,mm,pitted,poricidal,pubescent,shaped,shrub,small,stout,tear-drop,terminal,tip,tree,trichome,truncate,white,wide,woody	0.5,5-25,apart,brown,na,papillose,plurifoliate
526	wfo-0001032308	success	190	108	74	89	101	19	73	1	0.7-1,0.7-1.2,1-10,1-2,1.5-2.5,1.8-2.5,1.9-3,2,2-6,4-8,5-7,6,8-9,abaxially,absent,adaxially,anther,apart,axillary,base,blade,broadly,bud,cell,chartaceous,clavate,cm,connivent,cordate,corolla,covering,cuneate,deep,diameter,elliptic,filament,flower,fruit,glabrous,globose,green,hair-like,homostylous,interjected,irregular,lanceolate,lateral,leaflet,lobed,long,medium,membranous,mm,narrowly,odd-pinnate,ovate,ovoid,pedicel,peduncle,pentagonal,petiole,petiolulate,petiolule,pore,poricidal,pubescent,pure,ripe,rounded,seed,sessile,shape,short,slightly,stigma,style,substellate,subtending,sympodial,terminal,testal,thick,tip,truncate,unit,wall,white,wide,x	0-3,0.2-2.1,0.3-5,12-16,2-3,2-4,3-10,3-6,3.8-5,4-7,4.8-7.7,5-merou,6-11,acumen,acute,ag,along,alyx,apex,apparently,articulated,axe,berry,brownish,capitat,ciliate,condition,digestion,distal,dorsally,dot,drying,eaf,edge,eed,enzyme,especially,exceeding,flat,folded,forked,fresh,geminat,generally,glabrou,greatly,green-white,greenish,hair,hal,half,honeycomb-shaped,invested,larger,leave,lengthening,like,living,lobe,lower,make,margin,midrib,minute,minutely,much,mucilaginous,nflorescence,non-glandular,obtuse,often,orbicular,orolla,pair,perfect,plant,plurifoliate,puberulent,removed,ruit,scattered,seudostipule,slit,spaced,specimen,stamen,ste,stem,straight,tamen,throughout,tri-,trichome,tube,typically,usually,vary,varying,wet,whitish,yellow	arrangement,calyx,capitate,colour,connation,feature,form,growth,inflorescence,leaf,length,ovary,pseudostipule,size,spacing,staman,surface,texture,type	0.7-1,0.7-1.2,1-10,1-2,1.5-2.5,1.8-2.5,1.9-3,2,2-6,4-8,5-7,6,8-9,abaxially,absent,adaxially,apart,axillary,broadly,bud,cell,chartaceous,clavate,cm,connivent,cordate,covering,cuneate,deep,diameter,elliptic,flower,fruit,glabrous,globose,green,hair-like,homostylous,irregular,lanceolate,lateral,lobed,long,medium,membranous,mm,narrowly,odd-pinnate,ovate,ovoid,pentagonal,petiolulate,poricidal,pubescent,pure,ripe,rounded,sessile,short,slightly,substellate,subtending,sympodial,terminal,testal,thick,tip,truncate,unit,wall,white,wide,x	capitate
527	wfo-0001032335	success	214	138	85	99	115	39	80	5	0.2â0.3,0.5â1,100+,1â1.5,1â3,2â10,2â2.5,4â14,4â5,5â6,6â19,6â6.5,7â10,acuminate,acute,anther,anthesi,apex,attenuate,base,berry,branched,bright,c.,calyx,capitate,cm,connivent,corolla,cup-shaped,densely,diameter,ellipsoidal,elliptic,filament,flattened-reniform,flower,globose,gold,gradually,growth,inflorescence,length,lengthening,like,lobe,lobed,long,loosely,many,midpoint,minute,minutely,mm,multangulate,narrowing,narrowly,new,nodding,onto,orange,pedicel,peltate,persistent,petiole,pitted,pore,poricidal,porrect,porrect-stellate,pubescent,ray,reddish,ripe,scar,short-stalked,shrub,simple,slit,small,somewhat,stellate,stem,stigma,stout,style,surface,terminal,time,tip,tree,trichome,tube,way,white,wide,woody,â4,âstellate	.2,.5,0,0.05,0.2,0.4,0.5,0.9â1,1.5â2,100,10â12,12â15,15,16,1â1.2,2.5â3,2â5,3361,4â6-rayed,5-merou,>,abaxial,abaxially,adaxial,ag,along,alyx,apar,appearing,ark,articulated,axe,beneath,boh,branching,cell,center,chartaceous,closely,covered,deltate,dichasia,discolorous,drying,eaf,eed,elongate,entire,equal,erec,evenly,exserted,fide,free,fruiting,fused,glabrous,golden-brow,golden-yellow,half,ilament,impressed,lamina,less,lower,margin,markedly,membranous,moderately,near,nflorescence,older,orolla,pair,pale,papillo,part,peduncle,per,perfect,pericarp,plane,plurifoliate,portion,primary,pubescence,reflexed,regularly,ruit,scurfy,sessile,shiny,short,silvery,slightly,sometimes,spaced,sparsely,square,strongly,stub,tal,tem,testal,thin,ud,unevenly,unit,upper,vary,varying,vein,visible,yellow,ympodial	age,apart,arrangement,bark,bud,coat,colour,connation,decurrency,dry,embryo,erect,feature,form,fruit,height,history,leaf,life,minor,na,number,ovary,papilla,papillose,plant,prickle,reproduction,seed,shape,size,spacing,specimen,texture,tuberculation,type,width,winging,young	0.2â0.3,0.5â1,100+,1â1.5,1â3,2â10,2â2.5,4â14,4â5,5â6,6â19,6â6.5,7â10,acuminate,acute,anthesi,attenuate,base,berry,branched,bright,c.,capitate,cm,connivent,cup-shaped,densely,diameter,ellipsoidal,elliptic,flattened-reniform,globose,gold,gradually,lengthening,like,lobed,long,loosely,many,minute,minutely,mm,multangulate,narrowing,narrowly,nodding,onto,orange,pedicel,peltate,persistent,petiole,pitted,poricidal,porrect,porrect-stellate,pubescent,reddish,ripe,short-stalked,shrub,simple,slit,small,somewhat,stellate,stem,stout,terminal,time,tip,tree,trichome,way,white,wide,woody,â4,âstellate	age,apart,erect,na,papillose
528	wfo-0001032337	success	225	160	121	130	95	30	115	6	0.4-1.5,0.5-3.5,1-10,1-2,1.2-2.8,1.4-2,1.5,1.6-4,2-3.5,2.3-11.5,3-8,3.6-5,4-17,4-9,8-10,8-17,9-21,9-29,abaxially,acuminate,acute,adaxially,anther,apart,apex,axillary,base,basiscopic,berry,borne,broadly,bud,canescent,cell,chartaceous,clavate,cm,connivent,corolla,covering,cuneate,darker,decurrent,deep,densely,diameter,distal,dot,elliptic,end,filament,flower,forked,fruit,generally,glabrous,globose,green,green-white,hair,hair-like,half,herb,homostylous,lanceolate,lateral,leaf,leaflet,lengthening,light,like,lobe,long,make,membranous,mm,mottled,mucilaginous,oblique,obtuse,odd-pinnate,often,ovate,ovoid,pedicel,peduncle,pentagonal,petiole,plant,pore,poricidal,pubescent,purple,rarely,ray,ripe,rotate,rounded,scattered,seed,short,side,singly,size,slit,sometimes,sparsely,stem,stigma,style,subglabrous,subtending,terminal,testal,thick,throughout,tip,tissue,tube,tuber,typically,unwinged,violet,violet-purple,wall,wet,white,wide,wing,x	0,1,1-4,10,2,2-14,2-4,2-4.5,2-7,2.3-4.8,3-4,4-6,4.5-14.5,5-11,5-merou,acumen,ag,along,alyx,apiculate,apparently,articulated,attenuate,axe,blade,brownish,capitat,ciliate,condition,cordate,digestion,dorsally,drying,eaf,edge,eed,enzyme,erec,especially,exceeding,except,flat,folded,frequently,fresh,geminat,glabrou,greatly,greenish,honeycomb-shaped,interjected,living,lower,margin,middl,midrib,minutely,nflorescence,orbicular,orolla,pair,paired,perfect,petiolulate,petiolule,plurifoliate,proximal,puberulent,reduced,removed,ruit,sessile,seudostipule,slightly,small,spaced,specimen,stamen,ste,stolo,straight,subequal,subsessile,tall,tamen,tem,tertiary,tri-,unit,unpaired,usually,vary,whitish,yellow,ympodial	5-merous,age,arrangement,calyx,capitate,coat,colour,connation,feature,form,growth,height,history,inflorescence,length,life,na,ovary,perennial,presence,pseudostipule,reproduction,shape,spacing,staman,stolon,surface,texture,tuberculation,type	0.4-1.5,0.5-3.5,1-10,1-2,1.2-2.8,1.4-2,1.5,1.6-4,2-3.5,2.3-11.5,3-8,3.6-5,4-17,4-9,8-10,8-17,9-21,9-29,abaxially,acuminate,acute,adaxially,apart,axillary,basiscopic,berry,borne,broadly,bud,canescent,cell,chartaceous,clavate,cm,connivent,covering,cuneate,darker,decurrent,deep,densely,diameter,distal,dot,elliptic,end,flower,forked,generally,glabrous,globose,green,green-white,hair,hair-like,half,herb,homostylous,lanceolate,lateral,leaf,lengthening,light,like,long,make,membranous,mm,mottled,mucilaginous,oblique,obtuse,odd-pinnate,often,ovate,ovoid,pentagonal,petiole,plant,pore,poricidal,pubescent,purple,rarely,ray,ripe,rotate,rounded,scattered,seed,short,side,singly,slit,sometimes,sparsely,stem,subglabrous,subtending,terminal,testal,thick,throughout,tip,tissue,typically,unwinged,violet,violet-purple,wall,wet,white,wide,wing,x	5-merous,age,capitate,na,perennial,stolon
529	wfo-0001032344	success	157	95	57	69	88	26	54	3	0.2-0.5,1-1.3,1.5-4.5,1.5-6,1.6-2.4,10-29,2-2.8,2-3,2.2-4,3-5,3-8.5,3-9,3.5-6.5,4-11,4-8,5-10,6-15,9.5-21,absent,bluish,branched,calyx,cm,connate,corolla,cyme,dark,diameter,dichasial,dichasially,distal,ebracteate,flower,forked,generally,globose,green,half,herbaceous,interjected,lateral,leaf,leaflet,long,medium,mm,monochasial,mucilaginous,odd-pinnate,ovoid,pedicel,peduncle,perennial,petiole,plant,puberulent,pubescent,purple,rotate,rotate-pentagonal,scarce,seed,size,stigma,style,terminal,violet,wide,yellow	1-3,1-4,2.8,3-6-foliat,3-7,abaxially,abruptly,acumen,acuminate,acute,adaxially,apex,apical,apically,articulate,base,belo,broadly,cell,covering,cuneate,decurrent,dehiscent,digestion,diminishing,dorsally,dot,eaf,edge,eed,elliptical,emoval,enzyme,exceeding,filament,globo,green-white,hair-like,honeycomb,inrolled,introrse,layeral,living,lobe,lon,long-attenuate,lower,lunat,make,maturing,nflorescence,nther,oblique,often,orolla,ovate,pair,pattern,perfect,petiolule,plan,poricidally,proximal,reveal,ruit,sessile,seudostipule,short,slit,smooth,sometimes,specimen,stamen,straight,tal,tem,testal,thick,throughout,toward,tuber-bearing,typically,unit,vary,wall,white,ympodial,Â¼	7,abaxial,adaxial,anther,arrangement,colour,connation,feature,form,fruit,growth,height,history,inflorescence,length,life,na,number,ovary,reproduction,shape,stem,surface,texture,wet,width	0.2-0.5,1-1.3,1.5-4.5,1.5-6,1.6-2.4,10-29,2-2.8,2-3,2.2-4,3-5,3-8.5,3-9,3.5-6.5,4-11,4-8,5-10,6-15,9.5-21,absent,bluish,branched,cm,connate,cyme,dark,diameter,dichasial,dichasially,distal,ebracteate,forked,generally,globose,green,half,herbaceous,long,medium,mm,monochasial,mucilaginous,odd-pinnate,ovoid,perennial,plant,puberulent,pubescent,purple,rotate,rotate-pentagonal,scarce,violet,wide,yellow	7,na,wet
530	wfo-0001032354	success	171	119	68	83	88	36	64	4	0,1-10,1-2,2-2.5,2.5-3,38/2,acute,anther,apex,aster,axillary,base,becoming,berry,bilobed,branch,branched,broadly,calyx,campanulate,capitate,cm,coarsely,colour,corolla,cuneate,decurrent,deep,discoidal,ellipsoid,filament,flower,fork,glabrous,glandular,globose,green,greenish-ivory,hair,leaf,lengthening,lobe,maturity,minute,minutely,mm,narrow,obovate,obovoid,occasionally,ovary,ovoid,pale,pedicel,pinnatisect,pore,poricidal,puberulent,rh,rotate,rounded,rugose-reticulate,shape,shrub,simple,size,slightly,slit,soft,somewhat,sparse,stellate,stem,stigma,style,surface,tip,trichome,uniseriate,violet,wing,wooded,young	0-5,0.3,0.5-1,0.8-1,0.8-1.2,1-3,1-5,10-lobed,2,25,250-400,29,3-4,4-6,40-75,5-10,5-15,acuminate,almost,angular,anthesi,aspect,axi,brown,c.,cell,creating,cut,deeply,dia,distal,eaf,eed,effect,except,exerted,facetted,fleshy,general,gre,gree,greyish,halfway,lanceolat,large,lasting,linear,lobed,lower,midrib,nflorescence,oval,ovate,pair,pebble-shaped,pedicellate,peduncle,plurifoliat,pubescent,rather,ruit,secondary,seedling,several,shoot,single,sinus,small,smaller,smel,spreading,stone,straight,strongly,tall,tub,ud,unit,unpleasant,usually,variable,vein,wide,within,woody,x,year,ympodial	arrangement,bud,coat,connation,decurrency,embryo,feature,form,fruit,grey,growth,height,history,inflorescence,length,life,minor,na,new,number,papilla,perennial,petiole,plant,plurifoliate,prickle,reproduction,scar,seed,spacing,texture,tube,tuberculation,type,width,winging	0,1-10,1-2,2-2.5,2.5-3,38/2,acute,aster,axillary,becoming,berry,bilobed,branch,branched,broadly,campanulate,capitate,cm,coarsely,cuneate,decurrent,deep,discoidal,ellipsoid,fork,glabrous,glandular,globose,green,greenish-ivory,hair,lengthening,maturity,minute,minutely,mm,narrow,obovate,obovoid,occasionally,ovoid,pale,pinnatisect,poricidal,puberulent,rh,rotate,rounded,rugose-reticulate,shrub,simple,slightly,slit,soft,somewhat,sparse,stellate,stem,tip,trichome,uniseriate,violet,wing,wooded	grey,na,perennial,plurifoliate
531	wfo-0001032358	success	216	116	57	84	132	32	55	2	0.5-3,0.6-1,0.7-1,1-2,1.3-1.7,13-20,15-40,2-10,2-3,2.2-7.5,3-10,3-4,3.5-13,4-4.5,4.5-5,acute,anther,anthesi,apart,apex,bark,base,berry,branched,brown,calyx,capitate,cm,cordate,corolla,cupuliform,curved,filament,flattened,flower,fruit,furcate,glabrescent,globose,green,growth,inflorescence,internodal,leaf,linear,lobe,midpoint,minutely,mm,new,orangish,ovate,ovoid,pale,papillate,pedicel,petiole,pitted,pore,poricidal,prickle,prickly,pubescent,purple,ray,red,reniform,ripening,rotate-stellate,scar,shrub,simple,stellate,stem,stigma,strongly,style,surface,time,tip,tube,type,x,yellowish	.1,.2,.3,.4,.5,/2,0,0.2-4,0.6-0.8,1-1.6,1.5-2,1.5-2.5,1/4-1/2,12-20,2,2-4,2-5,4-7,4-8,4-merous,abaxially,abscissio,adaxially,along,another,appearing,armed,away,basal,based,broad,bulbous,cell,center,densely,diameter,difoliate,dorsal,drying,eaf,eed,entire,equal,erect,expanding,exserted,free,frui,fruiting,geminate,glabrescen,glabrous,heteromorphic,interpetalar,irregular,irregularly,lamina,left,lengthening,like,lobed,long,longer,lower,lowermost,margin,margined,markedly,maturity,membranous,midrib,midvein,nflorescence,nodding,occasionally,often,older,one,pair,paler,papillat,part,peduncle,peg,per,perfect,pericarp,persistent,planar,porrect,portion,present,primary,rhachi,ruffly,ruit,sessile,shiny,short,short-stalked,sinuate,sinus,slightly,slit,small,sometimes,somewhat,space,spaced,sparsely,spreading,staman,tan,thick,thin,three,trichome,tub,tuberculate,two,ud,unevenly,unisexual,unit,upper,usually,vein,way,whitish,widely,ympodial,zygomorphic	0.5,arrangement,bud,coat,colour,connation,decurrency,dry,embryo,feature,form,height,history,length,life,minor,na,number,ovary,papilla,plant,reproduction,seed,shape,size,spacing,specimen,texture,tuberculation,width,winging,young	0.5-3,0.6-1,0.7-1,1-2,1.3-1.7,13-20,15-40,2-10,2-3,2.2-7.5,3-10,3-4,3.5-13,4-4.5,4.5-5,acute,apart,berry,branched,brown,capitate,cm,cordate,cupuliform,curved,flattened,furcate,glabrescent,globose,green,internodal,linear,minutely,mm,orangish,ovate,ovoid,pale,papillate,pitted,poricidal,prickly,pubescent,purple,red,reniform,ripening,rotate-stellate,shrub,simple,stellate,strongly,time,x,yellowish	0.5,na
532	wfo-0001032367	success	231	135	80	85	146	50	63	17	0.4-0.5,0.7-1.1,3-5,6-8,acute,anther,anthesi,apex,around,axi,base,berry,calyx,capitate,cm,connivent,cordate,curved,dark,densely,directed,filament,flattened-reniform,flower,free,gland-tipped,glandular-puberulent,globose,green,greenish,hair,immature,inflorescence,lanceolate,lateral,leaf,length,light,lobe,lobed,long,maturity,midpoint,minute,minutely,mixed,mm,mottled,narrowly,nearly,obtuse,ovary,ovate,pale,pedicel,petiole,pore,poricidal,prickle,ray,shorter,shrub,simple,size,small,specimen,stellate,stem,stigma,style,suborbicular,surface,tapering,terete,tip,triangular,trichome,truncate,tube,unbranched,uniformly,uniseriate,white,wide,yellow	-3,.2,.4,0-0.3,0.2â0.35,0.4â0.5,0.4â0.6,0.4â1,0.5â0.8,0.5â2,0.6,0.6â0.8,0.8,0.8â2,1-2,1-2.1,1.2,100-300,1â1.5,1â1.8,2,2-3-celled,2-4,2.2â2.5,2.2â2.8,2.5â3,2â2.5,3-celled,3.2â4,3â10,3â5,3â6,4,4â6.5,5-merous,5.5â6.9,5â18,6.8â8.2,7â10,8,abaxial,abaxially,accrescent,acicular,adaxial,adaxiall,adaxially,also,alyx,arme,ba,blade,branch,broad-based,congested,conical,copious,cream,deciduous,diameter,difoliate,distall,eaf,eed,enlarged,entire,equal,erect,expand,fertile,fruiting,geminat,geminate,glabrous,grading,herbarium,heterostylous,hyaline,infructescence,largest,layer,least,long-styled,longer,lower,lowermost,major,many,margin,membranous,mesocarp,mixture,moderately,nflorescence,often,one,orolla,oung,pair,papillat,peduncle,per,portion,prickly,puberulent,pubescence,pubescent,rarely,recurved,red-brown,rest,ruit,scarcely,scattered,secondary,sessile,shallow,short-styled,similar,slender,smaller,somewhat,sparsely,spongy,spreadin,spreading,staminat,ste,straight,tall,tamen,thick,tightly,time,tooth,twice,unarmed,unit,usually,variable,vary,vein,whitish,ympodial,â15,â5	0.2-0.35,0.4-0.6,0.5-2,1-1.8,15,2-2.5,2.2-2.5,2.2-2.8,2.5-3,3-6,6.8-8.2,7-10,arrangement,bark,bud,coat,colour,connation,corolla,decurrency,distally,dry,embryo,feature,form,fruit,growth,height,history,life,minor,na,new,number,papilla,papillate,perennial,plant,reproduction,scar,seed,shape,spacing,texture,tuberculation,type,unknown,width,winging,young	0.4-0.5,0.7-1.1,3-5,6-8,acute,apex,around,axi,base,berry,capitate,cm,connivent,cordate,curved,dark,densely,directed,flattened-reniform,free,gland-tipped,glandular-puberulent,globose,green,greenish,hair,immature,inflorescence,lanceolate,lateral,light,lobed,long,maturity,minute,minutely,mixed,mm,mottled,narrowly,nearly,obtuse,ovate,pale,poricidal,shorter,shrub,simple,small,stellate,suborbicular,tapering,terete,tip,triangular,trichome,truncate,unbranched,uniformly,uniseriate,white,wide,yellow	0.2-0.35,0.4-0.6,0.5-2,1-1.8,15,2-2.5,2.2-2.5,2.2-2.8,2.5-3,3-6,6.8-8.2,7-10,distally,na,papillate,perennial,unknown
533	wfo-0001032407	success	216	117	78	91	125	26	75	3	0.5-3,0.8,1-2,1-2.4,1.4-2.7,1.5-2.2,10-19.5,2-10.5,3-15,4-11,4-48,5,5-23,5-30,7-9,8-10,anther,axillary,berry,bud,cell,chartaceous,clavate,cm,coarsely,conical,connivent,corolla,covering,dark,densely,diameter,elliptic,finely,flower,forked,fruit,glabrous,green,hair,hair-like,herb,lanceolate,lateral,leaf,less,light,like,lobe,long,medium,membranous,minute,mm,moniliform,mottled,narrow,odd-pinnate,ovate,ovoid,pentagonal,petiole,plant,pore,poricidal,puberulent,pubescent,purple,rarely,ripe,rotate,seed,simple,size,stem,stigma,style,subtending,terminal,testal,thick,tip,tube,tuber,unwinged,wall,white,whitish,wide,wing,x	0-4,0.3-0.6,0.3-8,0.4-4,0.8-0.3,1-10,1-5,1.2-7,10-27,12,2-4,2.5-10.5,2.5-9,3.1-13.5,30,38,4-7,5-merou,6,abaxially,absent,acumen,acuminate,adaxially,ag,along,alyx,apart,apex,apparently,arranged,articulated,asymmetrical,attenuate,axe,base,basiscopic,bead,blade,brownish,capitat,ciliate,commonly,condition,decreasing,digestion,distal,drying,eaf,edge,eed,elongated,enzyme,erec,especially,exceeding,filament,folded,fresh,geminat,generally,glabrou,gradually,green-white,greenish,half,homostylous,honeycomb-shaped,interjected,larger,leaflet,lengthening,living,lower,make,margin,middle,minutely,mucilaginous,multiple,necklace,nflorescence,obtuse,orbicular,orolla,pair,pedicel,peduncle,perfect,petiolule,plurifoliate,proximal,pubescen,ray,removed,round,ruit,secondary,semierect,sessile,seudostipule,side,slit,spaced,sparsely,specimen,stamen,ste,stolon,straight,subequal,symmetrical,tall,tamen,tem,throughout,tissue,tri-,typically,unit,usually,vary,wet,yellow,ympodial	abaxial,adaxial,arrangement,calyx,capitate,colour,connation,feature,form,growth,height,history,inflorescence,length,life,na,number,ovary,perennial,pseudostipule,reproduction,shape,surface,texture,type,winging	0.5-3,0.8,1-2,1-2.4,1.4-2.7,1.5-2.2,10-19.5,2-10.5,3-15,4-11,4-48,5,5-23,5-30,7-9,8-10,axillary,berry,bud,cell,chartaceous,clavate,cm,coarsely,conical,connivent,covering,dark,densely,elliptic,finely,forked,glabrous,green,hair,hair-like,herb,lanceolate,lateral,less,light,like,long,medium,membranous,minute,mm,moniliform,mottled,narrow,odd-pinnate,ovate,ovoid,pentagonal,poricidal,puberulent,pubescent,purple,rarely,ripe,rotate,simple,stem,subtending,terminal,testal,thick,tip,unwinged,wall,white,whitish,wide,wing,x	capitate,na,perennial
534	wfo-0001032465	success	229	129	99	106	123	23	92	7	+,0.2,0.5-2,0.5-2.5-5.5-9,1-1.5,1-1.7,1-3-8-14,1-5-8-10,1.2-1.5,1.5-1.8,1/3,2,2-2.5,25,3-3.5,3-9,4,5,5-8,abaxial,anther,anthesi,base,berry,black,branched,brown,calyx,capitate,cm,commonly,conical,connivent,corolla,deeply,deltate,densely,diameter,ellipsoid,filiform,flattened,flower,glabrous,glandular,glandular-tipped,globose,greenish,growth,included,inflorescence,irregularly,later,lateral,leaf,length,lengthening,like,lobe,lobed,loosely,minutely,mm,narrowly,nodding,pedicel,petiole,pinnate,pinnatifid,poricidal,pubescent,purplish,reniform,reticulate,ripe,scar,seed,shape,simple,size,slit,spaced,sparsely,stellate-rotate,stem,stigma,strongly,style,surface,terminal,time,tip,transparent,trichome,tube,twining,uniseriate,variously,varying,vine,violet,way,white,woody,x,young,Â½	-11,.2,.5,0,0.5-1.5-5,1-celled,1.5,1.5-2,3-4,3-5,5-7,5-merou,9,acuminate,acute,ag,alyx,angled,apar,apex,apically,appearing,ark,articulated,axi,basal,cell,ciliate,clasping,cordate,coriaceous,de,decreasing,deep,deeper,distal,drying,eaf,edge,eed,elliptic,elongate,entire,erect,exserte,filament,free,fringe,fruiting,glabrescen,gland,green,growing,half,ilament,irregular,janeiro,larger,leaving,long,lower,margin,mature,membranous,minute,new,nflorescence,occasionally,often,older,orolla,outline,ovate,pair,paired,papillate,papillo,peduncle,peg,pendan,pentagonal,per,perfect,pericarp,planar,plurifoliat,pore,portion,primary,puberulent,reddish,revolute,rio,ruit,scattered,shallow,shiny,similar,sinus,sleeve,somewhat,splitting,subshrub,tem,testal,thicker,thin,tiny,toward,truncate,tuft,twinin,ud,unicellular,unit,upper,usually,vary,vein,wall,widest,yellowish,ympodial	adaxial,age,apart,arrangement,bud,colour,exserted,feature,form,fruit,glabrescent,greyish,hair,number,ovary,papilla,papillose,plurifoliate,spacing,texture,type,width,winging	+,0.2,0.5-2,0.5-2.5-5.5-9,1-1.5,1-1.7,1-3-8-14,1-5-8-10,1.2-1.5,1.5-1.8,1/3,2,2-2.5,25,3-3.5,3-9,4,5,5-8,anthesi,base,berry,black,branched,brown,calyx,capitate,cm,commonly,conical,connivent,corolla,deeply,deltate,densely,diameter,ellipsoid,filiform,flattened,glabrous,glandular,glandular-tipped,globose,greenish,included,irregularly,later,lateral,length,lengthening,like,lobe,lobed,loosely,minutely,mm,narrowly,nodding,pinnate,pinnatifid,poricidal,pubescent,purplish,reniform,reticulate,ripe,simple,slit,spaced,sparsely,stellate-rotate,stem,strongly,surface,terminal,time,tip,transparent,trichome,tube,twining,uniseriate,variously,varying,vine,violet,way,white,woody,x,young,Â½	age,apart,exserted,glabrescent,greyish,papillose,plurifoliate
535	wfo-0001032494	invalid_json	163	126	NA	85	78	41	NA	NA	.1,.5,0.8-1,0.9-1.2,1.45-1.5,1.5-8,1.6-2,1.8-4.5,16.5-20.5,2.3-2.5,2.5,2.5-8,3.4-14.5,3/4,4-8,5-40,5-6.4,acuminate,anther,anthesi,apart,apex,attenuate,bark,base,berry,calyx,clavate,cm,corolla,decurrent,deflexed,dry,filament,flattened-reniform,fruit,glabrous,globose,greenish-yellow,leaf,lobe,lobed,long,minor,minutely,mm,narrowly,opposite,ovary,ovate,ovoid,pale,papillose,pedicel,petiole,pitted,pore,poricidal,scar,shaped,shrub,simple,size,slender,small,stem,stigma,style,surface,tapering,tear-drop,tip,tree,triangular,trichome,tube,two-winged,uniseriate,way,white,whitish-green,winged,woody,x,zig-zag	.4,0.6-1,0.75-1,1-1.5,1.1-1.2,1.5,3-4,8-11,accrescent,appearing,axil,ba,beginning,beneath,brown,bullate,dia,differing,difoliate,eaf,edicel,eed,equal,evenly,except,expanded,exserted,flowered,free,fruiting,furcate,geminat,geminate,incrassate,inflorescenc,lateral,lax,lenticellat,light,lon,lower,main,major,margin,material,middle,nearly,nflorescence,node,occasionally,orange,pair,papillae,papillo,planar,portion,prominent,proximal,pubescent,quite,raised,revolute,ridge,ruit,slightly,somewhat,spaced,straight,tall,tan,ud,unit,upper,vein,venation,widest,yellow,ympodial	abaxial,adaxial,alternate,arrangement,bud,characteristic,coat,colour,connation,feature,flower,form,green,greyish,growth,hair,height,history,inflorescence,length,lenticellate,life,midpoint,number,papilla,perennial,plant,prickle,ray,reproduction,seed,shape,spacing,specimen,texture,tuberculation,type,unknown,value,width,winging	NA	NA
536	wfo-0001032507	success	206	168	126	144	62	24	123	3	.2,.5,0.25,0.3,0.5,0.7-1.2,0.8,1,1.2-1.7,1.5â7,10â20,15â20,1â1.5,1â10,2,2.5â4,20â30,2â9,3â5,3â7,5â10,5â20,5â8,6,8â15,abaxial,abaxially,absent,abundant,acuminate,acute,adaxially,adjacent,anther,anthesi,apex,armed,articulated,base,berry,blue,branched,broadly,brown,bud,cell,chartaceous,cm,collection,compound,confluent,connivent,corolla,cream,curved,deltate,diameter,distally,ellipsoid,elliptic,entire,fertile,filament,flattened-reniform,flower,flowering,four,fruiting,glabrous,globose,green,hair,herbaceous,herbarium,internode,interpetalar,lateral,leaflet,light,lobe,long,major,margin,material,midrib,minutely,mm,narrowly,oblong,occasionally,often,one,ovate,pale,pedicel,peduncle,pentagonal,perennial,pericarp,petiole,pinnate,pinnately,pinnatifid,pitted,poricidal,present,prickle,puberulent,pulp,purple,purplish,rachi,rarely,reddish,rotate-pentagonal,rounded,rugose,shape,side,simple,slender,sometimes,stem,stigma,stout,strongly,style,surface,terminal,testal,time,tip,tissue,tube,unbranched,variously,vein,vine,white,wide,widest,woody,yellowish,Ã	/4,1.3,1.5â2,2.5â6,4â10,adaxiall,ag,alyx,apiculate,becoming,blade,calyx,campanulate,deep,distinct,dr.,eaf,eed,either,elongating,equal,exserted,fifth,highly,individual,larger,lengthening,lobed,longer,lower,nearly,nflorescence,observe,orolla,papery,pistillate,plant,plurifoliat,pore,quadrate,ranging,recurve,regularly,ruit,single,sinus,slightly,slit,spreading,staminate,straight,tamen,tear,unequal,unit,unlobed,usually,variable,vary,way,wood,ympodial	colour,dry,feature,form,fruit,growth,history,inflorescence,leaf,length,life,number,observed,ovary,presence,ratio,recurved,reproduction,seed,size,staman,texture,type,width	.2,.5,0.25,0.3,0.5,0.7-1.2,0.8,1,1.2-1.7,1.5â7,10â20,15â20,1â1.5,1â10,2,2.5â4,20â30,2â9,3â5,3â7,5â10,5â20,5â8,6,8â15,abaxial,abaxially,absent,abundant,acuminate,acute,adaxially,adjacent,anthesi,armed,articulated,base,berry,blue,branched,broadly,brown,cell,chartaceous,cm,collection,compound,confluent,connivent,cream,curved,deltate,diameter,distally,ellipsoid,elliptic,entire,fertile,flattened-reniform,flower,flowering,four,glabrous,globose,green,hair,herbaceous,herbarium,interpetalar,lateral,leaflet,light,long,material,midrib,minutely,mm,narrowly,oblong,occasionally,often,one,ovate,pale,pentagonal,perennial,pinnate,pinnately,pinnatifid,pitted,poricidal,present,prickle,puberulent,pulp,purple,purplish,rarely,reddish,rotate-pentagonal,rounded,rugose,side,simple,slender,sometimes,stout,strongly,surface,terminal,testal,time,tip,tissue,unbranched,variously,vine,white,wide,widest,woody,yellowish,Ã	dry,observed,recurved
537	wfo-0001032523	success	200	130	74	92	108	38	72	2	-5,.2,/4,0.6-0.7,0.6-0.8,1-1.5,1-3,1-8,1.5-3,15-30,2,2-2.4,2-4,2-5.5,2.5-6,2.7-3,3-15,4-7,6-10,acuminate,acute,anther,apart,apex,apically,bark,base,berry,calyx,cm,conical,connivent,cuneate,deltate,dull,elliptic,erect,evenly,filament,flattened-reniform,flower,fruit,glabrescent,glabrous,green,herbaceous,lateral,leaf,length,lobe,lobed,long,maturity,mauve,midpoint,mm,moderately,narrow-deltate,orange,orange-brown,ovate,pale,pedicel,petiole,poricidal,prickle,prickly,ray,recurved,red,red-brown,scar,shrub,simple,spherical,spreading,stellate-pubescent,stem,straight,style,surface,tapering,terminal,tip,tube,unarmed,way,weakly,wide,woody,yellow,young	-2,.5,0-0.15,0-10,0-12,0-15,0-3,0.1-0.2,0.2,0.2-0.4,0.3-0.5,0.4-1,0.4-1.5,0.5-1,1-2,1.3-1.6,1/3-1/2,1/4-1/3,10-50,2-2.5,3-4,3.5-4,4-5-merous,5-12,5-20,6-20,6-8,abaxial,abaxially,acuminat,adaxial,alyx,ame,apar,apparently,articulated,blade,branching,brow,c.,curved,diameter,discolorous,drying,eaf,eed,elongating,entire,equal,filiform,free,fruiting,gently,glabrou,hair,inflated,infructescence,lon,longer,lower,margin,mature,membranous,minute,multangulate,nflorescence,older,one,open,orolla,oung,pair,peduncle,per,perfec,pericarp,perpendicular,plurifoliat,porrect,portion,primary,reflexed,ruit,scandent,secondary,sessile,smooth,sometimes,spaced,sparsely,stalk,stalked,stellate,strongly,subentire,tamen,terete,tertiary,time,trichome,unarme,unit,variously,vary,vein,venation,visible,ympodial	anthesi,arrangement,brown,bud,coat,colour,connation,corolla,decurrency,dry,embryo,feature,form,growth,height,history,inflorescence,life,minor,na,new,number,ovary,papilla,plant,pore,reproduction,seed,shape,size,spacing,specimen,stigma,texture,tuberculation,type,width,winging	-5,.2,/4,0.6-0.7,0.6-0.8,1-1.5,1-3,1-8,1.5-3,15-30,2,2-2.4,2-4,2-5.5,2.5-6,2.7-3,3-15,4-7,6-10,acuminate,acute,apart,apically,base,berry,cm,conical,connivent,cuneate,deltate,dull,elliptic,erect,evenly,flattened-reniform,glabrescent,glabrous,green,herbaceous,lateral,lobed,long,maturity,mauve,mm,moderately,narrow-deltate,orange,orange-brown,ovate,pale,poricidal,prickly,recurved,red,red-brown,shrub,simple,spherical,spreading,stellate-pubescent,straight,tapering,terminal,tip,unarmed,way,weakly,wide,woody,yellow,young	brown,na
538	wfo-0001032524	success	205	114	65	81	124	33	61	4	1-10,1-2,1-2.5,1.5-2,1.5-4,10-35,12-13,2-5,25-90,3-5,6-13,6-16.5,7-35,acute,anther,apex,attenuate,axillary,base,berry,bud,cell,chartaceous,clavate,cm,connivent,corolla,covering,cuneate,densely,diameter,elliptic,filament,flower,fruit,glabrous,globose,grayish-green,green,hair-like,herb,lanceolate,lateral,length,lengthening,light,lilac,lobe,long,membranous,mm,obtuse,odd-pinnate,ovate,ovoid,pedicel,pentagonal,petiole,plant,pore,poricidal,pubescent,purple,ripe,rotate,rounded,seed,size,slit,stem,stigma,style,subtending,terminal,testal,thick,tip,tube,unwinged,violet,wall	120-210,14-50,2-3,2.5-8,3-4,3-8.5,3.5-4.5,4,4-5,4.5-5,4.5-8,5-6,5-9,5-merou,50-70,7-8,?,abaxially,acumen,adaxially,ag,along,alyx,apart,apparently,arranged,articulated,ascending,axe,bead,blade,brownish,capitat,ciliate,condition,different,digestion,distal,dorsally,drying,eaf,edge,eed,enzyme,erec,especially,exceeding,except,flat,folded,forked,fresh,geminat,generally,glabrou,greatly,green-white,greenish,hair,hal,half,head,homostylous,honeycomb-shaped,interjected,leaflet,like,living,lower,make,margin,middle,midrib,minutely,moniliform,mucilaginous,multicellular,multiple,narrowly,necklace,nflorescence,non-glandular,often,orolla,pair,peduncle,perfect,petiolulate,petiolule,plurifoliate,proximal,puberulent,reduced,removed,ruit,sessile,seudostipule,short,silky,silvery-white,spaced,specimen,stamen,ste,stolon,straight,subequal,tall,tamen,tem,tetralobulate,throughout,tri-,trichome,tuber,typically,unit,usually,vary,wet,whitish,x,yellow,ympodial	abaxial,adaxial,age,arrangement,calyx,capitate,colour,connation,feature,form,growth,height,history,inflorescence,leaf,life,minor,na,new,number,ovary,papilla,perennial,reproduction,scar,shape,spacing,surface,texture,type,width,winging,young	1-10,1-2,1-2.5,1.5-2,1.5-4,10-35,12-13,2-5,25-90,3-5,6-13,6-16.5,7-35,acute,attenuate,axillary,berry,bud,cell,chartaceous,clavate,cm,connivent,covering,cuneate,densely,elliptic,glabrous,globose,grayish-green,green,hair-like,herb,lanceolate,lateral,lengthening,light,lilac,long,membranous,mm,obtuse,odd-pinnate,ovate,ovoid,pentagonal,poricidal,pubescent,purple,ripe,rotate,rounded,slit,subtending,terminal,testal,thick,tip,unwinged,violet,wall	age,capitate,na,perennial
539	wfo-0001032532	success	160	87	50	65	95	22	47	3	0.3-2.5,1-4,1.5-2.6,15-30,2,2-13,2-3,2.8-3.6,2.8-9.5,3-10,4-5.5,4.5,6,8-38,acuminate,apex,apical,base,branched,calyx,cm,conical,connate,corolla,cuneate,cyme,dehiscent,diameter,dichasial,dichasially,ebracteate,elliptical,filament,flower,forked,herbaceous,introrse,leaf,leaflet,long,maturing,mm,monochasial,mucilaginous,narrowly,oblique,odd-pinnate,often,ovate,ovoid,pedicel,peduncle,perennial,petiole,petiolule,plant,poricidally,rotate,rounded,seed,short,size,slit,stigma,style	0-.,1-1.5,1.5-3.2,1.5-4.3,13-52,2-10,2-3-5,3-6-foliat,3.4-12.2,3.7-10,6-22,abaxiall,abaxially,absent,acumen,acute,adaxially,apically,articulate,attenuate,cell,coarsel,covering,deep,digestion,diminishing,distal,dorsally,eaf,edge,eed,emoval,enzyme,exceeding,finely,flat,folded,generally,globo,gradually,green,green-white,hair-like,half,honeycomb,interjected,lateral,light,living,lobe,lon,long-attenuate,lower,lunat,make,medium,minute,nflorescence,nther,obtuse,orolla,pair,pattern,perfect,plan,proximal,pubescent,purple,reveal,ruit,sessile,seudostipule,specimen,stamen,straight,subequal,subsessile,tal,tem,terminal,testal,thick,throughou,throughout,tip,toward,tuber-bearing,typically,unit,vary,wall,wide,yellow,ympodial,Â¼	anther,arrangement,connation,feature,form,fruit,globose,growth,height,history,inflorescence,length,life,na,number,ovary,pore,reproduction,shape,stem,surface,wet	0.3-2.5,1-4,1.5-2.6,15-30,2,2-13,2-3,2.8-3.6,2.8-9.5,3-10,4-5.5,4.5,6,8-38,acuminate,apical,branched,cm,conical,connate,cuneate,cyme,dehiscent,dichasial,dichasially,ebracteate,elliptical,forked,herbaceous,introrse,long,maturing,mm,monochasial,mucilaginous,narrowly,oblique,odd-pinnate,often,ovate,ovoid,perennial,poricidally,rotate,rounded,short,slit	globose,na,wet
540	wfo-0001032536	success	254	126	67	96	158	30	64	3	0.5,1.3-2.2,10,10-30,10-50,2-3,20-22,20-25,20-50,3-3.5,3-6,4-9,5-8,7-10,<,abaxial,acute,adaxial,anther,anthesi,apex,bark,base,berry,bright,bristly,broadly,brown,calyx,capitate,clavate,cm,curved,deltate,densely,depressed,elliptic,fading,filament,flattened,flower,fruit,glandular,globose,grayish,growth,inflorescence,lateral,leaf,leaf-opposed,length,lobe,long-stalked,midpoint,minutely,mixture,mm,new,number,oblique,olive-green,once-branched,ovary,papillae,papillate,pedicel,pentagonal,petiole,plant,pore,poricidal,prickle,prickly,pubescent,purple,ray,reniform,rough,scar,shallowly,simple,slightly,sparsely,stellate,stem,stigma,style,surface,tapering,tip,tree,trichome,truncate,tube,white,yellow-green	-3,/3,1,1-2,1-2.5,1.5,10-20,100,13-24,14-16,2.5-3,3,4-6,4-8,5,5-6,5-merous,5.5-8,>,abaxially,abruptly,adaxiall,adaxially,age,almost,along,alyx,angle,apar,appressed,armed,around,articulated,axi,basal-most,berr,blade,bristle,broad-based,caudat,caudate,cell,chartaceous,clearly,conical,coriaceous,cu,dark,dbh,deeply,denser,diameter,difoliate,directed,diverging,eaf,eed,enlarged,entire,equal,evenly,free,fruiting,geminate,glabrescent,glabrous,glandular-puberulent,halfway,hanging,heterostylous,inflorescenc,infructesecnce,interpetalar,irregularly,juvenile,lamina,leaving,like,lobed,long,long-styled,lower,margin,mature,maturity,membranous,midrib,midvein,minute,mixed,multangulate,multiseriate,narrowing,narrowly,near,nflorescence,occasionally,occurring,odor,older,open,orolla,oung,papillat,part,peduncle,per,pericarp,porrect,portion,potato,prickl,primary,prominent,protuberance,rarely,reddish,reproductive,ruit,scattered,short-,short-styled,slender,small,smooth,soft,somewhat,spaced,spreading,stalk,staminate,stellate-pubescent,strongly,tall,tamen,terete,terminal,thick,time,tissue,triangular,trunk,unarmed,unequal,unit,upward,urceolate,usually,vary,vein,visible,way,wide,wood,woody,yellowish,ympodial,younger	apart,arrangement,bud,coat,colour,connation,corolla,dry,feature,form,hair,height,history,life,minor,papilla,perennial,reproduction,seed,shape,size,spacing,specimen,texture,tuberculation,type,unknown,width,winging,young	0.5,1.3-2.2,10,10-30,10-50,2-3,20-22,20-25,20-50,3-3.5,3-6,4-9,5-8,7-10,<,acute,berry,bright,bristly,broadly,brown,capitate,clavate,cm,curved,deltate,densely,depressed,elliptic,fading,flattened,glandular,globose,grayish,lateral,leaf-opposed,long-stalked,minutely,mixture,mm,oblique,olive-green,once-branched,papillae,papillate,pentagonal,poricidal,prickly,pubescent,purple,reniform,rough,shallowly,simple,slightly,sparsely,stellate,tapering,tip,tree,trichome,truncate,white,yellow-green	apart,perennial,unknown
541	wfo-0001032542	success	161	127	74	95	66	32	69	5	0.5-1,1-1.3,1-1.5,1-5,1.5-3.5,10-15-flowered,10-28,2-3,2.5-5,3-4,3-5,4-9.5,4.5-5,5-8,abaxial,acute,anther,anthesi,apex,bark,base,berry,bluish-green,bright,brown,calyx,capitate,closely,cm,conical,corolla,dark,deltate,dendritic,densely,dry,elliptic,elliptic-obovate,erect,filament,flattened-reniform,glabrous,globose,golden,green,growth,incrassate,inflorescence,later,leaf,lobe,long,margin,minor,minute,minutely,mm,narrowly,opposite,ovary,overlapping,pedicel,petiole,pitted,planar,pore,poricidal,pubescent,rounded,scar,shape,shaped,shining,shrub,simple,size,slender,small,somewhat,spaced,sparsely,stem,stigma,style,surface,tear-drop,tip,treelet,triangular,trichome,tube,wide,woody,yellow-green,young	.25,.25-0.5,.5,.5-1,/4,0.7-1,1-2,2-3.5,4-7,abaxially,acuminate,adaxially,along,apical,attenuate,axi,ba,basal,beginning,compact,deflexed,di,dia,differing,difoliate,distal,eaf,edicel,eed,either,exserted,free,fruiting,geminat,inflorescenc,lamina,lateral,less,like,lobed,lon,loose,lower,main,major,near,new,nflorescence,older,pair,papillo,persisten,portion,reddish-brown,ruit,slightly,strongly,swollen,tub,ud,unit,vein,way,x,yellowish,ympodial	0.25,adaxial,alternate,arrangement,bud,coat,colour,connation,embryo,feature,flower,form,fruit,hair,height,length,midpoint,na,number,papilla,papillose,persistent,plant,prickle,ray,seed,spacing,specimen,texture,tuberculation,type,width	0.5-1,1-1.3,1-1.5,1-5,1.5-3.5,10-15-flowered,10-28,2-3,2.5-5,3-4,3-5,4-9.5,4.5-5,5-8,acute,anthesi,berry,bluish-green,bright,brown,capitate,closely,cm,conical,dark,deltate,dendritic,densely,elliptic,elliptic-obovate,erect,flattened-reniform,glabrous,globose,golden,green,incrassate,later,leaf,long,margin,minute,minutely,mm,narrowly,opposite,overlapping,pitted,planar,poricidal,pubescent,rounded,shaped,shining,shrub,simple,slender,small,somewhat,spaced,sparsely,tear-drop,treelet,triangular,trichome,wide,woody,yellow-green,young	0.25,alternate,na,papillose,persistent
542	wfo-0001032564	success	160	127	76	90	70	37	74	2	.05,.05-0.1,.1,.5,0.25-0.5,0.3-1,1-1.3,1-1.5,1-2,1.3-2.5,1.5,2-2.5,5.5-9,6-7,anther,anthesi,apart,apex,bark,base,becoming,berry,broadly,bud,calyx,clavate,cm,conical,corolla,deflexed,deltoid,densely,dia,dry,elliptic,expanded,flower,glabrous,globose,golden,green,greenish-white,greyish-red,leaf,lobe,lobed,long,long-acuminate,minute,minutely,mm,narrowly,nearly,often,opposite,ovary,ovate,ovoid-reniform,papillose,pedicel,petiole,pitted,pore,poricidal,projection,puberulent,ripe,scar,shaped,shrub,simple,slightly,stem,stigma,style,surface,tear-drop,thread-like,tiny,tip,trichome,truncate,tube,unifoliate,uniseriate,winged,woody,x,yellowish-green,young	0.75-1,1-1.2,4-5,4-6-flowered,8-9,along,apar,arched,aspec,ba,beneath,branch,brown,converging,dark,eaf,edicel,eed,except,exserted,extreme,filiform,flattened,fresh,fruiting,geminate,giving,glabrate,halfway,lamina,later,lateral,like,lower,main,margin,material,member,middle,nflorescence,node,non-reproductive,obovoi,older,one,open,pair,papillo,planar,point,prominent,proximal,raised,reflexed,rounded,ruit,shiny,small,soon,straight,strongly,tall,tan,tapering,time,ud,unit,vein,widest,ympodial	4-6,arrangement,coat,colour,connation,decurrency,embryo,feature,filament,form,fruit,growth,height,history,inflorescence,length,life,midpoint,minor,na,new,number,papilla,plant,prickle,ray,reproduction,seed,shape,size,spacing,specimen,texture,tuberculation,type,width,winging	.05,.05-0.1,.1,.5,0.25-0.5,0.3-1,1-1.3,1-1.5,1-2,1.3-2.5,1.5,2-2.5,5.5-9,6-7,apart,apex,base,becoming,berry,broadly,clavate,cm,conical,deflexed,deltoid,densely,dia,elliptic,expanded,glabrous,globose,golden,green,greenish-white,greyish-red,leaf,lobed,long,long-acuminate,minute,minutely,mm,narrowly,nearly,often,opposite,ovate,ovoid-reniform,papillose,pitted,pore,poricidal,projection,puberulent,ripe,shaped,shrub,simple,slightly,stem,tear-drop,thread-like,tiny,tip,trichome,truncate,tube,unifoliate,uniseriate,winged,woody,x,yellowish-green,young	4-6,na
543	wfo-0001032569	success	164	129	74	93	71	36	71	3	.5,/3,0.5-10,0.8-1,1-1.2,1-1.5,1-4,1.2-5,1.5,1.5-2,2-3,2-4,4-18,4-8,7-27,7-9,acute,anther,anthesi,apex,bark,base,berry,bilobed,branched,broadly,calyx,closely,cm,conical,corolla,dark,decurrent,deflexed,dendritic,densely,dry,ellipsoid,elliptic,erect,filament,flattened,glabrous,globose,green,inflorescence,irregularly,later,leaf,lobe,lobed,long,matted,minor,minutely,mm,occasionally,onto,opposite,ovary,ovate,papillose,pedicel,petiole,pitted,pore,poricidal,pubescent,reniform,scar,shaped,shrub,simple,size,somewhat,spaced,splitting,stem,stigma,style,surface,tear-drop,thick,tip,triangular,trichome,tube,waxy,way,white,woody,x,young	1-2,1.7-2,5-6,5-60-flowered,abaxially,adaxially,along,apparently,appearing,axi,bearing,brown,bullate,cell,corrugated,dense,denser,dia,differing,difoliate,drying,eaf,edicel,eed,exserted,fleshy,free,fruiting,geminate,golden,gra,incrassate,lateral,lea,like,lon,los,lower,main,major,margin,mature,middle,moderately,nflorescence,obscured,open,otherwise,pair,paler,papillo,pericar,planar,portion,present,pubecsence,rich,ruit,sparsely,stone,strongly,tall,time,tub,tuft,ud,unifoliate,unit,vein,widest,ympodial	5-60,arrangement,bud,coat,colour,connation,decurrency,embryo,feature,flower,form,fruit,gray,growth,height,history,length,life,midpoint,na,new,number,papilla,plant,prickle,ray,reproduction,seed,shape,spacing,specimen,texture,tuberculation,type,width,winging	.5,/3,0.5-10,0.8-1,1-1.2,1-1.5,1-4,1.2-5,1.5,1.5-2,2-3,2-4,4-18,4-8,7-27,7-9,acute,base,berry,bilobed,branched,broadly,closely,cm,conical,dark,decurrent,deflexed,dendritic,densely,ellipsoid,elliptic,erect,flattened,glabrous,globose,green,irregularly,later,leaf,lobed,long,matted,minutely,mm,occasionally,onto,opposite,ovate,papillose,petiole,pitted,poricidal,pubescent,reniform,shaped,shrub,simple,somewhat,spaced,splitting,tear-drop,thick,tip,triangular,trichome,waxy,way,white,woody,x	5-60,gray,na
544	wfo-0001032576	success	227	117	84	98	129	19	83	1	-10,/5,0-5,0.3-0.7,0.5-1,0.5-2,0.5-4,0.8-1.2,0.8-1.4,1-4,1.5-2,1.5-2.3,1.5-7.5,1.8-2.5,1/3,2-10,2-4,2-5,3-14,acute,anther,apart,apex,apically,base,berry,bright,brown,calyx,cell,cm,cuneate,deltate,densely,diameter,ellipsoid,evenly,flattened-reniform,flower,fruit,glabrescent,glandular,gray,green,hair,herb,infructescence,lanceolate,lateral,leaf,length,lobed,long,maturity,minutely,mm,moderately,obtuse,often,outline,ovate,pale,pedicel,peduncle,per,petiole,pit,poricidal,prickly,purple,raised,red,reticulate,scar,shiny,shrub,simple,slender,small,sparsely,spherical,spreading,stellate,stellate-pubescent,stem,style,surface,tapering,terminal,tip,tube,upper,way,white,wide,yellow,yellow-orange,young	-12,/4,0-1.5,0-2,0-3,0-30,0.1,0.1-0.15,0.1-0.2,0.1-0.25,0.3-0.5,0.5-1.5,0.8-2,1-3,1.2-1.8,1/2-2/3,1/3-1/6,2-3,2.5-3,2.5-4,4,4-5-merous,4-6,4-6-8,4-6.5,5-30,6-8,7-8,abaxially,acuminat,alyx,apar,apparently,articulated,ascendant,ba,bark,blade,branched,branching,brow,brown-green,chartaceous,concolorous,conical,curved,difoliate,distance,drying,dull,eaf,eed,elongating,entire,equal,erect,extending,eye,faint,filament,flattened,free,fruiting,geminat,glabrous,gland,globular,herbaceous,lobe,longer,lower,margin,mature,membranous,midpoint,midvein,naked,narrow-deltate,narrow-ovate,near,nflorescence,obovate,older,one,open,orange-brown,orolla,oung,pair,perfec,pericarp,porrect,portion,prickl,prickle,primary,ray,red-green,reduced,reflexed,rounded,ruit,scandent,sessile,short,shorter,side,slightly,smooth,sometimes,spaced,stalk,stalked,straight,tamen,tertiary,time,trichome,unarmed,unit,usually,variously,vary,vein,venation,visible,woody,yellow-green,ympodial	abaxial,acuminate,adaxial,arrangement,colour,corolla,feature,form,growth,inflorescence,number,ovary,seed,shape,size,spacing,texture,type,width	-10,/5,0-5,0.3-0.7,0.5-1,0.5-2,0.5-4,0.8-1.2,0.8-1.4,1-4,1.5-2,1.5-2.3,1.5-7.5,1.8-2.5,1/3,2-10,2-4,2-5,3-14,acute,apart,apically,base,berry,bright,brown,cell,cm,cuneate,deltate,densely,diameter,ellipsoid,evenly,flattened-reniform,glabrescent,glandular,gray,green,hair,herb,infructescence,lanceolate,lateral,lobed,long,maturity,minutely,mm,moderately,obtuse,often,outline,ovate,pale,per,pit,poricidal,prickly,purple,raised,red,reticulate,shiny,shrub,simple,slender,small,sparsely,spherical,spreading,stellate,stellate-pubescent,tapering,terminal,tip,upper,way,white,wide,yellow,yellow-orange,young	acuminate
545	wfo-0001032595	success	197	137	84	93	104	44	82	2	-pilose,0.5-1,1-2,1-3,1-6,1.5-2.5,1.5-4.5,15-25,15-40,2-4,2.3-24,3-10,3-12-25,3-4,4-25,4-7,5-6,6-7,acuminate,acute,along,anther,apart,apex,apiculate,basal,base,branch,branched,brownish-purple,calyx,cm,connivent,cordate,cucullate,deeply,deltate,densely,diameter,dull,eglandular,ellipsoidal,filament,finely,flattened,flower,fork,forked,fruit,fusiform,glabrous,glandular,greenish,hair,lanceolate,leaf-opposed,lobe,loosely,margin,mature,mm,narrowly,oblique,often,ovoid,pale,pedicel,petiole,pore,pseudohair,puberulent,pubescent,rarely,reniform,rugulose,shallow,shrub,simple,slightly,small,stellate,stigma,style,tip,tree,triangular,truncate,tube,unbranched,violet,white,x,yellow	0-0.5-3.5,1,1-2.5,1-6.5-20,1.5-2,1.5-5,12-16,2-3,25-40,3-4-foliate,3-5,4-5,5-merou,9-14,abaxially,accrescen,adaxially,aggregate,also,alyx,ape,apical,articulated,axe,blade,brownish,cell,ciliat,connective,coriaceous,cream,crow,dense,denser,dilated,directed,distally,eaf,eed,entire,equal,exceeding,free,fruiting,geminate,gland,homostylous,larg,leaving,lon,long,longitudinal,lower,m.,major,midrib,moderately,near,nflorescence,opening,orolla,ovate,part,pedicellar,peduncle,per,perfect,pilo,pilose,produced,prominent,purple,purplish,rachi,remnant,ruit,shorter,side,single,slit,spaced,sparsely,spreading,stamen,stone,strongly,subcoriaceous,swelling,tall,tamen,tem,thecae,time,tomentose,toward,trunk,two,ud,umbrella-shaped,unit,vary,vein,wide,ympodial	anthesi,arrangement,bud,coat,colour,connation,corolla,decurrency,dry,embryo,feature,form,growth,height,history,inflorescence,leaf,length,life,midpoint,minor,na,number,ovary,papilla,perennial,plant,prickle,ray,reproduction,scar,seed,shape,size,spacing,specimen,stem,surface,texture,tuberculation,type,width,winging,young	-pilose,0.5-1,1-2,1-3,1-6,1.5-2.5,1.5-4.5,15-25,15-40,2-4,2.3-24,3-10,3-12-25,3-4,4-25,4-7,5-6,6-7,acuminate,acute,along,apart,apex,apiculate,basal,base,branch,branched,brownish-purple,cm,connivent,cordate,cucullate,deeply,deltate,densely,diameter,dull,eglandular,ellipsoidal,finely,flattened,fork,forked,fusiform,glabrous,glandular,greenish,hair,lanceolate,leaf-opposed,lobe,loosely,margin,mature,mm,narrowly,oblique,often,ovoid,pale,pseudohair,puberulent,pubescent,rarely,reniform,rugulose,shallow,shrub,simple,slightly,small,stellate,tip,tree,triangular,truncate,unbranched,violet,white,x,yellow	na,perennial
