	coreid	status	nwords_original	nwords_result	nwords_recovered	nwords_omitted	nwords_created	prop_recovered	common_words	original_only	result_only
0	wfo-0001025636	success	208	86	59	149	27	0.284	0.1-0.3,1-10,1-2,1-3.5,1-5,1-5.5,1.4-3.5,10-45,2.5-6,6.5-10,abaxially,adaxially,anther,apex,blue,broadly,cell,clavate,cm,corolla,covering,diameter,elliptic,filament,flower,fruit,glabrous,globose,green,greenish,hair-like,herb,lateral,minutely,mm,moderately,mottled,odd-pinnate,ovate,ovoid,pedicel,peduncle,petiole,plant,puberulent,pubescent,purple,rotate,rotate-pentagonal,seed,slightly,stigma,style,subglabrous,testal,thick,wall,whitish,yellow	0-2,0-5,0.1,0.6-2.8,1,1-2.2,1-3,1-4,1.1-6.1,1.7-5.2,1.7-9.2,1.8,2,2-4,2.6-8.3,3-5,3-6,5-merou,9.5-29.5,absent,acumen,acuminate,acute,ag,along,alyx,apart,apparently,articulated,axe,base,berry,blade,brownish,capitat,chartaceous,ciliate,clearly,condition,connivent,contracted,cuneate,decurrent,digestion,distal,dorsally,drying,eaf,edge,eed,end,enzyme,especially,exceeding,except,flat,folded,fresh,geminat,generally,glabrou,greatly,green-white,hair,hal,half,high,highly,homostylous,honeycomb-shaped,interjected,lanceolate,larger,leaflet,lengthening,like,living,lobe,long,longer,lower,make,margin,membranous,midrib,minute,mucilaginous,multicellular,near,nflorescence,oblique,obovate,obtuse,often,orbicular,orne,orolla,pair,perfect,petiolulate,petiolule,plurifoliate,pore,poricidal,proximal,reduced,removed,ripe,rosette-forming,rounded,ruit,scale-like,semierec,sessile,seudostipule,short,singly,size,slit,sometimes,spaced,specimen,stamen,ste,stem,stolo,straight,subequal,tall,tamen,tem,terminal,throughout,tip,tri-,truncate,tube,tuber,typically,unequal,unforked,unit,unwinged,uppermost,vary,wet,wide,x,ympodial	0.1-1.8,abaxial,adaxial,arrangement,capitate,colour,form,growth,height,history,inflorescence,leaf,length,life,na,number,ovary,perennial,position,rachi,reproduction,shape,spacing,staman,surface,texture,width
1	wfo-0001025637	success	193	98	74	119	24	0.383	0-0.3,0.2-0.9,1-12,1-2,14-38,2-20,2.5-8,2.8-4.2,3-10,3-5,5-7,abaxially,acuminate,acute,adaxially,anther,apex,axillary,blue,brownish,bud,cell,clavate,cm,condition,coriaceous,corolla,covering,dark,deep,diameter,dot,drying,elliptic,filament,flower,forked,fresh,fruit,glabrescent,glabrous,globose,green,greenish,hair-like,herb,lateral,leaf,light,lilac,medium,mm,odd-pinnate,ovoid,pedicel,peduncle,pentagonal,petiole,plant,rachi,rotate,seed,stigma,stripe,style,subtending,terminal,testal,thick,tiny,wall,white,whitish,yellow	0-27,0.2-0.5,0.3-0.5,0.8-2.6,1-2.5,1-5,1.2-3.5,1.5-5,1.6-2.5,2-3,2-7,3-4,3-9,4-6,5-merou,acumen,adaxiall,ag,along,alyx,apart,apparently,arranged,articulated,attenuate,axe,base,bead,berry,blade,capitat,connivent,cuneate,decreasing,decurrent,digestion,distal,dorsally,eaf,edge,eed,enzyme,erec,exceeding,flat,folded,geminat,generally,glabrou,green-white,hair,hal,half,high,homostylous,honeycomb-shaped,interjected,lanceolate,leaflet,lengthening,like,linear,living,lobe,long,lower,make,moniliform,mottled,mucilaginous,multiple,necklace,nflorescence,onto,orolla,ovate,pair,perfect,petiolulate,petiolule,plurifoliate,pore,poricidal,purple,removed,ripe,rounded,ruit,secondary,seudostipule,short,size,slit,sometimes,spaced,specimen,stamen,stolon,straight,subequal,symmetric,tall,tamen,tem,throughout,tip,toward,tri-,tube,tuber,typically,unit,unwinged,usually,vary,wet,wide,x,ympodial	abaxial,adaxial,arrangement,capitate,colour,form,growth,height,history,inflorescence,length,life,na,number,ovary,perennial,position,reproduction,shape,spacing,staman,surface,texture,width
2	wfo-0001025639	success	154	76	51	103	25	0.331	1-2,1-3,1-4,2.8-3.2,20-35,4-10,6-8,8-12,8-9,apex,branched,broadly,cm,corolla,cyme,dark,diameter,dichasial,dichasially,distal,ebracteate,elliptic,filament,flower,globose,green,green-white,half,herbaceous,leaf,medium,mm,monochasial,obovate,odd-pinnate,ovate,ovoid,pedicel,peduncle,perennial,petiole,plant,puberulent,pubescent,rotate,seed,stigma,style,violet,white,yellow	10-21,2-3,2-3.5,3-4,3-5,3-6,3-6-foliat,3.5-7,4.5-8.5,5-1.,5-10,5-8,6-12,abaxially,acumen,acuminate,acute,adaxially,apical,apically,articulate,base,belo,calyx,cell,connate,covering,cuneate,dehiscent,digestion,diminishing,dorsally,eaf,edge,eed,elliptical,emoval,enzyme,exceeding,flat,folded,forked,frequently,generally,globo,gradually,hair-like,honeycomb,interjected,introrse,lateral,leaflet,lobe,lon,long,long-attenuate,lower,lunat,make,maturing,mucilaginous,nflorescence,nther,oblique,often,orolla,pair,pattern,perfect,petiolule,plan,poricidally,present,produced,proximal,rare,reveal,ruit,seudostipule,short,size,slit,sometimes,stamen,straight,tal,tem,terminal,testal,thick,throughou,throughout,top,toward,truncate,tuber-bearing,typically,unit,vary,wall,wide,ympodial,¼	abaxial,adaxial,anther,arrangement,colour,form,fruit,growth,height,history,inflorescence,length,life,na,number,ovary,position,rachi,reproduction,shape,spacing,staman,surface,texture,width
3	wfo-0001025642	success	149	83	62	87	21	0.416	0.3-0.4,1-2.7,1-3.2,1.5-2.5,10-20,2-10,2-3,3-5,5-6,9-12,acuminate,acute,apex,articulate,base,branched,cm,corolla,cyme,diameter,dichasial,dichasially,diminishing,distal,ebracteate,flower,forked,globose,gradually,green,green-white,half,herbaceous,lanceolate,lateral,leaf,leaflet,lunate,mm,monochasial,mucilaginous,oblique,obtuse,odd-pinnate,ovoid,pedicel,peduncle,perennial,petiole,plant,proximal,puberulent,seed,sessile,size,stellate,stigma,style,terminal,throughout,yellow,¼	1,1-2,1-2.5,1-3,1-4,3,3-6-foliat,3.5-6,4-7.5,4.5-8,5.5-7,7-11.5,8-13,abaxially,absen,absent,acumen,adaxially,apical,apically,apiculate,attenuate,calyx,cell,connate,covering,dehiscent,digestion,dorsally,eaf,edge,eed,elliptic,elliptic-lanceolate,emoval,enzyme,exceeding,filament,flat,folded,generally,globo,hair-like,honeycomb,interjected,introrse,lanceolat,living,lobe,lon,long,lower,make,maturing,nflorescence,nther,often,orolla,pair,pattern,perfect,plan,poricidally,present,reveal,ruit,seudostipule,short,slit,specimen,stamen,straight,tal,tem,testal,thick,throughou,toward,tuber-bearing,typically,unit,vary,wall,whit,wide,without,ympodial	anther,arrangement,color,form,fruit,growth,height,history,inflorescence,length,life,number,ovary,position,reproduction,shape,spacing,stem,surface,texture,white
4	wfo-0001025644	success	204	79	53	151	26	0.26	1-10,1-2,1.3-2.1,10-11,13-21,2-3,2.5-6,25-50,3-10,4-19,4-6,abaxially,adaxially,anther,apex,blue,broadly,clavate,cm,corolla,diameter,elliptic,filament,flower,forked,fruit,glabrous,globose,green,greenish,herb,minutely,mm,mucilaginous,odd-pinnate,ovate,ovoid,pedicel,peduncle,pentagonal,petiole,plant,puberulent,pubescent,seed,stigma,style,terminal,tinged,wet,white,whitish,yellow	.3,0-5,0.8-1.5,10,12-28,2,2-4,2.4-4,2.5-11,3-4,3-5,3.3-8.2,4.5-9.5,5-merou,6-7,6.5-13,absent,acumen,acuminate,acute,ag,almost,along,always,alyx,apart,apparently,articulated,attenuate,axe,axillary,base,berry,blade,brownish,bud,c.,capitat,cell,chartaceous,ciliate,condition,connivent,cordate,covering,cuneate,denticulate,digestion,distal,dorsally,drying,eaf,edge,eed,end,enzyme,erec,especially,exceeding,except,finely,flat,folded,fresh,geminat,generally,glabrou,greatly,green-white,hair,hair-like,half,homostylous,honeycomb-shaped,interjected,invested,lanceolate,lateral,leaflet,lengthening,like,living,lobe,long,lower,make,margin,membranous,middl,midrib,mottled,multicellular,nflorescence,non-glandular,oblique,often,one,orbicular,orolla,pair,perfect,petiolule,placed,plurifoliate,pore,poricidal,proximal,purple,rarely,reduced,removed,rounded,ruit,sessile,seudostipule,shallowly,short,size,slit,spaced,specimen,stamen,ste,stem,stolo,straight,subequal,subtending,tall,tamen,tem,testal,thick,throughout,tip,tri-,trichome,truncate,tube,tuber,typically,uniseriate,unit,usually,vary,wall,well-developed,wing,winged,x,ympodial	abaxial,adaxial,arrangement,capitate,colour,form,growth,height,history,inflorescence,leaf,length,life,na,number,ovary,perennial,position,rachi,reproduction,shape,spacing,staman,surface,texture,width
5	wfo-0001025645	success	150	72	47	103	25	0.313	0.3-0.8,1-3.5,1-4,10-11,12-17,15-25,2-4.5,2.5,5-5.5,apex,branched,cm,corolla,cyme,diameter,dichasial,dichasially,distal,ebracteate,elliptic-lanceolate,filament,flower,glabrous,globose,green,green-white,half,herbaceous,lanceolate,leaf,mm,monochasial,odd-pinnate,ovoid,pedicel,peduncle,perennial,petiole,plant,puberulent,rachi,seed,stellate,stigma,style,throughout,yellow	0.5-1,0.8,1-2,10-16,2-3,3-5.5,3-6-foliat,4-12,4-5,4-6,4-7,5,8-10,abaxially,absen,acumen,acuminate,acute,adaxially,apical,apically,articulate,base,calyx,cell,connate,covering,cuneate,decurrent,dehiscent,digestion,diminishing,dorsally,eaf,edge,eed,elliptic,emoval,enzyme,exceeding,flat,folded,forked,generally,globo,gradually,hair-like,honeycomb,interjected,introrse,larger,lateral,leaflet,living,lobe,lon,long,lower,lunat,make,maturing,mucilaginous,mucronate,nflorescence,nther,oblique,oblong,often,orolla,pair,pattern,perfect,plan,poricidally,proximal,reveal,ruit,second,sessile,seudostipule,short,size,slit,specimen,stamen,straight,tal,tem,terminal,testal,thick,throughou,toward,tuber-bearing,typically,unit,vary,wall,whit,wide,without,ympodial,¼	abaxial,adaxial,anther,arrangement,colour,form,fruit,growth,height,history,inflorescence,length,life,na,number,ovary,position,reproduction,shape,spacing,staman,surface,texture,white,width
6	wfo-0001025646	success	136	69	44	92	25	0.324	0.25-0.4,0.6-3,0.7-3.5,1-4,1.1-1.4,3.2-6,4-10,4-5,7-8,apex,branched,cm,corolla,cyme,diameter,dichasial,dichasially,distal,ebracteate,elliptic,filament,flower,fruit,globose,half,herbaceous,leaf,mm,monochasial,odd-pinnate,ovary,ovate,pedicel,peduncle,pentagonal,perennial,petiole,plant,probably,puberulent,stigma,strigose,style,yellow	0-.,0.5-2.1,0.6-2.3,1-7,1.1-4.5,1.2,1.2-7.0,1.5-3,2-3,2-4,2.3-9.0,2.5-3,3,3-6-foliat,3.5-7,4-15.5,abaxially,abruptly,acumen,acuminate,acute,adaxially,apical,apically,apiculate,articulate,attenuate,ature,base,calyx,caudate,connate,cuneate,decurrent,dehiscent,diminishing,dorsally,eaf,edge,eed,exceeding,flat,folded,forked,generally,globo,gradually,interjected,introrse,lateral,leaflet,like,lobe,lon,long,lower,lunat,maturing,nflorescence,nther,oblique,obovate,often,orolla,pair,perfect,petiolule,plan,poricidally,proximal,seen,sessile,seudostipule,short,size,slightly,slit,sometimes,stamen,straight,tal,tem,terminal,toward,tuber-bearing,typically,unit,vary,whit,wide,ympodial,¼	abaxial,adaxial,anther,arrangement,colour,form,growth,height,history,inflorescence,length,life,na,number,position,rachi,reproduction,seed,shape,spacing,staman,surface,texture,white,width
7	wfo-0001025647	success	194	86	60	134	26	0.309	0.06-0.24,0.8-3,1-10,1-2,1.2-3,1.4-5,2-4,2-5,2.5-3,4-10,5-6,abaxially,adaxially,anther,apex,articulated,axillary,blue,cell,clavate,cm,corolla,covering,densely,diameter,elliptic,filament,flower,fruit,glabrous,globose,green,greenish,hair-like,herb,lateral,light,linear,minutely,mm,moderately,narrowly,odd-pinnate,ovoid,pedicel,peduncle,petiole,plant,puberulent,pubescent,rotate,seed,stigma,style,testal,thick,unbranched,wall,whitish,yellow	0-4,0.4-1.5,0.6-3,1,1-3,1-5,1.3-2.9,1.5-5,1.5-5.5,2,2-3,3-6,4-6,5-merou,6.2-11,absent,acumen,acute,ag,along,alyx,apart,apparently,attenuate,axe,base,berry,blade,borne,broadly,brownish,bud,capitat,chartaceous,ciliate,condition,connivent,decurrent,digestion,distal,dorsally,drying,eaf,edge,eed,end,enzyme,erec,especially,exceeding,except,flat,folded,forming,frequently,fresh,geminat,glabrou,greatly,green-white,hair,hal,half,high,homostylous,honeycomb-shaped,interjected,lanceolate,leaflet,lengthening,like,living,lobe,long,lower,make,margin,membranous,midrib,mucilaginous,multicellular,near,nflorescence,oblique,obtuse,often,orbicular,orolla,ovate,pair,perfect,petiolulate,plurifoliate,pore,poricidal,proximal,reduced,removed,ripe,rosette,ruit,scale-like,sessile,seudostipule,short,singly,size,slit,sometimes,spaced,specimen,stamen,ste,stem,stolo,straight,subequal,subtending,tall,tamen,tem,terminal,throughout,tip,tri-,tube,tuber,typically,unit,unwinged,vary,wet,x,ympodial	abaxial,adaxial,arrangement,capitate,colour,form,growth,height,history,inflorescence,leaf,length,life,na,number,ovary,perennial,position,rachi,reproduction,shape,spacing,staman,surface,texture,width
8	wfo-0001025652	success	156	81	57	99	24	0.365	.3,0.5-1,1-1.5,1.5-2,2-3,2-6,3-5,4-6,4-7,acute,anther,anthesi,apex,base,bilobed,closely,cm,corolla,elliptic,filament,fleshy,flower,fruit,furcate,glabrous,growth,leaf,lobed,minutely,mm,nearly,occasionally,opposite,ovary,ovoid-reniform,pale,paler,pedicel,petiole,pitted,planar,plant,shape,shiny,shrub,simple,small,spaced,stigma,strongly,style,surface,tan,tree,white,winged,x	.5,1,10-20,15-17,15-19,2-5,20-50,3-3.5,3-5-flowered,4,9-11,abruptly,acuminate,appearing,bark,blade,broad,calyx,campanulate,closed,completely,connate,decurrent,densely,dia,differing,difoliate,dry,eaf,edicel,eed,emerge,envelope,free,geminat,glabrate,green,greyi,greyish,growing,irregular,lateral,like,live,lobe,lon,long,lower,main,major,margin,matte,middle,minor,minute,narrowing,new,nflorescence,older,one,onto,overlappin,ovoid,pair,papillae,papillo,papillose,parallel,pinkish-grey,pore,poricidal,portion,rather,red-papillose,ry,scar,shaped,size,soon,specimen,stem,straight,tall,tapering,tear,tear-drop,thick,thicker,tightly,tip,tube,ud,unit,vein,wider,widest,wing,ympodial,young	abaxial,adaxial,arrangement,colour,diameter,form,height,history,inflorescence,length,life,na,number,overlapping,peduncle,perennial,position,rachi,reproduction,seed,spacing,staman,texture,width
9	wfo-0001025653	success	218	72	45	173	27	0.206	.0,.3,.5,.6,.7,.8,.9,1.3,20,anther,apart,apex,chartaceous,cm,corolla,densely,diameter,extra-axillary,filament,flower,fruit,glabrous,globose,lateral,leaf,least,long,mm,obtuse,ovate,pedicel,peduncle,petiole,pubescent,rhizomatous,short,shrub,simple,stellate,stigma,straight,style,surface,truncate,unbranched	.1,.2,0.1,0.13,0.15,0.2–0.4,0.3–0.5,0.3–0.8,0.6–1.6,0.7–1.1,0.8,1.0–1.6,1.1–1.3,1.3–1.8,1.6,1.9–3.3,1–1.5,2.3–3.2,2.5–4.0,2.6,4–6,5-merou,6–8,6–9,7–12,8–11,90°,abaxially,absent,acuminate,adaxiall,adaxially,adnate,aequilateral,ag,alyx,among,anthesi,apical,apparently,appearing,around,articulate,attenuate,axe,ba,bark,base,blade,broad,brown,bud,calyx,channeled,clinate,congested,craspedodromous,cylindrical,deltoid,developed,directed,distinct,dry,eaf,edge,eed,either,emerging,entire,erect,extending,ferruginous,fertile,filiform,free,glandular,globolunate,hair,heterostylous,increasing,intact,internode,interpetalar,intersepalar,know,known,lanceolate,layer,less,lobe,lobed,lon,longer,low,lower,margin,mature,midpoint,midrib,midvein,minute,much,nflorescence,noticeably,oblique,occasionally,opaque,opposed,orolla,persistent,plurifoliat,pore,porrect,porrect-stellate,portion,potentially,prickl,prickle,primary,raised,ray,reddish,reduced,remaining,restricted,rigid,rounded,row,ruit,scarcely,secondary,see,seen,sessile,short-stipitate,shorter,shot-stipitate,side,sinuate,sloughing,sparsely,splitting,spread,stamen,stellae,stellate-pubescent,stem,stipe,stipitate,subcordate,suture,tamen,tem,time,tip,tissue,transparent,truncat,tube,two,ud,unarme,unarmed,vary,vein,well,wide,yellow-ferruginous,ympodia,young,±equal,±erect,×	0.6-1.6,5-merous,6-8,abaxial,adaxial,arrangement,colour,form,growth,height,history,inflorescence,length,life,na,number,ovary,plant,position,rachi,reproduction,seed,shape,spacing,staman,texture,width
10	wfo-0001025654	success	140	88	58	82	30	0.414	1,1-2,15-22,2,2-2.5,4-5,5-6,5-merous,abaxial,abaxially,absent,adaxial,anther,apex,broadly,calyx,chartaceous,cm,diameter,dull,elliptic,filament,flower,fruit,fruiting,glabrous,globose,hooked,inflorescence,leaf,margin,minutely,mm,pale,pedicel,pedicellate,peduncle,petiole,position,prickle,pubescent,purple,rachi,repand,shallowly,shrub,simple,slender,slightly,stellate,stem,stigma,straw-coloured,style,sub-axillary,surface,triangular,yellow	0,2-foliate,25-30,3/4,4,5,6,7-8,?,abortive,abundant,accrescen,acumen,acuminate,alyx,ape,apica,apparently,armed,articulated,axe,ba,base,blade,branched,cuneate,eaf,eed,erect,flattened,frequently,geminat,glandular,hair,homostylou,juvenile,lanceolate,larger,later,less,lobe,long,lower,mainly,mature,midvein,minute,mostly,narrowed,nflorescence,oblique,often,older,orolla,phase,pore,retrorse,ruit,scarcely,scattered,sessile,several,shortly,single,size,smaller,solitary,sparsely,sub-acuminate,tal,tamen,tem,tip,toward,unarme,unit,unknow,unknown,vary,x,ympodial,young	arrangement,bark,bud,cell,center,colour,corolla,form,growth,height,history,length,life,na,new,number,ovary,perennial,plant,red,reproduction,scar,seed,shape,spacing,staman,texture,trichome,unarmed,width
11	wfo-0001025655	success	226	97	78	148	19	0.345	1-1.2,1-1.5,1-2,1.3-1.5,1.5-2,2-3.5,3-5,4-5,6-7,abaxial,acuminate,anther,apex,asymmetric,attenuate,base,beige,cinereous,clavate,cm,cordate,cordate-lanceolate,cyme,deeply,diameter,enlarged,epicarp,equal,ferruginous,ferruginous-pubescent,ferruginous-tomentose,filament,flower,fruit,glabrous,globose,held,helicoid,hirsute-glandular,leaf,leathery,length,lilac,linear-lanceolate,minutely,mm,parted,pedicel,peduncle,persistently,petiole,plant,rachi,rugose,shrub,slender,slightly,solitary,stellate,stigma,style,sub-capitate,sub-globose,sub-quadrangular,subreniform,subsagittate,subterete,surface,tomentose-velutinous,unarmed,unbranched,upright,villous,violet,viscid-velutinous,within,without,yellowish	-3-5-lobed,-8-17,0.3-0.4,0.6-0.8,1-3,1.4-2,11,2,2-2.5,2-3,2-5-celled,2.5-3,2.5-5-,3-,3-7,3-8-flowered,4,4-6,5-6-merous,5-7,6-8,8-10,accrescent,along,alyx,anthesi,armed,articulate,ba,bark,basal,blade,branch,branched,brow,brown,calyx,canaliculate,central,compressed,curved,dark,densely,di-,discolorous,distal,dry,eaf,eed,elongate,entire,erect,exceeding,free,fruiting,functional,fused,geminat,glabrescent,gland,glandular,glandular-stellate,glandular-tipped,gynoeci,indument,lanate,lobe,long,long-exserted,long-stalked,longer,lower,many-celled,maturit,midrib,mix,monoclinous,mucilaginous,multiangulate,multiangulate-stellate,multiseriate,nflorescence,numerous,oblong-urceolate,older,one,orolla,papillo,part,peduncl,perennia,persistent,petiol,porrect-stellate,prickle,primary,prolonged,prominent,ranch,ray,recurved,reddish,reduced,reflexed,rounded,ruit,secondary,sepal,sessile,short,similar,small,somewhat,sparsely,splitting,stalk,stalked,stamen,staminate,stellae,stellate-glandular,stem,straight,strongly,sub-sessile,subcoriaceous,surrounded,tall,tamen,terete,time,tomentose,triangular-lanceolate,trichome,trifoliate,tube,uniseriate,unit,vary,vein,velutinous,weakly,wide,woolly,ympodial,young,¼,½	adaxial,arrangement,colour,corolla,form,growth,height,history,inflorescence,life,ovary,papillose,perennial,position,reproduction,seed,shape,staman,texture
12	wfo-0001025656	success	209	104	84	125	20	0.402	-10,0.2-,0.8-1,1-1.5,1-4,1.5-2,12-15,2.5-5,3-12,4-5,8-9,abaxially,acuminate,adaxially,almost,anther,apart,apex,base,berry,blue,brown,chartaceous,clavate-truncate,cm,coriaceous,corolla,corymbose,cyme,diameter,elliptic,elliptic-ovate,elongate,filament,flattened,flower,glabrous,glandular,globose,green,grey,growth,heterostylous,hirsute,inflorescence,internodal,lanate,lobed,long-styled,loosely,mature,minutely,mm,ochraceous,ovary,ovate,pedicel,peduncle,petiole,plant,poricidal,purple,reniform,reticulate,rusty,short-styled,shrub,simple,stellate,stigma,style,subcoriaceous,subglobose,subreniform,surface,tapering,tip,tomentose,tomentose-lanate,tomentose-velutinous,trichome,viscid,x,yellow	-14,0.2-0.3,0.2-0.4,0.5-0.6,1-2,1.8-2,1/3,10-,10-15,2-2.5,3,3-3.5,3-7,30-40,4-4.5,4-6,5-,6,6-11,8-10,acute,adult,along,anthesi,apical,apically,armed,bark,basal,branched,calyx,cell,channelled,congested,cuneate,curved,densely,denser,discolorous,distal,eaf,eed,entire,erect,evenly,exserted,flexuous,foliaceous,free,fruiting,gland,gre,inflorescenc,juvenile,lengthening,like,linear-lanceolate,lobe,lobed-angulate,long,long-stalked,longer,looser,lower,margin,midpoint,midrib,minute,mixed,multangulate,multicellular,near,new,nflorescence,older,papillat,partially,perfect,pericarp,plurifoliat,pore,porrect,portion,prickle,prickly,pubescence,pubescent,raised,reflexed,relatively,rounded,rugose,ruit,scandent,scar,sessile,several,short-stalked,single,slightly,spaced,sparse,sparsely,stalk,staminate,stem,straight,subscandent,subtuncate,tall,testa,time,tube,turbinate,ud,unit,upper,vein,venation,white,whitish,without,wood,ympodial,young	abaxial,adaxial,arrangement,colour,form,fruit,height,history,leaf,length,life,papillate,perennial,position,reproduction,seed,shape,spacing,staman,texture
13	wfo-0001025657	success	239	93	70	169	23	0.293	0.1-0.4,0.2-0.4,0.5-2.5,1-1.6,1-3,1.3-2,1.5-1.8,2-10,2-3.5,2.7-4.3,25-60,3-6,4-4.4,5-14,5-16,8.3-12,abaxially,adaxially,anther,apart,berry,bluish,branched,brown,cm,conical,corolla,dark,deltoid,densely,diameter,dried,filament,fleshy,flower,fruit,granular,green,leaf,length,mm,narrowly,ovate,pale,pedicel,peduncle,persistent,petiole,pseudo-terminal,rachi,reticulate-punctate,ripe,shrub,simple,soft,stellate,stellate-pubescent,stigma,style,suborbicular,surface,tan,tomentose-pubescent,tomentum,tree,velutinous-pubescent,white,x,yellow,yellowish	-2,/3,1-1.1,1-1.3,1.2-1.5,1.7-1.9,12x,2.2-5.5,2.5-9.3,2/3,3-4,3-4.8,3.2-6,4-4.5,4-7,6-12,6-8,6.5-10,7-27,7-9,7-9.5,8-10.5,accrescent,acute,ag,also,anthesi,apex,apparently,appearing,ark,around,articulated,ascending,axe,axillary,ba,base,blade,blunt-tipped,branch,broadly,bud,calyx,capitat,central,chartaceous,closely,cordate,cylindrical,dendritic-multangulat,dendritic-multangulate,dense,directed,distally,due,eaf,earl,edge,eed,elliptic,entire,especially,evident,exerted,expanded,exserted,farinose,few-rayed,free,fruiting,glabrous,glandula,glandular,hair,half,inserted,lanate-pubescent,lanceolate,lateral,lengthening,light,lobe,lobed,long,long-stalked,longitudinal,lower,m.,magnification,main,margin,midrib,minutely,mixed,multangulate,nearly,nflorescence,oblong,obtuse,occasional,often,older,open,orbicular,orolla,ovat,ovate-lanceolate,overlapping,part,parted,partly,perfect,persistently,plurifoliate,pore,poricidal,porrect-stellate,present,pubescence,pubescent,ray,reportedly,ruit,scented,semi-ovate,sessile,short,short-,short-stalked,side,slightly,slit,somewhat,spaced,splitting,stamen,stem,stipitate-glandular,stipitate-multangulate,strongly,subcampanulate,subcoriaceous,suture,tall,tamen,terete,thick-stalked,thickened,thin-stalked,time,tip,tomentose,transparent,tube,two-third,ud,unarme,unarmed,unit,upper,usually,vary,vein,way,weakly,wide,ympodial,young	abaxial,adaxial,arrangement,capitate,colour,form,growth,height,history,inflorescence,life,na,number,ovary,perennial,plant,position,reproduction,seed,shape,spacing,staman,texture
14	wfo-0001025666	success	217	77	58	159	19	0.267	0.3,0.5-1,0.5-1.5,1,1-1.5,1-1.7,1.5-2.5,4-5,6-7.5,acute,andromonoecious,anther,apex,base,chartaceous,cm,densely,diameter,elliptical,extra-axillary,filament,finely,flattened,flower,fruit,glabrous,globose,green,inflorescence,leaf,length,lobed,mm,ovate,pale,perennial,petiole,pinkish,plant,prostrate,pseudo-racemose,pseudo-umbellate,purple,reticulate,shallowly,simple,sparsely,stellate-pubescent,stigma,stoloniferous,style,surface,white,whitish,x,yellow,yellowish,yellowish-green	%,.8,0-0.7,0-5,0.05-0.25,0.2-0.3,0.2-0.35,0.2-0.8,0.25-0.35,0.25-0.4,0.5-2,1-1.4,1-2,1-locular,1.5-1.8,1.5-3.5,1.6-2.3,10-30,14-29,2-3,2-4,2-8,2.8-4.5,20-60,21-30,25-65,3-3.5,3-5,3-7,3.5-4,4-6,5-6,5-merou,5.5-9.5,6-20,7-8,8-12,9-10,9-20,abaxially,absen,absent,acicular,across,adaxially,alyx,apart,armed,articulated,attenuate,axe,ba,blade,brown,calyx,capitat,center,confined,connivent,cross-section,cuneate,cylindrical,d.,difoliate,directed,distal,distall,eaf,eed,eglandular,elliptica,entire,exocarp,finger,fruiting,functional,geminate,gland-tipped,hair,half,heterostylous,incomplete,index,interpetalar,juicy,lamina,lateral,less,lobe,lobing,long,longer,loosely,lower,margin,mature,mesocarp,midpoint,midrib,midvein,minute,moderately,moist,narrowly,nflorescence,oblique,obtuse,orolla,part,pedicel,peduncle,per,placenta,pore,porrect,presen,present,prickle,probably,rachi,ray,ridged,ruit,septum,sessile,short,shrub,side,slightly,spaced,sparse,stage,stellae,stellate,straight,strongly,tal,tamen,tapered,tem,terete,thick,throughout,time,tissu,tissue,transparent,triangular,tube,unarme,unarmed,unbranched,unit,uvenile,vary,vein,weakly,wide,ympodial	5-merous,abaxial,adaxial,arrangement,capitate,colour,corolla,form,growth,height,history,life,ovary,position,reproduction,seed,shape,staman,texture
15	wfo-0001025669	invalid_json	216	105	71	145	34	0.329	'',.5,0.1-0.3,1-10,1-2,1-4,1.4-2.5,13-35,2-3,2.2-6.5,3-7,``,abaxially,adaxially,anther,apex,base,blue,broadly,brownish,cell,clavate,cm,condition,corolla,covering,diameter,drying,elliptic,filament,flower,fresh,fruit,glabrous,globose,green,greenish,herb,lateral,minutely,mm,moderately,monochasium,obtuse,odd-pinnate,ovate,ovoid,pedicel,peduncle,petiole,plant,puberulent,pubescent,purple,rarely,ripe,rotate,seed,slightly,stigma,streaked,style,subglabrous,testal,thick,tinged,typically,wall,white,whitish,yellow	0-1,0-5,0-7,0.8-2.4,1,1-2.2,1-3,1.3-4.2,1.6-4.4,2,2-4,2.2-6,2.4-7,3-5,4-6,5-merou,9-24.5,absen,absent,acumen,acuminate,acute,ag,along,alyx,apart,apparently,articulation,axe,berry,blade,capitat,chartaceous,ciliate,clearly,connivent,contracted,cuneate,decurrent,digestion,discussion,distal,distinct,dorsally,eaf,edge,eed,end,enzyme,erec,especially,exceeding,except,extra,flat,flowered,folded,forming,geminat,glabrou,greatly,green-white,hair,hair-like,half,highly,homostylous,honeycomb-shaped,interjected,lanceolate,larger,leaflet,lengthening,like,living,lobe,long,lower,make,margin,membranous,midrib,minute,mottled,mucilaginous,multicellular,near,nflorescence,oblique,obovate,often,one,orbicular,orolla,pair,perfect,petiolulate,petiolule,placed,plurifoliate,pore,poricidal,proximal,reduced,removed,rosette,rounded,ruit,scale-like,see,sessile,seudostipule,short,single,size,slit,sometimes,spaced,species,specimen,stamen,ste,stem,stolo,straight,subequal,tall,tamen,tem,terminal,throughout,tip,tri-,truncate,tube,tuber,unbranched,unequal,unit,unwinged,vary,wet,wide,x,ympodial	'extra,'hair-like,[,],abaxial,adaxial,arrangement,capitate,characteristic,colour,form,growth,height,history,inflorescence,leaf,length,life,na,number,ovary,perennial,position,rachi,reproduction,shape,spacing,staman,surface,texture,value,width,{,}
16	wfo-0001025685	success	222	104	84	138	20	0.378	/3,0.4-6,1-4,1.5-2,12-13,2-4,2-5,2-6,2-7,3-10,3-3.5,4-5,6.5-9,abaxially,adaxially,adult,angulate,anther,apart,articulated,base,berry,brown,chartaceous,clavate,cm,cordiforme,coriaceous,corolla,dark,diameter,discolorous,entire,filament,finely,flattened,flower,glabrous,glandular-viscid,globose,green,growth,internodal,juvenile,lanceolate,like,lobed,long-styled,margin,mm,orangish,ornamented,ovary,ovate-cordiforme,ovate-elliptic,pedicel,peduncle,petiole,plant,quadrate,red,reniform,reticulate,ripe,shallowly,short-styled,shrub,simple,small,stellate,stem,stigma,style,subcompressed,subglobose,subscabrous,subtruncate,tomentose-scabrous,tomentose-velutinous,tree,velutinous-floccose,way,white,yellowish	-15,-22,-30,/4,0.2-0.3,0.3-0.5,0.3-1,0.45-0.9,0.5-1,1-1.5,1-multicellular,1.4,1.5-2.5,1.8-2.5,10-15,2,2-2.2,2-3,3,3-4,3.5-10,4-4.5,50,7-18,7-8,8-10,<,acuminate,acute,anthesi,apex,apiculate,armed,ascendin,bark,basal,basally,branched,caly,calyx,channelled,concav,cordate,cuneate,curved,deciduous,deltate,dense,distal,eaf,eed,elongating,erect,exserted,flowering,foliaceous,free,fruiting,glabrescen,glandular,heavily,heterostylous,impressed,larger,lobe,long,lower,midpoint,minute,minutely,mixed,multangulate,multicellular,new,nflorescence,oblique,oblong-lanceolate,obverse,older,ovate,papillo,partially,per,perfect,pericarp,persistent,plurifoliat,pore,poricidal,porrect,portion,prickle,prickly,puberulent,pubescence,pubescent,raised,ray,recurved,reduced,reflexed,rest,ruit,scabrous,scandent,scar,sessile,size,slightly,slit,spaced,sparse,sparsely,stalked,staminate,straight,subcordate,tapering,testa,thick,time,tip,tomentose-ferruginous,tomentose-floccose,triangular-lanceolate,trichome,truncate,tube,turbinate,ud,uneven,unit,vein,venation,without,woody,x,ympodial	abaxial,adaxial,colour,denser,form,fruit,height,inflorescence,leaf,length,na,number,position,reproduction,seed,shape,spacing,staman,surface,texture
17	wfo-0001025688	success	218	120	74	144	46	0.339	0.1,0.5,1,1-celled,1/2,4-lobed,abaxially,acicular,anther,apex,base,brown,calyx,cm,curved,deeply,diameter,distally,enlarged,entire,erect,except,extra-axillary,filament,flattened,flower,fruit,fruiting,glabrous,gland-tipped,globose,glutinous,hair,hyaline,leaf,less,lobed,long,margin,minute,mm,nearly,otherwise,ovate,pedicel,peduncle,petiole,pilose,prickle,puberulent,pubescence,rachi,ripe,scattered,shrub,similar,simple,sparsely,stellate,stem,stigma,style,suborbicular,sulcate,surface,thin-textured,truncate,unbranched,way,white,x,yellow,yellow-green,yellowish-green	0.1–2,0.2,0.5–2,0.5–3,0.5–3.5,0.6–0.8,0.6–2,0.6–2.4,0.6–4,0.8,0–10,1.3–1.7,1.5–2,1.5–3,1.5–4,14155,15–25,1–1.5,1–1.6,1–1.8,1–2,1–3-celled,1–6-celled,1–8,2-foliate,25,2–3,2–3.5,2–4-celled,2–4–celled,3.2–3.6,3–10,3–4,4,40–75,4–15,4–5-rayed,4–6,4–9,5,59,5°,5–18,6–7,6–8,8–10,8–15,=,abruptly,accrescent,acute,adaxiall,adaxially,also,angle,anthesi,armed,ascending,average,axe,blade,branch,coiling,conpsicuously,constricted,contiguou,cylindrical,darker,dense,densely,developing,directed,distall,eaf,eed,fewer,flowering,free,fresh,geminate,gland,grading,green,lacking,lanceolate,larger,lobe,lon,lower,major,many,minor,mottling,n,narrowed,narrowly,nee,nflorescence,none,often,one,orolla,per,pericarp,pore,rarely,rather,recurved,ruit,scarious,sessile,short,single,size,slightly,small,sometimes,somewhat,spreading,stellae,stipitate,straight,tal,tamen,tapering,tem,thic,thick,thickene,thickened,tip,triangular,truncat,tube,twice,unit,upper,usually,vary,vein,wide,wing,ympodial,±	0.1-2,0.5-3,0.5-3.5,0.6-4,1-1.6,1-2,2-4-celled,3-10,3-4,4-6,4-9,6-7,8-15,abaxial,adaxial,arrangement,bark,bud,cell,center,colour,contiguous,corolla,form,growth,height,history,inflorescence,length,life,na,new,number,ovary,perennial,plant,position,reproduction,scar,seed,shape,spacing,staman,texture,trichome,width
18	wfo-0001025694	success	199	84	52	147	32	0.261	1,20,5-merous,abaxial,acute,adaxial,andromonoecious,anther,apex,brown,chartaceous,cm,dark,densely,diameter,elliptic,filament,flower,fruit,glabrous,globose,green,inflorescence,length,long,membranaceous,mm,moderately,mottled,often,ovate,pedicel,peduncle,petiole,plant,pubescent,rachi,reniform,rugose,shrub,simple,sparsely,stellate,stellate-pubescent,stigma,style,surface,white,whitish,yellow,young,×	0.2,0.2–0.3,0.3–0.6,0.5–1,0.5–1.5,0.5–3,1.5–2,1.5–3.5,10–15,10–25,1991,1–2,1–2.5,1–3,2.5,2.5–11,25–50,2–15,2–3,2–3.5,2–4,2–5-branched,3–5,3–6,4–12,4–15,4–5,5–10,6–10,6–20,8–12,abaxially,absen,absent,accrescent,adaxiall,adaxially,alyx,androgynoecious,apart,apical,armed,articulated,asymmetrical,attenuate,axe,ba,base,becoming,berry,beyond,blade,calyx,capitat,center,completely,connivent,cordate,covering,cylindrical,discolorous,drying,eaf,eed,entire,erect,exerted,exserted,flattened,frui,fruiting,functionally,fused,gland-tipped,glandular,hair,hermaphroditic,heterostylou,interpetalar,like,little,lobe,lower,male,margin,matur,midpoint,midrib,midvein,mixed,multicellular,multiseriate,narrowly,nearly,nflorescence,obtuse,occasionally,opening,orange,orolla,per,pinnate,plurifoliat,pore,porrect-stellate,prickle,ray,recurved,reflexed,roselike,ruit,rusty,scandent,secondary,short,side,slit,spaced,sparse,specifically,spine,stalk,stamen,staminate,stem,still,swollen,tal,tamen,tan,tem,tip,tissue,triangular,triangular-ovate,tube,turning,unicellular,uniseriate,unit,vary,vein,venation,walker,whelan,wide,ympodial	0.5-1.5,0.5-3,1-3,2-15,2-3.5,3-5,3-6,4-12,4-15,6-10,arrangement,capitate,colour,corolla,form,growth,height,history,leaf,life,mature,na,number,ovary,perennial,position,reproduction,seed,shape,spacing,staman,texture
19	wfo-0001025697	success	181	106	81	100	25	0.448	0.15-0.75,1-1.7,1-2,1.7-8.6,10-26,25-35,3-10,3-4,3-5,3-6,5.5-11.5,abaxially,acuminate,acute,adaxially,anther,apex,axillary,blue,brownish,bud,cell,clavate,cm,condition,coriaceous,corolla,covering,dark,deep,diameter,drying,elliptic,filament,flower,forked,fresh,fruit,glabrescent,glabrous,globose,green,green-white,greenish,hair,hair-like,herb,lateral,leaf,light,lilac,make,medium,mm,mucilaginous,odd-pinnate,ovate,ovoid,pedicel,peduncle,pentagonal,petiole,plant,purple,rachi,ripe,rotate,seed,short,stigma,stripe,style,subtending,terminal,testal,thick,throughout,wall,wet,whitish,yellow	-9,0-14,0.6-3.5,0.8-2,1-3,1.5-1.8,2-10.5,2-2.6,2-4,2-6,3.3-11,4-7.5,5-merou,6.5-13.5,acumen,adaxiall,ag,alyx,apart,apparently,articulated,asymmetric,attenuate,axe,base,basiscopic,berry,blade,capitat,connivent,decreasing,decurrent,digestion,distal,dorsally,eaf,edge,eed,enzyme,erec,exceeding,flat,folded,geminat,generally,glabrou,hal,half,high,homostylous,honeycomb-shaped,interjected,lanceolate,leaflet,lengthening,linear,living,lobe,long,lower,nflorescence,orbicular,orolla,pair,perfect,petiolulate,plurifoliate,pore,poricidal,removed,rounded,ruit,sessile,seudostipule,side,size,slightly,slit,spaced,specimen,stamen,straight,subequal,subglabrou,tall,tamen,tem,tip,tissue,toward,tri-,tube,typically,unit,unwinged,usually,vary,wood,x,ympodial	abaxial,adaxial,arrangement,capitate,colour,form,growth,height,hermaphroditic,history,inflorescence,length,life,na,number,ovary,perennial,position,reproduction,shape,spacing,staman,surface,texture,width
20	wfo-0001025699	success	181	89	67	114	22	0.37	1-1.5,1-2,1-2.5,1.5-2,10,15-20,2-2.5,2-6,2cm,3-15,4-5,5-winged,8-9,absent,acute,almost,anther,apart,apex,berry,branching,brown,campanulate,capitate,cm,conical,corolla,dark,darker,diameter,dry,elliptic,filament,flower,glabrous,globose,green,growth,inflorescence,irregularly,leaf,leaf-opposed,leafy,lobed,minutely,mm,ovary,papillose,pedicel,peduncle,petiole,reniform,reticulate-pitted,rounded,shoot,short,simple,small,spaced,stigma,style,surface,tangled,tree,trichome,white,x	.2,.5,0.5,1,1-3,1.5,1/3,2,3-3.5,3-5.5,3-8,499,5-8,5.5-14,abaxially,adaxially,age,anthesi,apparently,appearing,articulating,attenuate,bark,base,becoming,c.,calyx,completely,conspicuously,continuing,corrugate,crystal,cup-shaped,deltate,densely,difoliate,dorsal,drying,eaf,eed,ellipsoid,entire,erect,exerted,face,fide,free,fruiting,glabrou,grey-brown,immature,included,inclusion,inflorescenc,lanceolate,leaving,lengthening,less,lobe,lower,margin,markedly,midrib,narrowly,new,nflorescence,nodding,older,one,onto,oxalate,pair,pale,papillat,peg,penden,per,perfect,plurifoliate,pore,poricidal,portion,primary,red,reddish,rounded-sagittate,ruit,sand,scar,slightly,slit,somewhat,stearn,stem,straight,strongly,thickened,time,tip,triangular,tube,ud,unit,vein,way,white-spotted,wide,wing,winged,woody,yellow,ympodial,young,½	abaxial,adaxial,arrangement,colour,form,fruit,height,history,length,life,na,number,plant,position,rachi,reproduction,seed,shape,spacing,staman,texture,width
21	wfo-0001025700	success	189	92	67	122	25	0.354	0.30-2.0,0.5-2,0.8-2.6,10-40,10.5-12,15-40,2-12,2.5-4,5.3-17.5,5.5-8,abaxially,acuminate,acute,adaxially,anther,apex,brownish,cell,chartaceous,clavate,cm,condition,corolla,covering,diameter,dot,drying,elliptic,filament,flower,forked,fresh,fruit,glabrescent,glabrous,globose,green,greenish,hair-like,herb,lateral,leaf,lilac,medium,mm,odd-pinnate,ovate,ovoid,pedicel,peduncle,pentagonal,petiole,plant,purple,ripe,rotate-pentagonal,seed,sometimes,stigma,style,terminal,testal,thick,wall,white,whitish,yellow	0-16,0.7-2.7,0.8-4,1-2,1-3,1.1-2.3,1.5-2,2-7,3-4,3-8,3.5-10.5,3.7-8.6,4-5,5-15,5-20,5-merou,5.5-18,9-31,acuman,acumen,ag,alyx,apiculate,apparently,articulated,asymmetric,attenuate,axe,axillary,basal,base,basiscopic,berry,blade,bud,capitat,connivent,considerably,decrease,decreasing,digestion,distal,dorsally,eaf,edge,eed,enzyme,erec,exceeding,except,flat,folded,geminat,generally,glabrou,green-white,hair,hal,half,high,homostylous,honeycomb-shaped,interjected,lanceolate,larger,leaflet,lengthening,light,linear,living,lobe,long,lower,make,mucilaginous,narrowly,nflorescence,orbicular,orolla,pair,par,perfect,petiolulate,plurifoliate,pore,poricidal,proximal,removed,rounded,ruit,sessile,seudostipule,short,side,size,slightly,slit,specimen,stamen,straight,subequal,subglabrou,subtending,tall,tamen,tem,throughout,tip,tissue,toward,tri-,tube,typically,unit,unwinged,usually,vary,wet,whose,winged,x,ympodial	abaxial,adaxial,arrangement,capitate,colour,form,growth,height,history,inflorescence,length,life,na,number,ovary,perennial,position,rachi,reproduction,shape,spacing,staman,surface,texture,width
22	wfo-0001025702	success	279	107	90	189	17	0.323	.0,0.3–2.2,0.5–0.8,1.2–1.6,1.4–2.8,1.6–2.0,1/3,2,2.3,2–14,3.2,4.5–5.2,6.6,abaxially,acuminate,acute,adaxially,anther,apex,apiculate,attachment,attenuate,base,becoming,brown,calyx,capitate,chartaceous,cm,corolla,cream,deltate,densely,developed,diameter,dry,elliptic,emerging,entire,extra-axillary,filament,flattened-orbicular,flower,fruit,glabrous,globose,incurved,internode,interpetalar,lanceolate,lateral,lobe,margin,mature,minute,mm,moderately,nearly,notched,oblong,obtuse,ovate,pedicel,petiole,point,poorly,pubescent,red,reddish,scandent,shrub,somewhat,sparsely,stellate,stem,stigma,style,sub-coriaceous,surface,tip,tissue,toward,truncate,upper,white,yellow,yellow-tan,±glabrous,×,–6	.1,.3,.5,.7,/2,0.04,0.3–0.4,0.4–2.3,0.5–0.6,0.5–1.3,0.6–0.9,0.6–1.0,0.7–1.4,1.3–1.8,1.3–2.8,1.4–1.6,1.4–2.2,1.6–1.7,1.6–1.8,1.6–2.1,1.6–2.3,1.7,1.7–2.3,1.7–9.2,1.9,1/4–1/3,2.0–3.2,2.2,2.2–2.9,2.3–6.6,2.3–7.8,2.5,2.6–7,3.6–3.9,4,4.3,4–16,5-merou,5.2–7.5,5.4,6.9–10.3,6–10,6–8,adjacent,adnate,aequilateral,ag,alyx,anthesi,apart,apical,apparently,appearing,appresse,around,articulate,axe,ba,bark,based,berry,blade,branch,broad,broad-based,broadly,brochidodromous,bud,channeled,completely,congested,cuneate,curved,deciduous,deflexed,deltoid,dentate,difoliate,directed,distal,distally,distinct,eaf,edge,eed,either,endocarp,exocarp,extending,ferruginous,fertile,filiform,flexed,forked,free,geminat,glandular,glossy,gradually,gree,hair,homostylous,hooked,hort,increasing,indistinct,intact,intersepalar,joining,juic,laterally,lax,layer,limp,lon,long,longer,lower,m.,midpoint,midrib,midvein,nflorescence,oblique,occasionally,opaque,orolla,per,perforated,pore,porrect,portion,potentially,presen,prickle,primary,pseudo-intermarginal,pseudo-peduncle,raised,ray,reflexed,remaining,retrorse,rounded,row,ruit,scattered,secondary,seen,sessile,shoot,side,simple,sinus,sloughing,smoot,smooth,sometimes,soon,splitting,spread,stamen,stellae,stellate-pubescent,straight,strongly,suture,tamen,tem,thin,time,transparent,triangular,tube,two,ud,unarmed,unbranched,vary,vein,wide,yellow-ferruginou,yellow-ferruginous,ympodia,young,±90,±90°,±connivent,±equal	abaxial,adaxial,colour,form,green,growth,height,inflorescence,leaf,length,number,ovary,plant,seed,shape,staman,texture
23	wfo-0001025704	success	248	90	72	176	18	0.29	0-3.5,0.5-1.5,0.7-1,1-3.5,1-4,1-6,1.2-3,1.5-3.2,3-6,4-12,4.5-6.5,5-merous,abaxial,abaxially,acute,adaxial,almost,andromonoecious,anther,apart,apex,branched,cell,chartaceous,cm,densely,diameter,ellipsoid,evenly,filament,flattened-reniform,flower,fruit,green,green-yellow,leaf,length,lobed,maturity,mauve,mm,orange-brown,outline,pale,pedicel,peduncle,petiole,pit,plant,raised,rarely,red-green,round,shape,shrub,small,smooth,sometimes,spherical,stellate,stellate-pubescent,style,surface,tree,unbranched,warty,white,white-gray,yellow,yellow-green,yellowish,young	-10,-2,-3,-5,/6,0,0-100,0-2,0-5,0.1,0.1-0.3,0.1-0.5,0.15-0.8,0.3-0.8,1,1.5-2,1.5-4.5,1.8-3.5,1/2-4/5,1/4-3/4,1/5,2,2-10,2-3,2-4.5,2-5,2-7,2.5-4.5,2.7-4,3-10,3-15,3-5,4-5,5-20,6-12,6-15,8-12,8-15,8-17,age,alyx,apar,apically,apiculate,apparently,articulated,auriculate,axe,ba,bark,base,berry,blade,broad-deltate,brow,calyx,connivent,cordate,covering,curved,deltate,development,discolorous,distal,distance,drying,eaf,eed,elliptic,elongating,end,equal,erect,extending,flattened,free,fruiting,glabrescent,glabrous,gray,half,hermaphrodite,heterostylous,infructescence,irregular,lateral,less,lobe,lobing,long,long-styled,longer,lower,lowermost,margin,mature,midpoint,midvein,moderately,multangulate,near,nflorescence,obtuse,occasionally,often,older,one,open,orange,orolla,oung,ovate,pair,pendulous,per,pericarp,plurifoliat,poricidal,porrect,portion,prickl,prickle,prickly,primary,prominent,ray,recurved,red-brown,reflexed,retaining,rounded,ruit,scar,secondary,sessile,short-styled,shorter,side,slender,somewhat,spaced,sparsely,spreading,stalk,stalked,staminat,stellate-pubescen,stem,stout,straight,strongly,tamen,tapering,terete,terminal,tertiary,throughout,time,tip,trichome,truncate,tube,unarmed,unit,upper,variously,vary,vein,venation,visible,way,wide,widening,woody,ympodial,×	colour,corolla,form,growth,height,history,inflorescence,life,na,number,ovary,perennial,reproduction,seed,spacing,staman,stigma,texture
24	wfo-0001025714	success	249	82	42	207	40	0.169	abaxially,acute,anther,apex,broadly,cm,diameter,extra-axillary,filament,flattened,flower,fruit,glabrous,glandular-pubescent,globose,light,minutely,mm,orbicular,ovary,ovate,pedicel,peduncle,petiole,pilose,pubescent,rachi,rounded,shrub,simple,stellate,stigma,stipitate-glandular,style,subreniform,tan,terete,unbranched,white,x,yellow,yellowish	%,-5,-rayed,.2,0.1–0.8,0.2–0.8,0.5,0.5–0.6,0.5–1.3,0.5–2,0.8,0–0.4,1,1.2–2.4,1.3–3,1.5–2,1.5–2.5,1.5–3.5,1.6–2.3,1.8–,1/3,100,10–11,13,15,15–25,1–2,1–4,2,2-foliate,2.2–3,2.5,2.5–3.8,2.8,2–3,2–4-celled,2–7,2–8,3.7–5,3–16,3–9,4–18,4–6,5,5.9–7.5,50,5–25,5–6.5,6.2–6.8,6–16,7–18,7–8.5,8–13,9.2–10,9–22,>,absent,accrescent,acicular,adaxiall,adaxially,additional,always,anthesi,apart,appearing,armed,around,articulated,ascending,asia,attenuate,axe,ba,base,berry,blade,branch,calyx,capitat,caudate-tipped,completely,concealing,covering,curved,cylindrical,decidedly,differing,dilated,dimorphic,directed,distall,eaf,eed,enlarged,entire-margined,erect,fertile,few-branched,few-rayed,forward,free,frui,fruiting,geminat,glabrou,gland,gland-tipped,gland–tipped,hair,half,halfway,herbarium,horizontally,hyaline,immediately,increasingly,lacking,larger,latter,less,lobe,lobed,lobing,long,longer,longest,lower,lowermost,mainly,major,male,many-rayed,margin,maturity,midrib,minor,minute,mixed,multangulate,narrowly,nearly,nflorescence,numerous,obtuse,often,one,orolla,pair,per,perhaps,plane,pointing,pore,predominating,prickle,pubescence,rare,rarely,recurved,reflexed,ruit,scarcely,scattered,sessile,short,shorter,similar,single,size,slender,slightly,small,smaller,sometimes,spaced,sparse,specimen,spine,spreading,stellae,stem,stipitate,stouter,straight,subcordate,subglabrous,tal,tamen,tem,thin-textured,time,toward,triangular,truncate,tube,unequal,unit,upper,usually,various,vary,way,wide,ympodial,–1.25,–7–9	0-0.4,0-0.8,0.1-0.8,0.5-0.6,0.5-2,1-2,1.3-3,1.5-3.5,1.6-2.3,2-7,3-9,5.9-7.5,6.2-6.8,9-22,abaxial,adaxial,arrangement,capitate,colour,corolla,form,growth,height,history,inflorescence,leaf,length,life,na,number,perennial,plant,position,reproduction,seed,shape,spacing,staman,surface,texture
25	wfo-0001025726	success	158	93	66	92	27	0.418	-10,-5,0.2,0.2-0.3,0.5,1-1.5,1-2.5,10-15,2.5,20-40,3-10,3-5,6-8,abaxially,adaxially,anther,apex,branched,brown,chartaceous,cm,diameter,entire,filament,flattened,flower,foveolate,fruit,glabrous,globose,green,hair,internode,light,margin,mm,occasionally,pedicel,peduncle,perennial,petiole,pinnate,pinnatifid,plurifoliate,puberulent,purple,rachi,rarely,rugose,shape,simple,slender,spreading,stellate,stigma,strongly,style,subwoody,surface,terminal,variable,variously,white,woody,x,yellow	-16,0-1,0.5-1.5,1,1-3,2-,2-3,3-4,4,4-10,5,6-12,7-9,accrescen,acuminate,acute,adaxiall,adjacent,ag,alyx,anthesi,armed,articulated,axe,ba,base,becoming,blade,broadly,calyx,campanulate,clustered,compound,confluent,connivent,dr.,eaf,eed,elliptic,elongating,equal,fertile,fruiting,geminat,imparipinnately,lateral,leaflet,lengthening,lobe,lobed,long,major,midrib,narrowly,nflorescence,oblon,oblong,often,orolla,ovate,pore,poricidal,present,prickle,ranging,recurve,recurved,rounded,ruit,scandent,side,size,slit,stout,straight,swollen,tamen,tem,terminally,time,tip,truncat,tube,ud,unbranched,unit,usually,vary,vein,vin,wide,ympodial	2-10,abaxial,arrangement,colour,corolla,form,growth,height,history,inflorescence,leaf,length,life,na,number,ovary,plant,position,reproduction,seed,spacing,staman,stem,texture,truncate,vine,width
26	wfo-0001025729	success	177	107	79	98	28	0.446	.5,/4,0.25-0.5,0.7-1.2,1-1.5,1-5,1.1-1.5,1.2-1.8,1.75,4-5,abaxial,abaxially,abrupt,acute,adaxially,anther,apex,axil,basal,base,bright,calyx,cm,corolla,covering,cyathiform,dark,densely,dia,diam,dirty,elliptic,f,filament,flattened-reniform,fleshy,furcate,glabrous,globose,green,greenish-yellow,lamina,lateral,leaf,live,lobed,long,main,minutely,mm,occasionally,opposite,ovary,pale,papillose,pedicel,petiole,pit,pitted,plant,shiny,simple,sparsely,stigma,style,surface,tapering,tree,treelet,trichome,tube,tuft,uniseriate,vein,way,white,widening,x,yellow	-20,1.5-2,2,2-3.5,20,3-6,4-8,5-50-flowered,6-8,7-8,9-17,along,anthesi,apar,apical,apiculate,appearing,bark,berry,black,blackish,branched,bristly,bud,covered,deflexed,deltoid,denser,differing,difoliate,drying,eaf,edicel,eed,enclosed,expanded,free,fruiting,geminat,gently,glabrou,greyish-brown,growing,incrassate,lat,like,lobe,lon,lower,m.,mainly,major,margin,member,middle,minor,minute,nflorescence,oblique,often,older,one,overlapping,overtopping,pair,papillo,partially,pore,poricidal,portion,prominent,pubescent,quite,raised,reflexed,ripening,rounded,ruit,scar,shaped,short,size,stem,stout,straight,tall,tear-drop,terminal,tip,touching,tub,ud,unit,usually,widest,woody,ympodial,young	4-20,5-50,adaxial,apart,arrangement,colour,diameter,flower,form,fruit,growth,height,history,inflorescence,length,life,na,number,peduncle,position,rachi,reproduction,seed,shape,spacing,staman,texture,width
27	wfo-0001025737	success	220	97	72	148	25	0.327	0.3–2,0.7–1.3,0.8–1.1,0.9–1.1,1.5–2,1.5–3,1.5–5,10–12,1–1.5,2.5–4.5,25–50,3.5–8,5-merous,5–6,7–8,abaxially,adaxially,anther,apart,apex,attenuate,bright,cm,densely,diameter,extra-axillary,filament,flattened-reniform,flower,fruit,glabrous,globose,greenish,growth,interpetalar,lateral,light,lighter-colored,long,loosely,margin,minutely,mm,narrow,orange,ovate,ovate-lanceolate,pale,pedicel,peduncle,petiole,pitted,rarely,reflexed,seed,shiny,shrub,simple,slender,stellate,stellate-tomentose,stigma,style,surface,tinge,tissue,tomentose,violet,white,yellow,×,–4	-branched,0.2–0.3,0.3–0.7,0.6,0.6–0.9,1.4–1.8,1.5,1.5-2,1.5–6.5,1.7–2.2,10,1–,1–1.2,2,2.5–3,2–3,3,3.5–5,3–10,44599,47092,4–11,4–6,5,51,8–10,8–16,9-10,95,absent,accrescen,acute,adaxiall,age,alyx,angularly-cordate,apical,apparently,appressed-tomentose,armed,articulated,axe,ba,base,becoming,blade,branch,broad-based,capitat,deeply,difoliate,directed,distall,eaf,eed,entire,except,fertile,filiform,finely,free,geminat,glabrou,gland-tipped,green,hair,high,homostylous,immature,internode,juicy,juvenile,lance-ovoid,like,linear-attenuate,linear-lanceolate,lobe,lobed,lon,long-stipitate,lower,major,midpoint,midvein,midzone,minute,mixed,near,nee,nflorescence,northern,numerous,oblong,obtuse,odorle,orolla,part,per,perfect,persistently,pore,porrect,prickle,principal,range,ray,rounded,ruit,scarcely,sessile,shallowly,short-,short-stipitate,shorter,side,sinus,southern,spaced,sparsely,splitting,ste,stellae,stellate-pubescent,stem,stipe,straigh,straight,tamen,tem,thick-chartaceous,time,tomento,triangular-attenuate,tube,turning,ud,unarmed,usually,vary,vein,vigorous,whitish,wide,x,ympodia,–14,–20,–3	abaxial,adaxial,arrangement,capitate,colour,corolla,form,height,history,inflorescence,leaf,length,life,na,number,ovary,plant,position,rachi,reproduction,shape,spacing,staman,texture,width
28	wfo-0001025741	success	231	96	76	155	20	0.329	0.5–0.8,0.5–3,1.7–2,1.8–2.1,11–14,12–15,1–4,2.5–8,2–7.5,3–10,4–6,5-merous,5–17,6.5–9,8–15+,abaxial,adaxial,andromonoecious,anther,apart,brown,chartaceous,cm,dark,densely,diameter,extraaxillary,fading,filament,flattened,flower,fruit,glabrous,globose,golden-tan,green,inflorescence,juicy,lanceolate,leaf,length,light,lighter,lustrous,maturity,membranaceous,mm,moderately,once-branched,orange,outline,ovate,pedicel,peduncle,petiole,plant,pubescent,rachi,reniform,rotate-stellate,rugose,short-cylindrical,simple,stigma,strongly,style,surface,tree,unbranched,violet,white,yellow,×,–20,–30,–8	.2,.5,0-0.1,0–0.1,1.1–2,1.2–1.5,10–35,15–45,1–2,1–2.5,2.5–3,2.5–3.5,20–23,29–36,2–3,2–3.2,2–4,30–120,3–6,4–5,4–7,5–6,6–7,8–18,abaxially,abundant,abundantly,acuminate,acute,adaxially,along,alyx,andromonoeciou,anthesi,apex,armed,articulated,axe,ba,bark,base,becoming,berry,blade,broad-based,calyx,capitat,column,congested,connivent,covered,cuneate,curved,cylindrical,db,deltate,deltoid,difoliate,directed,distall,dry,eaf,eed,eglandular,either,emergent,entire,equal,flowering,free,fresh,frui,fruiting,functionally,geminat,glandular,hair,half,hermaphroditic,heterstylous,included,inflated,interpetalar,knobby,like,lobe,lobed,lon,long,long-stalked,lower,major,margin,midpoint,midvein,multangulate,multiseriate,nearly,nflorescence,oblique,one,orange-tan,orolla,part,pericarp,pore,porrect-stellate,present,prickle,ray,remaining,ruit,runk,sessile,shallowly,sharp,shiny,short,short-stalked,side,small,somewhat,spaced,sparse,sparsely,stalk,stalked,staminate,stellate,stellate-pubescent,stem,stout,straight,subtending,tamen,tan,tapered,thi,thin,time,tissue,tube,tuft,unarmed,unit,vary,vein,wide,within,ympodial,young,–12,–28,–39,–6	arrangement,capitate,colour,corolla,form,growth,height,history,life,na,number,ovary,perennial,position,reproduction,seed,shape,spacing,staman,texture
29	wfo-0001025743	success	157	72	45	112	27	0.287	0.15-0.3,0.9-2.6,1.2-4,4-8,4.5-5.5,5-10,6-7,8-10,9-18,andromonoecious,apex,articulated,base,broadly,chartaceous,cm,cylindrical,diameter,extra-axillary,flower,fruit,glabrous,globose,green,herbaceous,inflorescence,length,mm,obtuse,ovate,pale,pedicel,peduncle,petiole,plant,prostrate,resprouter,sprawling,stellate,straight,strongly,style,unbranched,white,yellow	%,.5,0-15,0-6,0.1-0.3,0.3-0.5,0.3-0.6,0.4-0.5,0.4-0.8,0.5-0.9,0.9-1.2,1,1-6,1.3-1.8,11-25,12-17,2-3,2-4,2-4.5,2.3-5,2.8-3.5,3-13,3-4,3-6,3.5-5.5,30-80,5-20,5-merou,6-10,6-20,abaxially,absen,absent,acicular,adaxiall,adaxially,adult,alyx,apart,armed,axe,ba,blade,branche,brown,calyx,cordate,cuneate,decimetre,deeply,deltate,dense,directed,distall,eaf,eed,finger,fruiting,functional,gland-tipped,grey,hair,half,heterostylous,index,lamina,lateral,less,lobe,lobed,lobing,lon,long,longer,lower,margin,mature,mid-point,midvein,minute,nflorescence,nther,oblique,onl,orolla,part,per,pore,presen,present,prickle,ruit,short,side,simple,spaced,stage,tal,tem,thick,throughout,time,tube,unit,unknow,uvenile,vary,vein,wide,x,yellowish-gree,ympodial	5-merous,abaxial,adaxial,anther,colour,corolla,filament,form,growth,height,history,leaf,life,na,number,ovary,position,prickly,reproduction,seed,shape,spacing,staman,stigma,surface,texture,yellowish-green
30	wfo-0001025749	success	217	92	69	148	23	0.318	0.2-1.5,0.3-1.5,0.5-0.8,0.5-0.9,0.8-0.9,1-10,1-13,1-2,1-9,2-10,2.5-6,5-merous,abaxial,acute,adaxial,anther,apart,apex,apparently,berry,chartaceous,cm,concolorous,curved,dark,densely,diameter,discolorous,drying,dull,filament,flattened-reniform,flower,fruit,gently,glabrous,green-brown,lateral,leaf,length,lobed,maturity,mauve,mm,moderately,orange-brown,orange-red,orbicular,ovate,pale,pedicel,peduncle,petiole,red-brown,rounded,shrub,smooth,sometimes,sparsely,spherical,stellate,stellate-pubescent,straight,strongly,style,surface,white,yellow,yellow-green	-1,-12,.5,/5,0-10,0-3,0-5,0-6,0-8,0.1,0.1-0.2,0.1-0.3,0.1-0.4,0.2,0.4-0.7,0.5,0.5-1.3,0.5-3,0.6-4.5,1,1-3,1-6,1-8.5,1.5,1.5-2,1.5-2.5,1/4-1/3,1/5-1/2,2-2.5,2/3,3-20,3-5,4-8,5-,5-10,5-20,6-8,abaxially,acuminat,adaxially,adnate,almost,alyx,apar,apically,articulated,bark,base,blade,branched,broad-deltate,calyx,cuneate,difoliate,distance,eaf,eed,elongating,equal,erect,extending,filiform,flattened,free,fruiting,geminat,glabrescent,gray,herbaceous,indistinct,infructescence,light,lobe,lon,long,long-ovate,longer,lower,magnification,margin,markedly,mature,midpoint,midvein,narrow-deltate,narrow-ovate,nflorescence,oblong,obtuse,occasionally,older,one,open,orange-brow,orolla,oung,pair,pendulous,per,perfec,pericarp,poricidal,porrect,portion,prickl,prickle,prickly,primary,procumbent,purple,rarely,ray,recurved,reduced,ruit,scar,sessile,shorter,side,spaced,spreading,stalk,stalked,stem,straw-yellow,tamen,tapering,terete,tertiary,time,tip,toward,trichome,tube,unit,usually,variously,vary,vein,venation,visible,way,wide,without,yellow-orange,yellowish,ympodial,½-2/	arrangement,colour,corolla,form,growth,height,history,inflorescence,life,na,number,ovary,perennial,plant,position,rachi,reproduction,seed,shape,spacing,staman,stigma,texture
31	wfo-0001025754	success	164	83	57	107	26	0.348	0.5-1,0.5-1.5,1,1-3,1.5-3,10-20,4-6,5-15,absent,anther,apex,brown,center,chartaceous,cm,cordiform,diameter,dm,drying,edge,filament,fine,flower,fruit,glabrous,globose,herb,immature,leaf,long,margin,maturing,membranaceous,mm,moderately,nearly,parallel,pedicel,peduncle,petiole,pubescent,rachi,radiating,raised,ridge,rotate,running,semitransparent,shallow,solitary,sparsely,stigma,style,surface,white,x,yellow	-celled,.5,0.1-0.2,1-2,1-3.5,1.5,1.5-4,10-35,2-4,2-5-celled,2-7,2-foliate,3-10,3-5,3-6,4,5-12,abaxially,abundant,acuminate,acute,adaxiall,adaxially,along,asymmetrical,axe,barely,base,berry,beyond,blade,branch,calyx,ciliate,connected,cordate,decumbent,decurrent,dehiscing,densely,denser,dried,eaf,eed,eglandular,emarginat,entire,equal,erect,explosively,exserted,flat,geminat,glandular,hair,held,interpetalar,leaving,like,linear-lanceolate,lobe,lower,lying,main,material,maturit,mesocarp,mixed,much-branched,nfloresence,notch,oblong,often,orolla,palmately,penden,per,placenta,pressure,probably,pubescen,ruit,short,slightly,small,sometimes,stamen,stem,straight,swollen,tal,tamen,tem,tissue,triangular,truncate,tube,unbranched,unit,upright,vary,vein,visible,watery,wid,woody,ympodial	abaxial,adaxial,arrangement,colour,corolla,form,geminate,growth,height,history,inflorescence,length,life,na,number,ovary,perennial,plant,position,reproduction,seed,shape,spacing,staman,texture,width
32	wfo-0001025760	success	210	89	67	143	22	0.319	-10,-6,.5,0-0.5,0.3-1,0.45-0.9,0.5-2,0.8-1.8,1-1.8,1-2,1-4,2.3-4,abaxial,abaxially,acute,adaxial,almost,annual,anther,apex,black,chartaceous,cm,cream,curved,dark,diameter,dull,elliptic,filament,flattened-reniform,flower,fruit,gently,glabrous,green,herb,lateral,leaf,length,lobed,marking,maturity,membranous,mm,moderately,orange,orange-brown,ovate,pale,pedicel,peduncle,perennial,petiole,red-brown,shape,smooth,spherical,stellate,stellate-pubescent,style,surface,unbranched,white,yellow,yellow-green,young	-12,-3,-5,/3,0-100,0.1,0.1-0.2,0.15-0.3,0.2-0.35,0.4-0.8,0.5-1.5,0.7-2.5,1,1-,1.5,1.5-2.5,1.5-4.5,1.5-5,1/4,1/4-1/2,1/4-1/3,1/5,2-2.5,2-3,2.1-3.5,2.5-10,2.5-8,2/3,3,3-6,3.5-17,3.5-9,5-10-merous,5-18,8-10,acut,alyx,apar,apically,apparently,articulated,bark,base,berry,blade,broad-deltate,brow,calyx,concolorous,connivent,cultivar,cuneate,deltate,difoliate,discolorous,distance,drying,eaf,eed,elongating,equal,erect,extending,free,fruiting,geminat,geminate,glabrescent,hair,infructescence,lengt,lobe,long,longer,lower,margin,mature,midpoint,midvein,minute,nflorescence,often,older,one,open,orolla,oung,pair,pendulous,per,perfec,pericarp,poricidal,porrect,portion,primary,ray,recurved,reflexe,rounded,ruit,scar,sessile,shorter,shrub,side,simple,slender,sometimes,spaced,spreading,stalk,stalked,stellate-pubescen,stem,stout,straight,subentire,tamen,tapering,terete,tertiary,thick-stalked,time,tip,trichome,tube,unarme,unarmed,unit,upper,usually,various,variously,vary,vein,venation,visible,way,weakly,wide,woody,ympodial	apart,arrangement,colour,corolla,form,growth,height,history,inflorescence,life,na,number,ovary,plant,position,rachi,reproduction,seed,spacing,staman,stigma,texture
33	wfo-0001025782	success	200	81	59	141	22	0.295	0-5,0.1-0.25,0.4-0.6,0.55-0.75,0.9-1.3,1-4,1.2-6,1.3-1.6,2-3,2-7,4,4-4.5,5-merous,abaxial,acuminate,adaxial,andromonoecious,anther,apex,apically,chartaceous,climbing,cm,curved,diameter,dull,evenly,filament,flattened-reniform,flower,fruit,gently,glabrous,green,lateral,leaf,length,lobed,membranous,mm,moderately,orange-brown,pedicel,peduncle,petiole,plant,porrect,sessile,shrub,sparsely,spherical,stellate-pubescent,style,surface,trichome,unbranched,weakly,white,yellow	-2,.5,0-10,0.1-0.15,0.1-0.2,0.3-1,0.5-1,1,1-1.7,1-2,1-2.5,1.5-3,1/4-1/2,1/4-1/3,1/6,10-13,2-10,2-2.5,2-5,2.5-3.5,2/3-3/4,20,3-4,3-5,4.5-9,5-20,5-6.5,5-8,5.5-6,6-14,6-8,abaxially,acuminat,also,alyx,apar,apart,apparently,articulated,bark,base,berry,blade,brown,calyx,concolorous,conical,connivent,cuneate,deltate,densely,difoliate,discolorous,distal,distance,drying,eaf,eed,elliptic,elongated,elongating,equal,extending,flattened,free,fruiting,geminat,geminate,glabrescent,green-brown,hair,hermaphrodite,heterostylous,infructescence,lengt,less,lobe,long,long-styled,longer,lower,lowermost,margin,mature,maturity,midpoint,midvein,minute,nflorescence,occasionally,older,one,open,orolla,oung,pair,pendulous,per,pericarp,poricidal,portion,prickl,prickle,prickly,primary,ray,red-brow,reduced,ruit,scar,short-styled,shorter,side,simple,smooth,spaced,spreading,staminat,stellate,stem,stout,straight,tamen,tapering,terete,tertiary,time,tip,toward,tube,unit,vary,vein,venation,visible,way,wide,woody,yellow-green,ympodial,young	arrangement,color,corolla,form,growth,height,history,inflorescence,life,na,number,ovary,perennial,position,reproduction,seed,shape,spacing,staman,stigma,texture,width
34	wfo-0001025783	success	179	96	75	104	21	0.419	.5,0.5,0.5-1,0.5-1.5,1-1.2,1-1.5,1-3,2,2-5,7-10,abaxially,anther,apart,apex,base,branched,brown,c.,cluster,cm,corolla,dendritic,densely,diameter,ellipsoid,elliptic,entire,filiform,flattened,flower,glabrous,globose,growth,lateral,lax,less,lobed,margin,minutely,mm,narrowly,number,pale,pedicel,peduncle,perfect,petiole,pitted,pubescent,purple,reniform,ripe,sagittate,shiny,shoot,short,shrub,simple,somewhat,sparsely,stellate,stigma,style,surface,suture,terminal,thin,trichome,uniseriate,vine,violet,way,weak,within,woody	0.8-3.5,1.8-2,2-3+,2-6.5,3-4,5,5-merou,<,abaxiall,acute,adaxiall,adaxially,along,alyx,anthesi,ape,ark,articulated,axil,berry,branching,bud,calyx,cell,completely,confined,conical,coriaceous,eaf,eed,erect,expanded,exposed,exserted,fleshy,flexuous,free,fruiting,glabrou,green,greyish,groove,hromosome,ilament,inserted,keeled,known,lobe,long,long/tall,lower,mature,midrib,midvein,minute,mmm,near,new,nflorescence,nodding,obscured,obtuse,occasionally,older,orolla,outlin,pair,penden,pentagonal,pericarp,plurifoliat,point,portion,possibly,primary,revolute,ruit,scar,scarious,see,sleeve,slightly,sometimes,spaced,sparse,stem,strongly,testal,time,transparent,triangular,truncate,tube,tuft,twinin,type,ud,unit,upper,vary,vein,wide,yellowish,ympodial	3,abaxial,colour,filament,form,fruit,height,inflorescence,leaf,length,na,ovary,plant,position,reproduction,seed,seen,shape,spacing,texture,width
35	wfo-0001025784	success	241	90	56	185	34	0.232	-3,.5,0.2-0.3,0.5,1-5,3.5,abaxially,acute,anther,apart,apex,black,cm,curved,diameter,enlarged,extra-axillary,filament,flattened,flower,fruit,glabrous,globose,green,greenish,greenish-yellow,lanceolate,leaf,mm,narrowly,nearly,ovate,pedicel,peduncle,petiole,pilose,pubescent,purple,rachi,rounded,shrub,simple,smooth,stellate,stigma,style,subreniform,surface,thin-textured,truncate,unbranched,white,x,yellow,yellow-brown,yellow-green	.2–0.4,0.2,0.2–1.1,0.3–0.5,0.4–2.5,0.5–1.8,0.5–2,0.5–3,0.6–0.8,0.7,0.8–1.1,0.8–1.2,0.9–1.2,0.9–1.4,1,1.2,1.2–2.5,1.3–1.8,1.6–2.2,1/3,10,10–15,15075,1709,1–,1–3,1–5,2,2-foliate,2.5–3.3,2/3,2–2.5,2–3,2–4,2–5-celled,2–7,3–4,3–4-rayed,4.5–5.5,5,5–6,6,6.5–8,6.5–8.5,=,accrescent,acicular,adaxiall,adaxially,also,always,anthesi,articulated,asplund,ba,base,becoming,blade,branched,brazil,calyx,cell,ciliate,completely,conical,cylindrical,directed,distall,drying,eaf,eed,enclosing,especially,et,exceeding,fertile,fide,free,frui,fruiting,geminat,glabrescent,glabrou,gland,gland-tipped,glandular-pubescent,hair,hyaline,insolated,irregularly,irwin,lobe,lobed,long,longitudinal,lower,lowest,major,male,many,margin,midpoint,midrib,minute,minutely,moderately,mostly,mottled,much,n,nflorescence,numerous,obtuse,offset,one,orolla,pair,per,pore,prickle,pubescence,raised,rarely,ray,recurved,reflexed,reported,ripe,rudimentary,ruit,second,sessile,shallowly,sharp,short,side,similar,slightly,small,sometimes,somewhat,spaced,sparsely,spiny,sprawling,spreading-pilose,stamen,ste,stellae,stem,stipitate,stout,straight,subcapitat,subcordate,tal,tamen,tem,thick,thicker,time,tip,toward,triangular,tube,unarmed,unequal,unit,upper,usually,variously,vary,vein,way,wid,wide,widest,without,ympodial,young,–2,–4,–5.5,–8,–9	.2-0.4,0.5-3,0.8-1.2,0.9-1.2,0.9-1.4,10-15,2-3,4.5-5.5,abaxial,adaxial,arrangement,colour,corolla,form,growth,height,history,inflorescence,length,life,na,number,ovary,perennial,plant,position,reproduction,seed,shape,spacing,staman,subcapitate,texture,width
36	wfo-0001025788	success	158	82	55	103	27	0.348	0.5-2,1-4,1-5,15-30,2-3,2.8-9.5,4-5.5,5-8,8-38,acute,apex,blue,branched,cm,conical,corolla,cyme,deep,diameter,dichasial,dichasially,distal,ebracteate,elliptical,filament,finely,flower,forked,green,green-white,half,herbaceous,leaf,medium,mm,monochasial,mucilaginous,narrowly,obtuse,odd-pinnate,ovate,ovoid,pedicel,peduncle,perennial,petiole,plant,pubescent,purple,rotate,seed,stigma,style,tip,yellow	-8,0-6,1.8-2.7,1.8-3.9,10-24,14-48,2-10,2-13,2-5,2m,3-,3-6-foliat,4-3.,4.5-10.1,4.5-12.5,6-7,6.2-12.5,abaxiall,abaxially,acumen,acuminate,adaxially,apical,apically,articulate,attenuate,base,calyx,cell,connate,covering,cuneate,dehiscent,digestion,diminishing,dorsally,eaf,edge,eed,emoval,enzyme,exceeding,flat,folded,generally,globo,gradually,hair-like,honeycomb,interjected,introrse,lateral,leaflet,living,lobe,lon,long,long-attenuate,lower,lunat,make,maturing,nflorescence,nther,oblique,often,orolla,pair,pattern,perfect,petiolule,plan,poricidally,proximal,reveal,rounded,ruit,sessile,seudostipule,short,size,slit,specimen,stamen,straight,subequal,subsessile,tal,tem,terminal,testal,thick,throughou,throughout,toward,tuber-bearing,typically,unit,vary,wall,wide,ympodial,¼	abaxial,adaxial,anther,arrangement,colour,form,fruit,globose,growth,height,history,inflorescence,length,life,na,number,ovary,position,rachi,reproduction,shape,spacing,staman,surface,texture,wet,width
37	wfo-0001025792	success	203	95	70	133	25	0.345	0.4-0.7,1-10,1-2,1-3,10-15,2.5-3.5,21-28,4-6,5-10,7.5-8,9-12,abaxially,adaxially,anther,apex,axillary,blue-mauve,blue-purple,brownish,bud,cell,cm,condition,corolla,covering,densely,diameter,drying,elliptic,filament,flower,forked,fresh,fruit,glabrous,globose,green,greenish,hair-like,herb,lanceolate,lateral,mauve,minutely,mm,odd-pinnate,ovoid,pedicel,peduncle,petiole,plant,puberulent,pubescent,purple,rachi,ripe,rotate-pentagonal,seed,stigma,streak,style,subtending,terminal,testal,thick,tinged,wall,white,whitish,yellow	1-4,2-11,2-3,2-3.5,2.5-4,3-4,3-5,3.5-6,4-12,4.5-7,5,5-6,5-9,5-merou,7-10,8-10,acumen,acuminate,acute,ag,along,alyx,apart,apparently,articulated,articulation,auriculate,axe,base,basiscopic,berry,blade,broadly,capitat,chartaceous,ciliate,connivent,dark,decurrent,developing,digestion,distal,distinct,distinctly,dorsally,eaf,edge,eed,enzyme,especially,exceeding,except,flat,folded,geminat,generally,glabrou,greatly,green-white,hair,hal,half,high,homostylous,honeycomb-shaped,indistinct,interjected,leaflet,lengthening,like,living,lobe,long,lower,make,margin,membranous,midrib,minute,mottle,mucilaginous,narrow,narrowly,nflorescence,oblique,often,onto,orolla,pair,papillose,perfect,petiolulate,plurifoliate,pore,poricidal,proximal,reduced,removed,rounded,ruit,semi-erec,semi-rosette,sessile,seudostipule,short,shortly,side,size,slightly,slit,spaced,specimen,stamen,ste,stem,straight,sub-rosette,subequal,tall,tamen,tem,throughout,tip,tri-,tube,unit,usually,vary,wet,wing,x,ympodial,young	abaxial,adaxial,arrangement,capitate,colour,form,growth,height,history,inflorescence,leaf,length,life,na,number,ovary,perennial,position,reproduction,shape,spacing,staman,surface,texture,width
38	wfo-0001025804	success	155	80	51	104	29	0.329	0.5-1,1-3,1.2-1.5,1.4-1.7,10-20,3-4.5,3.5-12,6-8,abaxially,adaxially,anther,apex,base,bilobed,cm,corolla,cream,difoliate,elliptic,filament,flattened,flower,glabrous,globose,green,incrassate,internodal,leaf,light,lobed,margin,minutely,mm,nearly,obovate,occasionally,opposite,ovary,paler,pedicel,pitted,plurifoliate,reddish-brown,reniform,shrub,somewhat,stigma,style,surface,white,whitish-green	.25,.5,1-1.5,1.5-2,11-20,16-35,2-2.5,2.5-4,4-10,5,7-10,?,acute,age,anthesi,apar,ape,apiculate,attenuate,ba,bark,berry,branched,c.,calyx,clavate,conical,covered,cucullate,dark,decurrent,deflexed,densely,dia,differing,drying,eaf,edicel,eed,ellipsoid,erect,exserted,fleshy,free,fruiting,geminat,glandular,later,lateral,lengthening,lobe,long,lower,main,major,many,mere,middle,minor,minute,near,nflorescence,often,older,onto,pair,papillae,papillat,papillate,papillose,planar,pore,poricidal,portion,projection,red,red-papillose,reddish-brow,regularly,rim,ruit,scar,sessile,size,slit,spaced,stem,strongly,tall,thick,time,tip,tub,tube,ud,unit,vein,widest,wing,winged,woody,x,ympodial,young	abaxial,adaxial,apart,arrangement,colour,diameter,form,fruit,geminate,growth,height,history,inflorescence,length,life,na,number,peduncle,petiole,plant,position,rachi,reproduction,seed,shape,spacing,staman,texture,width
39	wfo-0001025813	invalid_json	197	117	84	113	33	0.426	'',1-10,1-2,1-4,1.5-1.8,15-30,3-3.5,3-4,3-7,6-7,``,abaxially,adaxially,along,anther,apex,articulated,base,berry,blue,broadly,brownish,cell,ciliate,cm,condition,corolla,covering,dark,densely,diameter,distal,drying,elliptic,especially,filament,flower,fresh,fruit,glabrous,globose,green,green-white,greenish,hair,herb,lateral,light,make,margin,midrib,minutely,mm,monochasium,mucilaginous,obtuse,odd-pinnate,ovoid,pedicel,peduncle,petiole,pilose,plant,puberulent,pubescent,rachi,rarely,rotate,seed,stem,stigma,style,suborbicular,testal,thick,throughout,tip,typically,violet,wall,wet,white,whitish,yellow	0-2,0.7-1.7,1-1.5,1.2-4.5,1.3-7,1.5-2,1.5-6.5,2-3,2-4,2-5,3-5,3-6,5-18.5,5-6,5-merou,absent,acumen,acuminate,acute,ag,alyx,apart,apparently,axe,blade,borne,chartaceous,connivent,contracted,cuneate,decreasing,decurrent,digestion,discussion,distinct,dorsally,eaf,edge,eed,end,enzyme,exceeding,extra,flat,folded,geminat,glabrou,hair-like,half,highly,homostylous,honeycomb-shaped,interjected,lanceolate,larger,leaflet,lengthening,like,living,lobe,long,longer,lower,membranous,minute,near,nflorescence,often,orbicular,orolla,ovate,ovoi,pair,perfect,petiolulate,plurifoliate,pore,poricidal,removed,rosette-formin,ruit,see,sessile,seudostipule,short,single-flowered,singly,size,slit,sometimes,spaced,species,specimen,stamen,ste,stolo,straight,strongly,tamen,tem,terminal,thir,toward,tri-,tube,tuber,unforked,unit,unwinged,vary,vein,x,ympodial	'extra,'hair-like,[,],abaxial,adaxial,arrangement,characteristic,colour,form,growth,height,history,inflorescence,leaf,length,life,na,number,ovary,perennial,position,reproduction,shape,spacing,staman,surface,texture,third,value,width,{,}
40	wfo-0001025817	success	238	103	68	170	35	0.286	1-1.6,10,abaxially,acuminate,anther,apart,apex,asymmetric,base,bifurcate,black,broadly,brown,chartaceous,cm,dark,deeper,densely,diameter,dull,eventually,extra-axillary,filament,flower,fruit,glabrate,glabrous,globose,green,lanceolate,larger,leaf,lenticular,minutely,mm,moderate,near,occasionally,ovate,pale,pedicel,peduncle,pedunculate,petiole,pitted,pubescent,purple,rachi,rarely,ripe,short,shrub,simple,sized,small,stellate,stigma,style,surface,time,tree,turning,unequally,violet,white,white-stellate,yellow,×	0.5–0.7,0.6–0.8,0.8–1.5,0–1.6,1.5–2.5,1.7-2.1,1.8–2.3,1.8–3,10–16,10–35,12–16,1–3,1–5,2–2.9,2–3,2–5,2–6.5,2–8,3.2–8,3.5–6,3–,3–13,3–6,3–8,4–5.5,4–6,4–7,5-merou,5–20,5–6,6–13,7–9,8–14,8–21,absent,accrescen,acute,adaxially,age,along,although,alyx,amount,apiculate,apparently,armed,articulated,asymmetrically,axe,ba,berry,bicolorous,blade,branch,branched,broad-based,calyx,campanulate,capitat,central,compresse,conical,deciduous,deltoid,dense,developing,difoliate,directed,distall,distally,eaf,eed,entire,exceeding,except,expanded,expansion,fertile,fewer,filiform,flowering,forming,free,fruiting,geminat,glabrou,high,impressed,interpetalar,juvenile,lacking,large,lateral,laterally,like,linear-lanceolate,lobe,long,low,lower,major,margin,midpoint,midvein,minute,much,nerve,nflorescence,numerous,oblong,obtuse,often,one,orolla,overlapping,persistent,persistently,pinnatifi,pore,portion,present,prickle,prickly,principal,pubescence,racemose,rayed,reaching,recognizable,rounded,row,ruit,sessile,single,sinuate–repand,sinus,slender,slightly,sometimes,soon,spaced,sparse,spreading,stalked,stellae,stem,stout,strongly,tamen,tapering,tissue,tomentose,trunk,tube,ultimate,unarmed,underside,unit,usually,variously,vary,vein,velvety,weakly,well,wide,without,woolly,ympodial,young	0-1.6,1.5-2.5,2-2.9,2-8,3-13,3-8,3.2-8,4-5.5,4-7,5-merous,7-9,abaxial,adaxial,arrangement,capitate,colour,corolla,form,growth,height,history,inflorescence,length,life,na,ovary,perennial,plant,position,reproduction,seed,shape,spacing,staman,texture
41	wfo-0001025825	success	187	99	75	112	24	0.401	0.4-1,0.5-10.4,1-2,1-5.5,10-24,2-3.7,22-86,3-10,4-8,5-10,6-10,abaxially,acuminate,acute,adaxially,anther,apex,axillary,back,berry,brownish,bud,cell,clavate,cm,condition,coriaceous,corolla,covering,dark,diameter,drying,elliptic,filament,flower,forked,fresh,fruit,glabrescent,glabrous,green,greenish,hair,hair-like,herb,lateral,leaf,light,lilac,lobe,medium,mm,odd-pinnate,ovoid,pedicel,peduncle,pentagonal,petiole,plant,rachi,rotate-pentagonal,seed,shiny,short,stigma,streak,style,subtending,terminal,testal,thick,wall,white,whitish,yellow	0-0.21,0.4-3,0.5-0.8,0.7-2.2,0.9-2,0.9-4,1-3,1.1-1.4,10.5-26,14-85,2-5,3-5,3-8.5,3.7-6.5,4-9,5-7,5-merou,6.6-14,acumen,adaxiall,ag,alyx,apart,apparently,articulated,asymmetric,attenuate,axe,base,basiscopic,blade,capitat,connivent,cuneate,decreasing,decurrent,digestion,distal,dorsally,eaf,edge,eed,enzyme,erec,exceeding,flat,folded,geminat,generally,glabrou,green-white,hal,half,high,homostylous,honeycomb-shaped,increasing,interjected,lanceolate,leaflet,lengthening,living,long,lower,make,middle,mucilaginous,nflorescence,orbicular,orolla,ovate,pair,perfect,petiolulate,plurifoliate,pore,poricidal,removed,rounded,ruit,sessile,seudostipule,side,size,slightly,slit,smaller,spaced,specimen,stamen,straight,subequal,subglabrou,tall,tamen,tem,throughout,tip,tissue,toward,tri-,tube,unit,unwinged,usually,vary,wet,wide,wing,winged,x,ympodial	abaxial,adaxial,arrangement,capitate,colour,form,growth,height,history,inflorescence,length,life,na,number,ovary,perennial,position,reproduction,shape,spacing,staman,surface,texture,width
42	wfo-0001025835	success	297	94	72	225	22	0.242	0.2-2,0.5-2.8,0.6-1.3,0.65-0.8,0.7-3,1-1.5,1-4,1-9,1.2-2,2.5-3,3-7,3.5-4,acute,adaxial,anther,apex,berry,bright,brown,cell,clavate,cm,corolla,diameter,drying,dull,erect,evenly,filament,flattened-reniform,flower,fruit,glabrous,globose,green,lateral,leaf,length,lobed,maturity,mauve,mm,moderately,obtuse,orange,outline,ovate,ovoid,pale,pedicel,peduncle,petiole,pit,rachi,raised,red,shiny,shrub,simple,small,smooth,stellate,stellate-pubescent,stigma,style,surface,thin,white,yellow,yellow-orange,yellowish,young	.1,.3,/4,0.05-0.1,0.1,0.1-0.2,0.5,0.5-0.7,0.5-1,0.7-1.8,1,1-2,1-2.5,1-3,1-5,1-7,1-8,1.2-1.8,1.5-1.8,1.5-2,1.5-3,1.5-3.5,1/2,1/3,1/3-3/4,1/4-1/2,1/4-1/3,1/4-2/3,2-6,2.2-2.5,2.5-3.5,20,3-5,3-6,30-45°,4,4-5,4-8,5,5-20,5-merou,6,6-8,7-9.5,8,9-11,abaxially,accrescent,acuminate,adaxially,ag,almost,always,alyx,apar,apart,apically,apiculate,apparently,armed,articulated,axe,bark,base,becoming,beyond,black,blade,branche,branched,broad-based,broad-deltate,calyx,chartaceous,concolorous,covering,cupular,curved,dark,deep,deltate,developed,development,difoliate,distance,divided,dorsal,eaf,eed,elongating,equal,exserted,extending,faint,finely,finger-hair,flat,flattened,foliaceous,free,fruiting,geminat,gently,glabrescent,gre,green-brown,greenish,infructescence,irregula,irregular,lamina,lengthening,less,lobe,lobing,long,long-deltate,longer,longitudinal,lower,margin,mature,midpoint,midvein,minute,mostly,network,nflorescence,obconical,oblong,occasional,often,older,one,open,opening,orange-brown,orange-translucent,orolla,oung,ovoi,pair,papillae,papillo,part,pendulous,per,perfect,pericarp,point,pore,poricidal,porrect,portion,prickle,primary,pronounced,rarely,ray,reduced,reflexed,regular,rest,ribbed,ridged,rounded,ruit,scar,secondarily,secondary,sessile,shallow,short,shorter,shortly,side,significantly,sinus,slender,slightly,slit,sometimes,somewhat,spaced,sparsely,spherical,spreading,stalk,stalked,stem,straight,straw-yellow,stump,tamen,tapering,terete,terminal,tertiary,throughout,time,tip,toward,translucent,trichome,trifoliate,tube,ud,unarmed,unequal,unit,upper,usually,variously,vary,vein,venation,visible,weakly,wide,widest,wing,woody,x,ympodial,×	abaxial,arrangement,colour,form,growth,height,history,inflorescence,life,number,ovary,papillose,perennial,plant,position,reproduction,seed,shape,spacing,staman,texture,unknown
43	wfo-0001025838	success	217	101	80	137	21	0.369	0.5-1,0.7-2,1-1.2,1-1.5,1.5-3.5,1.5-5,1.8-2,10-60,2-5,4-15,4.5-5.5,6.5-7,adaxial,anther,apart,apex,berry,black,branched,brown,capitate,clavate,cm,corolla,dendritic,dense,densely,diameter,elliptic,erect,filament,flattened,fleshy,flower,fruit,glabrous,globose,greenish,growth,inflorescence,lanceolate,lateral,leaf,lobed,many,membranous,minutely,mm,narrowly,nodding,often,pale,pedicel,peduncle,petiole,pitted,pubescent,purple,reddish,reniform,seed,shiny,shrub,simple,slender,slightly,stellate,stigma,style,surface,terminal,thin,time,tinged,tree,trichome,tuft,white,x,yellow	-20,.5,0.5,1.2-5,1.5-1.7,1.5-2,1.5-2.5,10-15,2-2.5,2.5-3,2/3,20-40,3.5-,5,5-merou,6-15,abruptly,acuminate,adaxially,ag,along,alyx,anthesi,apiculate,appearing,archin,ark,articulated,attenuate,axil,basall,base,branch,broad,calyx,cell,clustered,connivent,cucullate,cup-shaped,dark,decurrent,denser,disintegrating,drying,eaf,eed,ellipsoidal,entire,exserted,extending,free,fruiting,glabrescent,hairy,ilament,inserted,insertion,irregularly,keeled,lamina,lengthening,less,like,lobe,long,loosely,lower,m.,margin,midrib,minute,mostly,narrowing,never,new,nflorescence,occasionally,older,onto,orolla,ovoid,pair,papillat,papillo,per,perfect,pericarp,platform,plurifoliat,point,pointed,pore,poricidal,portion,primary,quadrate,revolute,ripe,ruit,scar,shin,short,sinus,sleeve,slit,small,sometimes,spaced,sparsely,spreading,square,stem,strongly,tall,tem,testal,thi,tip,tube,turbinate,twinin,ud,uniseriate,unit,upper,vary,vein,wall,way,weight,wing,winged,woody,yellowish,ympodial,¾	5-merous,abaxial,arrangement,colour,form,height,history,length,life,na,number,ovary,plant,position,rachi,reproduction,shape,spacing,staman,texture,width
44	wfo-0001025845	success	180	91	68	112	23	0.378	0.3-0.5,0.4-1.5,0.5-11,0.5-2.5,1-4.5,1.5-2,1.5-7,2-5-lobed,3-13,4-5,4-6,5-6,6-6.5,acuminate,adaxial,anther,apart,apex,articulated,base,branch,brown,chartaceous,cm,corolla,diameter,ellipsoidal,extra-axillary,filament,flattened,flower,fork,fruit,glabrous,greenish,herb,leaf,light,located,membranaceous,minutely,mm,near,orange,ovate,ovoid,patch,pedicel,peduncle,petiole,pinnately,puberulent,rachi,rotate-stellate,rugose-verrucate,sand-punctate,shrub,simple,sparsely,stigma,style,truncate,unbranched,veiny,white,x,yellow,yellowish	.5,1,1-1.8,1-2,1.5,1.5-13,1.5-2.5,2,2-15,2-3,2.5-4,3,3-4,3-6,3-foliat,6-9,7-10,abaxially,abundantly,acute,adaxially,aggregate,along,apiculate,around,ascending,axe,ba,blade,calyx,cell,channe,compressed,connivent,cuneate,cylindrical,dark,decurrent,deltate,diamete,directed,distall,distally,divided,eaf,eed,eglandular,elliptic,entire,especially,free,glabrou,green,inserted,lateral,laterally,lobe,lobed,long,longitudinal,lower,major,margin,mesocarp,midrib,narrowly,nearly,nflorescence,obovate,obtuse,often,orolla,part,perfect,pore,pubescent,purple,radiu,rarely,rounded,ruit,sagittate,shorter,side,sinus,small,spaced,stone,stripe,strongly,subcordate,tal,tamen,tapered,tem,terminal,thecae,thick,tightly,time,tip,tomento,triangular,truncat,tube,unit,unlobed,vary,vein,wide,ympodial,youn	abaxial,arrangement,colour,form,growth,height,history,inflorescence,length,life,na,number,ovary,plant,position,reproduction,seed,shape,spacing,staman,surface,texture,width
45	wfo-0001025850	success	197	111	90	107	21	0.457	.5,0.5-1,0.5-3,0.6-1,1,1-1.5,1.5,2-12,2-6.5,30,6-7,abaxial,anther,anthesi,base,berry,branched,broadly,brown,capitate,cell,cm,corolla,densely,diameter,divaricate,elliptic,erect,filament,flattened,flower,glabrous,glandular,globose,green,growth,inflorescence,irregularly,later,lateral,lax,lobed,many,margin,minutely,mm,narrowly,nearly,nodding,openly,orange,outline,pale,papillate-puberulent,pedicel,peduncle,petiole,pinnatifid,pitted,pubescent,reddish,reniform,rhomboid,ripe,scattered,shiny,shrub,simple,sinuate,slender,spaced,spreading,stellate,stem,stigma,style,surface,tan,terminal,testal,thin,time,tip,trichome,uniseriate,vine,white,woody,x,yellow	-5,-7,.8,0.5,0.5-,1-3,1-celled,1.5-5,15-20,2,3-4,4-5,5-7,5-merou,acute,ag,along,alyx,apar,apex,apparently,ark,articulated,axi,basal,calyx,connivent,cupped,cyathiform,deciduous,deflexed,deltate,denser,divided,drying,eaf,eed,ellipsoid,elongate,em,entire,exserted,extending,fleshy,free,fruiting,geminat,glabrou,gland,half,halfway,ilament,lamina,leaving,lengthening,less,lobe,long,loosely,lower,membranous,midrib,minute,new,nflorescence,node,occasionally,often,older,orolla,pair,papillo,peg,per,perfect,planar,plurifoliate,pore,poricidal,portion,primary,puberulen,rounded,ruit,scar,shallowly,sinus,sleeve,slightly,slit,small,sometimes,soon,splitting,spreadin,strongly,surfac,tiny,truncate,tube,twinin,ud,unit,vary,vein,ympodial,young	5-merous,adaxial,apart,arrangement,bark,colour,form,fruit,height,leaf,length,na,number,ovary,papillose,plant,position,seed,shape,spacing,texture
46	wfo-0001025856	success	185	80	42	143	38	0.227	anther,apex,berry,branched,brown,chartaceous,cm,compound,corolla,diameter,elliptic,filament,flattened-reniform,flower,foveolate,glabrous,globose,green,lateral,light,mm,oblong,orange,pedicel,peduncle,perennial,petiole,pinnately,rachi,rugose,slender,spreading,stellate,stigma,streak,strongly,style,surface,terminal,uniformly,white,yellow	.4,/4,0,0.3-1,0.3–0.5,0.5,1-3,1.5–2,10–,10–15,15–20,1–,1–1.5,1–2,1–5,2,2.5–4,20,20–30,20–35,2–,2–4,3,3-10,3–4,3–5,4–,4–10,4–6,5–,5–10,5–15,5–7,6–12,abaxially,acuminate,acute,adaxially,ag,always,alyx,anthesi,apiculate,armed,articulated,axe,base,becoming,blade,bud,c.,calcium,calyx,campanulate,commonly,connivent,corresponding,crystal,cuneate,densely,difoliate,dr.,eaf,eed,ellipsoid,entire,equal,exserted,fifth,four,fruiting,geminat,glabrescent,glabrou,herbaceous,internode,larger,leaflet,lengthening,lobe,lobed,long,long-styled,longer,lower,major,margin,narrowly,nearly,nflorescence,oblique,often,one,opposite,orolla,outline,oxalate,pair,papillat,pericarp,petiolulate,petiolule,plurifoliate,pointed,pore,poricidal,present,prickle,rarely,recurve,recurved,rounded,ruit,side,slightly,slit,somewhat,soon,stout,straight,subopposite,subwood,subwoody,tamen,tem,throughout,time,tip,triangular,truncat,tub,tube,unequal,unit,usually,vary,vein,vin,way,wide,widest,ympodial,×	1-5,10,10-15,10-30,2-15,2.5-4,20-35,4-10,5-10,5-7,abaxial,adaxial,arrangement,colour,dry,form,fruit,growth,height,history,inflorescence,leaf,length,life,na,number,ovary,plant,position,reproduction,seed,shape,spacing,staman,texture,truncate,vine,width
47	wfo-0001025872	success	160	81	53	107	28	0.331	0.25-0.5,0.6-1,1-2,1.2-1.6,2-5,4-4.5,6-8,anther,apart,apex,becoming,beneath,branched,bright,brownish,capitate,cm,corolla,dark,deeply,densely,dry,elliptic,filament,flattened-reniform,fleshy,flower,glabrous,globose,green,greenish-tan,later,lateral,leaf,live,lobed,material,mm,narrowly,occasionally,opposite,ovary,pedicel,petiole,pitted,plant,pubescent,shrub,stigma,style,surface,terminal,white	.1,.5,0.5,0.5-1,1,1-1.3,1-1.5,1.2-1.5,1.7-3,10-25-flowered,2-2.5,2/3,3.5-4,4.5-13,6-10,acute,along,anthesi,apically,auriculate,ba,bark,base,beginning,berry,blade,broadly,calyx,coriaceous,crinkled,crowded,cup-shaped,decurrent,deflexed,dense,dia,eaf,edicel,eed,exserted,flattened,free,fruiting,glandular-resinous,grayish-brow,incrassate,inflorescenc,irregularly,junction,lobe,lon,long,lower,main,margin,midrib,minutely,nflorescence,often,older,onto,pair,paler,papillae,papillo,papillose,planar,plurifoliat,pore,poricidal,portion,prominent,red-papillose,revolute,rounded,rounded-triangular,ruit,scar,several,shaped,simple,somewhat,soon,spaced,specimen,stem,straight,tall,tapering,tear-drop,thick,thickened,time,tip,trichome,tub,tube,ud,uniseriate,unit,vein,visible,way,woody,x,ympodial,young	10-25,abaxial,adaxial,arrangement,colour,diameter,form,fruit,growth,height,history,inflorescence,length,life,na,number,peduncle,perennial,plurifoliate,position,rachi,reproduction,seed,shape,spacing,staman,texture,width
48	wfo-0001025875	success	205	84	64	141	20	0.312	0.1-1.1,0.3-2,0.8-0.9,0.8-1.8,1.2-1.8,2.4-2.8,3-6,4.5-6.5,5-10,8-11,abaxially,acute,adaxially,andromonoecious,anther,apex,chartaceous,cm,dark,deeply,densely,diameter,erect,extra-axillary,filament,flower,fruit,glabrous,globose,green,inflorescence,lanceolate,leaf,length,lobe,lobed,mm,oblate,obtuse,pale,pedicel,peduncle,perennial,petiole,plant,pseudo-racemose,purple,rhizomatous,rotate,shallowly,shrub,simple,sparsely,stellate-pubescent,stigma,streak,style,surface,truncate,unbranched,weakly,white,yellow,yellowish	%,.05,0-0.1,0-0.5,0-1.5,0-5,0.1-0.2,0.2-0.45,0.25-0.4,0.3-0.4,0.4-0.5,0.4-0.7,0.5-1,0.5-1.3,0.5-6,0.7-0.8,0.9-1.4,1-10,1-2,1-3,1-7,1.1-1.6,1.5-2.5,1.5-6,15-25,2-locular,2.3-3,2.5-4.5,3-5,4-10,5-11,5-14,5-15,5-9,5-merou,6-13,7-10,7-14,7-8,8-14,9-13,?,absen,absent,accrescent,acicular,across,adaxiall,adult,alyx,anvil-shape,apart,articulated,attenuate,axe,ba,basal,base,blade,branchlet,calyx,cross-section,cuneate,cylindrical,decimetre,deltate,directed,distally,dm,eaf,eed,eglandular,entire,exocarp,finger,fruiting,functional,geminat,gland-tipped,grey,hair,half,hastate,heterostylous,juicy,juvenile,lamina,lateral,less,linear,long,longer,lower,margin,mature,mesocarp,mid-point,midpoint,midvein,minute,moist,narrowly,nflorescence,oblique,orolla,pair,part,per,placenta,plurifoliate,pore,porrect,possibly,present,prickle,ray,ruit,sessile,short,spaced,stalk,stalked,stellae,stellate,straight,tal,tamen,tem,thick,throughout,time,transparent,tube,unarme,unarmed,unit,upper,vary,wide,x,ympodial	abaxial,adaxial,arrangement,colour,corolla,form,growth,height,history,life,na,number,ovary,position,reproduction,seed,shape,spacing,staman,texture
49	wfo-0001025888	success	256	119	88	168	31	0.344	.3,.4,.5,1.5,2.1,3,3.2,3.8,9.5,abaxially,across,adaxially,adnate,along,anther,apex,apiculate,attachment,base,branching,calyx,cm,corolla,deltoid,densely,diameter,dry,extra-axillary,flattened-orbicular,flower,fruit,glabrous,glandular,globose,hair,internode,interpetalar,lamina,lateral,leaf,lobe,long,longitudinally,mature,minute,mm,moderately,nearly,notched,oblong,orange-red,ovate,pedicel,peduncle,petiole,point,poorly-developed,porrect,pubescence,pubescent,red,restricted,scattered,sessile,short-stipitate,shrub,simple,small,stellae,stellate,stigma,straight,style,time,tip,tissue,tree,truncate,unbranched,vein,white,wide,yellow,yellow-ferruginous,yellow-tan,young,±glabrous,×	.05,.6,0.04,0.1,0.2,0.3–0.5,0.4,0.4–0.6,0.4–0.7,0.5–0.7,0.6–1.2,0.7–0.8,0.7–1.5,0.8,0.8–1.0,0.9–1.1,0.9–1.2,0.9–1.3,1.0–1.8,1.2–2.3,1.4–1.8,1.5–1.9,1.5–2.0,1.5–2.1,1.5–4.0,1.7–2.1,1.8–2.3,1.8–3.5,1.9–2.2,1.9–3.4,1/2–2/3,1/3,2.2,2.5–2.6,2.6,2.7–3.0,3.0–11.1,3.1–4.2,3/4,4.2–5.5,4–8,4–9,5,5-merou,5.5–11.1,5–7,6–10,7.1–9.1,8.1–17.1,90°,acute,alveolate,alyx,anthesi,apart,apparently,appearing,appresse,arching,area,articulate,axe,ba,berry,blade,branch,broad,brochidodromous,bud,capitat,central,channeled,chartaceous,clinate,congested,cuneate,dehiscen,denser,dentate,development,difoliate,distal,distinct,eaf,eed,either,emerging,endocarp,entire,exocarp,fertile,filament,filiform,flexed,free,geminat,glabrescent,gradually,homostylous,hooked,increasing,intersepalar,juic,less,little,lon,longer,lower,major,many,margin,middle,midpoint,midrib,midvein,minor,nflorescence,oblique,opaque,orolla,per,portion,potentially,pubescen,raised,ray,reflexed,rigid,rounded,row,ruit,shinny,shorter,side,sinuate,sinus,smoot,sometimes,spaced,sparsely,splitting,spread,spreading,stellate-pubescent,stipe,surface,swelling,tamen,tardily,tem,thin,though,tube,two,typically,ud,unarmed,vary,weakly,well,ympodia,±90°,±aequilateral,±equal,±erect,±overlapping,±smooth,±straight	0.3,0.6-1.2,0.7-1.5,0.9-1.2,1.0-1.8,1.4-1.8,1.5-2.0,1.5-4.0,1.8-2.3,1.9-2.2,3.0-11.1,5.5-11.1,8.1-17.1,adhesion,capitate,color,dehiscence,dehiscent,form,growth,height,inflorescence,length,ovary,plant,position,seed,shape,size,staman,stem
50	wfo-0001025892	success	170	77	49	121	28	0.288	0.2-0.4,0.3-0.8,1-2,2.8-3,4.5-7.5,5-17,7-15,8-11.5,absent,anther,apex,articulated,base,chartaceous,cm,densely,diameter,extra-axillary,flower,fruit,globose,grey-green,herbaceous,inflorescence,lanceolate,leaf-opposed,length,linear,long,mm,narrowly,oblate,obtuse,pale,pedicel,peduncle,petiole,purple,resprouter,simple,stellate,stellate-pubescent,sticky-glandular,stigma,style,unbranched,white,yellow,yellowish-green	%,.3,0-0.1,0-0.3,0-1,0-10,0.05-0.1,0.1-0.2,0.2-0.5,0.2-0.8,0.3-0.5,0.3-0.7,0.4-0.6,0.4-0.8,0.7-0.9,0.8-1.1,1.5-5,10-17,2-7,2-locular,2.5-4,2.5-6,4-merou,5-7,6-10,8-10,8-11,8-13,9-18,abaxially,absen,adaxiall,adaxially,alyx,apart,axe,ba,blade,broad-based,calyx,connivent,cross-section,cuneate,curved,cylindrical,d.,deltate,dense,directed,distall,distributed,dult,eaf,eed,eglandular,entire,erect,exocarp,finger,fruiting,geminat,glabrous,gland-tipped,glandular,grey,hair,half,juicy,lamina,lateral,less,lobe,longer,lower,margin,mature,mesocarp,mid-point,midpoint,minute,moist,nflorescence,oblique,orolla,papillae,part,per,perfect,placenta,pore,porrect,present,prickle,pseudo-racemose,ray,ruit,sessil,sessile,short,solitary,spaced,stage,stalk,stellae,stem,straight,tal,tamen,thick,throughout,time,triangular,truncat,tube,unarmed,unit,uvenile,vary,wide,x,ympodial	4-merous,abaxial,adaxial,arrangement,colour,corolla,filament,form,growth,height,history,leaf,life,na,number,ovary,perennial,plant,position,rachi,reproduction,seed,shape,spacing,staman,surface,texture,truncate
51	wfo-0001025893	success	157	89	63	94	26	0.401	.4,.5,0.5-1.5,0.8-1,1-4,1.5-2,2-2.5,3-5,5-6,along,anther,apex,base,beneath,bi-lobed,brownish-green,calyx,capitate,closely,cm,corolla,decurrent,dia,elliptic,filament,flower,fruit,glabrous,globose,golden-puberulent,green,internodal,leaf,lobed,long,minutely,mm,narrowly,nearly,obovate,opposite,ovary,overlapping,ovoid-reniform,pale,papillose,pedicel,petiole,pitted,shrub,slender,sometimes,spaced,stigma,style,surface,tapering,tube,vein,white,winged,x,yellowish	.25,1-1.2,1-1.5,1-2.5,1.5-1.7,11-20,2-3,6-10,accrescent,anthesi,attenuate,bank,barely,bark,bearing,beginning,berry,blade,branched,broadly,cup-shaped,deflexed,deltoid,densely,difoliate,dry,eaf,early,eed,ellipsoid,erect,even,exserted,faintly,free,fruiting,geminate,glabrate,gravelly,greyish,growing,impressed,inflorescenc,lateral,lobe,lon,long-acuminate,longitudinally,lower,main,many,margin,material,middle,nflorescence,occasionally,older,pair,papillo,planar,plurifoliat,pore,poricidal,portion,puberulent,red-papillose,reflexed,river,rocky,ruit,sandy,scar,shaped,slightly,specimen,stem,straight,stream,striat,tall,tear-drop,thickened,time,tip,trichome,ud,unicellular,unit,usually,visible,widest,woody,ympodial,young	abaxial,adaxial,arrangement,colour,diameter,form,growth,height,history,inflorescence,length,life,na,number,peduncle,perennial,plant,position,rachi,reproduction,seed,shape,spacing,staman,texture,width
52	wfo-0001025896	success	146	81	54	92	27	0.37	-3,-30,0.5,0.5-2,1-25,1-6.5,1-8,1.5-9,2-2.5,2.5-14,4-6,5-15,6-10,abaxial,angled,apart,apex,brownish,chartaceous,cm,densely,diameter,elliptic-ovate,flower,forked,fruit,glabrous,globose,greenish,membranaceous,mm,nearly,orange,ovate,pale,pedicel,peduncle,petiole,pubescent,purple,rachi,red,rotate-stellate,rugose,shrub,simple,smooth,stigma,style,surface,unbranched,white,x,yellow	.5-2.5,1-1.5,1-3,1.5-2,10-15,10-25,2-14,2.5-5,4,4-12,4-23,4-5,5-7,6-13,7-,7743,abaxially,absen,acosta,acuminate,acute,adaxiall,adaxially,aggregate,also,articulated,axe,ba,base,blade,branched,calyx,cell,connivent,constricted,cuneate,cylindrical,deltate,dendritically,directed,distall,eaf,eed,eglandular,entire,especially,gland,hair,inflated,like,lobe,long,lower,many-foliat,margin,moderately,near,nflorescence,nther,obtuse,occasionally,often,orolla,perfect,pore,present,puberulent,pubescen,radiu,ripe,ruit,short-stalked,solí,spaced,sparsely,stalked,stem,stone,subcordate,tal,tem,time,tip,triangular-ovate,triangular-subulate,truncat,tube,unit,vary,vein,wide,ympodial	adaxial,anther,arrangement,colour,corolla,filament,form,growth,height,history,inflorescence,leaf,length,life,na,number,ovary,plant,position,reproduction,seed,shape,spacing,staman,texture,truncate,width
53	wfo-0001025902	success	211	89	66	145	23	0.313	0.1-0.5,0.5-2.5,1-1.5,11-15,2.5-4,3-10,4-13,5-6,8-15,abaxially,acute,anther,apex,becoming,black,clavate,cm,corolla,densely,diameter,dull,ellipsoid,filament,flattened-reniform,flower,glabrous,globose,green,growth,inflorescence,lanceolate,lateral,leaf,leaf-opposed,length,linear,mature,minute,minutely,mm,ovary,pale,pedicel,peduncle,petiole,pitted,pubescent,rotate-stellate,rounded,scrambling,simple,slender,sometimes,stigma,style,surface,tapering,terminal,trichome,uniseriate,vine,violet,whitish,woody,x,yellow	.2,.5,/2,0.5-2,1-1.2,1.2-1.5,1.5,1.5-2,1.5-3,1/3,1983,2-6,4,4-5,4-6,40,5-merou,8-10,8-9,>,absent,accompanied,adaxially,ag,aid,along,always,alyx,anthesi,apar,ark,articulated,attenuate,axi,bark,base,beginning,berr,berry,branch,branched,branching,broadly,c.,cabrera,calyx,cell,chartaceous,circular,climbin,completely,conical,connivent,deciduou,deltate,eaf,eed,either,entire,except,exfoliatin,exserted,fide,fleshy,free,fruiting,geminat,ilament,leaving,lengthening,less,lobe,lobed,long,loosely,low,lower,margin,markedly,midvei,new,nflorescence,obscured,occasionally,often,older,one,orolla,pair,papillat,papillose,peg,pendant,per,perfect,pericarp,planar,plurifoliate,pore,poricidal,portion,primary,prominent,revolute,ridged,ruit,scar,scattered,semi-aquati,semi-circular,shallow,sleeve,slit,small,somewhat,soon,spaced,sparsely,spreading,stem,strongly,tangled,tem,testal,thin,time,tip,tube,twining,ud,ultimate,unit,usually,vary,vegetation,vein,water,way,weak,weight,widely,wing,yellowish,ympodial,½	5-merous,abaxial,adaxial,apart,arrangement,colour,form,fruit,height,history,life,na,number,plant,position,rachi,reproduction,seed,shape,spacing,staman,texture,width
54	wfo-0001025906	success	188	103	79	109	24	0.42	0.1-2,0.20-0.60,1-2,1.6-12.4,16-51,2-4.4,3-10,3-5,4-12,4-7,5-7,8.5-12.5,abaxially,adaxially,anther,axillary,blue,brownish,bud,cell,clavate,cm,condition,coriaceous,corolla,covering,dark,diameter,drying,filament,flower,forked,fresh,fruit,glabrous,globose,green,green-white,greenish,hair,hair-like,herb,lanceolate,lateral,leaf,light,lilac,linear,make,mm,mucilaginous,odd-pinnate,ovoid,pedicel,peduncle,pentagonal,petiole,plant,pubescent,purple,ripe,rotate,seed,shiny,short,stigma,stripe,style,subglabrous,subtending,terminal,testal,thick,throughout,wall,wet,white,whitish,yellow	0-14,0.15-0.6,0.2-0.6,1-3,1-6,1.1-2,1.8-4.8,2-6,2.6-5.2,4-10,4-5,5-6,5-merou,5.2-9,8-16,acumen,acute,adaxiall,ag,alyx,apart,apex,apparently,articulated,axe,base,berry,blade,capitat,connivent,cuneate,decreasing,decurrency,decurrent,delimited,digestion,diminishing,distal,dorsally,eaf,edge,eed,enzyme,erec,exceeding,falcate,first,flat,folded,geminat,generally,glabrou,hal,half,high,homostylous,honeycomb-shaped,interjected,leaflet,lengthening,living,lobe,long,lower,next,nflorescence,obtuse,orolla,pair,perfect,plurifoliate,pore,poricidal,rachi,removed,ruit,second,sessile,seudostipule,size,slightly,slit,smaller,spaced,sparsely,specimen,stamen,straight,sub-glabrous,subequal,subglabrou,tall,tamen,tem,third,tip,toward,tri-,tube,typically,unit,unwinged,usually,vary,well,width,wood,x,ympodial	abaxial,adaxial,arrangement,capitate,colour,form,growth,height,history,inflorescence,length,life,na,number,ovary,perennial,position,pseudostipule,reproduction,shape,spacing,staman,surface,texture
55	wfo-0001025907	success	148	72	44	104	28	0.297	-4,1-3,1-5,1.5-2,2,4-5,acuminate,acute,anther,apex,axil,axillary,brown,cm,conical,densely,diameter,elliptic,filament,flattened,flower,fruit,glabrous,green,greenish,growth,lobed,mm,obovate,ovary,ovoid-reniform,pedicel,per,petiole,plant,pubescent,round,rugose,seed,shrub,simple,stigma,style,surface	.05,.5,.5-1,0,0-60,0.8-1.8,1,1-1.2,1-2.3,1.5-2.2,10-15,12-45,2-3.5,2-8,2/3,3-,3-4,3/2,5-15,absent,along,anthesi,anthesis5-7,anticlinal,appearing,attenuate,base,beak,bearing,berry,breaking,c,calyx,cell,clavat,conspicuously,deciduous,eaf,edicel,eed,epidermal,erec,free,fruiting,globose,highly,included,iquito,irregular,isolated,lamina,lobe,lon,long,lower,margin,minutely,near,nearly,new,nflorescence,occasionally,open,pair,papillate,papillose,population,poricidal,portion,primary,projection,raised,red-papillate,reflexed,remaining,ruit,scar,scattered,single-stemmed,sinuous,size,slender,soon,sparsely,tal,tem,thickening,time,tip,trichome,truncate,tub,tube,ud,unifoliat,uniseriate,unit,variable,vein,white,white-lenticellate,without,x,ympodial	0.05,5-7,abaxial,adaxial,arrangement,clavate,colour,corolla,form,height,history,inflorescence,leaf,length,life,na,number,peduncle,perennial,position,rachi,reproduction,shape,spacing,staman,tall,texture,width
56	wfo-0001026203	success	197	88	64	133	24	0.325	0.06-0.86,0.38-11.3,0.4-3,1-2,2-4.9,2-43,3-10,3-11,3-5,3.2-23,7-47,abaxially,adaxially,anther,apex,blue,cell,clavate,cm,coriaceous,corolla,covering,dark,deep,diameter,elliptic,filament,flower,forked,fruit,glabrescent,glabrous,globose,green,greenish,hair,hair-like,herb,lateral,leaf,light,lilac,medium,mm,odd-pinnate,ovate,ovoid,pedicel,peduncle,pentagonal,petiole,plant,rachi,rotate,seed,short,stigma,style,terminal,testal,thick,wall,whitish,yellow	0-39,0-7,0.3-11,0.3-6,0.5-2.3,0.5-3.2,0.7-2.6,1-13,1-4,1-5,1-9,1.1-7.9,1.2-5.5,2-10,2-5,2-8.5,2.2-13.3,3.2-22,5-merou,acumen,acuminate,acute,ag,along,alyx,apart,apparently,arranged,articulated,asymmetric,attenuate,axe,axillary,base,basiscopic,bead,berry,blade,brownish,bud,capitat,condition,connivent,decreasing,decurrent,digestion,distal,dorsally,drying,eaf,edge,eed,enzyme,erect,exceeding,flat,folded,fresh,geminat,generally,glabrescen,glabrou,green-white,hal,half,high,homostylous,honeycomb-shaped,interjected,lanceolate,leaflet,lengthening,like,linear,living,lobe,long,lower,make,middle,moniliform,mucilaginous,multiple,necklace,nflorescence,orbicular,orolla,pair,perfect,plurifoliate,pore,poricidal,removed,ripe,rosett,rounded,ruit,sessile,seudostipule,side,size,slightly,slit,sometimes,spaced,specimen,stamen,stolon,straight,stripe,subequal,subglabrous,subtending,tall,tamen,tem,throughout,tip,tissue,toward,tri-,tube,tuber,typically,unit,unwinged,usually,vary,wet,white,wide,x,ympodial	abaxial,adaxial,arrangement,capitate,colour,form,growth,height,history,inflorescence,length,life,na,number,ovary,perennial,position,reproduction,shape,spacing,staman,surface,texture,width
57	wfo-0001026205	success	165	91	61	104	30	0.37	0.3-2,1,1-3,1.5,15-20,4,5-7.5,5-merous,7-9,abaxially,absent,anther,apex,calyx,chartaceous,cm,cream,deeply,diameter,elliptic,entire,extra-axillary,filament,flattened,flower,fruit,fruiting,globose,growth,leaf,linear-lanceolate,margin,minutely,mm,new,pedicel,peduncle,petiole,prickle,pubescent,purple,rachi,seed,sessile,short,shrub,simple,slender,sparsely,stellate,stellate-pubescent,stem,stigma,straight,strongly,style,surface,trichome,violet,white,yellow	-14,-2.5,-6,.5,.5-2,0.5-,0.75-1,1-1.5,1-2,1-6,2-14,2-3,3,3/4,30-35,5.5-6,8,accrescen,acuminate,acute,adaxially,alyx,apical,apparently,armed,around,articulated,attenuate,axe,ba,base,blade,cuneate,densely,difoliate,distinct,divided,eaf,eed,enlarged,erect,exceeding,extror,four,geminat,glabrous,glandular,globo,hair,homostylous,including,lateral,lobe,long,lower,major,maturing,midpoint,minor,minute,nflorescence,node,oblique,often,orolla,perfec,pore,porrect,porrect-stellate,proximally,rare,rarely,ray,ruit,scarcely,shortly,similar,size,slightly,small,smaller,solitary,sparse,stellat,stellate-pubescen,summit,tall,tamen,tem,thickened,third,tip,toward,tube,unarme,unarmed,unit,usually,vary,wide,wing,x,ympodial,zigza	0.5-2.5,2,abaxial,adaxial,arrangement,bark,bud,cell,center,colour,corolla,form,height,history,inflorescence,length,life,na,number,ovary,plant,position,red,reproduction,scar,shape,spacing,staman,texture,width
58	wfo-0001026208	success	214	91	68	146	23	0.318	/3,0.5-1.2,0.6-0.8,0.7-2,0.8-1.5,1-5,2-20,2-4,2.5-6,3.5-5,5-22,5-merous,abaxial,abaxially,acuminate,acute,adaxial,anther,apart,apex,base,berry,branched,bright,cm,dark,densely,diameter,dull,elliptic,erect,evenly,filament,flattened-reniform,flower,fruit,glabrous,green,green-brown,lateral,leaf,length,lobed,long,maturity,mauve,mm,moderately,orange,orange-brown,ovate,pale,pedicel,peduncle,petiole,recurved,red,shrub,sometimes,spherical,stellate-pubescent,style,surface,terminal,way,white,yellow,young	-1/2,-10,-3,-5,.5,0,0-20,0-4,0-5,0-8,0.1,0.1-0.2,0.1-0.25,0.1-0.3,0.5-0.8,0.6-0.9,0.8-1.3,1-2,1-4,1.5,1.5-2.5,1.8-2.3,1.8-2.5,1/3,1/4-1/3,1/4-1/6,11-25,2,2-3,2.5-5,3-30,3-5,3-6,3/,4-7,4-9,5,5-,5-17,6-22,6-8,acut,alyx,apar,apically,apparently,articulated,bark,becoming,blade,broad-deltate,brown,calyx,chartaceous,conical,connivent,cuneate,curved,deltate,difoliate,discolorous,distance,drying,eaf,eed,elongated,elongating,equal,extending,flattened,free,fruiting,geminat,geminate,glabrescent,gray-greenish,infructescence,lobe,longer,lower,margin,mature,membranous,midpoint,midvein,nflorescence,older,one,open,orolla,oung,pair,pendulous,per,perfec,pericarp,poricidal,porrect,portion,prickle,prickly,primary,pubescent,ray,red-brow,rounded,ruit,scar,sessile,shorter,side,slender,smooth,somewhat,spaced,sparsely,spreading,stalk,stalked,stellate,stem,stout,straight,straw-yellow,subentire,tamen,tapering,terete,tertiary,time,tip,toward,trichome,tube,unarme,unarmed,unit,usually,variously,vary,vein,venation,visible,wide,woody,ympodial	arrangement,colour,corolla,form,growth,height,history,inflorescence,life,na,number,ovary,perennial,plant,position,rachi,reproduction,seed,shape,spacing,staman,stigma,texture
59	wfo-0001026215	success	150	86	60	90	26	0.4	-3,0.05,1-3,1.5,2-3,3/4,4-5,7-8,acuminate,anther,apex,axillary,base,berry,brown,clavate,cm,completely,conical,corolla,densely,diameter,elliptic,filament,flattened-round,flower,fruit,glabrous,green,greenish,herb,horizontal,kink,length,less,lobed,marked,markedly,mm,nearly,occasionally,often,ovary,ovoid-reniform,papillate,pedicel,petiole,purple,rugose,seed,shrub,simple,stigma,strongly,style,surface,way,white,winged,x	.05,.5,0,0.5-1,1,1.5-2,1.5-2.2,13-35,15-2,18-20,2,2-3.5,2-4,4-15,abaxially,abruptly,absent,along,anthesi,anticlinal,ape,axil,beak,bifi,broadly,calyx,cell,conspicuously,continually,deltate,eaf,edicel,eed,enlarged,entire,epidermal,erect,exserted,free,fruiting,globose,highly,internode,irregular,lobe,long,lower,minutely,narrowing,nflorescence,noddin,nodding,onto,pair,papillae,papillat,per,poricidal,portion,primary,projection,raised,red-papillose,reflexed,rounded,ruit,scar,shortsympodial,single-stemmed,sinuous,small,ste,stem,tal,tem,thickening,time,tip,tub,tube,ud,unifoliat,unit,usually,vein,white-lenticellate,white-pubescent,wide,wing,without	abaxial,adaxial,arrangement,bifid,colour,form,growth,height,history,inflorescence,leaf,life,na,number,peduncle,perennial,plant,position,rachi,reproduction,shape,spacing,staman,tall,texture,unifoliate
60	wfo-0001026220	success	158	76	39	119	37	0.247	/3,0.3-1.5,1.3-1.7,2.5-3.5,4-12,annual,anther,back,band,blade,brown,cm,dark,essentially,foveolate,glabrous,herb,internodal,leaf,long,minutely,often,ovate,pentagonal,petal,petiole,pigment,plant,purple,red,reddish,reticulately,ridged,spherical,stellate-pubescent,suffused,surface,terminally,yellow	.3-2.8,.5,0.2,1,1.0-1.8,1.5-2.5,10-20,4-10,5-10,50-90,6-10,7-11-flowere,8-12,accrescent,across,acute,along,alyx,anthesi,ape,armed,base,bearded,becoming,berry,calyx,campanulate,closely,coarsely,conspicuous,developing,dia,difoliate,divided,dry,dryin,eaf,eed,flattened-ovo,foliaceous,geminat,glandular,glaucescent,hair,heteromorphic,interpetalar,invested,lacking,lanceolate,large,later,latter,lobe,lon,main,many,maturity,mm,mostly,much,near,nearly,nflorescence,obtuse,one,orolla,pentagonal-stellae,per,persistent,persisting,pinnatifid,pinnatisect,plicate,portion,prickle,prickly,proximal,ray,reduced,ruit,scattered,second,short,shorter,side,similar,simple,slende,somewhat,spaced,splitting,stellae,stellate,stem,straight,surrounding,tall,tamen,thrice,tightly,tigma,tissue,tub,tube,twice,tyle,ultimate,unexpande,unit,upon,vary,vein,ventral,well-developed,widely,year,yello,ympodial,young	7-11-flowered,abaxial,adaxial,apex,arrangement,colour,corolla,diameter,filament,flattened-ovoid,flower,form,fruit,growth,height,history,inflorescence,length,life,na,number,ovary,pedicel,peduncle,pentagonal-stellate,position,rachi,reproduction,seed,shape,spacing,staman,stigma,style,texture,unexpanded,width
61	wfo-0001026227	success	150	66	41	109	25	0.273	.3,.8,0,0-1.5,0.3-2.2,1-4,apex,chartaceous,cm,densely,diameter,elliptical,flower,fruit,globose,green,herbaceous,inflorescence,leaf-opposed,length,lobed,mm,moderately,obtuse,ovate,pale,pedicel,peduncle,petiole,pseudo-racemose,resprouter,shallowly,solitary,sparsely,stellate,stellate-pubescent,stigma,style,thick,unbranched,yellow	%,0-0.1,0-1,0-3,0.1-0.7,0.25-0.4,0.3-0.4,0.3-0.5,0.3-0.6,0.3-0.9,0.4-1.4,0.5-1,0.9-1.2,1,1-1.3,1.5-4,1.6-2,10-15,15-20,17-55,2-10,2-2.5,2-3,2.5-3,3-6,3-7.5,5-30,5-merous,6-8,7-8,abaxially,absen,absent,acicular,across,adaxially,apart,armed,articulated,axe,ba,base,blade,calyx,chartaceou,cuneate,d.,deltate,distributed,eaf,eed,eglandular,entire,finger,fruiting,gland-tipped,gree,grey,hair,half,index,lamina,lateral,lobe,lobing,lon,long,longer,lower,margin,mature,mid-point,midpoint,midvein,nflorescence,oblique,orolla,part,per,porrect,present,prickle,ray,ruit,sessile,short,side,simple,spaced,sprawling,stage,stalk,stellae,straight,tal,tamen,tem,throughout,time,transparent,tube,unit,unknow,uvenile,vary,wide,x,yellowish,ympodial	abaxial,adaxial,anther,colour,corolla,filament,form,growth,height,history,leaf,life,number,ovary,perennial,plant,position,reproduction,seed,shape,spacing,staman,surface,texture,unknown
62	wfo-0001026229	success	299	96	65	234	31	0.217	1,5,abaxial,abaxially,adaxial,anther,base,berry,black,brown,clavate,cm,corolla,cyme,dark,densely,diameter,elliptic,elongated,flattened,flower,fruit,glabrous,globose,golden,green,growth,hirsute,immature,inflorescence,internodal,irregular,lateral,leaf,lobed,long,mature,membranaceous,mm,moderately,narrowly,ovate-elliptic,pale,pedicel,peduncle,petiole,pit,pubescent,purple,rachi,reniform,shiny,shrub,simple,sparsely,stellate,stigma,style,subopposite,surface,terminal,unbranched,white,yellow,¾	0.1–1.47,0.2–0.8,0.35,0.3–0.9,0.3–1.2,0.4,0.8–1.2,0.8–2,0.9,0.9–4.3,1-celled,1.2–4.8,1.3–1.5,1.3–1.7,1.4,1.7–11.8,1.7–2.3,1.8,1.8–5.5,1.9–2.5,1/3,13,1–1.4,1–2,1–4,2,2.3–3.4,2.8–4,2–3,2–3-celled,2–4-celled,3,35,3–4,3–5,4.5–6.5,4–6,5-merou,5–9,6–15,6–7,6–8,8.6–12,8–10,9–31,accrescent,acuminate,acute,adaxiall,adaxially,ag,almost,also,always,alyx,anthesi,apex,ark,articulated,associated,asymmetric,attenuate-caudate,axe,ba,barely,beneath,blade,branch,branching,broadly,broken,calyx,camptodromous,capitate,celled,central,changing,commentary,commonly,completely,concentrated,connivent,cordate,covered,creating,cuneate,cylindrical,deltoid,develope,developed,differing,directed,discolorous,di­,dried,drying,eaf,eed,eglandular,ellipsoidal,entire,even,faces,few-rayed,found,free,frequently,fresh,fully,geminate,glabrescent,gland,glandular,glandular-capitate,hair,head,hispid,hyaline,ilament,impressed,included,insertion,introrsely,involute,lamina,lanceolate,larger,less,like,lobe,long-stalked,longer,longitudinal,lower,mainly,margin,material,maturit,midpoint,midri,midvein,minute,mixed,much,multangulate,multangulate-stellate,multiseriate,narrow-ovate,near,nearly,new,nflorescence,oblong,often,old,older,one,open,opening,orientation,orolla,other,oung,ovate,pair,paired,papillose,pedunculate,per,perfect,pink,plurifoliate,point,poorly,pore,poricidal,porrect-stellate,portion,primary,purplish,ra,raised,rarely,ray,remnant,revolute,rounded,ruit,secondary,see,sessile,shin,short-,short-stalked,shorter,size,slightly,slit,small,smaller,solitary,sometimes,somewhat,spread,spreadin,spreading,stalk,stem,strongly,subsessile,supported,surfac,three,tree,trichome,trifoliate,tube,tuft,type,ud,unequal,unit,upper,usually,vary,vein,venation,vestiture,visible,weakly,whitish-green,wide,yellowish-white,ympodial	0.1-1.47,0.3-1.2,0.35-4.3,0.9-4.3,1.3-1.7,1.8-5.5,1.9-2.5,2.8-4,5-merous,6-15,6-7,arrangement,colour,filament,form,height,history,length,life,na,number,ovary,perennial,plant,position,reproduction,seed,shape,spacing,staman,texture
63	wfo-0001026230	success	144	72	45	99	27	0.312	.25,.5,.8,0.3-1.5,0.9-2,1-1.4,2-4,3-4,acuminate,anther,apart,apex,area,base,calyx,cm,corolla,elliptic,filament,fruit,glabrous,globose,green,leaf,lobed,minutely,mm,nearly,opposite,ovary,papillose,pedicel,petiole,shrub,simple,slender,small,stigma,style,surface,tapering,tree,tube,white,x	0.5-3,0.75-1,1-1.5,1-4,1.1-1.8,1.8-2.3,1.9-4.1,12.6-20.8,2-5,4.6-9.3,5-10,5-20-flowered,acute,anisomorphic,anisophyllou,anthesi,apiculate,appears,back,bark,beginning,beneath,berry,broadly,bud,clavate,clu,completely,cordate,coroll,deflexed,deltoid,dia,difoliate,distal,eaf,edicel,eed,enclosing,erect,evenly,except,free,fruiting,geminate,grey,immature,inflorescenc,large,lateral,lobe,lon,long,long-acuminate,long-triangular,lower,main,major,margin,middle,minor,nflorescence,obtuse,older,orbicular,ovoid,pair,pointed,pore,poricidal,portion,raised,reflexed,rounded,ruit,rusty-papillose,scar,shaped,sinus,slightly,spaced,stem,straight,strongly,tall,tear-drop,thickened,tip,ud,umbonate,unit,unknown,vein,white-lenticellat,widest,winged,woody,ympodial,young	5-20,abaxial,adaxial,arrangement,colour,diameter,flower,form,growth,height,history,inflorescence,length,life,na,number,peduncle,plant,position,rachi,reproduction,seed,shape,spacing,staman,texture,width
64	wfo-0001026233	success	165	94	56	109	38	0.339	-1,-1.9,-5.5,-50,.75,0.7-0.8,0.8-1.55,1.2-2.7,3.2-3.7,3.2-4.7,3.5-4.5,5-30,6,annual,anther,antrorse,apex,calyx,campanulate,capitate,cm,densely,diameter,elliptic,entire,evident,filament,fruiting,globose,herb,leaf,less,lilac,margin,mm,ovate,pale,papery-scarious,petiole,pinnatisect,pubescent,reticulate,rounded,seed,simple,sparsely,stigma,style,subglobose,surface,trans-ovoidal,trichome,unifoliate,uniseriate,x,yellow	-3.8,-8.1,.25,0.3,0.5,0.7-,0.8-1.3,0.8-4,1,1-,1.1,1.5,1/2,2,2-,2.1,2.3-7,2.4-3.5,2.6,2/3,4-,5-6.2,abundant,accrescent,acute,ag,annular,articulated,ascending,basal,base,bearing,berry,broadly,coat,conspicuous,cuneate-attenuate,curved,cylindrical,difoliat,dimorphic,eaf,eed,ellipsoidal,embryo,few-,glabrous,hair,herbaceous,hig,interlobular,investing,lamina,larger,lobe,lobed,long,longitudinal,longitudinally,lower,membrane,minutely,moderately,multicellular,narrowly,near,non-glandular,obtuse,occasionally,opening,orolla,other,outer,ovule,partially,pinnatipartite,pore,poricidal,portion,present,protuberance,pubescen,ree,ridged,ruit,scarcely,seede,serrate,shorter,slender,slightly,slit,small,smaller,striate,strongly,styl,tem,tip,tube,tuberculate,unequal,unit,vary,venatio,verrucose,wider,winged,ympodial	abaxial,adaxial,arrangement,bark,bud,cell,center,colour,corolla,difoliate,flower,form,fruit,growth,height,history,inflorescence,length,life,na,new,number,ovary,pedicel,peduncle,plant,position,prickle,rachi,reproduction,scar,shape,spacing,staman,stem,texture,venation,width
65	wfo-0001026241	success	220	101	71	149	30	0.323	109,5-merous,abaxially,adaxially,anther,apex,appearing,appears,base,berry,black,branching,brittle,brown,capitate,cell,cm,conical,corolla,covered,densely,dry,erect,et,filament,flower,fruit,galiano,glandular-pubescent,globose,herb,inflorescence,internodal,leaf,lobed,mm,near,orangish,outline,ovary,ovate,ovoid,pedicel,peduncle,perennial,petiole,pinnatifid,pitted,pubescent,pulp,rachi,remain,reniform,seed,shallowly,shiny,sinuate,stellate,stem,stigma,stout,style,subshrub,surface,taproot,ternate,triangular,tuberculate,white,woody,x	.2,.3,.5,0.1–0.15,0.2–,0.3–,0.3–0.4,0.3–0.6,0.3–1,0.5,0.5–0.7,0.5–0.8,0.5–1,0.7–1.1,1-,1-celled,1.2–1.5,1.2–2,1.5–1.7,1.5–2.5,1.5–3.5,1.9–2.1,1/3–1/2,10-20,1–,1–1.1,1–1.4,1–1.5,1–2,2-flowered,2.5–3,2–2.1,2–3,3,3-,30–50,3–3.1,4-,4.5–5,5,5-celled,6,always,anthesi,apical,articulated,attenuate,ba,basal,basiscopically,beak,broader,calyx,campanulate,center,connecting,cordate,cup,curved,curving,darker,decurrent,deflexe,dehiscing,deltate,denser,depressed-globose,dia,difoliate,discrete,drying,dwarf,eaf,eglandular,elliptic,enclosed,entire,equal,erose,extended,foliat,foliose,free,fruiting,geminate,glabrous,gland,glandular,intially,irregularly,larger,lateral,leaflet,like,lobe,lon,long,longitudinal,main,margin,midvein,mixture,much,nflorescence,oblique,one,onto,open,papillat,papillate,per,perfect,pericarp,pore,portion,prolonged,pubescen,robust,ruit,simple,slightly,slit,small,smaller,sometimes,somewhat,spatulate,stamen,strongly,succulent,sulcate,terminal,testa,thick,thickened,tip,tissue,trichome,truncate,tube,ud,uniseriate,unit,usually,vein,way,wide,wing,ympodial	0.5-0.7,1-1.1,1-2,1.5-1.7,2,2-2.1,2.5-3,30-50,4.5-5,abaxial,adaxial,arrangement,colour,diameter,form,growth,height,history,length,life,na,number,plant,position,reproduction,shape,spacing,staman,texture,width
66	wfo-0001026242	success	210	79	54	156	25	0.257	0-2,0.4-0.5,0.4-2,0.5-1,0.7-1.3,1-1.5,1-2.5,1.5-4,10-20,2.5-4.5,4-5-merous,abaxial,acute,anther,apart,apex,berry,branched,bright,cm,diameter,dull,elliptic,erect,evenly,filament,filiform,flattened-reniform,flower,fruit,glabrescent,glabrous,green,lateral,leaf,length,lobed,membranous,mm,orange-brown,pedicel,peduncle,petiole,recurved,red,red-brown,shrub,smooth,spherical,stellate,style,surface,white,yellow	-0.9,-1.5,-2,-5,-6,/4,0,0.05-0.2,0.1,0.3-0.5,0.35-,0.4-0.55,0.5,0.5-0.7,0.55-0.9,0.7,1-3,1.2-2,1.5-3,1/2,1/5-1/3,1/6-1/4,10-,2-2.5,2-5,2.5-2.8,3-6.5,30-80,4-10,4-13,4.5-5.5,5-,5-18,5-7,6.5-8,7-17,8-20,abaxially,acut,almost,alyx,ame,apar,apically,apparently,articulated,bark,base,blade,broad-deltate,c.,calyx,concolorous,connivent,cuneate,curved,deltate,densely,difoliate,distance,drying,eaf,eed,elongating,equal,extending,eye,flattened,free,fruiting,geminat,glabrou,glandular,green-gra,hair,infructescence,irregularly,largely,lobe,long,longer,lower,margin,mature,maturity,midpoint,midvein,minute,moderately,multangulate,naked,narrow-deltate,nflorescence,obtuse,occasionally,older,one,open,orolla,oung,pair,pale,pale-brown,per,perfec,pericarp,poricidal,porrect,portion,prickl,prickle,prickly,primary,ray,reflexed,rounded,ruit,scar,sessile,shorte,shorter,side,simple,sometimes,spaced,sparsely,spreading,stalk,stalked,stellate-pubescent,stem,straight,subentire,tamen,tapering,terete,tertiary,time,tip,trichome,tube,unarme,unarmed,unit,upper,variously,vary,vein,venation,visible,way,weakly,wide,woody,ympodial,young	0.35-0.55-0.9,adaxial,arrangement,colour,corolla,form,growth,height,history,inflorescence,life,na,number,ovary,perennial,plant,position,rachi,reproduction,seed,shape,spacing,staman,stigma,texture
67	wfo-0001026259	success	233	103	75	158	28	0.322	.8,1.5,6,abaxial,abaxially,adaxial,anther,apex,base,berry,broadly,brown,central,cm,concave-reniform,corolla,cylindrical,diameter,ellipsoid,filament,fleshy,flower,fruit,globose,green,green-orange,halfway,herb,inflorescence,internodal,lateral,leaf,length,less,lilac,live,lobed,membranous,minutely,mm,once-branched,ovary,ovate-lanceolate,pale,papillate,pedicel,peduncle,petiole,plant,pubescent,rachi,rarely,ripe,shiny,shrub,simple,slightly,smooth,somewhat,sparsely,spreading,star,stellate,stigma,straight,style,surface,translucent,trichome,turning,uniseriate,white,yellow,yellow-green,young	.1,.7,0.1–0.2,0.2–0.4,0.3–1.2,0.4–0.6,0.5,0.5–0.6,0.7–0.9,0404,0–2,1,1-celled,1.0–1.2,1.0–3.3,1.2–8.4,1.4–4.0,1.5–2.0,11–22,12–24,1m,1–2,1–2-celled,1–3-celled,2-ridged,2/3,2–17,2–3-celled,3.0–3.4,35–45,4–5,5-merous,5–14,5–7-celled,7–10,8–11,?,acuminate,acute,adaxially,affected,age,anthesi,apar,appressed,arising,becoming,beyond,branch,branched,branching,calyx,cell,close,coloured,cone,congested,conical-ellipsoid,cream-coloured,decurrent,dehiscing,deltate,densely,difoliate,drop,eaf,eed,elongating,end,entire,especially,et,exerted,free,fruiting,geminat,glabrous,gradually,growt,hilum,individual,knapp,larger,leave,lengthening,like,lobe,lon,long,longer,lower,lowermost,margin,much,narrower,narrowly,near,nearly,nflorescence,node,occasionally,often,one,outline,pair,pathogen,pentagonal,per,perfect,pericarp,pore,poricidal,portion,positioned,primary,purple,purple-black,purple-coloured,recurving,reduced,reflexed,relatively,remaining,rounded,ruit,scar,short,shorter,similar,slit,sometimes,spaced,splitting,stem,stone,stout,strongly,sub-laterally,tall,tapering,tem,testal,thick,tightly,tinged,tip,together,toward,tube,two,ud,unit,vein,wide,winged,woody,ympodial,–15	0-2,0.2-0.4,0.3-1.2,1-3-celled,1.0-1.2,1.0-3.3,1.4-4.0,12-24,3.0-3.4,5-14,arrangement,colour,form,growth,height,history,life,na,number,perennial,position,reproduction,seed,shape,spacing,staman,texture,width
68	wfo-0001026262	success	179	141	118	61	23	0.659	0.2-0.6,0.5,0.5-1,0.5-1.5,0.8-1.4,1-2,1-5,1.5,10-15,2-5,3,3-10,3-6,4-10,4-6,4-7,4-8,7-13,7-9,abaxial,abaxially,absent,acute,adaxial,adaxially,anther,apex,apical,armed,asymmetrical,attenuate,base,brown,calyx,chartaceous,cm,connivent,cordate,cylindrical,dark,densely,diameter,directed,discolorous,either,extra-axillary,filament,flower,fruit,geminate,glabrous,globose,green,hair,immature,leaf,light,like,lobed,long,major,mature,midpoint,midvein,mm,moderately,mottling,multicellular,multiseriate,nearly,netlike,obscure,obtuse,occasionally,often,orange,ovate,pair,pedicel,peduncle,petiole,pit,pore,porrect-stellate,prickle,pubescent,rachi,raised,ray,recurved,reniform,ridge,roselike,rusty,secondary,separated,shrub,side,slightly,sparsely,stalk,stellate,stem,stigma,style,surface,tan,tapering,triangular,unarmed,unbranched,unicellular,unlobed,vein,vine,white,x,yellow	0.25-0.5,0.5-1mm,0.75-1.5,1,1-.,1.5-2,2-2.5,2-3,30,4-15,5-8,5-merou,absen,accrescent,adaxiall,alyx,apar,apparently,axe,berry,beyond,blade,contiguous,difoliate,distal,eaf,eed,em,end,expanded,exserted,filiform,frui,fruiting,glabrou,gree,interpetelar,intorsel,lacking,lobe,lower,midrib,narrowly,nflorescence,orolla,per,perfect,ruit,scandent,simple,spaced,stamen,ste,tamen,tissue,tube,unequa,unit,vary,wide,ympodial	1-4,5-merous,apart,armature,arrangement,color,corolla,form,growth,height,inflorescence,intorsely,length,ovary,plant,position,seed,shape,spacing,staman,texture,unequal,width
69	wfo-0001026267	success	162	93	64	98	29	0.395	.25,0.6-1.7,0.7-1.1,1-1.2,1-2.6,2.5-3,3-15,5-7,acuminate,acute,anther,apex,base,bright,calyx,closely,cm,corolla,densely,drying,filament,flattened-reniform,glabrous,globose,green,greyish-green,lavender,leaf,lobed,minutely,mm,narrowly,nearly,occasionally,often,opposite,ovary,ovate,overlapping,pale,papillose,pedicel,petiole,pitted,pubescent,ripening,shrub,simple,slender,small,spaced,sparsely,stigma,style,surface,tan,tapering,tinge,tree,trichome,tube,uniseriate,white,yellow-green	.5,0.1-1,0.5-1,1-1.5,1-4,1.5-2,1.5-2.3,20-30-flowered,3-6.1,3.2-8.6,4-8,8-10,8.5-15,anthesi,attenuate,axil,ba,bark,beginning,beneath,berry,blackish,body,broadly,crateriform,cuneate,decurrent,deflexed,depressed,dia,differing,difoliate,distally,distinct,eaf,edicel,eed,except,exerted,free,fruiting,geminat,greenish-white,hard,incrassate,inflorescenc,larger,lateral,lobe,lon,long,longinflorescence,lower,main,major,margin,maturity,middle,minor,older,one,pair,papillo,pitting,pore,poricidal,portion,quickly,raised,reflexed,remaining,rough,ruit,scar,scarious,scattered,shaped,size,slightly,softening,soon,stem,straight,tall,tear-drop,tip,triangular,tuft,ud,unit,vein,widest,wing,winged,woody,x,ympodial,young	20-30,abaxial,adaxial,arrangement,colour,diameter,flower,form,fruit,growth,height,history,inflorescence,length,life,na,number,peduncle,perennial,plant,position,rachi,reproduction,seed,shape,spacing,staman,texture,width
70	wfo-0001026272	success	182	92	71	111	21	0.39	1,1-1.5,12-15,2-2.5,2-3,2-7,20,4-5,5-8,7-8,abaxial,anther,apex,apiculate,base,brown,clavate,cm,corolla,corymbose,cream-colored,cyme,diameter,elliptic,filament,flattened,flower,form,glandular,globose,green,growth,inflorescence,internodal,lobed,mm,obelliptic,ovary,ovoid,pedicel,peduncle,petiole,pitted,pubescent,rachi,reniform,reticulately,rugose,scabrous,scandent,shrub,simple,somewhat,spaced,stellate,stigma,style,subglobose,surface,terete,thick,trichome,unarmed,unevenly,velutinous,viscid-pubescent,way,white,x,yellowish,¾	0.2-0.3,1-1/5,1-2,1-2-celled,1.2-1.5,1.5-2,1/3,20-30,3-4,3-5,3.5-4,6-8,7-10,abaxially,adaxially,age,anthesi,armed,articulated,bark,basal,berry,beyond,branched,calyx,celled,coriaceous,densely,denser,discolorous,distal,eaf,eed,epidermi,erect,exserted,free,fruiting,fused,glabrous,heterostylous,lanceolate,lengthening,like,lobe,long,long-styled,lower,many,midpoin,midpoint,minute,mixed,multangulate,multicellular,new,nflorescence,numerous,oblong,older,partially,pendant,per,perfect,pericarp,plurifoliat,pore,poricidal,porrect,porrect-stellate,portion,prickle,prickly,pubescence,quarter,raise,recurved,reddish,reduced,ruit,rusty,scar,sessile,short-styled,slightly,slit,sparse,sparsely,stalked,staminate,stem,sub-sessile,subconical,subcoriaceous,subtruncat,tapering,testa,time,tip,triangular-lanceolate,tube,turbinate,ud,unarme,unicellular,unit,upper,venation,visible,woody,ympodial	adaxial,arrangement,colour,fruit,height,history,leaf,length,life,na,number,plant,position,reproduction,seed,shape,spacing,staman,subtruncate,texture,width
71	wfo-0001026279	success	248	84	62	186	22	0.25	0.8-2.3,0.9-1.8,1-10,1-3.5,1.1-1.9,1.9-3.2,11.5-19.7,3-4,3.1-4.2,3.4-5.2,9-22,abaxially,adaxially,anther,black,brown,capitate,cm,conical,corolla,dark,deltoid,diameter,drying,elliptic,filament,flower,fruit,glabrescent,globose,granular,grayish,green,lanceolate,lavender,leaf,length,lilac,mm,pale,pedicel,peduncle,petiole,plant,plurifoliate,pseudo-terminal,rachi,reticulate-punctate,scabridulous,scabrous,shrub,simple,stellate,stigma,style,suborbicular,surface,tomentose-pubescent,tree,white,yellow,yellowish-tan	-11.4,-2.9,-34.3,-4,-5.9,/14-1/8,0.2-0.4,0.25-0.4,0.9-1,1-1.4,1.1-1.6,1.5-1.8,1.5-3,1.7-2.3,1.9-3,1/2,14-27,2.4-3.2,2.5-3.2,2.6-4.8,2/3,3.1-3.6,3.5-7.8,3.8-5.1,4-7.5,5-200,5-8,8,8-11,8.5-10.5,accrescent,acuminate,acute,adaxiall,ag,anthesi,apart,apex,apparently,appearing,appressed,ark,around,articulated,attenuate,axe,axillary,ba,base,berry,blade,blunt-tipped,branch,branched,bud,calyx,chartaceous,closely,completely,covering,cuneate,cylindrical,dendritic-echinoi,dendritic-echinoid,dense,directed,distally,due,eaf,earl,echinoi,echinoid,edge,eed,elongated,entire,enveloping,equal,evident,exerted,expanded,farinose,few-rayed,fleshy,free,fruiting,glabrescen,glabrous,grayish-green,hair,half,immature,inserted,lateral,lengthening,lobe,lobed,long,long-stalked,longer,longitudinal,longitudinall,lower,m.,main,many,margin,mature,midrib,minute,mixed,multangulate,multangulate-pubescent,multiseriate,narrowly,nflorescence,oblong,obovate,occasional,occasionally,often,older,open,orbicular,orolla,ovate-lanceolate,overlapping,partly,perfect,pore,poricidal,porrect-stellate,present,prominent,pubescence,rounded,ruit,scattered,secondary,semi-ovate,sessile,short,short-,short-decurrent,short-stalked,side,slightly,slit,slowly,somewhat,spaced,splitting,stalk,stamen,stem,subcampanulate,subcoriaceous,subsessile,sulcate,suture,tall,tamen,tertiary,thickened,thin,thin-stalked,time,tip,tomentose,tube,ud,unarme,unarmed,unit,unwinged,upper,usually,vary,vein,way,whitish,wide,x,yellowish,ympodial,young	75-200,abaxial,adaxial,arrangement,colour,form,growth,height,history,inflorescence,life,na,number,ovary,perennial,position,reproduction,seed,shape,spacing,staman,texture
72	wfo-0001026292	success	190	120	88	102	32	0.463	-13,0.25-0.5,0.5-1,0.5-1.5,0.5-2,0.75-1.25,1-1.5,1-3,1-5,1.5,1.5-8,10-15,12-16,2-6,2.5-3.5,20-25,3-8,3-9,5-10,absent,acute,adaxial,anther,apex,base,brown,bud,calyx,chartaceous,cm,dark,diameter,distally,expanded,extra-axillary,filament,filiform,flower,fruit,fruiting,glabrous,globose,green,immature,leaf,lobed,long,many,margin,mature,mm,moderately,nearly,netlike,orange,orange-red,ovate,pedicel,peduncle,petiole,pit,prickle,pubescent,rachi,raised,recurved,reniform,ridge,roselike,separated,shrub,simple,slightly,small,sparsely,stellate,stem,stigma,style,surface,tan,triangular,unbranched,white,whitish,wide,x,yellow	0.5,1-2.5,1-8,1.5-2,1.5-2.5,1/3,13-17,2-3,2-4,3-15,3-5,30-40,4-8,5-merou,abaxially,absen,accrescent,adaxiall,adaxially,alyx,apar,apical,apparently,armed,asymmetrical,attenuate,axe,berry,beyond,blade,connivent,cordate,curved,cut,cylindrical,densely,difoliate,directed,discolorous,distal,eaf,eed,either,end,exserted,flattened,frui,geminate,glabrou,gree,hair,introrsel,lanceolate,less,like,lobe,lon,lower,major,midpoint,midrib,midvein,multicellular,multiseriate,nflorescence,obscure,obtuse,occasionally,often,orolla,pair,per,perfect,pore,porrect-stellate,ray,reflexed,ruit,scandent,secondary,side,sinus,spaced,spreading,stalk,stamen,swollen,tamen,tapering,tem,thin-skinned,tube,unarmed,unequa,unicellular,unit,upward,vary,vegetatio,vein,way,ympodial	5-merous,abaxial,apart,arrangement,bark,cell,center,colour,corolla,form,growth,height,history,inflorescence,length,life,na,new,number,ovary,perennial,plant,position,reproduction,scar,seed,shape,spacing,staman,texture,trichome,width
73	wfo-0001026298	success	192	83	60	132	23	0.312	0.2-4,0.25-0.5,0.3-2,0.4-1,0.5-3,0.6-1.5,1-1.5,1.5-4,2850,3-6,anther,apex,area,broadened,closely,cm,corky,corolla,fide,filament,flower,glabrous,globose,green,haught,inflorescence,leaf,length,lobed,long-styled,minutely,mm,obovate,opposite,ovary,overlapping,ovoid-reniform,pale,papillose,pedicel,petiole,pitted,plant,puberulent,rather,red,rhizomatous,rough,shape,short-styled,shrub,simple,spaced,stigma,style,surface,tapering,treelet,white,yellowish-tan	.5,0.1-0.3,0.5-2,0.75-1,0.8-2,1.4-6,1.5-2.5,1.5-9,2-3,3-4,3/4,4-13,5-30-flowered,7-12,8-28,acuminate,acute,along,american,anthesi,appearing,appressed,auriculate,ba,bark,base,bearing,beginning,beneath,berry,blade,bu,calyx,caudate,central,conical,costa,deflexed,deltoid,densely,dia,differing,difoliate,distal,dry,eaf,edicel,eed,ellipsoid,elliptic,erect,even,exsertion,free,fruiting,geminat,glabrate,golden,greyish,impressed,inflorescenc,later,lateral,lobe,locality,lon,long,long-triangular,lower,main,major,margin,material,middle,midrib,minor,minute,nflorescence,oblique,occasionally,often,older,one,orbicular,pair,papillo,peelin,planar,pore,poricidal,portion,prominent,rarely,reddish,reflexed,rest,rican,rounded,ruit,scar,scattered,shaped,shorter,single,size,slender,sometimes,somewhat,stem,straight,tall,tear-drop,thick,third,time,tip,trichome,tube,two,ud,unicellular,uniseriate,unit,variable,varying,vein,way,widest,woody,x,ympodial,young	5-30,abaxial,adaxial,arrangement,colour,diameter,form,fruit,growth,height,history,life,na,number,peduncle,position,rachi,reproduction,seed,spacing,staman,texture,width
74	wfo-0001026299	success	239	102	75	164	27	0.314	-3.5,0.25-0.5,0.4-0.5,0.5-2.5,0.8-1,1,1.1-1.7,1.5-,1.8-2,3.5-10,5-20,6-20,anther,apex,beneath,broadly,brown,calyx,capitate,cm,conical,corolla,dark,densely,diameter,elliptic,erect,filament,flower,fruit,fruiting,glabrous,glandular,globose,green,hair-like,herb,imparipinnate,inflorescence,interrupted,investing,leaf,less,loosely,margin,minutely,mm,obovate,often,outgrowth,ovary,pale,pedicel,peduncle,pentagonal,perennial,petiole,prostrate,pubescent,rachi,short,simple,sparsely,spreading,stem,stigma,stripe,style,surface,tall,tip,trichome,velvety,white,yellow	--,-0.8,-1,-10,-2.5,-5,.5,0-8,0.1-0.2,0.1-0.25,0.1-0.4,0.1-0.5,0.15-0.2,0.2-0.25,0.2-1,0.3-0.4,0.4-2,0.5,0.5-0.6,0.5-0.7,0.5-1,0.6-2,0.7-3.5,0.8-0.9,0.9-1,1-1.4,1-celled,1.2-1.6,1.2-5,1.5-2.3,2-4,2-6,2-foliate,2-locular,2.2-3.2,2.5,2.5-7,25,3-,5,5-15,7-12,abaxially,absent,abundant,acroscopically,acute,adaxially,almost,along,angled,anthesi,apical,appearance,appendage,approximately,articulated,axi,basal,base,basiscopically,berr,bract,bracteate,cell,change,chota,column,could,crenat,crenate-serrate,decurrent,developed,diamete,distal,eaf,ebracteate,edicel,eed,eglandular,entire,exserted,give,gree,hal,half,head,interjected,intermixed,internode,irregularly,jequetepeque,lacking,lanceolate,larger,lateral,leaflet,like,lobe,lobed,lon,long,long-acuminate,longer,lower,marañón,maturity,middle,minute,mixture,multicellular,narrowly,nearly,nflorescence,node,oblique,occasionally,pair,patent,petiolule,population,present,primary,pseudostipule,pubescence,purple,reflexed,regularly,rest,ruit,scarcely,scattered,secondary,sessile,silky,size,sparse,staminal,sterile,stout,straight,tem,terminal,tertiary,testa,thick,toward,truncate,tube,ud,unicellular,uniseriate,unit,usually,valley,variously,vein,wall,way,weak-walled,wide,winged,woody,ympodial	abaxial,adaxial,arrangement,bark,berry,bud,colour,form,growth,height,history,length,life,na,new,number,plant,position,prickle,reproduction,scar,seed,shape,spacing,staman,texture,width
75	wfo-0001026305	success	135	81	52	83	29	0.385	.25,0.2-1,0.5-2,0.6-1,0.7-1,1-1.5,2-2.5,5-7,6-9,abaxial,abaxially,adaxially,anther,apex,area,closely,cm,corolla,densely,difoliate,elliptic,filament,glabrous,globose,green,greenish-white,leaf,leaf-opposed,lobed,minute,minutely,mm,occasionally,ovary,ovoid-reniform,pale,papillose,pedicel,petiole,pitted,pubescent,shining,shrub,simple,spaced,sparsely,stigma,style,surface,tan,unifoliate,x	/4,0.25-0.5,1.3-1.5,2-6-flowered,2.5-3,3-8.5,4-4.5,7-16,7-9,acute,along,anthesi,apical,attenuate,ba,bark,base,beige-tan,berry,calyx,congested,conical,dark,deflexed,deltate,dendritic,dia,drying,eaf,edicel,eed,exserted,free,fruiting,geminat,glabrate,interlocking,knob-like,lamina,lateral,like,lobe,lon,long,lower,main,margin,middle,midrib,nflorescence,older,overlappin,pair,planar,pore,poricidal,portion,projection,reddish-brow,rounded,ruit,scar,scattered,shaped,slender,stem,strongly,styl,tall,tear-drop,tip,trichome,tub,tube,ud,unit,vein,visible,way,widest,woody,ympodial,young	2-6,adaxial,arrangement,colour,diameter,flower,form,fruit,geminate,growth,height,history,inflorescence,length,life,na,number,overlapping,peduncle,plant,position,rachi,reproduction,seed,shape,spacing,staman,texture,width
76	wfo-0001026307	success	193	115	89	104	26	0.461	0.2–1.5,0.5–0.7,0.5–5.0,0.8–2,1.0–1.2,1.0–2.4,1.0–2.5,2.0–3.5,3.0–4.0,3–8,4–5.7,5-merous,8–12,9,abaxial,abaxially,acute-acuminate,adaxial,anther,apex,appressed,berry,black,broadly,calyx,cell,central,clavate,cm,corolla,densely,diameter,ellipsoid,entire,eye,filament,flattened-reniform,flower,fruit,fruiting,glabrous,glandular,globose,green,growth,herb,internodal,lateral,length,lobed,margin,membranous,minutely,mm,new,ovary,ovate,paler,pedicel,peduncle,petiole,pubescent,purple,purple-yellow,ripe,scar,shallowly,shape,shrub,simple,sparsely,spreading,stellate,stem,stigma,straight,style,surface,tinged,trichome,turning,undulate,uniseriate,variable,vigorous,weak-stemmed,white,yellow,yellow-green	.0–1.2,.3,.5,.5–4.0,.6,.8,0.2–0.5,0.4,0.5–0.6,0.6,0.8–0.9,0.8–5,1.0–1.5,1.0–2.0,1–3-celled,1–6-celled,2.0,2.0–3.0,2.6–13,2/3,3.5–7.0,35–45,3–8-celled,5–7,acute,adaxially,age,angled,anthesi,apar,articulated,base,becoming,beyond,cone,cuneate,cylindrical,decurrent,difoliate,eaf,eed,end,exerted,facing,free,geminat,gradually,hilum,later,lengthening,like,lobe,long,longer,lower,middle,narrower,narrowing,nflorescence,one,outline,pair,papillat,pentagonal,per,perfect,pore,poricidal,portion,positioned,primary,recurved,reflexe,reflexed,restricted,ruit,shallow,shorter,side,slightly,slit,spaced,ste,stone,strongly,sub-laterally,tal,tem,testal,three,tip,toward,translucent,triangular,tube,two,ud,unequal,unevenly,unit,upper,vein,wide,ympodial	apart,arrangement,bark,bud,center,colour,form,height,history,inflorescence,leaf,life,na,number,papillate,perennial,plant,position,prickle,rachi,reproduction,seed,spacing,staman,texture,width
77	wfo-0001026317	success	169	91	71	98	20	0.42	/4,0.3-1.2,0.5-0.6,0.8-1,1-1.2,2-2.5,2-4,2.5-10,3,4-5,50-200,anther,anthesi,apart,base,branched,bright,capitate,clonal,closely,cm,conical,corolla,dendritic,densely,diameter,distally,elliptic,filament,flattened,flower,glabrous,globose,growth,inflorescence,internodal,lobed,many,minutely,mm,narrowly,nodding,orange,ovary,packed,pale,papillate,pedicel,peduncle,perfect,petiole,pitted,plant,pubescent,pulp,reniform,shrub,simple,sparsely,sticky,stigma,style,surface,terminal,thin,time,toward,way,white,x,yellowish	.5,0.25-1,0.5,0.5-0.8,0.5-1,0.6-,0.7-0.9,1-1.5,1-5.7,10-12,2-,3-3.5,3-foliate,3.5-15,6-8,6x,?,abaxially,absent,acuminate,acute,adaxially,age,apex,apically,approximately,attenuate,bark,berry,brown,calyx,correlated,dark,deltate,dense,drying,eaf,eed,em,entire,erec,erect,essentially,exerted,extremely,found,free,fruiting,geminat,halfwa,lamina,lengthening,less,like,lobe,longer,lower,margin,maturity,new,nflorescence,occasionally,often,pair,papillat,per,pericarp,planar,plane,population,pore,poricidal,portion,primary,pubescen,pubescence,rachi,red,reflexed,ruit,scar,shiny,slightly,slit,stem,straight,swollen,tip,triangular,trichome,tube,ud,uniseriate,unit,variable,vein,woody,ympodial	2,abaxial,adaxial,arrangement,colour,form,fruit,height,history,leaf,length,life,na,number,position,reproduction,seed,shape,spacing,texture
78	wfo-0001026321	success	213	85	63	150	22	0.296	0-0.2,0.1-0.4,0.5-0.6,1-4,1.2-3.5,3-10,3-4,4.5-6,7-9,8-20,adaxial,adaxially,andromonoecious,anther,apex,bisexual,broadly,chartaceous,cm,densely,diameter,extra-axillary,flower,fruit,glabrous,globose,green,greenish-white,grey-green,herbaceous,inflorescence,leaf,leaf-opposed,length,long,mm,obtuse,orbicular,ovate,pale,pedicel,peduncle,petiole,plant,prostrate,pseudo-racemose,rachi,resprouter,simple,solitary,sprawling,stellate,stellate-pubescent,stigma,style,surface,thick,throughout,unbranched,weakly,white,yellow,yellowish-green	%,.5,0-0.1,0-0.25,0-0.3,0-2,0-3.5,0.1-0.2,0.1-0.3,0.3-0.6,0.4-0.6,0.4-0.7,0.6-0.9,1-1.2,1-1.5,1-2,1-3,1-5,1-locular,1.2-1.7,1.5-3,10-17,2-3,2-4,2-5,2-5.5,2-7,2.5-5.5,2.7-3.1,20-40,3.5-8.5,30-65,4-,4.5,5-25,5-merou,50-100,6-10,6-11,7-10,8-11,abaxially,absent,accrescent,acicular,across,adaxiall,adult,also,alyx,apart,armed,articulated,ascending,attenuate,axe,ba,base,blade,branchlet,brown,calyx,capitat,central,connivent,cordate,cross-section,cylindrical,decimetre,deltate,directed,distall,eaf,eed,eglandular,elliptica,entire,exocarp,finger,frui,fruiting,functional,gland-tipped,glandular,glandular-puberulent,hair,half,halfway,heterostylous,hig,incomplete,juicy,juvenile,lanceolate,lateral,less,lobe,lobed,longer,lower,margin,mature,mesocarp,mid-point,midpoint,midrib,midvein,minute,moderately,moist,nflorescence,oblique,orolla,pair,part,per,placenta,pore,porrect,present,prickle,ray,rostrate,ruit,rusty,septum,sessile,shallowly,shallowly-lobed,short,side,spaced,sparse,stalk,stellae,straight,tamen,tem,time,transparent,tube,unarme,unarmed,unit,unknow,upper,vary,wide,x,ympodial	abaxial,arrangement,capitate,colour,corolla,elliptical,filament,form,growth,height,history,life,na,number,ovary,position,reproduction,seed,shape,spacing,staman,texture
79	wfo-0001026325	success	216	109	84	132	25	0.389	.2,0.5,0.5–1.5,0.5–5,0.6–1.8,1.2–2,1.7–3.5,10–12,1–1.5,1–2,1–2.5,1–6,2,2–4,3,5-merous,7–8.5,abaxially,absent,acute,adaxially,andromonoecious,anther,apart,apex,articulated,base,berry,blue-violet,chartaceous,cm,darker,densely,diameter,ellipsoid,elliptic,extra-axillary,filament,finely,flattened-reniform,flower,forked,foveolate,fruit,glabrous,green,herb,heteromorphic,inflorescence,leaf,lenticular,less,light,maturity,mm,moderately,mottling,oblong,obtuse,ovate-elliptic,ovoid,pale,pedicel,peduncle,perennial,petiole,rotate-stellate,simple,sometimes,stellate,stellate-pentagonal,stellate-pubescent,stigma,style,subglobose-ovoid,surface,unbranched,usually,weakly,white,yellow,yellow-orange,young,×	0.15–0.4,0.3,1,1.1–2,1.2–1.8,1.2–2.2,1.2–2.5,1.3–2.5,1.5,1.5–2.3,1.8–2.5,10–20,12–16,1–5,2-,2.5–4,2–10,2–5,2–6,3-foliate,3.3,3.5,4,4–7,4–8,5,5–9,6.5–15,7–10,accrescent,acuminate,adaxiall,alyx,appearing,armed,axe,blade,bud,c.,calyx,capitat,caudate,central,completely,connivent,covering,cuneate,curved,cylindrical,deltate,directed,directly,discolorous,distal,distall,downward,eaf,eed,emerging,exserted,few-branched,formed,fruiting,functionally,geminat,hair,hermaphorditi,hermaphroditic,lanceolate,lateral,like,linear,lobe,lobed,lon,long,long-stuled,lower,lowermost,major,malae,margin,narrowly,nflorescence,node,often,one,orolla,outline,per,plurifoliate,pointed,pore,prickle,producing,proximal,pubescent,ray,rind,root,ruit,sessile,shallowly,shoot,short-styled,side,sinuate,somewhat,spaced,sparsely,staminate,stem,straight,subentire,subtruncate,swelling,tall,tamen,tapered,tem,toug,triangular,tube,tuber-like,unarmed,unequal,unit,upright,vary,vein,ympodial,–3	abaxial,adaxial,arrangement,capitate,colour,corolla,form,growth,height,history,length,life,na,number,ovary,plant,position,rachi,reproduction,seed,shape,spacing,staman,texture,width
80	wfo-0001026335	success	157	96	70	87	26	0.446	.5,0.25-0.5,0.5-1,0.6-1,1-2,1-4,1.5-2,10-20,10-30,2-3,2-4,5-15,5-7,abaxially,adaxially,anther,apart,apex,branched,chartaceous,cm,dense,densely,diameter,elliptic,elliptic-ovate,erect,especially,filament,flattened,flower,forked,fruit,glabrescent,glabrous,globose,green,hair,leaf,leaf-opposed,like,mm,multangulate,pedicel,peduncle,petiole,probably,pubescence,pubescent,rachi,reticulate,ripe,scattered,sessile,shrub,simple,stellate,stellate-pubescent,stem,stigma,style,surface,tip,toward,unripe,white,whitish,x,yellow,yellowish	.5-3.5,0.1-0.3,0.8-1.3,1,1-1.5,1-3,1.5-4,2,2-7.5,3-18,3-5,4-5,5-,7-8,accrescent,acuminate,acute,adaxiall,ag,apparently,articulated,axe,ba,base,blade,calyx,capitat,connivent,covering,cuneate,curved,cylindrical,deltate,directed,distally,eaf,eed,entire,equal,frui,fruiting,geminate,glandula,glandular,held,lanceolate,large,lobe,long,longitudinal,lower,many-foliate,margin,midpoint,moderately,much,nflorescence,oblong,often,opening,orolla,paired,perfect,pore,ray,rounded,ruit,slightly,slit,smaller,sometimes,spaced,ste,straight,subtending,tal,tamen,tem,time,tube,unit,uprigh,usually,vary,vein,wide,ympodial	abaxial,adaxial,arrangement,capitate,colour,corolla,form,growth,height,history,inflorescence,length,life,na,number,ovary,perennial,plant,position,reproduction,seed,shape,spacing,staman,texture,width
81	wfo-0001026342	success	280	102	74	206	28	0.264	0.08,2.0,4.7,abaxially,acuminate,acute,adaxial,adaxially,aequilateral,anther,apex,attachment,attenuate,base,brochidodromous,bud,calyx,channeled,chartaceous,cm,corolla,densely,diameter,dry,entire,erect,flattened-orbicular,flattened-reniform,flower,fruit,glabrous,globose,inflorescence,internode,lateral,leaf,length,margin,markedly,midvein,mm,moderately,notched,oblique,occasionally,oval,ovate,pedicel,peduncle,petiole,point,porrect,pubescence,pubescent,raised,red,rounded,sessile,shrub,slightly,sparsely,stellae,stellate,stellate-pubescent,stigma,straight,style,surface,unbranched,vein,weakly,yellow,yellow-tan,±glabrous	.3,.4–3.0,.6,.9,0.06,0.07,0.3–0.5,0.3–0.6,0.3–0.9,0.4–0.6,0.6–1.3,0.6–2.8,0.7–1.4,0.7–1.6,0.7–1.8,0.8,0.8–1.1,0.8–1.2,0.8–1.5,0.9–1.3,1.1–1.5,1.1–3.7,1.2,1.3–1.8,1.5–2.1,1.5–2.3,1.7–2.6,1.8–2.2,1.9–2.9,1/2–2/3,1/3,2.0–7.6,2.1,2.1–3.3,2.1–3.7,2.5,2.5–3.8,2.8–4.9,2.9,3.1–13.7,3.2–3.7,3.6–4.6,4602,5-merou,5.1–6.6,5.2–7.7,5–8,6–12,7.7–11.2,7–8,8,8.5–9.5,8–13,9.5–14.2,90°,absent,adnate,ag,along,alyx,anthesi,apart,apical,apparently,appearing,arching,around,articulate,axe,ba,bark,becoming,bent,berry,blade,borne,branch,broad,brown,cancellate,capitat,caudate,climate,clinate,congested,connivent,deciduous,deltoid,dentate,development,difoliate,directed,distal,dorsally,edge,eed,either,emerging,endocarp,exocarp,extending,extra-axillary,fertile,filament,filiform,flexed,free,geminat,glandular,glossy,gradually,hair,homostylous,immature,increasing,individually,intact,interpetalar,intersepalar,juic,laxly,layer,less,lobe,lon,long,longer,lower,many,mature,mckee,midpoint,midrib,minute,moderate,nearly,nflorescence,oblong,observed,one,orolla,ove,per,perforated,pore,porrect-stellate,portion,potentially,ray,reddish,reflexe,remaining,rigid,row,ruit,seen,short-stipitate,shorter,side,simple,sinus,sloughing,smoot,soon,spaced,speciman,splitting,spread,stamen,stem,stipe,suture,tamen,tardily,tem,thin,time,tip,tissue,toward,translucent,transparent,trifurcating,truncate,tube,two,typically,ud,unarmed,upper,various,vary,well-developed,white,wide,yellow-ferruginous,ympodia,young,±90°,±densely,±equal,±evenly,×,–0.9,–19.0,–31.0	0.3-0.5,0.4-0.6,0.6-2.8,0.7-1.4,0.7-1.6,0.7-1.8,0.8-1.1,0.8-1.5,1.5-2.1,1.9-2.9,2.0-7.6,3.1-13.7,5.2-7.7,7.7-11.2,9.5-14.2,capitate,color,form,growth,height,ovary,plant,seed,shape,staman,stipule,texture,width
82	wfo-0001026343	success	221	73	53	168	20	0.24	-1.5,-4,0-4,0.05-0.5,0.2-0.7,0.45-1,0.5-1.5,1-4,1.3-1.7,2-3,2-3.2,2-6,2-8,5-merous,abaxial,adaxial,andromonoecious,anther,apparently,chartaceous,cm,densely,diameter,dull,filament,flattened-reniform,flower,fruit,glabrescent,glabrous,lateral,leaf,length,lobed,margin,mauve,mm,orange-brown,pedicel,peduncle,petiole,plant,purple,shrub,small,sparsely,spherical,stellate,stellate-pubescent,style,surface,tree,yellow	-1,-15,-3.5,-7,.5,/2,/5,0,0-10,0-2,0-40,0-5,0.05-0.2,0.1-0.2,0.15,0.2,0.2-0.3,0.3,0.5,0.8-1.5,1-2,1-3,1.5-2,1.5-2.5,1.8-2.2,1.8-3,1/,1/3,1/4-2/3,1/5,10-30,2-4,2-5,2.2-3.2,2.5-8,3-4,3-5,3.5-4.5,5-10,5.5-9,6-9,7-12,7-14,7-8,7-9,abaxially,acuminat,acute,alyx,apar,apart,apex,apically,articulated,bark,base,berry,blade,branched,broadly,brow,calyx,concolorous,connivent,cream,cuneate,curved,dark,deltate,distal,distance,drying,eed,elliptic,elongating,equal,erect,extending,faint,flattened,free,fruiting,green,green-brown,hermaphrodite,heterostylous,infructescence,less,lobe,lobing,lon,long,long-styled,longer,lower,lowermost,marking,mature,maturity,midpoint,midvein,moderately,multangulate,narrow-deltate,nflorescence,obtuse,older,one,open,orange,orolla,oung,ovate,pair,pale,pendulous,per,pericarp,plurifoliat,poricidal,porrect,portion,prickl,prickle,prickly,primary,ray,reddish,reduced,reflexed,rounded,ruit,scar,secondary,sessile,short-styled,side,smooth,sometimes,spaced,spreading,stalk,stalked,staminat,stem,stout,tamen,tapering,terete,tertiary,time,tip,trichome,tube,unarmed,unit,upper,variously,vary,vein,venation,visible,way,weakly,wide,woody,ympodial,young	5.5,colour,corolla,form,growth,height,history,inflorescence,life,na,number,ovary,perennial,reproduction,seed,shape,spacing,staman,stigma,texture
83	wfo-0001026351	success	199	83	70	129	13	0.352	0.5-1,0.5-1.0,0.5-1mm,1-1.5,1-3,10-15,15-50,2-3.5,2-5,3-10,4-7,4-9,8-15,abaxial,abaxially,acute,adaxial,andromonoecious,anther,apex,base,berry,brown,cm,coriaceous,corolla,dark,densely,diameter,extra-axillary,filament,flattened,flower,fruit,glabrous,globose,green,immature,leaf,leathery,length,lobed,mature,mm,moderately,nearly,orange-red,ovary,ovate,pale,pedicel,peduncle,petiole,plant,pubescent,purple,rachi,reniform,seed,stellate,stigma,style,subcoriaceous,surface,tan,vine,white,wide,x,yellow	0.25-0.5,0.5,0.5-1.5,0.75-1.0,1-.,1-2,1-2.5,1-4,10-18,12-16,2-4,3-6,3-9,4-6,40-80,5-15,5-merou,6-10,6-8,absent,accrescent,adaxially,alyx,apar,apical,apparently,armed,asymmetrical,attenuate,axe,beyond,blade,branch,branched,bud,calyx,chartaceous,commonly,connivent,cordate,cylindrical,difoliate,directed,discolorous,distally,distinct,eaf,eed,either,em,entire,exserted,exseted,filiform,forming,frui,fruiting,functionally,geminate,glabrou,gree,hair,hermaphroditic,heteromorphic,introrsel,like,lobe,long,long-styled,lower,major,male,margin,midpoint,midrib,midvein,multicellular,multiseriate,narrowly,nflorescence,obtuse,occasional,occasionally,often,orane,orange,orolla,outer,pair,per,pore,porrect-stellate,prickle,proximally,ray,recurved,red,revolute,roselike,ruit,scrambling,short-,side,simple,siz,slightly,spaced,sparsely,spreading,stalk,stamen,ste,stellare,stem,straight,surfac,swellin,tamen,tapering,triangular,tube,unarmed,unbranched,unequal,unicellular,unit,vary,vein,ympodial	1-6,apart,colour,form,growth,height,inflorescence,number,reproduction,shape,spacing,staman,texture
84	wfo-0001026352	success	209	83	60	149	23	0.287	.5,0.5-0.8,0.5-3,0.7-2,1-10,1.2-1.7,12-60,3-15,4-4.5,5-6,abaxially,anther,apart,apex,berry,blue,capitate-truncate,chartaceous,cm,corolla,densely,diameter,ellipsoid,filament,flattened,flower,glabrous,globose,green,growth,inflorescence,leafy,length,membranous,mm,narrowly,ovate,pale,pedicel,peduncle,petiole,pink,pubescent,rachi,reniform,shiny,shoot,short,simple,stellate,stigma,style,surface,terminal,thin,unspecified,vine,white,woody,yellowish	.3,0.5,0.5-1,0.5-1.5,0.6-,0.9-1,1-,1-1.5,1-2-celled,1.5,1.5-2,1.5-4.6,10+,2,2-3-celled,3.5-9,5-merou,6-7,7-9,<,?,acuminate,acute,adaxiall,ag,almost,alyx,angle,anthesi,antrorsely,apparently,appearance,arising,articulated,articulation,axi,bark,basal,base,bending,branch,branching,broadly,brown,calyx,cell,conical,cordate,curved,deciduous,deltate,denser,discolorous,eaf,eed,entire,evenly,eventually,expanded,exserted,few-celled,free,fruiting,giving,greenish,half,heigh,herbarium,ilament,immature,impressed,inflorescenc,irregularly,junction,lamina,large,largest,leave,leaving,lengthening,like,lobe,lobed,long,lower,many,margin,mature,minutely,near,nearly,new,nflorescence,older,orolla,outline,pair,papillate,papillo,peg,per,perfect,pericarp,plurifoliat,point,pore,poricidal,portion,primary,principal,reflexed,rest,revolute,right,ruit,scar,seen,shallowly,sleeve,slit,small,spaced,sparser,specimen,spreadin,spreading,stem,straw-colored,strongly,tem,third,time,tip,trichome,truncate,tub,tube,tuberculate,ud,uniseriate,unit,upper,vary,vein,violet,weak,wide,widest,ympodial	5-merous,abaxial,adaxial,arrangement,colour,form,fruit,height,history,leaf,life,na,number,ovary,plant,position,reproduction,seed,shape,spacing,staman,texture,width
85	wfo-0001026352	success	214	88	67	147	21	0.313	.5,0.5-0.8,0.5-3,0.7-2,1-10,1.2-1.7,12-60,3-15,4-4.5,5-6,abaxially,adaxially,anther,apart,apex,base,berry,blue,capitate-truncate,chartaceous,cm,corolla,densely,diameter,ellipsoid,evenly,filament,flattened-reniform,flower,form,glabrous,globose,green,growth,inflorescence,leaf,leafy,length,lobed,membranous,mm,narrowly,nearly,ovate,pale,pedicel,peduncle,petiole,pink,pubescent,rachi,shiny,shoot,short,simple,stellate,stigma,style,surface,terminal,unspecified,vine,white,woody,x,yellow,yellowish	.3,0.5,0.5-1,0.5-1.5,0.6-,0.9-1,1-,1-1.5,1-2-celled,1.5,1.5-2,1.5-4.6,10+,2,2-3-celled,3.5-9,5-merou,6-7,7-9,<,?,acuminate,acute,ag,almost,alyx,angle,anthesi,antrorsely,apparently,appearance,arising,ark,articulated,articulation,axi,basal,bending,branch,branching,broadly,brown,calyx,cell,conical,connivent,cordate,curved,deciduous,deltate,denser,discolorous,eaf,eed,entire,eventually,expanded,exserted,few-celled,free,fruiting,geminat,giving,greenish,half,heigh,herbarium,ilament,immature,impressed,inflorescenc,irregularly,junction,lamina,large,largest,leaving,lengthening,like,lobe,long,lower,many,margin,mature,minutely,near,new,nflorescence,older,orolla,outline,pair,papillate,papillo,peg,per,perfect,pericarp,plurifoliate,point,pore,poricidal,portion,primary,principal,reflexed,rest,revolute,right,ruit,scar,seen,shallowly,sleeve,slit,small,spaced,sparser,speciman,specimen,spreadin,spreading,stem,straw-colored,strongly,tem,thin,third,time,tip,trichome,truncate,tub,tube,tuberculate,twining,ud,uniseriate,unit,upper,vary,vein,violet,weak,widest,ympodial	5-merous,abaxial,adaxial,arrangement,colour,fruit,height,history,life,na,number,ovary,plant,position,reproduction,seed,shape,spacing,staman,texture,width
86	wfo-0001026357	success	206	94	70	136	24	0.34	0.1-0.3,0.2-0.7,0.4-1.6,0.6-1.5,0.8-1.2,0.9-1.2,1-6,1.5-2.5,2-2.8,2-6,3.9-6.2,30-68,4-7,5.8-13.6,7-15,abaxially,adaxially,anther,apart,apex,asymmetrically,branched,chartaceous,cm,conical,corolla,diameter,elliptic,ferrugineous-pubescent,filament,flower,foveolate,fruit,globose,green,immature,lanceolate,leaf,length,long-attenuate,many,mature,mm,narrowly,nearly,oblanceolate,ovate,ovate-lanceolate,pedicel,peduncle,persistently,petiole,rachi,scabrous,several,shrub,simple,small,smooth,sparsely,stellate,stellate-pubescent,stigma,style,tan,time,tree,white,x,yellow	0.11-0.29,0.8-1,1-1.2,1.1-1.7,1.4-2,1.5-2.2,1.5-2.8,1.7-2.9,1/2,10-11,10-17,2-3,2-3.3,2.3-4.2,2.5-3.3,4-5,4-6,5,6-7.5,7-10,absen,accrescent,acute,adaxiall,ag,along,anthesi,apparently,around,articulated,axillary,ba,bark,base,berry,blade,blunt-tipped,branch,brown,calyx,capitat,closely,completely,conspicuous,coriaceous,covering,cylindrical,dark,decurrent,densely,directed,distally,eaf,edge,eed,ellipsoid,entire,enveloping,exserted,farinose,fleshy,free,fruiting,glabrous,granular,hair,half,hig,inserted,large,lateral,lengthening,line,lobe,lobed,long,lower,m.,main,margin,midrib,minute,mostly,multangulat,multangulate,multangulate-pubescent,nflorescence,oblong,obovoid,obtuse,older,orolla,pale,perfect,plurifoliate,pore,poricidal,porrect-stellat,porrect-stellate,pubescent,revolute,rough,ruit,runk,semi-ovate,sessile,short-stalked,side,slightly,slit,somewhat,spaced,sparse,stellate-pubescen,stellate-tomentose,stelliform,stem,suture,tamen,terete,testa,thick-stalked,tip,tomentose-pubescent,touching,tube,ud,unit,vary,vein,way,weakly,whitish,within,ympodial,young	abaxial,adaxial,arrangement,capitate,colour,form,growth,height,history,inflorescence,life,na,number,ovary,plant,position,reproduction,seed,shape,spacing,staman,surface,texture,width
87	wfo-0001026367	success	216	101	66	150	35	0.306	1.2-1.6,abaxial,abaxially,adaxial,adaxially,anther,apart,apex,articulated,asymmetric,base,black-brown,blue,broadly,cm,colored,densely,diameter,dried,eventually,filament,finely,flower,fruit,glabrate,globose,green,growth,immature,lance,lateral,lavender,leaf,lenticular,lighter,longer,loosely,minutely,mm,ovate,overtopped,pedicel,peduncle,pentagonal,petiole,pitted,plump,pubescent,rotate,shrub,simple,slightly,soon,sparsely,stellate,stellate-pubescent,stellate-tomentose,stigma,style,surface,tan,terminal,tomentose,turning,yellow,×	.5,0.2–0.5,0.4–0.6,0.4–0.7,0.5–0.7,0.7–1.5,1.8–2.5,10,10–15,10–18,15-20,15–30,1–2,1–3,2.5–4,2–3,2–3.5,2–4,2–4.5,2–5-branched,3–4,3–6,3–7,5-merou,5–7.5,5–9,6–8,7-9.7,7–11,8–10,acicular,acuminate,acute,adaxiall,age,along,alyx,apparently,armed,ascending,attenuate,axe,ba,blade,branch,branched,capitat,caudate,center,close,closely,cordate,deeply,deltoid,dense,denser,directed,distally,eaf,eed,entire,erect,farinose,filiform,geminat,glabrous,hair,high,homostylous,initially,internode,interpetalar,interwoven,irregularly,larger,later,like,little,lobe,lobed,lon,long,looser,lower,margin,maturit,midpoint,midvei,midvein,midzone,mostly,much,narrowly,near,nflorescence,oblong,often,orolla,ovoid,perfect,plurifoliate,pore,porrect,prickle,principal,pubescence,ray,rounded,ruit,sessile,shallowly,short,shorter,side,similar,sinuately,sinus,small,somewhat,some­what,spaced,splitting,spreadin,spreading,spreadingly,stalk,stalked,ste,stellae,stem,tamen,tawny,tem,thick-chartaceous,time,tip,tissue,tomento,triangular,tube,ud,unarmed,usually,vary,vein,weakly,well-developed,wide,ympodia,–20	0.5-0.7,1-2,1-3,10-18,15-30,2-3,2-4.5,3-7,5-7.5,8-10,arrangement,capitate,colour,corolla,form,height,history,inflorescence,length,life,maturity,na,number,ovary,perennial,plant,position,rachi,reproduction,seed,shape,spacing,staman,texture,width
88	wfo-0001026377	success	155	80	51	104	29	0.329	0.5,1,2,2-3,2.5,3-5,4,5-6,5-7,5-merous,7,7-7.5,abaxially,acute,andromonoecious,anther,apex,articulated,base,bright,broadly,chartaceous,cm,densely,extra-axillary,filament,flower,forked,hermaphroditic,leaf,mm,ovate,pale,pedicel,peduncle,petiole,plant,prickly,pubescent,purple,rachi,shrub,simple,staminate,stellate,stellate-pubescent,stigma,style,surface,unbranched,x	-8,0,1/5-1/4,12,16,3,3-,30,8-13,abaxiall,abundant,abundantly,acumen,adaxially,along,apica,armed,axe,ba,belo,blade,branched,broad,brownish,calyx,cell,central,cut,distall,distinctly,eaf,eed,ending,ermaphroditic,fresh,geminat,hair,hermaphrodite,heterostylous,internode,lateral,like,linear,lobe,lon,long,lower,main,mainly,margin,midpoint,midrib,minor,narrow,nflorescence,oblique,often,orolla,polished,pore,porrect,prickl,prickle,proximal,ray,reduced,repand,retrorse,rounded,ruit,scattered,seen,shallow,sharp,short,side,single,sinus,smaller,sparsely,stem,stipe,stou,straggly,straight,structure,subcordate,subsagittate,tamen,taminate,tapered,tem,tipped,transition,triangular,tube,unequal,unknow,unknown,vary,vein,vestigia,way,ympodial	11,20,3-8,abaxial,adaxial,arrangement,colour,corolla,diameter,form,fruit,growth,height,history,inflorescence,length,life,na,number,ovary,perennial,position,reproduction,seed,shape,spacing,staman,texture,vestigial
89	wfo-0001026379	success	219	98	73	146	25	0.333	-4.5,0.2-0.4,0.7-1,0.7-2.5,0.8-1.2,1-1.7,1-10,1-2,1.5-2.3,1.9-3.4,2-7,2.6-3.7,5.3-10.2,8-15,8.3-10,acute,anther,apart,apex,articulated,attenuate,base,branched,brown,cm,conical,corolla,dark,diameter,dried,echinoid,filament,finely,flower,fruit,globose,growth,leaf,length,many,minutely,mm,multangulate,multangulate-pubescent,obovate,ovate,ovate-lanceolate,pale,pedicel,peduncle,persistently,petiole,pitted,plant,porrect-stellate,rachi,reniform,rich,scabrous,shrub,simple,small,stelliform,stigma,style,time,tomentose-pubescent,tree,velutinous-pubescent,violet,whitish,x,yellow	0.2-0.38,0.9-1.2,1-3.7,1.3-2.1,1.7-4.9,1.8-2.6,1.8-3.2,1.8-5,1/2,13,2-2.8,2.4-5.1,2.9-4,2/3,3-11,3/4,4-5,4.1-7,50-450,6-10.6,8-13,8-29,9-14,abaxially,accrescent,adaxiall,adaxially,ag,along,anthesi,apparently,around,axillary,ba,bark,basal,berry,blade,blunt-tipped,branch,calyx,capitat,chartaceous,closely,completely,covering,cylindrical,dendritic-echinoid,densely,directed,distal,distally,eaf,echinoi,echinoid-pubescent,edge,eed,ellipsoid,entire,enveloping,evident,farinose,few-rayed,fleshy,free,fruiting,glabrous,granular,gray-brown,grayish,hair,hig,included,inserted,lacking,large,lateral,lengthening,line,lobe,lobed,long,long-attenuate,lower,m.,main,margin,mature,midrib,minute,mostly,multangulat,nearly,nflorescence,oblong,obtuse,often,older,orolla,partly,perfect,plurifoliate,pore,poricidal,present,pubescen,rather,recent,ruit,runk,scattered,semi-ovate,sessile,short-stalked,side,size,slit,sometimes,somewhat,spaced,sparse,stellate,stellate-,stellate-pubescent,stellate-tomentose,stem,suture,tamen,terete,testa,thin,tip,translucent,tube,ud,uneven,unit,upper,usually,vary,vein,vestigial,way,whitish-brown,ympodial,young	150-450,abaxial,adaxial,arrangement,capitate,colour,form,height,history,inflorescence,life,na,number,ovary,perennial,position,pubescent,reproduction,seed,shape,spacing,staman,surface,texture,width
90	wfo-0001026388	success	264	97	63	201	34	0.239	0.2-0.6,1.5-2,1.6,1.8,45,8.5,?,abaxially,adaxially,anther,apex,attenuate,bilobed,brown,cm,corolla,diameter,dilated,distinctly,erect,extra-axillary,filament,flower,fruit,glabrous,globose,glutinous,green,leaf,length,life,light,mm,moderately,ovate,pedicel,peduncle,petiole,pilose,plant,prickle,rachi,ripe,scattered,sessile,shape,shrub,simple,sometimes,somewhat,sparsely,stellae,stellate,stigma,style,suborbicular,surface,thin-textured,truncate,unbranched,x,yellow-orange,yellowish	.2,.5,.7,0.15,0.2–1,0.2–2,0.4–1,0.5–1.7,0.5–2,0.5–4,0.8–1.5,0.8–2.5,1-2,1.4,1.4–1.6,1.5–2.2,1.5–3.5,108,10–20,12,1–2,1–2.5,1–6,2-foliate,2.5–4,20–,25,2–4,2–4-celled,2–9,3,3.2–3.7,4–10,4–5-rayed,4–6-celled,5,5–12,5–20,6,65–145,6–11,6–7,8-13,=,abundant,acicular,acuminate,acute,adaxiall,always,angle,apar,apiculate,apparent,appearance,armed,ascending,base,becoming,blade,bleaching,branch,bright,calyx,ciliate,closely,color,conduplicate,confined,covering,cylindrical,deeply,dense,developing,directed,distall,divided,division,dried,eaf,eed,enlarged,entire,especially,exceeding,except,exclusive,exserted,first,flowering,folded,forward,free,geminat,geminate,giving,gland,glistening,golden,grading,greenish,hair,halfway,hyaline,inserted,inside,lanceolate,larger,lateral,least,less,lighter,lobe,lobed,lon,long,lower,major,margin,midrib,minute,minutely,mostly,much,n,nearly,nflorescence,oblique,often,one,orolla,otherwise,outside,ovate-apiculate,pair,papillat,par,per,plane,pointing,pore,pressing,probably,purple-colored,ranging,rarely,recurved,reflexed,reported,rip,ruit,scarious,shallowly,sideway,similar,single,sinuate,sinus,size,slightly,small,smaller,spaced,spreading,stamen,stem,stipitate,straight,straw,strongly,sunlight,tal,tamen,tem,thickened,tip,triangular,tube,turning,twice,twisted,two,unarmed,unicellular,unit,upper,usually,various,variously,vary,vein,viewed,white,whole,wide,wing,yellow,yellow-green,ympodial,±,–8	0.2-1,0.4-1,0.5-1.7,0.5-2,0.5-4,0.8-2.5,10-20,2-9,4-10,4-5-rayed,5-12,6-7,abaxial,adaxial,apart,arrangement,colour,form,growth,height,history,inflorescence,na,number,ovary,perennial,position,reproduction,seed,spacing,staman,texture,trichome,width
91	wfo-0001026397	success	202	91	73	129	18	0.361	0.5-1,1-2,1-3,1-9,10-14,10-20,13-18,2-10,2.5,3-4,5-15,5-8,8-20,absent,adaxial,andromonoecious,anther,base,brown,chartaceous,cm,coriaceous,cylindrical,dark,diameter,filament,flower,fruit,functionally,glabrous,globose,green,hermaphroditic,immature,leaf,line,lobed,male,many,mature,mm,moderately,nearly,netlike,occasional,orange,ovate,pedicel,peduncle,petiole,pit,plant,pubescent,purple,rachi,raised,red,reniform,ridge,separated,small,sparsely,stellate,stigma,style,surface,unbranched,vine,white,whitish,woody,x,yellow	0.5-1.5,1,1-.,1-2.5,1-6,1.5,1.5-3,1.5-3.5,12-15,12-16,2-2.5,2-5,3-3.5,3-5,3-9,4-16,4-8,5,5-merou,50-100,6-10,abaxially,absen,accrescent,acute,adaxially,alyx,anthesi,apar,apex,apical,armed,asymmetrical,attenuate,axe,berry,beyond,blade,bud,calyx,connivent,cordate,densely,difoliate,directed,discolorous,eaf,eed,either,em,entire,expanding,exserted,extra-axillary,filiform,flattened,frui,fruiting,geminate,glabrou,glandular,greatly,gree,greem,hair,heteromorphic,introrsel,leathery,like,lobe,long,long-styled,lower,major,margin,midpoint,midrib,midvein,multicellular,multiseriate,narrowly,nflorescence,obscure,obtuse,often,older,orolla,pair,per,pore,porrect-stellate,present,prickle,ray,recurved,reflexed,roselike,ruit,rusty,secondary,short-and,side,simple,siz,slightly,spaced,spreading,stalk,stamen,ste,stem,straight,tamen,tan,tapering,thick,triangular,tube,unarmed,unequal,unicellular,unit,usually,vary,vein,weakly,wide,ympodial,young	1-4,abaxial,apart,colour,corolla,form,growth,height,inflorescence,length,number,ovary,reproduction,seed,shape,spacing,staman,texture
92	wfo-0001026400	success	187	98	73	114	25	0.39	0.2-0.8,0.5-1.2,1-10,1-2,12-27,3.4-4.8,30-55,5-7,6-15,6.5-20,9-13,abaxially,adaxially,anther,apex,axillary,blue,brownish,bud,cell,clavate,cm,condition,corolla,covering,dark,deep,diameter,drying,elliptic,filament,flower,forked,fresh,fruit,glabrescent,glabrous,globose,green,greenish,hair,hair-like,herb,lateral,leaf,light,lilac,mm,odd-pinnate,ovate,ovoid,pedicel,peduncle,pentagonal,petiole,plant,purple,ripe,seed,semi-stellate,short,stigma,stripe,style,subtending,terminal,testal,thick,tip,wall,white,whitish,yellow	0.4-1,0.5-1,0.7-1.1,1.3-2.6,1.7-2.2,10-18,10-28,13-30,2-6,2-8,2.4-5.9,3-6,3.5-5.9,4-7,5-merou,6-13,8-12,acumen,acuminate,acute,adaxiall,ag,alyx,apart,apparently,articulated,asymmetric,attenuate,axe,base,basiscopic,berry,blade,capitat,connivent,coriaceous,decreasing,decurrent,digestion,distal,dorsally,eaf,edge,eed,enzyme,erec,exceeding,finely,flat,folded,geminat,generally,glabrou,gree,green-white,hal,half,high,homostylous,honeycomb-shaped,interjected,lanceolate,leaflet,lengthening,linear,living,lobe,long,lower,make,moderately,mucilaginous,nflorescence,orbicular,orolla,pair,perfect,petiolulate,plurifoliate,pore,poricidal,puberulent,pubescent,removed,rounded,ruit,sessile,seudostipule,side,simple,size,slightly,slit,spaced,specimen,stamen,straight,subequal,tall,tamen,tem,throughout,tissue,toward,tri-,tube,typically,unit,unwinged,usually,vary,wet,x,ympodial	abaxial,adaxial,arrangement,capitate,colour,form,growth,height,history,inflorescence,length,life,na,number,ovary,perennial,position,rachi,reproduction,shape,spacing,staman,surface,texture,width
93	wfo-0001026406	success	219	91	77	142	14	0.352	.2,.5,0-3,0-30,0-5,0.4-0.9,0.5-1.5,1-2,1.8-2.4,1/4,1/4-1/2,2-3,2.5-8,3-10.5,5-25,5-8,6.5-7,abaxial,acute,andromonoecious,anther,apart,apex,articulated,base,berry,branched,broad-deltate,cm,cream,dark,densely,diameter,dirty-whitish,erect,filament,flattened-reniform,flower,fruit,fully,glabrous,green,herb,leaf,length,lobed,long-styled,margin,marking,maturity,mm,opening,orange-brown,pale,pedicel,peduncle,pendent,petiole,plant,porrect,prickle,red-brown,short-styled,shrub,spherical,spreading,stalked,stellate,stellate-pubescent,style,surface,trichome,upper,velvety,way,yellow,young	-1,0,0.3,0.3-0.5,0.3-0.7,0.4-0.8,0.5,0.5-2.5,0.8,00-200,1,1.3-1.5,1.5-2,1.5-5,1/,1/3,1/4-1/3,10-30,12-19,2-2.7,2-6,2.9-3.2,20-60,3-4,3.2-3.8,30-60,5,5-50,5-6,5-7,5-merous,6-12,6-15,7-10,7-8,7-9,9-15,abaxially,adaxial,adaxially,alyx,ame,apar,apically,apparently,bark,blade,c.,calyx,chartaceous,conical,connivent,cordate,curved,deltate,discolorous,distal,distance,drying,eaf,eed,elongated,elongating,equal,extending,flattened,foliaceous,free,fruiting,gently,hermaphrodite,heterostylous,infructescence,lateral,least,lobe,lon,long,longer,lower,lowermost,mature,mauve,midpoint,midvein,moderately,nflorescence,oblong,obtuse,older,one,open,orolla,oung,ovate,pair,pendulous,per,pericarp,plurifoliat,poricidal,portion,prickl,prickly,primary,purple,ray,reflexed,rounded,ruit,scar,sessile,side,smooth,sometimes,spaced,sparsely,stalk,staminat,stem,stout,straight,tamen,tapering,terete,terminal,tertiary,time,tip,tube,unit,variously,vary,vein,venation,visible,weakly,white,wide,woody,yellow-brow,ympodial	color,corolla,form,growth,height,inflorescence,number,ovary,reproduction,seed,shape,spacing,staman,texture
94	wfo-0001026407	success	221	99	80	141	19	0.362	+,.5,/3,0.5-0.6,0.5-2,1-10,1.2-1.5,1.5-1.7,20-40,3.5,4-5,5,5-10,7-8,abaxially,adaxially,anther,apart,appearing,base,becoming,berry,black,brown,capitate,chartaceous,cm,corolla,deep,dense,densely,diameter,elliptic,filament,flattened-reniform,fleshy,flower,glabrous,globose,golden,growth,inflorescence,internodal,irregularly,lateral,lax,lobed,membranous,minutely,mm,narrowly,occasionally,papillate,pedicel,peduncle,petiole,pitted,pubescence,pubescent,purple,purplish,reddish,ripe,shiny,short,shrub,slightly,spaced,stellate,stigma,stout,style,surface,terminal,vine,violet,way,woody,x,yellow	-11,-6,0.5,0.5-1,0.9-3,1,1-1.2,1.3,1.5-2,1.5-7,2-2.5,2.5-3,20-30,3.5-5.5,5-7,5-merou,7-10,acute,ag,aid,along,always,alyx,anthesi,apex,area,ark,around,articulated,axi,basal,beneath,berr,blunt,branch,branched,broadly,brownish,calyx,cell,clear,climbin,congested,conical,connivent,deltate,dendritic,denser,discolorous,eaf,eed,ellipsoid,entire,erect,evenly,exserted,free,fruiting,geminat,glabrescen,glabrou,golden-pubescent,ilament,interpetalar,lamina,leafy,leaving,lengthening,like,lobe,long,loosely,lower,many,margin,markedly,midvein,mixture,near,new,nflorescence,numerous,oblique,obscured,often,older,open,orolla,outline,pair,pale,paler,papillat,pedice,peg,pentagonal,per,perfect,pericarp,persistent,planar,plurifoliate,pore,poricidal,portion,primary,pubescenc,revolute,ruit,scar,simple,sinus,sleeve,slit,small,sparsely,sparser,spreading,stem,stiff,strongly,tangled,tem,testal,thin,time,tip,transition,trichome,truncate,tube,twining,ud,undulate,unit,upper,usually,vary,vein,weak,ympodial	5-merous,abaxial,adaxial,colour,form,fruit,height,leaf,length,na,number,ovary,plant,position,reproduction,seed,shape,spacing,texture
95	wfo-0001026422	success	273	102	67	206	35	0.245	.0,3.5,56,6.8,8.4,abaxially,adaxially,alveolate,anther,apart,apex,base,becoming,bent,branching,calyx,capitate,chartaceous,cm,corolla,densely,diameter,dry,elliptic,evenly,extra-axillary,filament,flattened-irregular,flattened-reniform,flower,fruit,glabrous,globose,green,interpetalar,lanceolate,lateral,length,long,mm,moderately,observed,occasionally,ovate,pedicel,peduncle,petiole,pubescent,red-brown,shrub,simple,sparsely,stellate,stigma,straight,style,surface,time,tissue,typically,unbranched,well-developed,white,yellow,yellow-tan,yellowish-green,±congested	.04,.3,.6,.7,.9,/3,0.04,0.06,0.08,0.1–0.5,0.2,0.2–0.4,0.3–0.5,0.3–0.7,0.4–1.3,0.4–2.4,0.6–0.9,0.6–1.1,0.6–2.0,0.7–0.8,0.7–1.6,0.8,0.9–1.5,0.9–1.9,0.9–7.5,1.0,1.0–1.9,1.1–1.4,1.2–2.8,1.3–2.2,1.6–1.9,1.6–2.2,1.7–2.4,1.8–2.2,1.8–2.3,1/2–2/3,1/3,1/3–2/3,10,13.2–27.8,1–3,2.0–3.2,2.2–14.0,2.8–4.2,3.5–4.5,3.8–4.8,4.7,4–8,5-merou,5.0,5.8–7.4,5.8–8.3,5–7,6–8,7.6,7.7–9.2,7.8–26.9,absent,acuminate,acute,adnate,aequilateral,ag,alyx,anthesi,apical,apiculate,apparently,appearing,appresse,around,articulate,attenuate,axe,ba,bark,basal,berry,blade,borne,branch,broad,brochidodromous,bud,channeled,cream,cuneate,darker,deciduous,deltoid,dentate,development,difoliate,directed,distal,distally,distinct,eaf,edge,eed,either,emerging,endocarp,entire,erect,especially,exocarp,extending,fertile,filiform,free,geminat,glandular,glossy,gradually,gray-brown,gree,hair,homostylous,immature,increasing,individually,intact,internode,intersepalar,juic,layer,light,lobe,lon,longer,lower,many,many-flowered,margin,mature,midpoint,midrib,midvein,minute,much,nearly,nflorescence,oblique,oblong,orolla,ove,per,perforated,pore,porrect,porrect-stellae,portion,potentially,presumably,pubescence,raised,ray,reflexed,remaining,rigid,rounded,row,ruit,scarcely,sessile,short-stipitate,side,sinuate,sinus,sloughing,smoot,soon,splitting,spreading,stamen,stellae,stellate-pubescent,stem,stipe,stripe,suture,tamen,tardily,tem,thin,tip,translucent,transparent,truncate,tube,two,ud,unarmed,upper,various,vary,vein,weakly,wide,yellow-ferruginous,ympodia,young,±erect,×,–5	0.4-2.4,0.6-2.0,1-3,1.0-1.9,1.3-2.2,13.2-27.8,3.5-4.5,5,5-merous,5.8-7.4,7.8-26.9,abaxial,adaxial,arrangement,colour,form,growth,height,history,inflorescence,leaf,life,na,number,ovary,perennial,plant,position,reproduction,seed,shape,spacing,staman,texture,width
96	wfo-0001026424	success	138	73	31	107	42	0.225	1-1.5,1.5-2,10,15,3-4,apex,axil,blush-violet,broadly,calyx,cell,cm,corolla,cyme,ellipsoid,elliptic,flower,fork,glabrous,leaf,obovate,pedicel,peduncle,petiole,pinnatisect,rachi,rotate-stellate,scorpioid,shrub,simple,stem	-25,-3.5,-4,0.75-1.5,1,1-,1-10,1-2,10-15,12-60,15-30,2,3-11,637/1,8-,acuman,acumen,acuminate,acute,age,angular,anthesi,aspect,ba,base,becoming,blunt,bluntly,broad,campanulate,clonal,close,common,conspicuous,cuneate,cut,dia,distinct,downard,eaf,erect,exceeding,except,exerted,facetted,facing,floral,forked,general,glandular,gree,growing,hair,interacuminal,lacking,lanceolate,lanceolate-elliptic,larger,lasting,lavender,line,lobe,lobed,lon,long,lower,midvein,minute,mm,nflorescence,oblique,often,part,pedicellate,plurifoliat,point,raised,rarely,rh,rounded,second,several,shallowly,short,sinus,slightly,soft-wooded,soon,stone,straggly,time,tip,tissue,toward,triangular,tub,ud,unit,unwinged,usually,violet,within,woody,x,year,ympodial,young	1-4,abaxial,adaxial,anther,arrangement,bark,bud,center,colour,diameter,filament,form,fruit,fruiting,green,growth,height,history,inflorescence,length,life,margin,na,new,number,ovary,perennial,plant,position,prickle,reproduction,scar,seed,shape,spacing,staman,stigma,style,surface,texture,trichome,width
97	wfo-0001026440	success	181	89	64	117	25	0.354	1-5,1.1-1.5,1.5-2.1,14-30,2.9-4.4,3-7,3-8,7-14,abaxially,acute,adaxially,anther,apex,branched,broadly,chartaceous,closely,cm,conical,corolla,diameter,elliptic,filament,flower,globose,granular,green,greenish-yellow,hair,leaf,length,many,minute,minutely,mm,multangulate-pubescent,obovate,obtuse,ovate,pedicel,peduncle,perfect,persistently,petiole,pitted,porrect-stellate,reniform,scabrous,short-acuminate,shrub,simple,small,spaced,sparse,stellate,stigma,style,time,tomentose,tree,truncate,turning,white,yellow	0-15,1.1-1.4,1.3-1.7,1.8-4.5,1.9-3.7,1/2,1/2-2/3,2-2.8,2-4,3-5,3.9-6.5,3/4,4-12,5-7,9,accrescent,adaxiall,ag,along,always,anthesi,apparently,appressed,articulated,axillary,ba,bark,basal,base,berry,blade,blunt-tipped,bract-like,branch,branche,brown,calyx,capitat,dendritic-echinoid,dense,developed,dichotomy,directed,distal,distally,eaf,echinoi,echinoid,eed,entire,first,fleshy,free,fruiting,high,included,inserted,large,lengthening,lobe,lobed,long,long-attenuate,lower,m.,margin,mostly,multangulat,multangulate,nearly,nflorescence,oblong,obovoid-oblong,obscure,often,older,openly,orolla,pair,pale,plurifoliate,pore,poricidal,pubescen,rather,ripe,ruit,runk,semi-ovate,sessile,short-stalked,size,slit,sometimes,somewhat,stellate-pubescent,stem,suture,tamen,terete,testa,thick,thin,tip,tomentose-pubescent,tomentum,translucent,tube,ud,uneven,unit,usually,vary,way,x,ympodial,young	abaxial,adaxial,capitate,colour,form,fruit,growth,height,history,inflorescence,life,na,number,ovary,perennial,plant,position,pubescent,reproduction,seed,shape,spacing,staman,surface,texture
98	wfo-0001026441	success	197	106	80	117	26	0.406	0.3-0.7,1-10,1-2,10-14,15-20,2-2.5,2-8,4.5-6.5,5-10.5,7-8,abaxially,adaxially,anther,apex,articulated,axillary,berry,brownish,bud,cell,chartaceous,ciliate,cm,condition,conical,corolla,covering,diameter,distal,drying,elliptic-lanceolate,filament,flower,forked,fresh,fruit,glabrous,green,green-white,greenish,hair-like,herb,lateral,leaf,light,long,make,margin,middle,minutely,mm,mucilaginous,obtuse,odd-pinnate,ovate,ovoid,pale,pedicel,peduncle,petiole,plant,puberulent,pubescent,ripe,rotate,rounded,seed,sparsely,stigma,style,subtending,terminal,testal,thick,throughout,violet,wall,wet,whitish,yellow	.5,0-2,0.4-3,0.5-1.5,0.8,1-1.5,1.5-2,1.5-2.5,10,2-5.5,3-5,4-6,4-8,4-8.5,5,5-merou,6-15,7-20,9-14,absent,acumen,acuminate,ag,alyx,apart,apparently,attenuate,axe,base,blade,capitat,connivent,decreasing,digestion,dorsally,eaf,edge,eed,end,enzyme,equal,erec,especially,exceeding,flat,folded,fourt,geminat,generally,glabrou,gradually,hair,half,homostylous,honeycomb-shaped,interjected,internal,lanceolate,larger,leaflet,lengthening,like,living,lobe,lower,minute,mottled,narrow,nflorescence,one,orbicular,orolla,pair,perfect,petiolule,placed,plurifoliate,pore,poricidal,purple,removed,ruit,secondary,semierect,seudostipule,short,size,slightly,slit,spaced,specimen,stamen,star,ste,stem,stolo,straight,subequal,subsessile,symmetrical,tall,tamen,tem,tip,toward,tri-,tube,tuber,typically,unit,usually,vary,white,wide,wing,x,ympodial	abaxial,adaxial,arrangement,capitate,colour,form,fourth,growth,height,history,inflorescence,length,life,na,number,ovary,perennial,position,rachi,reproduction,shape,spacing,staman,surface,texture,width
99	wfo-0001026453	success	211	122	98	113	24	0.464	0.1-2.7,0.5,0.5-1,0.8-1.1,1,1-2,1.5-2,15,30,4m,5.5-8,7-9,<,adaxial,almost,anther,apart,bark,base,berry,bright,brown,calyx,capitate,cell,cm,conical,corolla,densely,diameter,distally,elliptic,entire,filament,filiform,flattened,flower,fruiting,glabrescent,glabrous,globose,grayish,growth,inflorescence,irregularly,lateral,leaf,length,linear,lobed,long,margin,maturity,minutely,mm,narrowly,nearly,new,occasionally,opposite,pale,pedicel,peduncle,perfect,petiole,pitted,porrect,prickle,pubescent,red,reddish,reniform,scar,scattered,sessile,shallowly,shiny,shrub,simple,small,sometimes,sparsely,stellate,stem,stigma,straight,style,surface,tan,tapering,thin,tree,trichome,violet,weak,white,x,yellowish	.5,0.45-5.5,0.5-0.7,1-1.2,1-1.5,1.9-21.3,10-20,2,2-2.5,5-32,6-10,6-8,6376,abaxially,aberrant,absent,acuminate,acute,adaxially,along,anthesi,apex,armed,articulated,attenuate,axi,basal,based,beneath,bent,branched,broad,deflexed,deltate-triangular,dense,denser,directed,distall,eaf,easily,eed,enlarged,enmeshing,equal,evenly,exceeding,exserted,free,hanging,howard,internode,lamina,lengthening,less,like,lobe,lower,midpoint,midrib,midvein,nflorescence,oblique,often,older,one,open,orange,outline,pair,papillo,parallel,per,pericarp,plurifoliat,pore,poricidal,portion,primary,pubescence,ray,rest,rounded,ruit,shorter,side,sinuate,slightly,slit,smaller,somewhat,sorter,spaced,sparse,sparser,spreading,strongly,surfac,tangled,testal,time,tip,triangular,trunk,tube,ud,unarmed,unit,upper,usually,vein,visible,within,ympodial	abaxial,arrangement,bud,center,colour,form,fruit,height,history,life,na,number,ovary,perennial,plant,position,rachi,reproduction,seed,shape,spacing,staman,texture,width
100	wfo-0001026460	success	131	72	45	86	27	0.344	.5,0.5-1.5,1-1.5,1.5-2,1/2,10-15,6-7,7-9,anther,apex,brown,capitate,closely,cm,completely,corolla,dark,distal,elliptic,filament,filiform,flower,glabrous,globose,green,greenish,inflorescence,leaf,lobed,membraneous,minutely,mm,opposite,ovary,ovoid-reniform,pedicel,pitted,shrub,simple,spaced,stigma,style,subshrub,surface,white	.1,13.5-21,2-2.5,2.5-3,4.5-5,5,513,6-9,8-10,abaxially,acut,acute-acuminate,adaxially,anthesi,axi,base,becoming,berry,branched,calyx,conical,deflexed,deltate,dia,do,drying,eaf,edicel,eed,erect,fide,floccose,free,frui,fruiting,inflorescenc,internodal,less,like,lobe,long,long-exserted,lower,major,middle,nearly,nflorescence,often,older,pair,pale,papillo,papillose,pore,poricidal,portion,puberulent,reddish,reddish-brow,reflexed,ruit,santo,scar,shaped,slightly,somewhat,soon,stem,tall,tapering,tear-drop,tiny,tip,trichome,tub,tube,ud,unifoliat,unit,vein,widest,woody,x,yellow,ympodial,young	abaxial,adaxial,arrangement,colour,diameter,form,fruit,growth,height,history,length,life,na,number,peduncle,petiole,plant,position,rachi,reproduction,seed,shape,spacing,staman,texture,unifoliate,width
101	wfo-0001026485	success	188	95	72	116	23	0.383	-22,-35,.25,1-10,1-2,1-2.5,1-4,10-25,2,20-30,3-25,3-6,3.5-7,6-9,abaxially,adaxially,andromonoecious,anther,apart,apex,articulated,base,bright,brown,chartaceous,cm,compound,diameter,filament,flattened,flower,forked,foveolate,fruit,glabrous,globose,greenish-white,inflorescence,leaf,light,margin,mm,obovoid,opposite,orange,ovate,pair,pedicel,peduncle,perennial,petiole,plant,puberulent,pubescent,pyriform,rachi,rarely,ripe,simple,slightly,sparsely,stellate,stigma,strongly,style,surface,tapering,thickened,truncate,unbranched,x,yellow	-1.5,0.25-1,1.5,1.5-5,10-20,2-3,2-4,2-6,2.3-5,2.5-5,20-40,20-50,3-4,3-7,4-9,4.5-9,45,5-20,5-7,5-merou,6-10,7-15,abaxiall,absen,accrescen,acute,aggregate,alyx,appearing,armed,attenuate,axe,blade,broadly,calyx,congested,connivent,cylindrical,developing,difoliate,directed,distall,dr.,eaf,eed,elliptic,elongating,entire,even,fertile,fruiting,geminat,glabrou,heterostylous,hollow,imparipinnate,internode,lanceolate,lateral,leaflet,leaving,like,lobe,long,long-attenuate,lower,lowermost,major,midvein,narrowly,nearly,nflorescence,oblique,occasionally,one,orolla,per,pore,prickle,recurve,recurved,reflexed,robust,rugose,ruit,scandent,scar,side,small,sometimes,spaced,speciman,spreading,straight,subcoriaceous,subopposite,swollen,tamen,tem,time,tip,tissue,tone-cell,toward,triangular,trichome,truncat,tube,unit,usually,vary,vein,vin,wide,winged,ympodial	5-merous,abaxial,arrangement,colour,corolla,form,growth,height,history,length,life,na,number,ovary,position,reproduction,seed,shape,spacing,staman,texture,vine,width
102	wfo-0001026489	success	153	75	46	107	29	0.301	0.05-0.1,0.5-2,0.8-1.2,0.8-1.3,1.5-5,2-5,2.5-4,5-6,acute,anther,apex,area,beneath,brown,closely,cm,corolla,dark,elliptic,filament,flattened-reniform,fleshy,glabrous,globose,green,leaf,lobed,minutely,mm,opposite,ovary,pedicel,petiole,pitted,pubescent,shiny,shrub,simple,spaced,stigma,style,surface,tapering,tip,white,widened	.3,0.25-0.5,0.5,0.5-0.75,0.5-1,0.6-1.4,0.8-3.7,1-1.5,1.3-3,2-3,2-4,2-8-flowered,2.5-13,2/3,8-13,along,anthesi,appearing,axil,ba,bark,base,berry,branched,broadly,calyx,cup-shaped,deflexed,deltoid,densely,dia,differing,difoliate,dry,eaf,edicel,eed,erect,exserted,extending,flattened,free,fruiting,geminat,gra,incrassate,lamina,later,lateral,lobe,lon,long,lower,main,major,margin,middle,minor,nflorescence,occasionally,often,older,one,overlappin,pair,paler,papillo,papillose,parallel,perpendicular,planar,pore,poricidal,portion,prominent,red-papillose,rhachi,ruit,scar,shaped,size,slender,somewhat,soon,specimen,stem,straight,strongly,tall,tear-drop,terminal,thickened,trichome,tub,tube,ud,uniseriate,unit,usually,vein,way,whitish,widest,woody,x,ympodial,young	2-8,abaxial,adaxial,arrangement,colour,diameter,flower,form,fruit,growth,height,history,inflorescence,length,life,na,number,overlapping,peduncle,plant,position,rachi,reproduction,seed,shape,spacing,staman,texture,width
103	wfo-0001026490	success	272	119	86	186	33	0.316	1.5,3,6,7-pinnate,abaxially,adaxially,along,anther,anthesi,apart,apex,axillary,branched,brown,chartaceous,cm,contiguously,corolla,darker,densely,diameter,distally,ellipsoidal,expanded,extra-axillary,filament,flat,flattened,flower,fruit,glabrous,green,immature,inflorescence,lacking,leaf,length,lenticular,light,lobe,main,mature,medium,midvein,mm,moderately,mottled,nearly,obtusely,orange,pedicel,peduncle,pentagonal,petiole,pointed,pubescent,punctate,rachi,reflexed,rounded,sand,seed,shape,shoot,short,simple,slightly,smooth,sometimes,somewhat,sparsely,spur,stem,stigma,striping,strongly,style,surface,teardrop-shaped,terminal,tip,vine,violet,white,yellow,×	.5,0.1–0.2,0.1–2.5,0.2–1,0.2–1.5,0.3–3.5,0.4–0.8,0.5–1,0.5–1.5,0.5–3.5,0.5–8,0.7–3,0.8–1.5,0.8–12,1.2–8,1.5–2,1.5–3.5,1.5–5,1.8–2.2,1.9,10–20,1–1.2,1–15,1–2.5,1–3,1–8,2,2.5–3.5,2–2.5,2–4,2–6,2–8,3–4.2,3–4.5,3–5,3–5-pinnate,3–8,4.6,4–4.5,4–5,5-merous,5–7,7,7–15,=,[,],absent,accrescent,acuminate,acute,ag,alyx,apical,apicall,apparently,around,articulated,axe,ba,base,becoming,blade,bract,bracteate,broadly,calyx,capitat,cauline,ciliate,climbing,commonly,completely,connivent,cordate,covered,crisped,cylindrical,decreasing,directed,distal,eaf,eed,eglandular,elliptic,entire,equal,exceeding,free,fruiting,fused,geminat,ground,incurved,interjected,irregularly,large,lateral,latrorse-introrse,leaflet,lobed,long,longitudinal,lower,lowermost,lunate,margin,markedly,match,mean,mean=,middle,minute,multicellular,near,nflorescence,node,obliqu,oblique,obliquely,oblon,oblong,obtuse,occasionally,one,opening,orolla,ovate,ovate-lanceolate,pair,papillose,part,per,perfec,perfect,petiolule,plurifoliate,pore,present,pseudostipule,pubescen,pubescence,pur,radial,reniform,resulting,revolute,rooting,ruit,seudostipule,shorter,similar,size,slender,slit,smaller,spaced,stamen,striation,tamen,tawny,tem,thickened,toward,trailing,transparent,trichome,trichomessympodial,truncate,tube,typically,unbranched,undulate,unit,vary,vegetation,wide,wing,woody,yellowish-tan,youn,½,–4,–4.5,–8,–9.5	0.1-0.2,0.1-2.5,0.5-1,0.5-1.5,0.8-1.5,1-1.2,1-3,1-8,1.5-3.5,10-20,3-4.5,4.5,5-7,7-15,abaxial,adaxial,arrangement,capitate,colour,form,growth,height,na,number,ovary,plant,position,reproduction,spacing,staman,texture,width,young
104	wfo-0001026491	success	165	84	56	109	28	0.339	.5,1,1.5-2.5,10-50,2.5-3.5,3,3-pinnate,5-6,5-8,abaxially,adaxially,anther,apex,base,branched,central,cm,deep,diameter,elliptic-lanceolate,filament,flower,glistening,globose,green,hair,highly,inflorescence,lanceolate,leaf,less,light,mm,often,ovate-elliptic,ovoid,pale,pedicel,peduncle,petiole,pubescent,purple,rachi,rotate-pentagonal,rotate-substellate,row,sharp,shrub,simple,spotted,stigma,strigose,suborbicular-ovate,surface,white,yellow	1-2,1.5-2,1.5-3.5,1.7,1977,2-3,2-4,2-celled,5-merou,6-8,7-8,abaxiall,absent,acuminate,acute,alyx,anderson,apparently,appressed,articulated,averaging,axe,ba,bayonet,bent,berry,blade,bract,branching,broadly,capitat,cellular-papillose,cellular-pilose,connivent,conspicuously,crinkly,cuneate,deciduous,deltoid,densely,directed,distall,eaf,eed,entire,equal,first,geminat,greatly,growing,homostylous,interjected,lateral,leaflet,lobe,long,lower,lunulat,margin,mean,middle,minutely,near,nflorescence,oblong-elliptic,obtuse,orolla,ovate,perfect,pilose,plurifoliate,point,pore,poricidal,porrect-incurved,present,rarely,readily,reduced,rounded,ruit,scandent,seudostipule,shortly,similar,slender,small,straight,strigo,strong,strongly,subacute,tal,tamen,tawny,tem,terminal,tightly,tip,tube,tyle,uniseriate,unit,upright,usually,ventral,whitish,x,ympodial	abaxial,adaxial,arrangement,capitate,colour,corolla,distally,form,fruit,growth,height,history,length,life,na,number,ovary,perennial,plant,position,reproduction,seed,shape,spacing,staman,style,texture,width
105	wfo-0001026501	success	195	95	69	126	26	0.354	.5,.6,/3,0-1,0.27-0.7,0.5-0.9,0.5-1,0.9-2.2,1-2,1-2.5,1/4,3.5-4,5-merous,?,abaxially,acute,almost,anther,apart,apex,articulated,base,berry,brown-green,cm,curved,densely,diameter,dull,elliptic,erect,filament,filiform,flattened-reniform,flower,fruit,glabrous,green,leaf,length,lobed,long,mauve,mm,moderately,orange-brown,orbicular,ovate,pale,pedicel,peduncle,petiole,rounded,shoot,short,shrub,simple,spherical,stellate-pubescent,straight,style,surface,terminal,tip,upper,way,white,yellow,yellow-green	-1.7,-3,.1,.35,.7,0,0-2,0.05-0.3,0.1,0.2-1.8,0.5,0.5-0.6,0.6-1,0.6-1.1,0.6-2,1,1.8-2.2,1/2-2/3,1/6-1/2,2-10,2.5-4,2.8-3,3-4,3-5,3-9,4-5,4-7,6-9,7-9,acicular,alyx,apar,apically,apparently,bark,becoming,blade,borne,branched,brown,calyx,chartaceous,color,concolorous,cuneate,deltate,discolorous,drying,eaf,eed,elongated,elongating,entire,equal,eye,filiform-acuminat,flattened,free,fruiting,glabrou,gray,infructescence,known,light,lobe,longer,lower,margin,mature,midpoint,naked,nflorescence,often,older,one,open,orolla,oung,pair,pendulous,per,perfec,pericarp,plurifoliat,poricidal,porrect,portion,prickl,prickle,prickly,primary,ray,reddish,ruit,scandent,scar,sessile,shorter,slender,small,smooth,sometimes,somewhat,spaced,sparsely,spreading,stalk,stalked,stellate,stem,subsessile,tamen,tapering,terete,time,trichome,tube,unarme,unarmed,unit,variously,vary,vein,visible,wide,ympodial	abaxial,adaxial,arrangement,colour,corolla,form,growth,height,history,inflorescence,life,na,number,ovary,perennial,plant,position,rachi,reproduction,seed,shape,spacing,staman,stigma,texture,unknown
106	wfo-0001026503	success	269	89	71	198	18	0.264	.9,0.7–3.7,1.0–3.5,1.1–1.4,1.3–1.6,1.4–2.3,1.5–2.0,2.2–2.5,2.2–6.3,3,3.0–4.5,5,8.2,anther,apiculate,attachment,brown,calyx,capitate,central,chartaceous,cm,corolla,depression,diameter,extra-axillary,filament,flattened-orbicular,flattened-reniform,flower,fruit,glabrous,globose,green,internode,lanceolate,lateral,leaf,lobe,long,many,margin,mm,nearly,notched,oblong,ovate,pedicel,peduncle,petiole,point,portion,red,red-brown,reddish,rotate-stellate,shallow,shrub,simple,small,stem,stigma,style,surface,tip,tree,truncate,white,yellow,yellow-tan,±smooth	.3,.5,.6,0.03,0.3–,0.3–0.6,0.4–1.2,0.6–0.7,0.6–1.0,0.7,0.8–1.1,0.8–1.7,0.8–3.5,1.0–1.5,1.0–1.6,1.3,1.3–3.7,1.4–1.7,1.5–1.8,1.5–2.5,1.7,1.9–5.5,1/3,1/3–1/2,1/4–1/3,2.2–2.8,2.3–2.6,2.6–2.9,22,2–3,4.0–12.0,4.7,4.8,4.9–5.8,5-merou,5.0,6.0,6.9–10.3,7–10,9.0–1.0,90°,abaxially,acuminate,acute,adaxially,adnate,aequilateral,ag,always,alyx,anthesi,apart,apex,apical,apparently,appearing,arching,around,articulate,attenuate,axe,ba,bark,base,becoming,bent,berry,blade,branch,branching,brochidodromous,bud,channeled,deltoid,dentate,developed,development,difoliate,directed,distal,distally,dry,eaf,edge,eed,eglandular,either,emerging,endocarp,entire,exocarp,extending,fertile,filiform,flattened,flexed,free,geminat,glabrou,glandular,glossy,gradually,gree,hair,homostylous,increasing,intact,interpetalar,intersepalar,irregularly,juic,lackin,lacking,layer,lon,lower,lying,major,mature,midrib,midvein,minor,minute,moderate,moderately,near,nflorescence,oblique,obviously,ocasionally,occasionally,opaque,orolla,outline,oval,pale,per,perforated,pore,potentially,present,pubescence,pubescent,raised,reflexe,remaining,rigid,rounded,row,ruit,scarcely,scattered,short,shortly,side,sinuate,sinus,slightly,sloughing,smoot,spaced,sparse,sparsely,splitting,spread,spreading,stamen,stellate,stipitate,straight,subacute,suture,tamen,tem,thin,though,time,tissue,transparent,tube,two,ud,unarmed,upper,usually,vary,vein,weakly,well,wide,without,yellow-ferruginous,yellowish,ympodia,young,±equal,±straight,×	abaxial,adaxial,arrangement,colour,form,growth,height,inflorescence,length,na,number,ovary,plant,position,seed,shape,staman,texture
107	wfo-0001026513	success	138	73	45	93	28	0.326	.25,0.8-2,1-1.5,1-3,3-5,4-5,6-8,acute,anther,apex,area,closely,cm,corolla,elliptic,filament,flower,fruit,glabrous,globose,green,lanceolate,leaf,lobed,long-styled,minute,mm,opposite,ovary,pale,papillose,pedicel,petiole,plant,short-styled,shrub,simple,slender,small,spaced,stigma,style,surface,treelet,white	.1,.3,.75,/3,2-2.2,2-5,3-6-flowered,7-9,8-16,anthesi,apiculate,ba,bark,base,berry,broadly,caly,calyx,completely,darkish,decurrent,deflexed,delicate,deltoid,dia,differentiated,dry,eaf,edicel,eed,erect,except,exserted,free,fruiting,gre,hirsute,immature,known,lateral,leave,less,live,lobe,long,longer,lower,main,mature,middle,minutely,much,nflorescence,obscure,older,overlappin,pair,pore,poricidal,portion,prominent,raised,reflexed,rest,ruit,scar,shaped,shiny,somewhat,soon,specimen,stem,straight,styl,tall,tear-drop,tip,trichome,tube,ud,undersurface,unifoliat,uniseriate,unit,vein,venation,way,wide,widest,woody,x,ympodial,young	3-6,abaxial,adaxial,arrangement,colour,diameter,form,growth,height,history,inflorescence,length,life,na,number,overlapping,peduncle,perennial,position,rachi,reproduction,seed,shape,spacing,staman,texture,unifoliate,width
108	wfo-0001026529	success	219	103	78	141	25	0.356	0.3-1,0.5-4.5,1-10,1-2,1.1-2.5,11-14,12-22,3-9.5,5-15,5-9,abaxially,acuminate,adaxially,anther,apex,blue,brownish,cell,chartaceous,clavate,cm,condition,corolla,covering,creamy,dark,deep,diameter,drying,elliptic,faintly,filament,flower,forked,fresh,fruit,glabrous,globose,green,greenish,hair-like,herb,lateral,length,light,lilac,medium,membranous,minutely,mm,moderately,odd-pinnate,ovate,ovoid,pedicel,peduncle,pentagonal,petiole,plant,puberulent,pubescent,pure,rarely,ripe,seed,shape,slightly,stigma,style,substellate,terminal,testal,thick,wall,white,whitish,yellow,yellowish	0-25,1,1-3,1-4.5,1.5-2.5,1.5-4,10,10-28,120-210,2,2-5,2-7.5,20-60,3-12,3-5,3-6,4-8,5-17,5-merou,50-70,6-20,600-950,?,acumen,acute,ag,along,alyx,apart,apparently,articulated,attenuate,axe,axillary,base,berry,blade,broadly,bud,capitat,ciliate,connivent,cordate,densely,digestion,distal,dorsally,dot,eaf,edge,eed,enzyme,erec,especially,exceeding,except,flat,folded,geminat,generally,glabrou,gland,glandular,greatly,gree,green-white,hair,hal,half,head,homostylous,honeycomb-shaped,interjected,lanceolate,leaflet,lengthening,like,living,lobe,long,longer,lower,lunate,make,margin,midrib,mucilaginous,narrowly,nflorescence,non-glandular,oblique,often,orbicular,orolla,pair,perfect,petiolulate,petiolule,plurifoliate,pore,poricidal,proximal,reduced,removed,rounded,ruit,scattered,sessile,seudostipule,short,size,slit,spaced,specimen,stamen,ste,stem,straight,subequal,subsessile,subtending,tall,tamen,tem,tetralobulate,throughout,tip,tri-,trichome,tube,typically,unit,unwinged,usually,vary,varying,wet,wide,wing,x,ympodial	abaxial,adaxial,arrangement,capitate,colour,form,growth,height,hermaphroditic,history,inflorescence,leaf,life,na,number,ovary,perennial,position,rachi,reproduction,spacing,staman,surface,texture,width
109	wfo-0001026534	success	150	82	54	96	28	0.36	0.5-1,1.5-9,10-20,10-50,2-2.5,2-7,2-8,2.5-15,3-10,3-25,5-6,acuminate,apex,articulated,auriculate,base,chartaceous,cm,cordate,densely,diameter,ellipsoidal,entire,flattened,fleshy,flower,fruit,glabrous,margin,mm,orange,ovate,ovoid,pale,pedicel,peduncle,perfect,petiole,pinkish,puberulent,pubescent,purple,rachi,red,simple,stellate,stigma,style,subcoriaceous,tree,truncate,white,x,yellow	-1.5,1-2,1-2.5,1-3,1.5-6,10-15,15-50,2-3,2.5-4,3-,3-4,3-5,3.5-4,4-10,4-foliat,4.5-5,6-35,7-12,7-40,abaxially,absent,acute,adaxially,aggregate,apart,ape,apiculate,axe,basal,beyond,blade,branched,bright,calyx,cell,connective,connivent,cylindrical,darker,deltate,directed,distally,eaf,eed,eglandular,equal,exserted,glandular,hair,lanceolate,leaving,lemon-yello,lobe,lon,long,longitudinal,lower,m.,moderately,narrowly,nflorescence,nther,obtuse,often,orolla,pedicellar,pore,presen,puberulen,radiu,remnant,ruit,shorter,slightly,small,spaced,sparsely,stamen,stone,stripe,tal,tem,thecae,time,tip,tomento,triangular,truncat,tube,ud,unbranched,unit,vary,vein,wide,ympodial	abaxial,adaxial,anther,arrangement,colour,corolla,filament,form,growth,height,history,inflorescence,leaf,length,life,na,number,ovary,perennial,plant,position,reproduction,seed,shape,spacing,staman,surface,texture
110	wfo-0001026535	success	248	97	78	170	19	0.315	.5,0.7-1.5,1-2,1-3,1-5,1.2-2,2-5,3.5-4,7-8,abaxial,acute,almost,anther,apex,apically,base,berry,black,brachyblast,chartaceous,clavate,cm,condensed,conical,corolla,cupular,dark,dendritic-pubescent,diameter,dilated,distributed,dorsal,dry,drying,elliptic,elongated,evenly,filament,flower,fruit,glabrous,green-brown,inside,leaf,length,liana,lobed,membranous,mm,mostly,number,obovate,orange-brown,outside,ovate,ovoid,pedicel,peduncle,petiole,plant,pubescent,rachi,rarely,ridged,rounded,short,shrub,side,sparsely,stigma,style,surface,terminal,thin,violet,widely,x,yellowish	.1,.2,.4,.8,0-0.5,0.1-0.2,0.15,0.2,0.2-0.3,0.2-1.5,0.5-1,1,1.3,1.5-2,1.5-3,1/2-2/3,1/3,2-3,2.5,3,3-4.5,3-5,4-15,5-10,5-7,5°,abaxially,absent,accrescent,adaxially,age,along,alternate,alyx,anthesi,apar,apparently,area,around,articulated,bark,becoming,branch,branched,branching,broadly,brown,calyx,clearly,clustered,concolorous,cuneate,cup,curved,deeply,delineate,delineated,deltoid,dendritic,dense,detaching,developed,developing,discolorous,divided,domatia,eaf,eed,ellipsoi,entire,equal,except,eye,fertilisation,fine,flat,flexuous,forming,free,frui,fruiting,increasing,known,leave,lengthening,like,linear,lobe,lon,long,loop,loose,lower,m.,main,margin,marginal,midvein,minute,minutely,much,naked,network,nflorescence,nther,oblong,obscure,older,orolla,pair,papillo,partly,pendulous,perfec,pericarp,plurifoliat,pointed,pore,poricidal,portion,primary,prominent,protruding,raised,ray,reaching,ruit,scar,secondary,see,simple,sinus,slender,slightly,smaller,smooth,soon,spaced,spreading,stem,stump,tearing,terete,tertiary,tip,tissue,toward,translucent,trichome,truncate,tube,tufted,two,ud,unarmed,uneven,unevenly,unit,unlignified,vary,vein,venation,visible,weakly,white,wide,wider,ympodial,young,youngest	0-2.5,1.5,adaxial,apart,arrangement,colour,form,growth,height,inflorescence,na,ovary,position,reproduction,seed,shape,spacing,staman,texture
111	wfo-0001026538	success	226	92	66	160	26	0.292	0.3-1.5,0.8-1.2,0.8-2.2,1-3,1.2-2.6,1.7-2.5,2-5,3.5-4.6,3.5-5.8,6-13,6.7-,8.1-14.8,abaxially,acuminate,acute,adaxially,anther,apart,apex,black,branched,broadly,brown-black,cm,corolla,deltoid,diameter,drying,elliptic,filament,flower,fruit,glabrous,globose,green,leaf,length,many,mm,obovate,ovate,pedicel,peduncle,petiole,porrect-stellate,pseudo-terminal,pubescent,rachi,reticulate-punctate,scabridulous,short,shrub,simple,small,stellate,stigma,style,subconical,suborbicular,surface,time,tomentose-pubescent,tree,white,yellow,yellowish-tan	-3.5,-5.8,.5-3,/15-1/9,0-160,0.1-0.3,0.4-,0.6-0.8,0.8-1.5,0.9-1.2,1-1.9,1-2.5,1.2-1.4,1.2-1.5,1.3-2.8,1.4-2.6,1.4-3,1.5-2.5mm,1.8-4.6,1/2,12-21.5,2-3.5,2.1-3.2,2.1-3.4,3-4,3.2-4.8,3.7-5.8,4-8,5,6.3-8.9,8-10,[,],accrescent,adaxiall,ag,along,anthesi,apparently,appearing,around,articulated,axe,axillary,ba,bark,base,berry,blade,blunt-tipped,branch,brown,bud,calyx,capitat,chartaceous,closely,completely,constricted,covering,cylindrical,decurrent,dense,densely,directed,distally,due,eaf,edge,eed,entire,enveloping,exserted,farinose,fleshy,free,frui,fruiting,glabrescen,glabrou,gray,hair,inserted,lackin,lanceolate,lateral,lengthening,lobe,lobed,long,long-attenuate,long-stalked,longer,longitudinal,lower,main,margin,measured,midrib,mixed,mostly,multangulate,nearly,nflorescence,obscured,obtuse,occasionally,older,orolla,ovate-lanceolate,overlapping,pale,perfect,plurifoliate,pore,poricidal,porrect-stellat,pubescence,rarely,rather,ruit,runk,semi-ovate,sessile,short-stalked,side,slightly,slit,sometimes,somewhat,soon,spaced,stamen,stem,subcampanulate,suture,tall,tamen,terete,thick,thickened,thin-textured,tip,tomentu,touching,tube,ud,unarme,unarmed,unit,usually,vary,vein,way,weakly,wide,x,yellowish,ympodial,young	0.4-1.5,60-160,abaxial,adaxial,arrangement,capitate,colour,form,growth,height,history,inflorescence,life,na,number,ovary,perennial,plant,position,reproduction,seed,shape,spacing,staman,texture,width
112	wfo-0001026539	success	194	75	45	149	30	0.232	abaxially,adaxially,anther,apex,branched,brown,clustered,cm,corolla,creamy,diameter,filament,flattened-reniform,flower,fruit,glabrous,globose,growth,height,lance-elliptic,lateral,leaf,minutely,mm,oblanceolate,orange,pedicel,peduncle,perennial,petiole,pilosulose,pitted,rachi,red,slender,staman,stellate,stigma,strongly,style,surface,terminal,vine,white,yellow	-6,.5,0,0.2,0.25,0.3-0.5,0.5,0.9,1,1-1.5,1-2-celled,1.5–2,10–15,10–28,15–20,1–2,2,2-4-celled,2.5,2.5–4,20,20–35,2–2.5,2–3,2–4,2–5,3,30,3–5,4–6,5,5.5,5–,5–10,6–15,absent,acuminate,acute,ag,always,alyx,anthesi,apiculate,approximately,armed,articulated,axe,ba,basal,base,becoming,berry,blade,broadly,bud,calyx,campanulate,capitat,cell,chartaceous,connivent,cucullate,deltate,densely,dr.,eaf,early,eed,ellipsoid,elongate,elongating,entire,equal,exserted,four,glabrou,hair,hooked,ine,interpetalar,larger,lengthening,lobe,lobed,long,long-attenuate,long-styled,longer,lower,major,margin,midrib,narrowly,nearly,nflorescence,occasionally,often,one,orolla,pair,pericarp,pointed,pore,poricidal,present,prickle,puberulent,pubescent,pustulate,recurve,recurved,robust,rounded,rugose,ruit,sessil,shallow,shoot,short,side,simple,sinuate,slightly,slit,somewhat,spreading,stem,stout,straight,subwoody,tamen,tapering,terminally,time,tip,tissue,triangular,trichome,tub,tube,unequal,usually,vary,vein,wide,winged,woody,young,×	10,10-15,15-20,2.5-4,20-35,30-40,4-6,5-10,6-15,abaxial,adaxial,arrangement,capitate,colour,form,history,inflorescence,length,life,na,number,ovary,plant,position,reproduction,seed,shape,spacing,texture,width
113	wfo-0001026604	success	192	110	95	97	15	0.495	.4,.5,0.8-0.9,1.2-1.7,1.5-9,10-30,2-2.3,2-2.5,2.3-3.5,4-4.5,50-100,?,acuminate,aid,along,anther,anthesi,apart,apex,bark,base,berry,brown,c.,capitate,climbing,cm,conical,cordate,corolla,cupped,dark,densely,diameter,ellipsoid,entire,flattened,flower,fruit,glabrous,globose,growth,later,leaf-opposed,liana,lobed,margin,midrib,minute,minutely,mm,narrowly,new,nodding,ovary,ovate,ovoid,pale,papillose,pedicel,peduncle,petiole,pitted,planar,pubescent,purple,red,reddish,reniform,ripe,scar,shape,shiny,shrub,simple,slender,slightly,spaced,stellate,stem,stigma,style,support,surface,terminal,thin,trichome,twisting,uniseriate,vining,violet,way,widely,woody,x	.75,0,0.1,0.4-0.6,0.8-1,1-1.2,1.1-1.3,1.5-2,3-3.5,3-5,3.5-4,4.5-7,5,5-7,<,absent,age,always,appearing,articulated,articulation,atop,basal,branching,brow,calyx,cell,clearly,comical,cucullate,deflexed,differentiated,distal,distinct,drying,due,eaf,eed,elongate,expanding,exserted,filament,flexuous,free,fruiting,inflated,leaving,lengthening,lobe,lower,mere,nflorescence,oblique,occasionally,older,outline,overall,pair,papillo,part,particularly,peg,per,perfect,pericarp,plurifoliat,poin,point,pore,poricidal,portion,primary,quarter,receptacle-like,rim,ruit,series,sinuate,slit,somewhat,stout,strongly,structure,swolle,testal,time,tip,truncate,tub,tube,ud,undulation,unit,upper,vein,ympodial,½	abaxial,adaxial,colour,form,inflorescence,leaf,length,na,number,position,rachi,seed,spacing,texture,width
114	wfo-0001026606	success	213	93	59	154	34	0.277	0.4-0.8,0.5-1.6,1.3-1.9,1.7-2.1,2.4-3.6,3-6,abaxial,abaxially,adaxial,apart,apex,asymmetric,base,berry,black,broadly,chartaceous,cm,diameter,expanded,extra-axillary,filament,flower,fruit,glabrate,glabrous,globose,golden,lenticular,minutely,mm,ovate,pedicel,peduncle,pentagonal,peripherally,petiole,pitted,puberulent,pubescent,rachi,ripe,scabrous,shrub,simple,slightly,small,stellate,stelliform,stigma,style,surface,tan,tree,white,wider,woolly,x,yellow	0.5–0.8,1.4-2.1,10–20,12-17,12.5-22.5,15–20,15–25,1–1.5,1–3,2-3,2–2.5,2–4,3-4.6,3–10,3–4,3–5,3–6,4.2-5.2,4–20,4–7,5-merou,5.8-7.2,5–15,6–7,6–8,7.3-9.7,7–12,8–10,abaxiall,absent,acute,adaxially,almost,along,alyx,an¬ther,apiculate,apparently,armed,articulated,asymmetrically,axe,ba,band,based,blade,blunt-tipped,branched,broad,capitat,central,closely,coarsely,compressed,concentrated,cordate,cylindrical,densely,developed,difoliate,directed,distally,eaf,eed,entire,eventually,forming,geminat,glabrou,hair,homostylous,initially,internode,interpetalar,lanceolate,larger,lateral,laterally,lighter,linear,lobe,lon,long,low,lower,main,margin,midpoint,midvein,moderately,much,nearly,nerve,nflorescence,obsolete,obtuse,occasionally,often,of¬ten,older,open,orolla,perfect,persistently,pore,present,prickle,prickly,pubescen,pubescence,rarely,ray,rayed,recurved,reduced,rounded,ruit,scar,scattered,sessile,short,shortly,sometimes,spaced,sparingly,sparsely,spreading,stellae,stellate-pubescent,stem,stout,subentire,tall,tamen,tapering,tem,thick,thickened,three,tissue,toothed,truncate,tube,unarmed,usually,vary,vein,warty,weakly,wide,widely,yello,ympodia,young	10-20,15-20,3-10,3-4,4-20,6-7,7-12,8-10,anther,arrangement,capitate,colour,corolla,form,growth,height,history,inflorescence,leaf,length,life,na,number,ovary,perennial,plant,position,reproduction,seed,shape,spacing,staman,texture,width
115	wfo-0001026607	success	204	86	62	142	24	0.304	0.1-0.3,0.8-3.4,0.8-4.5,0.8-5,1-10,1-2,1-8,10-30,2-10,2.5-3.8,4-6,6-10,abaxially,adaxially,anther,apex,cell,clavate,cm,corolla,covering,deep,diameter,elliptic,filament,finely,flower,forked,fruit,glabrous,globose,green,greenish,hair-like,herb,lateral,leaf,medium,minutely,mm,moderately,odd-pinnate,ovate,ovoid,pedicel,peduncle,pentagonal,petiole,plant,puberulent,pubescent,rachi,seed,stigma,style,terminal,testal,thick,violet,wall,whitish,yellow	0-3,0-4,0.3-1.8,0.5-5.8,1-3.8,1-5,1.5-4,2-2.5,2-3,2.4-5.8,2.7-19,3-8,4-10,5,5-merou,5.8-19.8,absent,acumen,acute,ag,along,alyx,apart,apparently,articulated,attenuate,axe,axillary,base,basiscopic,berry,blade,brownish,bud,capitat,chartaceous,ciliate,clearly,coarse,condition,connivent,decreasing,decurrent,digestion,distal,dorsally,dot,drying,eaf,edge,eed,enzyme,especially,exceeding,flat,folded,forming,fresh,geminat,generally,glabrou,greatly,gree,green-white,hair,hal,half,high,homostylous,honeycomb,interjected,lanceolate,larger,leaflet,lengthening,like,living,lobe,long,lower,make,margin,marked,membranous,midrib,minute,much,mucilaginous,nflorescence,obtuse,often,orbicular,orolla,pair,perfect,petiolulate,plurifoliate,pore,poricidal,present,rarely,removed,ripe,rosette,rounded,ruit,scattered,semierec,sessile,seudostipule,shaped,short,side,simple,size,slit,sometimes,spaced,specimen,stamen,ste,stem,straight,subtending,tall,tamen,tem,throughout,tip,toward,tri-,tube,typically,unit,unwinged,usually,vary,wet,white,without,x,ympodial	abaxial,adaxial,arrangement,capitate,colour,form,growth,height,history,inflorescence,length,life,na,number,ovary,perennial,position,reproduction,shape,spacing,staman,surface,texture,width
116	wfo-0001026613	success	159	75	49	110	26	0.308	0.6,1-10,1-2,2.3-8,2.5-2.8,3-5,5-6,6-12,8-18,8.5-10,8.5-9,abaxially,acuminate,adaxially,anther,apex,articulated,berry,chartaceous,cm,corolla,densely,diameter,filament,flower,forked,fruit,glabrous,green,herb,leaf,m-1.2,membranous,minutely,mm,odd-pinnate,ovate,pedicel,peduncle,petiole,plant,puberulent,pubescent,purple,rotate-pentagonal,stigma,style,terminal,yellow	0.5-1,1.5-4,11-19.5,2-7.5,3-10,4-5,4.5-8.5,5,5-7,5-merou,5.5-7,6-8,6.2-9.5,9.5-13.5,absent,acumen,ag,along,alyx,apart,apparently,attenuate,axe,axillary,base,blade,borne,bud,capitat,ciliate,conical,connivent,cordate,decreasing,distal,dorsally,eaf,edge,eed,end,erec,especially,flat,folded,geminat,generally,greatly,hair,hal,half,homostylous,immature,interjected,lanceolate,larger,lateral,leaflet,lengthening,like,lobe,long,lower,margin,mature,middle,midrib,minute,mottled,nflorescence,orolla,pair,perfect,petiolule,plurifoliate,pore,poricidal,proximal,pubescen,ruit,secondary,semierect,seudostipule,singly,size,slit,spaced,sparsely,ste,stem,stolo,subequal,subtending,symmetrical,tall,tamen,tem,tip,toward,tri-,tube,tuber,typically,unit,unknow,unknown,unwinged,usually,vary,x,ympodial	abaxial,adaxial,arrangement,capitate,colour,form,growth,height,history,inflorescence,length,life,na,number,ovary,perennial,position,rachi,reproduction,seed,shape,spacing,staman,surface,texture,width
117	wfo-0001026614	success	200	98	62	138	36	0.31	0.4-0.7,1.3-1.8,11-15,2.2-5.5,2.5,3.2-5.2,abaxially,acuminate,acute,adaxially,anther,apex,articulated,base,berry,black,brown,chartaceous,clavate,cm,dark,densely,diameter,dried,evenly,extra-axillary,filament,flattened-reniform,flower,foveolate,fruit,glabrous,globose,golden,interpetalar,leaf,minutely,mm,mottled,orange,orange-red,ovate,pedicel,peduncle,petiole,pubescent,rachi,ripe,rotate-pentagonal,shrub,simple,sparsely,stellate,stellate-pubescent,stigma,style,surface,tissue,white,x,yellow,yellowish	.8,0.2,0.2–0.3,0.5,0.5–2,1-,1.5–2,15–30,1–2,1–3,1–5,2.2,2.5–3,20–25,2–4,2–4-branched,2–6.5,3-foliate,3–10,4-7,4.5–11,4.5–5.5,5,5-merou,5.3-8.2,50,6.4-8.4,6–8,7.2-9.8,8–10,9–16,>,absent,across,adaxiall,alyx,apart,apparently,armed,axe,ba,blade,blunt-tipped,broad-based,calyx,campanulate,capitat,closely,commonly,concentrated,cylindrical,denser,developed,directed,distally,eaf,eed,entire,erect,especially,expanded,fleshy,fruiting,geminate,glabrescent,gland-tipped,globo,hair,homostylous,internode,irregularly,lanceolate-attenuate,lateral,less,linear,lobe,lobed,lon,long,lower,margin,midpoint,midvein,minute,nearly,nflorescence,oblique,obtuse,often,orolla,ovate-lanceolate,ovoid,pair,per,perfect,pore,prickle,pubescence,rarely,ray,reflexed,repand,rounded,ruit,scattered,sessile,shallowly,shin,side,similar,slightly,smaller,sometimes,somewhat,soon,spaced,spreading,stellae,stem,tall,tamen,tapering,tem,time,tissu,tube,ud,unarme,unarmed,usually,vary,vein,weakly,well,wide,ympodia,young,–5	0.5-3,1-2,1-5,15-30,2.5-3,3-10,4.5-5.5,8-10,9-16,abaxial,adaxial,arrangement,capitate,colour,corolla,form,growth,height,history,inflorescence,length,life,na,number,ovary,perennial,plant,position,reproduction,seed,shape,shiny,spacing,staman,texture,width
118	wfo-0001026632	success	108	74	44	64	30	0.407	.5,0,1-2,10-12,3-4,6,abaxially,adaxially,anther,apex,broadly,cm,condensed,cyme,densely,diameter,divided,elliptic,exposed,extra-axillary,filament,flower,halfway,height,leaf,lobe,mm,moderately,ovate,pedicel,peduncle,petiole,prickle,prominent,pubescent,scarcely,short,shrub,simple,stellate,stellate-pubescent,stigma,style,unknown	1.5,5-merou,7,abundantly,acumen,acuminate,acute,alyx,armed,ba,base,blade,bu,capitat,cell,central,commonly,developed,eaf,eed,equal,erect,flattened,geminat,glandular,hair,interacuminal,lamina,lanceolat,lateral,less,little,lon,long,lower,margin,minute,nflorescence,orolla,porrect-stellate,prickly,ray,reddish-brown,rounded,ruit,sessile,shallow,sinus,straight,structure,tamen,tem,tissue,toward,triangular,truncate,tube,unarme,unknow,vary,well,x,ympodial,young	5-merous,abaxial,adaxial,arrangement,bud,capitate,colour,corolla,form,fruit,growth,history,inflorescence,length,life,na,number,ovary,plant,position,rachi,reproduction,seed,shape,spacing,staman,surface,texture,unarmed,width
119	wfo-0001026642	success	193	87	54	139	33	0.28	abaxial,abaxially,annual,anther,apex,articulated,axillary,base,bipinnate,black,blade,blue,branched,brown,clavate,cm,dark,diameter,filament,flattened,flower,fruit,glabrous,globose,green-purple,herb,indumentum,lavender,leaf,length,lilac,mm,moderately,number,ovate,pale,pedicel,peduncle,pentagonal,perennial,petiole,pinnate,pitted,pubescent,shallowly,shoot,sparsely,stigma,style,subglabrous,surface,time,violet,yellow	.05,.1,.8,0.1,0.1–0.3,0.2,0.25,0.4,0.4–2.2,0.5,0.5–,0.5–0.7,0.5–1.7,0.5–2.0,0.5–3.5,0.6,0.6–1.0,0.75–1.0,0.75–2.0,0.7–1.6,0.8–1.2,1.0,1.0–2.0,1.2–1.7,1.2–2.0,1.2–3.5,1.2–6.2,1.6–8.0,1.9–3.0,12–30,1–10,1–3,2.0–4.0,2.5–3.5,2.5–4.0,2.8–3.0,3.0–5.1,3–5,4.0–6.0,4–7,5,5.0–7.0,50–100,6,<,acute,adaxiall,adaxially,ag,along,anthesi,apart,appressed,axe,ba,borne,calyx,cell,chartaceous,circular,connivent,cylindrical,decreasing,decumbent,densely,denser,divided,eaf,eed,either,elliptic,equal,erect,fleshy,geminat,glabrescen,gland,glandular,hair,half,lobe,lon,long,longitudinal,lower,m.,multicellular,narrow,nflorescence,oblong,obtuse,occasionally,often,opening,orolla,pair,perfect,pinnae,pore,poricidal,present,primary,probably,rapidly,rounded,ruit,secondary,sessile,side,simple,slit,sometimes,spaced,stone,straight,tal,tamen,tem,tip,tube,unicellular,unifoliate,uniseriate,unit,usually,vary,vein,white,wide,wing,woody,x,ympodial,–1.2,–11.0,–2.0,–4.5,–6,–7	0.4-2.2,0.5-3.5,0.75-2.0,1-10,1-3,1.2-3.5,12-30,2.8-3.0,3.0-5.1,5.0-7.0,50-100,adaxial,arrangement,colour,corolla,form,growth,height,history,inflorescence,life,na,ovary,plant,position,rachi,reproduction,seed,shape,spacing,staman,texture,width
120	wfo-0001026651	success	222	121	83	139	38	0.374	-celled,1,1.8,2.8,3,4,8,acuminate,acute,anther,antrorse,apex,appressed,arcuate,articulated,base,berry,brown,brownish-green,calyx,capitate,cell,chartaceous,ciliate,cyme,dark,densely,diameter,drying,dull,entire,erect,filament,flattened,flower,fruit,glabrous,globose,green,herb,lanceolate,lateral,leaf,length,light,long,margin,matte,membranaceous,mm,moderate,moderately,narrowly-elliptic,new,ovate-deltate,ovate-reniform,pedicel,peduncle,petiole,plant,pubescent,revolute,ripe,seed,shape,simple,slightly,sometimes,stellate,stem,stigma,style,sub-opposite,surface,terminal,translucent,trichome,unbranched,undulate,uniseriate,white,wide,yellow	0.2–1.3,0.35–2.6,0.9–3,1–2,2.2–10,2–11.5,2–13,2–3,2–3.3,2–4,2–4.5,2–8,3-plurifoliate,3–5,3–7,4–6,4–7.8,5-merou,6–10,6–14,abaxially,absent,accrescent,adaxiall,adaxially,along,alyx,anisophyllous,antror,antrorsely,apar,ark,asymmetric,attenuate,axi,beneath,beyond,branch,broadly,brochidodromous,capitat,circular,cm,connivent,cordate,cylindrical,decumbent,decurrent,differing,directed,discolorous,eaf,eed,elliptic,emarginate,equal,exfoliating,exserted,eye,flexuous,frui,geminate,geniculate,glabrescent,glabrou,glandular,growt,hair,head,highly,hilum,hollow,impressed,introrsely,less,like,lobe,longitudinal,lower,lying,major,markedly,midrib,minor,mostly,much-branched,multicellular,naked,nflorescence,normally,oblong-ellipsoid,obtuse,older,one,onto,opening,orolla,ovate-lanceolate,parallel,pedunculate,per,perfect,pore,poricidal,prominent,pubescence,reduce,region,rounded,ruit,secondary,shiny,shrub,similar,single-celled,size,slit,small,smaller,spaced,stalk,stamen,straight,subapical,tall,tamen,tem,turning,unit,upper,usually,vary,vein,venation,visible,woody,ympodial,young,×	1-2,2-13,2-3,2-8,2.2-10,3-7,4-6,5-merous,6-10,abaxial,adaxial,apart,arrangement,bark,bud,center,colour,corolla,form,fruiting,growth,height,history,inflorescence,life,na,number,ovary,perennial,position,prickle,rachi,reproduction,scar,spacing,staman,texture,width
121	wfo-0001026656	success	211	127	101	110	26	0.479	0.3-3,1-10,1-2,1-3.8,1.1-8.1,20-60,4-13,4-8,5-18,5-35,9-11,abaxially,adaxially,along,anther,apart,apex,articulated,blue,broadly,brownish,capitate,cell,chartaceous,ciliate,cm,condition,corolla,covering,dark,densely,diameter,distal,dot,drying,elliptic,especially,filament,flower,forked,fresh,fruit,generally,glabrous,glaucous,globose,green,green-white,greenish,greenish-yellow,hair,hair-like,herb,lanceolate,lateral,light,like,make,margin,membranous,midvein,minutely,mm,moderately,mucilaginous,narrowly,occasionally,odd-pinnate,ovate,ovoid,pedicel,peduncle,pentagonal,petiole,plant,puberulent,pubescent,purple,rachi,rotate-pentagonal,scattered,seed,sometimes,somewhat,star,stem,stigma,style,subglabrous,terminal,testal,thick,throughout,tinged,tip,violet,wall,wet,white,whitish,yellow	0-4,0.3-4.2,0.4-6.5,0.7-10.5,0.9-13,1,1-1.8,1-4,1-5,1.5-7,10,2-6,2-8,2.5-17,4-10,5,5-merou,5.5-27,absent,acumen,acuminate,acute,ag,alyx,attenuate,base,bearing,blade,borne,bud,clavat,connate,connivent,cuneate,curved,decurrent,digestion,dorsally,eaf,edge,eed,end,enzyme,erec,exceeding,flat,folded,geminat,greatly,half,homostylous,honeycomb-shaped,interjected,larger,leaflet,lengthening,living,lobe,long,lower,lunate,middl,mottled,nflorescence,non-glandular,oblique,often,orolla,pair,petiolulate,petiolule,plurifoliate,pore,poricidal,pubescen,ranging,removed,ruit,scale-like,seudostipule,short,singly,slightly,slit,spaced,specimen,stamen,ste,stolo,straight,subequal,subtending,symmetrical,tall,tamen,tem,tertiary,therefore,tri-,truncate,tube,tuber,typically,unit,unwinged,vary,wide,wing,without,ympodial	abaxial,adaxial,arrangement,clavate,colour,form,growth,height,history,inflorescence,leaf,length,life,middle,na,number,ovary,perennial,position,reproduction,shape,spacing,staman,surface,texture,width
122	wfo-0001026663	success	251	94	67	184	27	0.267	-2.9,0.2-0.6,0.4-2.2,0.9-1.5,1,1-3.2,1-5,1.1-2.1,1.2-2,1.4-3.1,2-12,2.9-5,4.7-25.9,8-17,abaxially,adaxially,anther,apart,branched,brown,cm,conical,corolla,dark,diameter,drying,filament,flower,fruit,glabrescent,globose,granular,green,immature,leaf,length,less,light,many,mm,ovate-lanceolate,pale,pedicel,peduncle,persistent,petiole,pseudo-terminal,rachi,rich,scabrous,short,shrub,simple,small,stellate,stigma,style,subglobose,time,tomentose,tomentose-pubescent,tree,usually,violet,white,x,yellow	-15,-8,-9.7,.5-2.5,/25-1/15,/3,0-160,0.3-0.8,1-2.5,1.1,1.4-2.6,1.6-2.3,1.9-2.6,1/2,1/3,1/4-1/2,10-26,10.3-13.2,12-14,2.1-2.6,2.5-3.7,2.8-5.3,2/3,24-45,3-5,3.5-5,3.8-5.7,31,4.5-5.7,5-8,5.5-,5.5-8.8,7.5-9,accrescent,acuminate,acute,adaxiall,ag,along,angled,anthesi,apex,apparently,appressed,around,articulated,ascending,attenuate,axe,axillary,bark,base,becoming,berry,blade,blunt-tipped,branch,broadly,bud,calyx,capitat,chartaceous,closely,completely,constricted,covering,cylindrical,densely,directed,distally,distributed,eaf,echinoi,echinoid,echinoid-pubescent,edge,eed,elongated,entire,enveloping,especially,evident,exserted,farinose,flared,fleshy,free,fruiting,glabrescen,glabrous,granular-tomentose,greenish-brown,grooved,hair,inserted,lanceolate,lateral,lengthening,line,lined,lobe,lobed,long,long-stalke,long-stalked,longer,longitudinal,longitudinally,lower,m.,main,margin,matur,midrib,midvein,minute,multangulate,multangulate-pubescent,nearly,nflorescence,obtuse,occasional,occuring,older,opening,openly,orolla,ovate,ovate-lanceolat,perfect,plurifoliate,pore,poricidal,porrect-stellate,present,pubescence,pubescent,rather,ray,ridged,robust,ruit,runk,sessile,short-stalked,side,slightly,slit,sometimes,somewhat,soon,spaced,sparsely,stalk,stalked,stamen,stem,strongly,subcampanulate,subcoriaceous,subglabrous,suture,tall,tamen,tangled,terete,thick,thin,tip,tomentum,touching,tube,ud,unarme,unarmed,unit,upper,vary,vein,way,whitish,wide,ympodial,young	5.5-9,70-160,abaxial,adaxial,arrangement,capitate,colour,form,growth,height,history,inflorescence,life,mature,na,number,ovary,perennial,plant,position,reproduction,seed,shape,spacing,staman,surface,texture
123	wfo-0001026686	success	196	79	54	142	25	0.276	0.6-0.9,1-10,1-2,1.5-7,10-28,2.4-3.6,3-4,5-8,6.5-12.7,7-9,8-14,abaxially,adaxially,anther,apex,articulated,berry,chartaceous,cm,conical,corolla,densely,diameter,filament,flower,forked,fruit,glabrous,green,greenish,herb,leaf,light,long,minutely,mm,mucilaginous,odd-pinnate,ovoid,pedicel,peduncle,petiole,plant,puberulent,pubescent,purple-violet,rotate-stellate,seed,sparsely,stigma,style,terminal,whitish,yellow	.4,0.2-0.5,1,1-2.5,1.2-3.4,1.2-3.6,1.7-2.5,2-10,2-9,2.5-8,3-5,3.7-8,4-6,5,5-16.5,5-merou,8-10,8-27,absent,acumen,acuminate,ag,along,alyx,apart,apparently,axe,axillary,base,blade,borne,brownish,bud,capitat,cell,ciliate,condition,connivent,covering,decreasing,digestion,distal,dorsally,drying,eaf,edge,eed,elliptic-lanceolate,end,enzyme,equal,erec,especially,exceeding,flat,folded,fresh,geminat,generally,glabrou,gradually,green-white,hair,hair-like,half,homostylous,honeycomb-shaped,interjected,lanceolate,larger,lateral,leaflet,lengthening,like,living,lobe,lower,make,margin,middle,midrib,minute,mottled,nflorescence,obtuse,often,orbicular,orolla,ovate,pair,perfect,petiolule,plurifoliate,pore,poricidal,pubescen,purple,removed,ripe,round,ruit,secondary,semierect,seudostipule,singly,size,slightly,slit,spaced,specimen,stamen,star,ste,stolo,straight,stripe,subequal,subsessile,subtending,symmetrical,tall,tamen,tem,testal,thick,throughout,tip,toward,tri-,tube,tuber,typically,unit,usually,vary,wall,wet,white,wide,wing,x,ympodial	abaxial,adaxial,arrangement,capitate,colour,form,growth,height,history,inflorescence,length,life,na,number,ovary,perennial,position,rachi,reproduction,shape,spacing,staman,surface,texture,width
124	wfo-0001026695	success	128	69	41	87	28	0.32	0.6-8,1-4,1.6,11-14,2,2.5-5.2,4,6-7,6-8,apex,branched,cm,corolla,cyme,diameter,dichasial,dichasially,distal,ebracteate,filament,flower,glabrescent,half,herbaceous,leaf,mm,monochasial,odd-pinnate,ovate,ovate-lanceolate,pedicel,peduncle,perennial,petiole,plant,pubescent,simple,stellate,stigma,style,yellow	1-1.5,1-2,2-3,2-6,2.5-3,2.5-7,3-4,3-6-foliat,3-8,4-5,4-5.5,6-12,6.5-13,8-16,8-17.5,abaxially,absen,acumen,acuminate,acute,adaxially,apical,apically,articulate,base,calyx,compound,connate,cordate,cuneate,decurrent,dehiscent,dorsally,eaf,edge,eed,exceeding,flat,folded,forked,generally,globo,interjected,introrse,lateral,leaflet,lobe,lon,long,lower,lunat,maturing,nflorescence,nther,oblique,often,one,orolla,pair,perfect,plan,poricidally,proximal,rounded,ruit,sessile,seudostipule,short,short-acuminate,slit,stamen,straight,tal,tem,terminal,triangular,tuber-bearing,typically,unit,unknow,unknown,vary,whit,wide,without,ympodial,¼	abaxial,adaxial,anther,arrangement,colour,form,fruit,globose,growth,height,history,inflorescence,length,life,na,number,ovary,position,rachi,reproduction,seed,shape,spacing,staman,surface,texture,white,width
125	wfo-0001026696	success	139	79	52	87	27	0.374	0.3-4.5,0.8-7,1,1-4,1.3-2.1,3-17,3-3.5,5-35,9,apex,articulate,branched,broadly,cm,corolla,cyme,densely,diameter,dichasial,dichasially,distal,ebracteate,filament,flower,globose,green,green-white,half,herbaceous,lanceolate,light,linear,mm,monochasial,odd-pinnate,ovate,ovoid,pedicel,peduncle,perennial,petiole,plant,proximal,pubescent,seed,stellate,stigma,style,throughout,white-cream,yellow,¼	0.9-7.2,1-1.3,1.5-3,2-17,2-3,3-6,3-6-foliat,3-8.5,4-16,abaxially,acumen,acute,adaxially,apical,apically,apiculate,base,calyx,cell,connate,covering,cuneate,decurrent,dehiscent,digestion,dorsally,eaf,edge,eed,emoval,entire,enzyme,exceeding,flat,folded,forked,generally,globo,hair-like,honeycomb,introrse,lateral,light-yello,living,lobe,lon,long,lower,lunat,make,margin,maturing,mucilaginous,nflorescence,nther,oblong,obtuse,often,orolla,pattern,perfect,plan,poricidally,reveal,rounded,ruit,seudostipule,short,simple,sinuate,slit,specimen,stamen,straight,tal,tem,testal,thick,throughou,tuber-bearing,typically,unit,vary,wall,wide,without,ympodial	abaxial,adaxial,anther,arrangement,colour,form,fruit,growth,height,history,inflorescence,leaf,length,life,light-yellow,na,number,ovary,position,rachi,reproduction,shape,spacing,staman,surface,texture,width
126	wfo-0001026706	success	232	93	67	165	26	0.289	0.6-2.2,0.8-2.8,0.9-2,1-2.2,1-5,1.5-3,3-4.6,4,4.5-5.5,5.3-6.4,7-16,abaxially,acute,adaxially,anther,apart,apex,articulated,attenuate,base,branched,chartaceous,cm,corolla,dark,diameter,filament,flower,fruit,glabrate,globose,golden,green,leaf,length,many,mm,ovate,ovate-elliptic,ovate-lanceolate,pedicel,peduncle,petiole,pseudo-terminal,pubescent,rachi,reticulate-punctate,shrub,simple,small,sparsely,stellate,stigma,style,subconical,subglobose,suborbicular,surface,tall,time,tomentose-pubescent,tree,velutinous,white,whitish,yellow,yellowish-tan	-3.1,-4.4,-5.5,-6.1,.5,/14-1/6,0-240,0.2-0.3,0.2-0.5,0.8-1.2,0.8-1.5,0.9-1.9,1.1-4,1/2-2/3,10-15,12,14-32,2.2-3.3,2.3-3.8,2.5-3,2.7-4,2.9-6,2/3-3/4,3.1-3.8,3.6-5.7,4.2-12,5-6.5,6-10,6-8,6.1-,8-14,9.8-15.4,accrescent,adaxiall,ag,anthesi,apparently,appearing,around,axe,axillary,ba,bark,becoming,berry,blade,blunt-tipped,branch,brown,bud,calyx,capitat,closely,completely,coriaceous,covering,crisped,cuneate,cylindrical,dendritic-echinoid,dendritic-multangulate,densely,directed,distally,eaf,edge,eed,entire,enveloping,exserted,farinose,fleshy,fourth,free,fruiting,furfuraceou,glabrous,grayish,hair,herbarium,indument,inserted,lackin,lacking,lanceolate,lateral,lengthening,lobe,lobed,long,long-stalked,longitudinal,lower,m.,main,margin,matted,midrib,minute,mixed,multangulat,multangulate,nearly,nflorescence,oblong,obscured,obtuse,occasionally,often,older,orolla,pale,perfect,persistent,plurifoliate,pore,poricidal,porrect-stellate,pubescence,rather,reddish,ruit,runk,semi-ovate,sessile,short-,short-stalked,side,slightly,slit,softly,somewhat,soon,spaced,specimen,splitting,stalked,stamen,stem,strongly,subcampanulate,sulcate,suture,tamen,thin-walled,tip,tomentu,touching,translucent,transparent,tube,ud,unarme,unarmed,unevenly,unit,upper,vary,vein,wavy,way,wide,x,ympodial,young	6.1-15.4,80-240,abaxial,adaxial,arrangement,capitate,colour,form,growth,height,history,inflorescence,life,na,number,ovary,perennial,plant,position,reproduction,seed,shape,spacing,staman,texture,width
127	wfo-0001026707	success	196	84	59	137	25	0.301	.5,/3,0.5-1,0.6-0.7,0.7-1.4,1-5,1.6-2,3-4,3-4.5,3-8,4,5-merous,8-15,?,abaxially,acute,anther,apart,apex,articulated,base,berry,branched,clustered,cm,densely,diameter,erect,filament,flattened-reniform,flower,fruit,glabrous,green,leaf,length,lobed,long,mauve,mm,moderately,narrow-oblong,orange-brown,pedicel,peduncle,petiole,rounded,shrub,small,sometimes,spherical,stellate-pubescent,style,surface,tip,tree,way,white,yellow-green	-1/3,-3,-5,.8,0,0-20,0.05,0.05-0.15,0.1-0.2,0.3-0.8,0.5-3,0.6-0.8,0.7-1,0.7-1.5,1-1.7,1-3,1.5-1.8,1/3,1/3-1/2,1/3-3/4,1/4-1/3,1/8-1/4,11-16,2-10,2-2.3,2-6,2.5-3,2.5-4,2.5-6,3-7,5-10,5-25,5-7,5-8,alyx,apar,apically,apparently,attenuate,bark,blade,branche,broad-deltate,broadly,calyx,chartaceous,color,concolorous,connivent,curved,cuspidat,decurrent,discolorous,drying,eaf,eed,elongating,entire,equal,eye,foliaceous,free,fruiting,fused,gently,glabrescent,glabrou,gray,inflated,infructescence,juvenil,known,lateral,less,lobe,longer,lower,margin,mature,midpoint,naked,narrow-deltate,nflorescence,obtuse,older,one,open,orolla,oung,per,perfec,pericarp,plurifoliat,poricidal,porrect,porrect-lepidote,portion,prickle,prickly,pubescent,ray,red-brown,reflexed,ruit,scar,sessile,shorter,simple,slender,smooth,spaced,sparsely,spreading,stalk,stalked,stellate,stem,stout,straight,tamen,tapering,terete,terminal,time,trichome,tube,unarmed,unit,upper,variously,vary,venation,visible,weakly,wide,ympodial,¼	abaxial,adaxial,arrangement,branch,colour,corolla,form,growth,height,hermaphroditic,history,inflorescence,life,na,number,ovary,perennial,plant,reproduction,seed,shape,spacing,staman,stigma,texture
128	wfo-0001026711	success	210	96	78	132	18	0.371	.8,0-6,0.3-1,0.5-1.5,0.7-1.4,0.75-1,1.5-2.2,1/2-2/3,1/3,2-3.5,2-6,3.5-5.2,5-merous,abaxially,acute,anther,apart,apex,articulated,base,berry,branched,cell,cm,connivent,curved,densely,diameter,dull,erect,evenly,filament,flattened-reniform,flower,fruit,glabrous,green,leaf,length,lobed,long,lower,maturity,mauve,mm,obtuse,occasionally,orange,orange-brown,outline,pedicel,peduncle,petiole,pit,poricidal,prickly,purple,raised,red,shrub,slender,small,smooth,spherical,stellate,stellate-pubescent,style,surface,tapering,tip,unarmed,uniform,upper,way,weakly,yellow,yellow-green,young	-15,-2,-5,-6,-7,.2,.5,0,0-0.2,0-25,0-4,0.1,0.15,0.2-0.3,0.7-,0.7-0.9,0.8,0.8-2.2,0.9-1.1,0.9-1.5,1-,1-2,1-30,1.5-,1.7-4,1/,1/4,1/4-1/3,2-2.2,2-2.5,2-4,2.1-2.5,3-4,3-4.5,3-5,3-7,4-8,4.5-7,7-8,acicular,acuminat,alyx,ame,apar,apically,apparently,bark,blade,brow,c.,calyx,concolorous,cuneate,deltate,difoliate,discolorous,distance,drying,eaf,eed,elliptic,elongating,equal,extending,faint,free,fruiting,geminat,infructescence,lateral,less,lobe,longer,margin,mature,midpoint,midvein,moderately,narrow-deltate,nflorescence,older,one,open,orolla,oung,pair,pale,pendulous,per,perfec,pericarp,perpendicular,porrect,portion,prickl,prickle,primary,ray,reduced,reflexed,rounded,ruit,scar,sessile,shallowly,shorter,side,sometimes,somewhat,spaced,spreading,stalk,stalked,stem,straight,tamen,terete,terminal,tertiary,thick-chartaceous,time,trichome,tube,unit,variously,vary,vein,venation,visible,wide,woody,ympodial	abaxial,adaxial,colour,corolla,form,growth,height,inflorescence,number,ovary,plant,reproduction,seed,shape,spacing,staman,stigma,texture
129	wfo-0001026717	success	207	89	64	143	25	0.309	0.6-1.5,1-10,1-2,13-28,15-34,2.5-4.5,2.5-5.5,3-6,3.3-11,5-11,5-13.5,abaxially,acuminate,adaxially,anther,apex,cell,chartaceous,cm,conical,corolla,covering,dark,diameter,elliptic,filament,flower,forked,fruit,glabrous,green,greenish,hair-like,herb,lanceolate,lateral,leaf,light,medium,membranous,minutely,mm,odd-pinnate,ovoid,pedicel,peduncle,pentagonal,petiole,plant,puberulent,pubescent,purple,rotate,seed,sparsely,stigma,style,terminal,testal,thick,violet,wall,whitish,yellow	0.3-0.6,0.3-2.5,0.3-5,0.8,1-2.5,1-3,1.3-2.5,1.4-2.2,1.8-3,14-22,2.2-5,3-4,3-5,4-6,4-8,4-9,5,5-6,5-merou,5.3-9,7-11,acumen,ag,along,alyx,apart,apparently,articulated,attenuate,axe,axillary,base,berry,blade,borne,brownish,bud,capitat,ciliate,condition,connivent,darker,decreasing,decurrent,digestion,distal,dorsally,drying,eaf,edge,eed,end,enzyme,equal,erec,especially,exceeding,flat,folded,fresh,geminat,generally,glabrou,gradually,green-white,hair,half,homostylous,honeycomb-shaped,interjected,larger,leaflet,lengthening,like,living,lobe,long,lower,make,margin,middle,midrib,minute,mottled,mucilaginous,narrow,nflorescence,obtuse,often,one-quarte,orbicular,orolla,ovate,pair,perfect,petiolule,plurifoliate,pore,poricidal,present,pubescen,removed,ripe,round,ruit,secondary,semierect,sessile,seudostipule,singly,size,slightly,slit,spaced,specimen,stamen,ste,stolo,straight,stripe,subequal,subglabrous,subsessile,subtending,symmetrical,tall,tamen,tem,throughout,tip,toward,tri-,tube,tuber,typically,unit,usually,vary,wet,wide,wing,x,ympodial	abaxial,adaxial,arrangement,capitate,colour,form,growth,height,history,inflorescence,length,life,na,number,ovary,perennial,position,rachi,reproduction,shape,spacing,staman,surface,texture,width
130	wfo-0001026725	success	166	76	48	118	28	0.289	.3,.5,0.7-1.2,1-1.2,1-4.5,1-5,1.5,1.6-2,anther,apart,apex,beneath,broadly,capitate,cm,corolla,cup-shaped,elliptic,filament,flattened-reniform,fruit,glabrous,globose,green,greenish-white,leaf,lobed,minutely,mm,opposite,ovary,ovate,pedicel,petiole,pitted,planar,pubescent,reddish-brown,reflexed,shrub,simple,slightly,stigma,style,surface,tapering,white,x	/4,0.2,1-1.5,1.2-1.7,1.5-2,1/2,2,2.2-4,3.5-4,3.6-7.7,5-20-flowered,5-5.5,5-6,8-18.6,8-9,accrescent,acute,anthesi,attenuate,axil,bark,base,becoming,berry,black,bluish,brownish-papillose,calyx,character,crackin,dark,deflexed,dia,differing,difoliate,dry,drying,eaf,edicel,eed,ellipsoid,evenly,extremely,free,fruiting,geminat,geographically,glandular-papillose,incrassate,inflorescenc,interpetalar,large,lateral,less,lobe,lon,long,lower,main,major,margin,margine,material,middle,minor,nflorescence,occasionally,often,older,one,onto,open,ovoid,pair,pale,paler,papillo,papillose,pore,poricidal,portion,prominent,proximal,rounded,ruit,scar,scarious,shaped,short,sinus,size,slender,spaced,split,stem,straight,stretching,subshrub,tall,tan,tear-drop,tip,triangular,trichome,tube,tuft,ud,uniseriate,unit,upper,varying,vein,way,widest,winged,woody,ympodial,young	5-20,abaxial,adaxial,arrangement,colour,diameter,flower,form,growth,height,history,inflorescence,length,life,na,number,peduncle,perennial,plant,position,rachi,reproduction,seed,shape,spacing,staman,texture,width
131	wfo-0001026733	success	188	92	61	127	31	0.324	-11,-13,-7,0.5-2,0.5-4,1-7,1.5-14,10-20,2-2.5,2-6,3-7,4-5,5-8,apex,chartaceous,cm,densely,diameter,eglandular-pilose,eglandular-villous,ellipsoidal,elliptic-ovate,flattened,flower,forked,fruit,fusiform,glabrate,glabrous,glandular-,glandular-puberulent,glandular-tomentose,green,greyish,immature,longitudinal,membranaceous,mm,moderately,ovate,pedicel,peduncle,perfect,petiole,pilose,pubescent-pilose,rachi,simple,stellate,stigma,stripe,style,submarginally,tree,truncate,unbranched,villous,white,white-puberulent,yellow,yellowish	-1,-14,-15,-2,-4,-8,.5-3,0.3-0.5,0.3-2,0.5,0.5-1,1,1-1.5,1-2,1-3,1.5-2,1.5-2.5,15-,2-3,2-4,2.5-7.5,20-50,25-40,3-15,3-3.5,3-4-foliat,4,4-23,4.5-5,7-10,8-12,abaxially,acuminate,acute,acute-acuminate,adaxially,aggregate,apart,ape,articulated,axe,basal,base,beyond,blade,calyx,capitat,cell,ciliat,color,connective,connivent,cordate,curled,cylindrical,deltate,dense,dia,directed,distally,eaf,eed,eglandular-pubescent,entire,equal,especially,exceeding,exserted,gland-tipped,glandula,hair,hirsute,lanceolate,leaving,linear-triangular,lobe,lon,long,lower,margin,midrib,narrowly,near,nflorescence,nther,oblique,orolla,ovoid,ovum,pedicellar,pore,present,pubescent,pubescent-pilo,radiu,remnant,ripe,round,ruit,shining,shorter,slightly,small,smooth,sometimes,spaced,sparsely,stamen,stone,swelling,tal,tem,thecae,time,toward,triangular,tube,ud,unit,unknow,unknown,usually,vary,vein,wide,x,ympodial	15-50,abaxial,adaxial,anther,arrangement,capitate,colour,corolla,filament,form,growth,height,history,inflorescence,leaf,length,life,na,number,ovary,perennial,plant,position,reproduction,seed,shape,spacing,staman,surface,texture,width
132	wfo-0001026734	success	266	102	77	189	25	0.289	0.5,1,3,abaxial,abaxially,absent,acuminate,adaxial,anther,apex,barely,base,becoming,berry,broadly,brown,chartaceous,clavate,closely,cm,congested,corolla,cylindrical,cyme,dark,densely,diameter,distally,drying,elliptic,flattened,flower,fruit,glabrous,globose,green,growth,immature,internodal,irregular,lateral,leaf,length,lobed,long-attenuate,maturity,membranaceous,mm,moderately,ovary,pale,pedicel,peduncle,petiole,pit,pubescent,purple,purplish,rachi,reniform,shape,shiny,shrub,simple,slightly,spaced,sparsely,stellate,stigma,style,subopposite,surface,unbranched,visible,white,yellow,¾	0.1,0.2,0.3,0.6,0.7–0.9,0.7–1,0.8–1,1.6–2,1.6–2.5,1.8–2.2,1.8–3,1/4,1–1.2,1–3,2.2–7,2.3–5,2.5–3,2–2.4,2–3,3.2–3.8,3–4,3–4-celled,3–8,4–6,4–7,4–8,4–9,5-merou,5–9,8,accrescent,acute,adaxiall,adaxially,ag,also,always,alyx,anthesi,apical,apice,archin,ark,articulated,associated,asymmetric,axi,beneat,beneath,blade,branch,branched,bright,caly,calyx,camptodromous,capitate,celled,central,commonly,connivent,covered,covering,cuneate,dense,denser,differing,directed,discolorous,downward,dried,due,eaf,eed,eglandular,emergent,entire,erect,f.,fewer,flat,foliate,forked,found,free,frequently,geminate,glabrescen,glabrescent,glandular,gray,hair,held,ilament,initially,introrsely,j,lamina,lanceolate,large,less,lobe,long,longer,longitudinal,lower,lying,margin,material,mature,maturit,midpoint,midri,minute,mostly,much,multiseriate,narrow,near,new,nflorescence,normally,oblong,obovate,observed,obtuse,often,old,older,one,one-celled,opening,orolla,other,oung,ovate,pair,paired,papillose,perfect,plane,pointing,pore,poricidal,porrect,porrect-stellate,portion,pubescence,raised,rarely,ray,rayed,reaching,rounded,ruit,scandent,secondary,sessile,short-stalked,shorter,size,slit,smaller,sometimes,sparse,spread,spreading,stalk,stem,still,subsessile,surfac,terminal,trichome,tube,tuft,ud,unequal,uniseriate,unit,upward,vary,vein,venation,vestiture,whole,wide,yellowish,ympodial	0.8-1,1.6-2,1.8-3,2.3-5,3-8,5-9,5-merous,arrangement,colour,filament,form,height,history,inflorescence,life,na,number,perennial,plant,position,reproduction,seed,spacing,staman,texture
133	wfo-0001026739	success	197	90	65	132	25	0.33	0.25-0.94,1-10,1-2,10-60,16-54,2.5-13.5,2.6-4.8,3.2-17.5,4-8,6-13,abaxially,adaxially,anther,apex,brownish,cell,clavate,cm,coriaceous,corolla,covering,dark,densely,diameter,drying,filament,flower,forked,fruit,glabrous,globose,green,greenish,hair-like,herb,lateral,leaf,light,mm,oblanceolate,odd-pinnate,ovate,ovoid,pedicel,peduncle,pentagonal,petiole,plant,pubescent,purple,rotate,seed,sometimes,stigma,stripe,style,sub-glabrous,terminal,testal,thick,wall,white,whitish,yellow,yellowish	0-0.34,0-38,0.4-5,0.5-1.2,1-3,1.2-2.1,1.4-3.5,2-4,2-5.3,2-6,2-9,2.7-6.9,3-4,3.8-8.5,5-merou,5.6-13.1,6.6-18,7-9,abaxiall,acumen,acuminate,acute,ag,along,alyx,apart,apparently,arranged,articulated,asymmetric,attenuate,axe,axillary,base,basiscopic,bead,berry,blade,brown,bud,capitat,condition,connivent,decreasing,digestion,distal,dorsally,eaf,edge,eed,enzyme,erec,exceeding,flat,folded,fresh,geminat,generally,glabrou,green-white,hair,hal,half,high,homostylous,honeycomb-shaped,interjected,lanceolate,larger,leaflet,lengthening,like,linear,living,lobe,long,lower,make,margin,moniliform,mucilaginous,multiple,necklace,nflorescence,orbicular,orolla,pair,perfect,petal,plurifoliate,pore,poricidal,removed,rest,ripe,rounded,ruit,sessile,seudostipule,short,side,simple,size,slit,spaced,specimen,stamen,stem,stolon,straight,subequal,subtending,tall,tamen,tem,throughout,tip,tissue,toward,tri-,tube,tuber,typically,unit,usually,vary,wet,wide,wing,winged,x,ympodial	abaxial,adaxial,arrangement,capitate,colour,form,growth,height,history,inflorescence,length,life,na,number,ovary,perennial,position,rachi,reproduction,shape,spacing,staman,surface,texture,width
134	wfo-0001026740	success	171	83	54	117	29	0.316	1-10,1-12,1-5,10-20,10-30,2-3,2.5-27,2.5-6,3-15,5-8,6-10,acuminate,acute,apex,branched,cm,curled,densely,diameter,eglandular,ellipsoidal,elliptic,flattened,flower,fruit,glabrous,greenish,hair,mm,moderately,ovate,pedicel,peduncle,perfect,petiole,pilose,puberulent,pubescent,purple,rachi,reticulate,simple,sparsely,stellate,stigma,style,tomentose,tree,truncate,unbranched,violet,white-puberulent,whitish,yellow	-17,-2,0-10,0.5-1,1-2,1-3,1-4,2-4,2.5-3,2.5-4.5,20-50,3-3.5,3-5,3-foliat,3.5-40,4-5,4.5-10,5-40,8-19,abaxially,absen,absent,acute-acuminate,adaxially,aggregate,also,apart,ape,apiculate,articulated,axe,basal,base,beyond,blade,browni,calyx,cell,ciliate,connective,connivent,cordate,corky,cylindrical,darker,deltate,directed,distally,eaf,eed,entire,equal,especially,exceeding,exserted,fleshy,glabrate,glandular-puberulent,immature,lanceolate,leaving,lobe,lon,long,lower,margin,mature,narrowly,near,nearly,nflorescence,nther,oblong,obtuse,often,orange,orolla,ovoid,pedicellar,pilo,pore,present,radiu,rarely,remnant,ruit,scar,sessile,shorter,slightly,small,sometimes,spaced,stamen,stone,stripe,subcoriaceous,swelling,tal,tems,thecae,time,toward,triangular,truncat,tube,ud,unit,unlobed,vary,vein,villous,wide,woody,x,ympodial,young	abaxial,adaxial,anther,arrangement,colour,corolla,filament,form,growth,height,history,inflorescence,leaf,length,life,na,number,ovary,perennial,plant,position,reproduction,seed,shape,spacing,staman,surface,texture,width
135	wfo-0001026752	success	169	99	69	100	30	0.408	-25,-50,1-12,1-5,1-6,1.5-12,10-20,15-35,2-2.5,3-18,3-4,4-5,abaxially,adaxially,also,apart,apex,articulated,base,black,branched,campanulate,cm,coriaceous,darker,densely,diameter,ellipsoidal,elliptic-oblong,elliptic-ovate,flattened,fleshy,flower,forked,fruit,glabrous,globose,green,greenish-brown,immature,mm,moderately,near,nearly,papillose,pedicel,peduncle,petiole,pilose,possibly,pubescent,pubescent-pilose,purplish,rachi,rarely,ripe,simple,stellate,stigma,stripe,style,tree,truncate,unbranched,vein,violet,white,whitish,yellow	-3,-4,0-,1,1-1.5,1-2,1-3,1.5-2,1.5-2.5,2,2-3,2-4,2.5-20,2.5-5,20-30,3,3-5,3-foliat,3.5-4,4-45,7-15,8-16,abruptly,absent,acute,aggregate,ape,apiculate,axe,basal,beyond,blade,calyx,capitat,cell,chartaceous,connective,connivent,cordate,cuneate,cylindrical,deltate,dilated,directed,distally,eaf,eed,entire,equal,exceeding,exserted,finely,hair,lanceolate,laterally,leaving,less,lobe,lon,long,lower,margin,narrowly,nflorescence,nther,obtuse,orolla,ovoid,pedicellar,perfect,pilo,pore,presence,present,radiu,rather,remnant,ruit,short-acuminate,slightly,small,somewhat,spaced,stamen,stone,tal,tem,thecae,time,tomento,triangular,tube,ud,unit,unknow,vary,wide,x,yello,ympodial	abaxial,adaxial,anther,arrangement,capitate,colour,corolla,filament,form,growth,height,history,inflorescence,leaf,length,life,na,number,ovary,perennial,plant,position,reproduction,seed,shape,spacing,staman,surface,texture,width
136	wfo-0001026754	success	176	92	67	109	25	0.381	-6+,0.5-1,0.9-1.1,1.5-3,1/2,10,2,2-2.5,2/3,30+,5,5-lobed,9,abaxially,acute,along,anther,anthesi,apex,base,berry,clavate,cm,corolla,deeply,dendritic,densely,diameter,elliptic,filament,flower,globose,growth,inflorescence,irregularly,lamina,later,lateral,leaf,lobed,membranous,minute,minutely,mm,narrowly,pedicel,peduncle,petiole,pubescent,simple,slender,spaced,sparsely,spreading,stellate-rotate,stigma,style,surface,terminal,trichome,vein,vine,way,white,woody,x,yellow	.5,0.5,1,1-,198.,2-3,2-4,2.5-3.5,3-4-celled,4-5,5-merou,5.5-9,7-9,9-11,adaxially,ag,alyx,apar,apparently,ark,articulated,asymmetric,axi,basal,branched,broadly,brow,cabrera,calyx,complete,conical,connivent,cucullat,denser,distal,divided,eaf,ed,ellipsoid,entire,especially,exerted,extending,fide,free,glabrous,half,halfway,ilament,leaving,lengthening,like,lobe,long,loosely,lower,many,margin,mature,midvein,mixture,mostly,new,nflorescence,oblique,older,orolla,outline,pair,papillo,peg,perfect,pinnate,planar,plurifoliat,pore,poricidal,portion,primary,puberulent,ruit,scandent,scar,seen,sleeve,slit,small,sometimes,splitting,stem,tangled,tem,time,tip,transparent,truncate,tub,tube,twinin,twining,ud,uniseriate,unit,upper,vary,weak,within,yellowish,ympodial	5-merous,abaxial,adaxial,apart,arrangement,colour,form,fruit,height,history,length,life,na,number,ovary,plant,position,rachi,reproduction,seed,shape,spacing,staman,texture,width
137	wfo-0001026756	success	147	78	52	95	26	0.354	.25,0-7-1.2,0.5-3,1.5-10,1.5-2,1.8-3,3-4,5-10,abaxial,anther,apex,base,bilobed,brown,closely,cm,corolla,dark,densely,difoliate,elliptic,filament,glabrous,globose,green,hard,leaf,lobed,minutely,mm,nearly,opposite,ovary,ovate,ovoid-reniform,pedicel,petiole,pinkish-white,pitted,pubescent,shape,shrub,simple,spaced,sparsely,stigma,style,surface,tree,unifoliate,white,woody	.5,0.25-0.5,0.5-1,1-1.5,1-2,1.5-1.7,1.5-3,3.5-8.5,5-10-flowered,5-5.5,6-10,6-16,abaxially,acute,adaxially,along,anthesi,apiculate,attenuate,ba,bark,berry,broadly,calyx,conical,corresponding,deflexed,deltate,dendritic,denser,dia,differing,distal,eaf,edicel,eed,erect,exserted,fleshy,free,fruiting,geminat,glabrescent,grayish-brow,inflorescenc,irregular,lamina,lateral,lax,like,lobe,long,lower,main,major,middle,minor,nflorescence,occasionally,older,overlappin,pair,pale,papillo,perhaps,pericarp,planar,pore,poricidal,portion,present,pubescence,rest,ruit,scar,shaped,somewhat,soon,stem,strongly,tall,tear-drop,thick,tip,trichome,tub,tube,ud,uniseriate,unit,vein,wide,widest,ympodial,young	adaxial,arrangement,colour,diameter,flower,form,fruit,growth,height,history,inflorescence,length,life,na,number,overlapping,peduncle,plant,position,rachi,reproduction,seed,spacing,staman,texture,width
138	wfo-0001026777	success	168	84	57	111	27	0.339	0.25-0.5,0.5-1.5,0.5-5,1-1.3,1-10,1-4,1.2-1.8,3-3.5,5-7,acuminate,acute,anther,apart,apex,base,beneath,blue,brown,capitate,cm,corolla,deflexed,elliptic,fide,filament,filiform,flattened-reniform,flexuous,glabrous,globose,green,growth,leaf,lobed,long,mm,narrowly,nearly,opposite,ovary,pedicel,petiole,pubescent,russet,seed,shiny,shrub,smooth,sparsely,stigma,style,surface,trichome,tuft,uniseriate,vellozo,white	.25,.5,/3,0.5-1,0.9-3,1-1.5,1-2,1.5-3,1.5-5,2-4,2-4.5,2-5,4-8,5-14,5-50-flowered,anthesi,apiculate,axil,ba,beginning,berry,body,branching,calyx,campanulate,cell,cup,decurrent,dense,dia,differing,difoliate,distal,eaf,edicel,eed,end,exserted,flattened,free,fruiting,geminat,glabrate,greyi,hyaline,incrassate,inflorescenc,irregularly,lateral,like,lobe,lon,lower,main,major,margin,matted,middle,minor,minutely,near,new,nflorescence,occasionally,often,older,one,onto,outline,overtopping,pair,papillo,papillose,pitted,planar,pore,poricidal,portion,prominent,quadrate-deltoid,quite,rest,ruit,scar,shaped,sinuate,size,slightly,somewhat,soon,spaced,stem,straight,tall,tapering,tear-drop,testa,thread-like,tip,tube,ud,unit,vein,wall,way,widest,woody,x,yellowish,ympodial,young	5-50,abaxial,adaxial,arrangement,colour,diameter,flower,form,fruit,height,history,inflorescence,length,life,na,number,peduncle,perennial,plant,position,rachi,reproduction,shape,spacing,staman,texture,width
139	wfo-0001026782	success	206	95	68	138	27	0.33	-10,-4,0.5-1,0.5-2,0–1,0–10,1,1-1.5,1.5,10–15,2-5,8-10,abaxially,adaxially,annual,anther,anthesi,apex,blue,bluish,brown,cm,dark,darker,diameter,filament,finely,flower,fruit,glabrous,globose,green,greenish,herb,immature,irregularly,length,light,like,lilac,maturity,mm,mottling,ovate,pedicel,peduncle,petiole,prickle,pubescence,purple,pustulate,rachi,reniform,rotate-campanulate,simple,stellate-tomentose,stem,stigma,style,surface,tomentose,unbranched,white,x,yellow,yellowish-brown,–5,–6	-5,0.5,1.3,1.4–2,1.5–2.5,1.8–3,1/3–1/2,15,1–3,1–5,2,2-foliate,2–4,3,3-4,3.5–8.5,3–12,4,4–10-rayed,4–13,4–6-rayed,4–9,5,6,6-7,7,abundant,abundantly,accrescent,acicular,acute,adaxiall,additional,apiculate,armed,articulate,axe,base,becoming,berr,blade,calyx,clavat,clustered,coarse,commonly,cordate,curved,dehiscent,deltoid,densely,dilated,divided,eaf,eed,enclosing,exceeding,except,fertile,fruiting,geminat,glabrou,gland-tipped,gradually,hair,internode,interpetalar,larger,lobe,lon,long,lower,lowermost,main,male,margin,midpoint,midrib,minute,much,much-branched,narrowly,nearly,nflorescence,numerous,obtuse,often,one,orolla,pair,partially,perfect,pore,porrect-stellate,pubescent,radiu,rarely,ray,ruit,sessile,shallow,short,shorter,slightly,small,smaller,somewhat,sparsely,spreading,stalk,staminate,ste,stellae,stellate,stellate-pubescent,stipitate,straight,strongly,tall,tamen,tapered,tem,terminal,thick-stalked,thin-textured,tip,tissue,tooth,triangular,tube,two,upper,upward,vary,vein,way,woody,ympodia	1-3,1-5,abaxial,adaxial,arrangement,clavate,colour,corolla,form,growth,height,history,inflorescence,leaf,life,na,number,ovary,plant,position,reproduction,seed,shape,spacing,staman,texture,width
140	wfo-0001026788	success	291	96	61	230	35	0.21	10.8,3,3.8,4,6.4,abaxially,adaxially,alveolate,anther,apart,apex,attachment,branching,chartaceous,cm,corolla,densely,diameter,erect,extra-axillary,filament,flattened-orbicular,flattened-reniform,flower,fruit,glabrous,globose,lanceolate,lateral,leaf,mm,moderately,notched,orange,oval,ovate,pedicel,peduncle,petiole,point,pubescent,scandent,shrub,simple,small,spaced,sparsely,stellate,stigma,straight,style,subcoriaceous,surface,time,tree,unbranched,well,white,yellow,yellow-tan,±glabrous	.0,.04,.05,.3,/3,0.2–0.3,0.3–0.4,0.3–0.5,0.4–0.6,0.4–0.7,0.5–0.7,0.5–0.8,0.6–1.0,0.6–1.3,0.6–1.9,0.8–1.1,0.8–1.8,0.9–1.2,0.9–1.3,0.9–2.0,0–,1.0–1.5,1.0–2.0,1.1–1.3,1.2–1.6,1.2–1.7,1.3–1.6,1.3–1.8,1.3–2.5,1.4–2.2,1.5–1.9,1.5–2.2,1.7,1.7–1.9,1/3,1/4–1/3,1–3,2.0,2.1–2.9,2.5–11.0,2.7–5.7,2.8–3.1,2.9–4.0,2/3,2/3s,2–3,3.0,3.4,3.8–4.9,4.0,4.6–6.0,4–7,4–8,5,5-merou,7.0–8.9,7.8–11.0,8,8.3–10.9,8.5,90°,absent,acuminate,acute,adjacent,adnate,aequilateral,ag,alyx,anthesi,apical,apparently,appearing,appressed,around,articulate,attenuate,axe,ba,bark,basal,base,based,becoming,berry,blade,branch,broad,broad-based,broadly,brochidodromous,brown,bud,calyx,capitat,channeled,clinate,connivent,curved,deciduous,deflexed,deltoid,dentate,developed,development,difoliate,directed,distal,distally,distinct,distinctly,dry,eaf,edge,eed,either,emerging,entire,evenly,exocarp,extending,fertile,filiform,flat,flexed,free,geminat,glandular,glossy,gradually,hair,homostylous,hort,increasing,incurved,intact,internode,interpetalar,intersepalar,juic,layer,laying,less,lobe,lobed,lon,long,longer,lower,many,margin,markedly,mature,midpoint,midrib,midvein,minute,nearly,nflorescence,oblique,occasionally,opaque,orolla,per,perforated,pore,porrect,porrect-stellate,portion,potentially,presen,prickle,primary,proximal,raised,ray,reddish,reflexe,remaining,restricted,retrorse,rigid,rounded,row,ruit,scarcely,scattered,sessile,shoot,side,sigmoid,sinuate,sinus,slightly,sloughing,smoot,sometimes,somewhat,soon,splitting,spread,stamen,stellae,stellate-pubescent,stem,suture,swelling,tamen,tem,thin,tissue,transparent,triangular,tube,two,ud,unarmed,upper,vary,vein,weakly,wide,yellow-ferruginou,yellow-ferruginous,ympodia,young,±90°,±dense,±equal,×	0-2.5-11.0,0.6-1.9,1.0-1.5,1.2-1.6,1.7-1.9,3.8-4.9,35,5-merous,7.8-11.0,abaxial,adaxial,arrangement,capitate,colour,form,growth,height,history,inflorescence,length,life,na,number,ovary,perennial,plant,position,rachi,reproduction,seed,shape,spacing,staman,texture,width
141	wfo-0001026790	success	236	91	70	166	21	0.297	-11,-4,0.2-1.5,0.5-4,1-1.5,1.8-4,1/4,1/4-1/2,2-11,2-3,2.5-4.5,4-9,6.5-9,abaxially,acute,andromonoecious,anther,apex,base,berry,branched,brown-green,cm,cream,dark,densely,diameter,dull,elliptic,erect,filament,flattened-reniform,flower,fruit,glabrous,green,lanceolate,lateral,leaf,length,lobed,long,long-styled,marking,maturity,mauve,mm,moderately,orange-brown,ovate,pale,petiole,plant,red-brown,rounded,short-styled,shrub,sometimes,sparsely,spherical,stellate,stellate-pubescent,style,surface,terminal,upper,way,yellow,yellow-green,young	-1/2,-1/3,-10,-19,-2,-3,-40,-6,-merous,0,0-10,0-150,0-20,0-30,0-5,0.2,0.2-0.4,0.2-0.6,0.2-2,0.5-2,0.6-10,0.7-1.5,0.7-3,0.8,1,1-2,1-3,1.5,1.5-2.5,1.5-3,1.5-4,1.5-5,1.9-2.6,1/2-3/,1/5-1/3,1/6-1/4,2,2-,2-30,2-5,2-7,2.7-3.2,3.5-17,4-,4-11,4-7,5,5-10,5-9,6-12,6-8,7-12,7-13,7-15,7-20,acuminat,adaxially,alyx,ame,apar,apart,apically,apparently,articulated,bark,becoming,blade,broad-deltate,c.,calyx,chartaceous,concolorous,conical,connivent,cordate,curved,deltate,discolorous,distance,drying,eaf,eed,elongated,elongating,entire,equal,extending,flattened,free,fruiting,gently,glandular,green-brown,hair,heterostylous,inflorescenc,infructescence,lobe,longer,lower,margin,mature,midpoint,midvein,minute,narrow-deltate,near,nflorescence,obtuse,older,one,open,orolla,oung,pair,pedicel,peduncle,pendulous,per,pericarp,plurifoliat,poricidal,porrect,portion,prickle,prickly,primary,ray,red-brow,reduced,reflexed,ruit,scar,sessile,side,simple,smooth,spaced,spreading,stalk,stalked,stem,stout,straight,tamen,tapering,terete,tertiary,time,tip,toward,trichome,tube,unarme,unarmed,unit,usually,variously,vary,vein,venation,visible,weakly,wide,woody,ympodial	abaxial,adaxial,arrangement,colour,corolla,form,growth,height,history,inflorescence,life,na,ovary,perennial,plurifoliate,position,reproduction,seed,shape,staman,texture
142	wfo-0001026818	success	252	100	78	174	22	0.31	-15,-3,0-1,0-1.5,0.5-1,0.5-2.5,0.7-2,1.8-3.5,2.5-4,5-15,5-20,6.5-9.5,7-15,8-11,abaxially,adaxially,anther,apart,base,branched,broadly,closely,cm,densely,diameter,elliptic,elliptic-ovate,erect,extra-axillary,felty-pubescent,filament,flower,fruit,glabrous,globose,hair,inflorescence,leaf-opposed,length,lenticular,like,minutely,mm,orange,orange-red,outline,pedicel,peduncle,perennial,perfect,petiole,pitted,prickle,pubescent,rachi,reniform-ovate,ripe,sessile,simple,spaced,spreading-hirsute,spreadingly,stalked,stellae,stellate,stellate-pubescent,stem,stigma,style,surface,tan,thickened,thin-textured,truncate,unbranched,white,x,yellow	-1.5,-2,-2.5,-4.5,-7,0.1-0.3,0.3-0.8,0.3-1,0.3-2.5,0.5-1.5,1,1-4,1.5-,1/3,2,2-15,2-3,2-4,2-4.5,2-foliate,2.5-5,2.7-4,3-5,4-10,4-6,4-7,5-11,5-12,5-9,6-10,7-30,7-50,8-15,abrupt,abundant,accrescent,acute,acute-,adaxiall,along,always,apex,apparent,articulated,ascending,attenuate,average,axe,ba,becoming,blade,broad-based,calyx,campanulate,capitat,capitate-glandular,cast,cauline,class,coarsely,commonly,compresse,connivent,cordate,covering,cream,cylindrical,deltoid,density,dentate,depressed-deltoid,directed,distal,distall,distinct,eaf,eed,elongate,entire,equaling,especially,essentially,female-sterile,foliar,frui,fruiting,geminate,grading,inserted,interlobal,lanceolate,large-leaved,larger,largest,lateral,laterally,less,lignescent,lobe,long,longest,lower,major,margin,maturit,mesocarp,middle,midpoint,midrib,mixture,mostly,multiseriate,nearly,nflorescence,numerous,oblique,obtuse,obtuse-,occasionally,often,one,orolla,oung,ovate,ovate-lanceolate,per,persistent,pore,prickly,principal,prominent,pubescence,purplish,radiu,ray,round-tipped,ruit,scattered,shallowly,short,shorter,side,similar,sinus,size,smaller,sometimes,somewhat,sparse,sparsely,spreading,stalk,ste,stipitate,tal,tamen,termination,time,tooth-like,transition,trichome,tube,two,unarmed,unit,usually,variable,vary,vein,vivo,weakly,wide,yellowish,ympodial	abaxial,arrangement,capitate,colour,corolla,form,growth,height,history,leaf,life,na,number,ovary,plant,position,reproduction,seed,shape,spacing,staman,texture
143	wfo-0001026819	success	218	129	104	114	25	0.477	0.5-1.5,1-10,1-2,1.5-10,2.5-5,3-120,3-18,3-20,4,4-7,5-30,6-11,abaxially,adaxially,along,anther,apex,articulated,blue,broadly,brownish,capitate,cell,chartaceous,ciliate,cm,condition,corolla,covering,dark,densely,diameter,distal,dot,drying,elliptic,especially,filament,flower,forked,fresh,fruit,glabrous,glaucous,globose,green,green-white,greenish,greenish-yellow,hair,hair-like,herb,lanceolate,lateral,light,like,make,margin,membranous,middle,midvein,minutely,mm,moderately,mucilaginous,narrowly,odd-pinnate,ovate,ovoid,pedicel,peduncle,pentagonal,petiole,plant,puberulent,pubescent,purple,rachi,rotate-pentagonal,scattered,seed,slightly,sometimes,somewhat,star,stem,stigma,stripe,style,subglabrous,terminal,testal,thick,throughout,tinged,tip,usually,violet,wall,wet,white,whitish,within,yellow	0-27,0.3-4.7,1-2.3,1-5,1.2-36,1.5-12,1.5-3.0,1.5-3.3,1.5-3.5,1.6-3.5,10,10-26,2-5,2-6,3-35,3-38,4-10,5-merou,7,absent,acumen,acuminate,acute,ag,alyx,apart,ascending,attenuate,base,bearing,blade,borne,bud,clavat,connate,connivent,cuneate,curved,decurrent,digestion,dorsally,eaf,edge,eed,end,enzyme,erec,exceeding,flat,folded,geminat,generally,glabrou,greatly,half,homostylous,honeycomb-shaped,interjected,larger,leaflet,lengthening,living,lobe,long,lower,lunate,mottled,nflorescence,non-glandular,oblique,often,orolla,pair,pedice,petiolule,plurifoliate,pore,poricidal,ranging,removed,ruit,scale-like,seudostipule,short,singly,slit,spaced,specimen,stamen,ste,stolo,straight,subequal,suborbicular,subrosette,subtending,symmetrical,tall,tamen,tem,tertiary,therefore,tri-,truncate,tube,tuber,typically,unit,unwinged,vary,wide,wing,without,ympodial	abaxial,adaxial,arrangement,clavate,colour,form,growth,height,history,inflorescence,leaf,length,life,na,number,ovary,perennial,position,reproduction,shape,spacing,staman,surface,texture,width
144	wfo-0001026821	success	204	98	72	132	26	0.353	.2,0.4-1.5,0.7-1.8,0.8-1,1-1.5,1-20,1-5,10-15,2-3.5,2.5-18,3-branched,4-4.5,5-10,5-12,5-20,adaxial,anther,apart,apex,appressed,broadly,brown,chartaceous,cm,dark,diameter,due,ellipsoidal,elliptic,filament,flattened,flower,forked,fruit,gglobose,glabrous,green,herb,lanceolate,lateral,leaf-opposed,length,light,mature,mm,odd-pinnate,pale,pedicel,peduncle,petiole,pilose,puberulent,pubescent,rachi,rarely,remnant,slender,small,sparsely,stellate,stigma,stripe,style,subglabrous,substellate,surface,thickening,unbranched,wall,white,x,yellow	/3,0-20,0.2-1.5,0.3-1.2,0.3-2.5,0.5-1.2,0.5-3.5,1-2,1-3,1.2-1.5,1.5-2.5,17,1977,2-15,2-6,2-celled,3-11,3-18,3-6,3-7,3-celled,5-34,5-merou,abaxially,acuminate,acut,adaxially,ag,alyx,anderson,angular,apical,apically,apiculate,articulated,auriculate,axe,ba,basal,base,bayonet,berry,blade,bract,cell,ciliat,cordate,cuneate,deltate,directed,distal,distally,eaf,eed,equal,especially,exceeding,frequent,fused,geminat,glabrou,gland-tipped,greatly,hair,homostylous,incurved,interjected,interstaminal,large,leaflet,lobe,long,long-attenuate,longitudinal,lower,lowermost,many,margin,mean,membrane,membranous,minute,minutely,moderately,much,narrowly,nflorescence,oblique,obliquely,oblong,obtuse,occasional,occasionally,one-celled,opening,orolla,pair,paired,per,perfect,petiolule,plurifoliate,pore,present,pseudostipular,pubescen,reduced,reniform,rounded,ruit,scandent,seudostipule,short,slightly,slit,smaller,somewhat,spaced,stamen,subtended,tamen,tem,terminal,time,tri-,truncat,tube,unit,vary,wide,winged,ympodial	10-20,abaxial,arrangement,colour,corolla,form,growth,height,history,inflorescence,leaf,life,na,number,ovary,perennial,plant,position,reproduction,seed,shape,spacing,staman,texture,truncate,width
145	wfo-0001026827	success	143	109	80	63	29	0.559	/3,0.2-0.5,0.4-0.6,0.5-2,0.6-1,1-1.1,1-1.5,1-2,1.3-1.6,1.5-2,2-2.2,2-4,5-6,abaxially,and/or,anther,anthesi,apart,apex,arachnoid,bark,base,branched,calyx,clavate,cm,conical,corolla,dendritic,dense,densely,diameter,distally,ellipsoid,erect,especially,filament,flower,glabrescent,glabrous,growth,inflorescence,internodal,lanceolate,leaf,less,like,lobed,margin,mm,narrowly,new,nodding,oblanceolate,ovary,papillate,pedicel,peduncle,petiole,plane,pubescent,rachi,reddish,revolute,scar,shrub,simple,sinus,slender,sparsely,stem,stigma,stout,style,surface,trichome,uniseriate,way,white,x	.5,1-,1-2.1,2-2.5,3-9,7-9,?,acute,adaxiall,age,appearing,attenuate,branch,broadly,crowded,deciduou,deltate,dry,drying,eaf,exerted,fleshy,free,irregularly,know,known,lamina,lengthening,lobe,lower,minutely,near,nflorescence,ot,pair,paler,papillat,perfect,planar,plurifoliat,pore,poricidal,portion,primary,slit,small,soon,straight,strongly,surfac,terminal,thick,thickened,third,tip,tub,tube,ud,unit,upper,vein,widest,ympodial	abaxial,adaxial,adaxially,arrangement,bud,cell,center,colour,form,fruit,fruiting,height,history,length,life,na,number,perennial,plant,position,prickle,reproduction,seed,shape,spacing,staman,texture,unknown,width
146	wfo-0001026830	success	198	107	82	116	25	0.414	0.3-1.3,0.5-1.0,1-10,1-11,1-2,10-57,2.5-5,4-7,4.5-17.5,6-13,7-18,abaxially,adaxially,anther,apex,axillary,brownish,bud,cell,ciliate,clavate,cm,condition,coriaceous,corolla,covering,deep,diameter,drying,elliptic,filament,finely,flower,forked,fresh,fruit,glabrescent,glabrous,globose,green,green-white,greenish,hair,hair-like,herb,lateral,leaf,light,make,margin,medium,mm,mucilaginous,odd-pinnate,ovate,ovoid,pedicel,peduncle,pentagonal,petiole,plant,purple,ripe,rotate,seed,short,simple,stigma,stripe,style,subglabrous,subtending,terminal,testal,thick,throughout,wall,wet,white,whitish,yellow,yellowish	0-10,0.4-1,0.5-1.2,0.9-1.9,1.1-2.7,1.4-4,1.5-4,2-4,2-6,2.5-4.4,2.7-8,3.5-8.5,4-10,4-14.5,4.4-14.5,5-11,5-merou,acumen,acuminate,acute,adaxiall,ag,along,alyx,apart,apparently,arranged,articulated,asymmetric,attenuate,axe,base,basiscopic,bead,berry,blade,brown,capitat,connivent,decreasing,digestion,distal,dorsally,eaf,edge,eed,enzyme,erec,exceeding,flat,folded,geminat,generally,glabrou,hal,half,high,homostylous,honeycomb,interjected,lanceolate,leaflet,lengthening,like,linear,living,lobe,long,lower,moderately,moniliform,multiple,necklace,nflorescence,orbicular,orolla,pair,perfect,petiolulate,plurifoliate,pore,poricidal,puberulent,pubescent,removed,rounded,ruit,sessile,seudostipule,shaped,side,size,slit,spaced,specimen,stamen,stolon,straight,subequal,subglabrou,tall,tamen,tem,tip,tissue,toward,tri-,tube,tuber,typically,unit,unwinged,usually,vary,x,ympodial	abaxial,adaxial,arrangement,capitate,colour,form,growth,height,history,inflorescence,length,life,na,number,ovary,perennial,position,rachi,reproduction,shape,spacing,staman,surface,texture,width
147	wfo-0001026831	success	207	95	75	132	20	0.362	.5,/4,0-6,0.2-1,0.3-0.65,0.5-1.2,0.6,1-2.2,1-2.5,1-4,1-6,1/3,3-6,5-merous,abaxially,acute,anther,apart,apex,apparently,articulated,base,berry,bright,cell,cm,cream,curved,dark,densely,diameter,dull,erect,filament,flattened-reniform,flower,fruit,glabrous,green,lateral,leaf,length,lobed,long,marking,maturity,mauve,mm,moderately,orange,orange-brown,outline,pale,pedicel,peduncle,petiole,raised,red-brown,rounded,scandent,shiny,shrub,slender,smooth,spherical,stellate-pubescent,style,surface,upper,usually,way,white,yellow,yellow-green,young	-0.25,-5,-6.5,-9,0-10,0-20,0-3,0.1,0.1-0.2,0.1-0.25,0.15-0.25,0.2-0.4,0.3-0.6,0.6-2,0.65-1,0.7-1.1,0.7-2,1-10,1-2,1-3,1.2-2,1.5-2.5,1/3-1/,1/3-2/3,1/5-1/4,2-2.5,2-3,2-4,2.3-2.9,2.5-4.5,3-5,3.5-10,7-10,7-8,alyx,apar,apically,attenuate,bark,blade,branched,broad-deltate,brow,calyx,caudat,chartaceous,concolorous,connivent,deltate,difoliate,distance,drying,eaf,eed,elliptic,elongating,equal,extending,eye,free,fruiting,fully,geminat,glabrescent,gray-brown,herbaceous,infructescence,less,lobe,longer,lower,margin,mature,membranous,midpoint,midvein,multangulate,naked,narrow-cuneate,nflorescence,oblong,occasionally,older,one,open,opening,orolla,oung,ovate,pair,pendulous,per,perfec,pericarp,poricidal,porrect,portion,prickl,prickle,prickly,primary,ray,reduced,ruit,scar,sessile,shorter,side,sometimes,spaced,sparsely,spreading,stalk,stellate,stem,subsessile,tamen,tapering,terete,tertiary,time,tip,trichome,tube,unit,vary,vein,venation,visible,white-gray,wide,ympodial	abaxial,adaxial,colour,corolla,form,growth,height,inflorescence,na,number,ovary,perfect,plant,reproduction,seed,shape,spacing,staman,stigma,texture
148	wfo-0001026841	success	139	72	42	97	30	0.302	0.25-0.3,0.5-2,0.75-1,0.8-1,0.8-3,1.5,1.5-2,3.5-5,4-8,6-8,acute,anther,apart,apex,bi-lobed,clavate,cm,corolla,elliptic,filament,filiform,glabrous,globose,green,inflorescence,leaf,lobed,minutely,mm,opposite,ovary,papillose,pedicel,petiole,pubescent,shining,shrub,simple,stigma,style,white,x	.25,.5,/4,0.05,0.25-0.5,0.5-0.75,0.5-1,0.6-1,2-2.5,3-6.5,5-8-flowered,7-9,9.2-18,along,anthesi,arch,axi,ba,bark,base,beneath,berry,broadly,calyx,conical,coroll,curly-tipped,decurrent,deflexed,deltoid,dia,eaf,edicel,eed,ellipsoid,exsertion,free,fruiting,glabrate,greyish-gree,hyaline,immature,joined,known,later,lateral,like,lobe,lon,long,lower,main,margin,middle,nflorescence,older,pair,paler,papillo,pore,poricidal,portion,prominent,raised,reddish,reflexed,rest,ruit,scar,series,shaped,slender,slightly,spaced,sparsely,stem,straight,tall,tapering,tear-drop,terminal,thickened,tip,trichome,tube,ud,unevenly,unifoliat,uniseriate,unit,vein,way,widest,winged,woody,ympodial,young	5-8,abaxial,adaxial,arrangement,colour,diameter,flower,form,fruit,growth,height,history,length,life,na,number,peduncle,perennial,plant,position,rachi,reproduction,seed,shape,spacing,staman,surface,texture,unifoliate,width
149	wfo-0001026849	success	180	100	82	98	18	0.456	0-10,0.5-1,1,1-2,1-6,1.5-2.5,11,2-3,38/2,5,5-10,637/2,7-8,acute,adult,anther,apex,aster,axil,base,brown,capitate,cell,cm,colour,conical,corolla,cyme,discoidal,distinctly,entire,erect,expanded,facetted,filament,floral,flowered,fork,free,glabrous,globular,green,grey-brown,growth,inflorescence,lavender,leaf,less,linear-lanceolate,lobe,long-cuneate,loosely,margin,minutely,mm,oblong,oblong-lanceolate,ovary,pedicel,peduncle,petiole,reproducing,reticulate,rh,rhachi,rotate,rounded,sea,seed,shallow,short-lived,shrub,slightly,stem,stigma,stone,stout,style,surface,undulate,vegetatively,violet	-50,1-1.5,1.75-2,100-130,2,30-,40,80-,adherent,amongst,appearing,aspect,australian,berry,calyx,composed,conspicuous,curved,cut,deflexed,developed,dia,distinct,eed,ellipsoid,emarginate,enlarge,exceeding,except,exerted,filled,flesh,flower,fruiting,general,glandular,globose,granule,greater,gree,hair,half,interacuminal,large,leave,lengthening,little,lon,long,lower,mature,maturity,mid-vein,minute,native,nflorescence,occasionally,often,pal,pale,pedicellate,petal,plurifoliat,pore,poricidal,preparation,pruinose,purple,rarely,relatively,ruit,ruiting,shed,simple,sinus,slende,slit,soft-wooded,solanum,solitary,sometimes,somewhat,soon,stony,thus,tip,tissue,tub,tube,ud,unarmed,unit,uvenile,way,well,x,ympodial,young	arrangement,diameter,form,fruit,height,history,juvenile,length,life,number,plant,plurifoliate,position,reproduction,shape,slender,texture,width
150	wfo-0001026851	success	267	121	88	179	33	0.33	.8,1-7,2,5,5-merous,abaxial,acicular,adaxial,almost,andromonoecious,anther,armed,base,berry,bilobed,bright,broadly,capitate,circular,cm,conspicuous,dark,diameter,dot,entire,evenly,fading,filament,flattened,flower,fruit,glabrous,gland,globose,glossy,green,greenish,heterostylous,hyaline,inside,irregularly,lateral,leaf,less,light,lighter,live,lobe,lobed,matte,membranous,minute,minutely,mm,orange,outside,ovate,pedicel,peduncle,petiole,pilose,plant,prickle,pubescence,pubescent,scattered,sessile,shrub,similar,simple,slightly,sparsely,stellate,stem,stipitate,straight,straw-colored,style,suborbicular,surface,tip,trichome,unbranched,uniform,way,white,winged,yellow	-2,-celled,.4,0.3–1,0.8–1.5,0–1,1,1.5,1.5–2,1.5–2.8,10-15,15,175–415,1979,1–4.5,1–7,2.2–3.6,2.5–4,2/3,2–10,2–3,2–3.5,300,3–3.6,3–5,4-5,4–5-celled,4–6,4–6-celled,5–6.5,5–7-celled,6–11,7–12,8–10.5,8–15,=,abaxiall,abundant,acute,alyx,apar,apex,appearing,articulated,average,ba,becoming,blade,branched,c.,calyx,ciliate,coarse,coarsely,coil,complete,connivent,conspicuously,cordate,curve,densely,dentate,difoliate,directed,distall,distally,eaf,eed,elongating,endocarp,enlarged,equal,exceeding,except,eye,fertile,fide,fine,flexuous,free,fruiting,geminat,grading,gradually,hair,heavily,infructescence,lacking,large,larger,lenticel,little,long,long-styled,lower,major,making,margin,merely,midrib,minor,moderately,mostly,much,n,naked,narrowly,near,nearly,nee,nflorescence,occasionally,often,one,orolla,otherwise,oung,pair,papillo,pattern,per,pericarp,pore,poricidal,portion,preserved,prickly,recurved,reflexed,rest,ruit,sap,scanden,scant,scar,scarious,shiny,short-styled,size,slender,small,smaller,sometimes,somewhat,spaced,specimen,speckled,spongy,sprawling,spreading,stamen,staminat,stipitate-glandular,tall,tamen,tapering,tasteles,terete,thick,thickened,tooth,tough,triangular,tube,twice,unarmed,unit,usually,vary,vein,visible,watery,well,wide,wing,yellowish,ympodial,–13,–2	/4,0-1,0.3-1,1.5-2,13,2-10,4-5-celled,5-6.5,5-7-celled,8-15,apart,arrangement,colour,corolla,form,growth,height,history,inflorescence,length,life,number,ovary,papillose,perennial,position,reproduction,seed,shape,spacing,staman,stigma,texture
151	wfo-0001026858	success	153	88	51	102	37	0.333	0.8,1-11.5,1-4,1.3-1.5,1.5-4,3-4,4-24,6-10,6-7,abaxially,adaxially,apex,branched,calyx,cell,cm,corolla,cyme,diameter,dichasial,dichasially,distal,ebracteate,filament,flower,glabrescent,glabrous,globose,green,green-white,half,leaf,light,mm,monochasial,odd-pinnate,ovate,ovate-lanceolate,ovoid,pedicel,peduncle,perennial,petiole,plant,seed,shiny,stellate,stigma,style,throughout,yellow	-30,-4,0-.,0.5,0.8-1,1-,1-10,1-5,2-2.5,2-3,2-4,2.5-3,3-,3-6-foliat,4.5-10.5,5-15,6-18,abruptly,acumen,acute,apical,apically,articulate,base,connate,cordate,covering,cuneate,dehiscent,digestion,diminishing,dorsally,eaf,edge,eed,emoval,enzyme,exceeding,flat,folded,forked,generally,globo,hair-like,herbaceous,honeycomb,interjected,introrse,lateral,leaflet,living,lobe,lon,long,lower,lunat,make,maturing,minute,mucilaginous,mucronate,nflorescence,nther,oblique,oblong,obtuse,often,orolla,pair,pattern,perfect,plan,poricidally,proximal,reveal,rounded,ruit,seudostipule,short,size,slightly,slit,specimen,stamen,straight,tal,tem,testal,thick,throughou,toward,triangular,tuber-bearing,typically,unit,vary,wall,white-crea,wide,without,ympodial,¼	abaxial,adaxial,anther,arrangement,bark,bud,center,colour,form,fruit,fruiting,growth,height,herb,history,inflorescence,length,life,margin,na,new,number,ovary,position,prickle,rachi,reproduction,scar,shape,spacing,staman,stem,surface,texture,trichome,white-cream,width
152	wfo-0001026870	success	206	83	63	143	20	0.306	0.5-1,0.7-1.4,1.4-1.8,12-28,2-3,2-3.5,2-6,3-12,4-5,9.5-12,anther,apex,black,brownish,chartaceous,cm,densely,diameter,dioecious,elliptical,erect,extra-axillary,female,filament,finely,flower,forked,fruit,glabrous,globose,grey,grey-green,inflorescence,length,male,mm,ovate,ovate-reniform,pedicel,peduncle,perennial,petiole,plant,pseudo-racemose,purple,reticulate,rhizomatous,ridged,rotate,rotate-stellate,rusty,shrub,solitary,stellate-pubescent,stem,stigma,style,surface,terete,unbranched,unknown,white,yellow	%,.05,.5,0,0-0.1,0-1,0.05-0.15,0.2-0.35,0.2-1.2,0.25-0.4,0.25-0.5,0.3-0.4,0.4-0.8,0.7-2,1,1-11,1-4,1-5,1.5-2,1.9-3,10-14,11-14,140-600,15-25,18-30,2-5,2-7,2-foliate,2.5-12,3-10,3-5,300-600,4-7,4-9,5-7.5,5-merou,6-70,7-11,7-8,abaxially,absent,abundant,accrescent,acicular,acute,adaxiall,adaxially,alyx,apart,armed,articulated,ascending,axe,ba,basal,base,blade,broad-based,broadly,brown,calyx,color,cuneate,cylindrical,d.,deeply,deltate,diamete,directed,distal,distall,distributed,dult,eaf,eed,eglandular,enclosing,finger,flattened,fruiting,functional,geminat,glabrou,gland-tipped,hair,heterostylous,index,interpetalar,lamina,lanceolate,lateral,lobe,lobed,lobing,lon,long,longer,lower,margin,mature,midpoint,midvein,minute,nflorescence,oblique,obtuse,orolla,part,per,pore,porrect,presen,present,prickle,probably,ray,ruit,sessile,short,side,simple,spaced,stage,stalk,stellae,straight,tal,tamen,thick,throughout,time,tissue,triangular,tube,unit,unknow,uvenile,vary,vein,wide,x,yellowish,ympodial	abaxial,colour,corolla,form,growth,height,history,leaf,life,na,number,ovary,position,reproduction,seed,shape,spacing,staman,texture,width
153	wfo-0001026874	success	222	109	69	153	40	0.311	.3,.5,0-1,0.5,15-20,2,anther,apex,asymmetric,base,broadly,cm,colored,dark,densely,diameter,filament,filiform,flower,foveolate,fruit,glabrate,glabrous,glandular,globose,green,growth,hair,lanceolate,leaf,length,lenticular,lighter,like,midrib,mm,near,often,orange,ovate,pedicel,peduncle,petiole,point,pubescent,rachi,reddish,ripe,scabrous,shiny,shrub,similar,simple,sparse,sparsely,stellate,stellate-pentagonal,stellate-tomentose,stem,stigma,style,surface,tan,thin-textured,vestiture,white,widest,x,yellow	0,0.2–0.6,1.5,1.5–2.5,1.5–4,1.5–5,12–20,1–,1–3,2-foliate,2–2.5,2–3,2–4,2–5,2–6,2–several-branched,3-5,4.5,4–7.5,5.5,5.5–7.5,5–15,6-7,6–12,6–9,8-12,8–20,9.5–11.5,abaxially,absent,across,acuminate,acute,adaxiall,adaxially,along,apar,apical,attenuate,axe,basally,based,berry,beset,blade,broad,calyx,capitate,caudate,clavat,compressed,connivent,deltoid,dense,depressed,developed,drying,eaf,eed,entire,erect,except,finely,flowering,fruiting,geminat,generally,glabrou,gland,glandular-pubescent,hermaphroditic,internode,interpetalar,juvenile,lance,lanceolat,lanceoloid,larger,lateral,laterally,lobe,lon,long,lower,main,major,margin,midpoint,midvein,minute,moderately,narrowly,new,nflorescence,obtuse,orolla,ovoid,per,perfect,pinnatifid,pore,portion,present,prickle,prickly,prominently,pubescen,pubescence,recurved,reduced,repand,rounded,ruit,scattered,sessile,short,side,slender,slightly,small,sometimes,somewhat,spaced,spreading,stalked,stellae,straight,subulate,swollen,tall,tamen,tem,tip,tipped,tissue,tooth,truncate,tube,ud,unarmed,upon,usually,variable,vary,varying,vein,warty,weakly,widely,yello,ympodia,–5,–many	--,1-,1-3,1.5-4,1.5-5,12-20,2-,2-3,2-6,5-15,5.5-7.5,6-12,9.5-11.5,abaxial,adaxial,apart,arrangement,clavate,colour,corolla,form,height,history,inflorescence,life,many,na,number,ovary,perennial,plant,position,reproduction,seed,several-branched,shape,spacing,staman,texture,width
154	wfo-0001026895	success	166	78	53	113	25	0.319	0.5-1,0.5-1.2,0.5-1.5,0.5-2,0.8-1,1.4-2.1,2-2.3,4.5-5,abaxial,adaxial,anther,apex,brown,capitate,closely,cm,corolla,dark,drying,elliptic,filament,filiform,flattened,glabrous,globose,green,hard,internodal,leaf,lobed,minutely,mm,mustard,narrowly,ovary,pale,pedicel,petiole,pitted,pubescent,reniform,shape,shrub,shrublet,simple,spaced,stigma,style,surface,tan,white,woody,yellow	.5,0-0.5,1-1.5,1-5,1.5-2,2-2.5,2-3,2.5-3.2,2/3,3-12,5-6,5-8-flowered,acute,along,anthesi,apical,apically,appearing,attenuate,ba,bark,base,berry,borne,broad,broadly,calyx,campanulate,conical,contracted,deflexed,deltoid,dendritic,denser,dia,differing,difoliate,eaf,edicel,eed,ellipsoid,elongate,erect,free,fruiting,geminat,glabrate,incrassate,lamina,lateral,like,lobe,lon,long,long-exserted,lower,main,major,margin,middle,minor,minute,nflorescence,obovate,often,older,overlappin,pair,papillo,pericarp,pointed,pore,poricidal,portion,present,projection,reddish,reddish-brow,ruit,scar,scattered,shaped,shoot,short,side,size,small,somewhat,soon,sparsely,stem,swollen,swollen-based,tall,tear-drop,thin,tip,toothed,trichome,tub,tube,tuft,type,ud,uniseriate,unit,usually,vein,way,widest,x,ympodial,young	5-8,arrangement,colour,diameter,flower,form,fruit,growth,height,history,inflorescence,length,life,na,number,peduncle,plant,position,rachi,reproduction,seed,spacing,staman,texture,width
155	wfo-0001026905	success	204	97	78	126	19	0.382	.5,0-2,0.4-1,0.5-0.7,0.5-1.5,0.6-0.7,0.9-1.3,1-2.5,1-4,1/2-3/4,2.5-3.5,5-merous,abaxially,anther,apex,apparently,articulated,base,berry,branched,cell,chartaceous,cm,cream,dark,densely,diameter,discolorous,drying,dull,erect,filament,flattened-reniform,flower,fruit,glabrous,gray-green,green,inflorescence,leaf,length,lobed,long,marking,maturity,mauve,mm,moderately,orange,orange-brown,outline,pale,pedicel,peduncle,petiole,pit,prickly,raised,red,rounded,shrub,small,smooth,sometimes,sparsely,spherical,stellate-pubescent,style,subentire,surface,unarmed,usually,way,weakly,white,yellow,yellow-green,young	-1.5,-10,-2,-2/3,-3,-4,.2,0,0-20,0-25,0.1,0.15,0.2-0.3,0.2-0.5,0.3-0.4,0.4,0.4-0.9,0.7-1.4,0.75-1.1,1,1-2,1-20,1-3.7,1-6,1.9-2.5,1/3,1/4,1/5-1/3,2-3,2.5-2.9,2/3-3/,3-5,3-8,5-6,6-8,7-8,acuminat,acute,alyx,ame,apar,apart,apically,attenuate,bark,blade,brow,c.,calyx,connivent,curved,deltate,difoliate,distance,eaf,eed,elongating,equal,extending,eye,free,fruiting,geminat,infructescence,lateral,lobe,longer,lower,margin,mature,midpoint,midvein,naked,oblong,older,one,open,orolla,oung,ovate,pair,pendulous,per,perfec,pericarp,poricidal,porrect,portion,prickl,prickle,primary,ray,reduced,ruit,scar,sessile,shallowly,shorter,side,slender,somewhat,spaced,spreading,stalk,stalked,stellate,stem,straight,tamen,tapering,terete,tertiary,time,tip,trichome,tube,unit,upper,variously,vary,vein,venation,visible,wide,woody,ympodial	abaxial,adaxial,colour,corolla,form,growth,height,na,number,ovary,perfect,plant,reproduction,seed,shape,spacing,staman,stigma,texture
156	wfo-0001026923	success	177	91	66	111	25	0.373	.5,0-5,0.25-0.5,0.5-1,0.6-0.8,1,1.5-4,2-6,20-50,3-5,5-10,5-15,5-9,abaxially,adaxially,anther,apart,apex,black,branched,brown,chartaceous,cm,densely,diameter,elliptic,elliptic-ovate,erect,filament,flattened,flower,forked,fruit,glabrescent,glabrous,globose,green,leaf,leaf-opposed,light,mm,moderately,orange,pedicel,peduncle,petiole,possibly,pubescent,purple,rachi,red,ripening,rugulose,shrub,simple,small,sparsely,stellate,stigma,strongly,style,surface,tree,white,x,yellow	-5,.1-0.3,0.5,0.8-1,1-1.5,1-3,1-4,1-7,1.5-2,10,2,2-2.5,2-3,3-4,4-18,4-5-,5-6,absent,accrescent,acuminate,acute,adaxiall,ag,apparently,articulated,axe,ba,base,blade,calyx,capitat,center,connivent,covering,cuneate,curved,cylindrical,deltate,denser,directed,distally,eaf,eed,eglandular,entire,equal,frui,fruiting,fused,geminate,gland-tippe,glandular,hair,held,intermediate,lanceolate,large,lateral,like,lobe,long,longitudinal,lower,many-foliate,margin,midpoint,midvein,much,multangulate,nearly,nflorescence,oblong,opening,orolla,paired,peltate,perfect,pore,pubescence,ray,relatively,rounded,ruit,scale,sessile,short,slightly,slit,smaller,sometimes,somewhat,spaced,ste,stem,straight,subtending,tal,tamen,tem,time,tip,trichome,tube,unit,uprigh,usually,vary,whitish,wide,yellowish,ympodial	abaxial,adaxial,arrangement,capitate,colour,corolla,form,growth,height,history,inflorescence,length,life,na,number,ovary,plant,position,reproduction,seed,shape,spacing,staman,texture,width
157	wfo-0001026924	success	190	83	58	132	25	0.305	-4,0-2.3,0.2-0.4,0.5-1.5,0.5-6,0.8-2.6,1-6,4.3-6.2,5-7,8-9,acute,anther,apex,brown,chartaceous,cm,densely,diameter,drab,drying,extra-axillary,finally,flower,fruit,glabrous,globose,green,grey,grey-green,herbaceous,inflorescence,length,light,lobed,minutely,mm,obtuse,ovate,pale,pedicel,peduncle,petiole,pseudo-racemose,purple,rachi,resprouter,rusty,shallowly,stellate,stellate-pubescent,stigma,style,surface,truncate,undulate,white,yellow,yellowish	%,0-0.2,0-1.5,0-2,0.05-0.1,0.05-0.2,0.1-0.3,0.4-0.5,0.5-0.6,0.5-0.7,0.5-0.8,0.7-1.1,0.7-1.2,0.8-1.2,0.9-1.3,1-1.5,1-4,1.1-4.2,10-13,17-40,2-,2-2.5,2-4,2-foliate,2.8-8.5,3,3-6,4-7,5,5-merou,6-8,7-10,7-8,abaxially,absen,absent,accrescent,acicular,across,adaxiall,adaxially,alyx,apart,apparently,appearance,axe,base,blade,calyx,capitat,connivent,cordate,cuneate,curved,cylindrical,d.,directed,distall,distally,distributed,dult,eaf,eed,eglandular,entire,erect,finger,first,fruiting,geminat,glabrou,gland-tipped,hair,half,lamina,lanceolate,lateral,less,lobe,long,longer,lower,margin,markedly,mature,mid-poin,midpoint,minute,narrowly,nflorescence,oblique,orolla,part,per,perfect,pore,porrect,present,prickle,raisin-like,ray,rostrate,ruit,short,simple,slightly,spaced,sparsely,stage,stalk,stellae,stem,straight,tal,tamen,thick,thicker,thicknes,throughout,time,triangular,tube,unarme,unarmed,unbranched,unit,unknow,uvenile,vary,wide,x,ympodial	abaxial,adaxial,capitate,colour,corolla,filament,form,growth,height,history,leaf,life,na,number,ovary,perennial,plant,position,reproduction,seed,shape,spacing,staman,texture,unknown
158	wfo-0001026925	success	215	83	58	157	25	0.27	0.5-1.5,0.9-1.8,1-1.3,1-1.4,1-25,1-3.5,2-5,2.4-3,3-7,4-10,5-merous,6-8,acute,andromonoecious,anther,apex,apparently,berry,cm,cream,dark,diameter,erect,filament,flattened-reniform,flower,fruit,glabrescent,glabrous,green,green-brown,lateral,leaf,length,lobed,marking,maturity,mauve,mm,moderately,orange-brown,pale,pedicel,peduncle,pendent,petiole,plant,red-brown,shrub,spherical,stellate,stellate-pubescent,style,surface,terminal,white,yellow,young	-2,.5,/6,0,0-10,0-20,0-5,0-7,0.1,0.1-0.2,0.1-0.3,0.2,0.5-4,0.7-1.8,00-200,1-3,1-4,1.5-2,1.5-2.5,1.5-4.5,1.8-2,1.8-2.5,1/3,1/3-1/2,1/4-2/3,1/6-1/3,2-4,2.4-2.6,2.5-6,2/,3-20,4-14,4-5,4-7,5-6,5-8,5.5-10,6-10,6-17,7-12,abaxially,acuminat,alyx,ame,apar,apart,apically,articulated,attenuate,bark,base,blade,branched,broad-deltate,brow,c.,calyx,chartaceous,concolorous,connivent,curved,deltate,distal,distance,drying,eaf,eed,elliptic,elongating,equal,extending,flattened,free,fruiting,gently,hair,hermaphrodite,heterostylous,infructescence,lobe,lobing,long,long-styled,longer,lower,lowermost,margin,mature,membranous,midpoint,midvein,minute,narrow-deltate,nflorescence,oblong,older,one,open,orolla,oung,ovate,pair,pendulous,per,pericarp,plurifoliat,poricidal,porrect,portion,prickl,prickle,prickly,primary,rarely,ray,reduced,reflexed,rounded,ruit,scar,secondary,sessile,short-styled,side,simple,smooth,sometimes,spaced,sparsely,spreading,stalk,stalked,staminat,stem,stout,straight,tamen,tapering,terete,tertiary,time,tip,translucent,trichome,tube,unarmed,unit,upper,vary,vein,venation,visible,way,wide,woody,yellow-orange,ympodial	abaxial,adaxial,arrangement,colour,corolla,form,growth,height,history,inflorescence,life,na,number,ovary,perennial,plurifoliate,position,rachi,reproduction,seed,shape,spacing,staman,stigma,texture
159	wfo-0001026946	success	205	104	77	128	27	0.376	0-5,0.5-2,1-10,1-2,1-4,1.6-3.7,12-23,2-15,2.5-10.5,5-7,8-15,8-25,abaxially,adaxially,anther,apex,attenuate,axillary,brownish,bud,cell,chartaceous,clavate,cm,condition,corolla,covering,creamy,deeply,densely,diameter,drying,elliptic,filament,flower,forked,fresh,fruit,glabrous,globose,green,greenish,hair-like,herb,lateral,membranous,minutely,mm,odd-pinnate,ovate,ovoid,pedicel,peduncle,pentagonal,petiole,plant,puberulent,pure,purple,ripe,seed,short-pubescent,slightly,stellate,stigma,streak,style,subtending,terminal,testal,thick,truncate,wall,white,whitish,yellow,yellow-white	0-20,0.9-3.5,0.9-4.3,1,1.5-2,10-39,2,2-5,2.7-9,3-20,3-5,3-6,3.5-10,4-7,4.1-9.4,5-merou,6-24,acumen,acuminate,acute,ag,along,alyx,apart,apparently,articulation,axe,base,berry,blade,borne,broadly,capitat,ciliate,connivent,digestion,distal,dorsally,dot,eaf,edge,eed,end,enzyme,erec,especially,exceeding,except,extremely,flat,folded,geminat,generally,glabrou,greatly,green-white,hair,half,homostylous,honeycomb-shaped,interjected,lanceolate,leaflet,lengthening,like,living,lobe,long,lower,make,margin,midrib,mottled,mucilaginous,narrowly,nflorescence,oblique,often,orbicular,orolla,pair,perfect,petiolulate,petiolule,plurifoliate,pore,poricidal,proximal,pubescen,pubescent,reduced,removed,rounded,ruit,scattered,sessile,seudostipule,short,singly,size,slit,spaced,specimen,stamen,ste,stem,stolo,straight,subequal,tall,tamen,tem,thir,throughout,tip,tri-,tube,tuber,typically,unit,unwinged,usually,variable,vary,wet,wing,x,ympodial	abaxial,adaxial,arrangement,capitate,colour,form,growth,height,hermaphroditic,history,inflorescence,leaf,length,life,na,number,ovary,perennial,position,rachi,reproduction,shape,spacing,staman,surface,texture,width
160	wfo-0001026962	success	205	108	85	120	23	0.415	.05,0.3-0.7,0.8-1,1-1.5,1-3,1-4.5,1.5-2,1.5-5,10-12,10-20,2-6,2/3-3/4,4-5,6-7,abaxially,abrupt,adaxially,anther,anthesi,base,calyx,closely,cm,corolla,darker,densely,diameter,dry,elliptic,evenly,except,filament,flattened-reniform,flower,fruit,glabrous,globose,green,incrassate,inflorescence,internodal,leaf,lobed,margin,material,minutely,mm,narrowly,occasionally,often,opposite,ovate-lanceolate,overlapping,packed,pale,papillose,pedicel,peduncle,pendent,petiole,pitted,pubescent,purplish,rachi,reflexed,shrub,simple,slender,small,sometimes,somewhat,stellate,stigma,style,surface,tapering,tinged,tree,tube,unbranched,way,white,woody,x,yellow	.5,0,0.5,0.5-0.8,0.5-1,0.5-1.5,1,1-1.2,1-2,1-6,1.5-17,1.5-3,15-22,2-2.5,2-5,3-3.5,3-6,9-12,9-17,abruptly,accrescent,acute,ag,alyx,apex,apparently,appearing,arising,articulated,axe,bark,basebud,becoming,beneath,blade,brittle,broadly,bud,capitat,cell,chartaceous,composed,connivent,constricted,cucullat,cylindrical,deflexed,deltate,denser,differing,difoliate,dimorphic,eaf,eed,elongate,entire,exerted,free,fruiting,geminat,glabrate,glabrou,ilament,later,lateral,like,lobe,long,longitudinal,main,major,minor,nflorescence,obconic,oblong,obovoid,older,one,opening,orolla,oung,outline,pair,paten,perfect,pore,portion,prominent,pubescen,raised,remaining,rest,rounded,rounder,ruit,sagittate,shaped,size,slightly,slit,soon,stem,straight,tal,tear-drop,tip,tooth,triangular,trichome,trunk,unarmed,unifoliate,uniseriate,unit,vary,vein,whit,yellowish,ympodial,young	abaxial,adaxial,arrangement,capitate,colour,form,growth,height,history,length,life,na,number,ovary,perennial,plant,position,reproduction,seed,shape,spacing,staman,texture
161	wfo-0001026963	success	151	105	74	77	31	0.49	-5,.4,.5,0.2-0.6,0.5,1-1.5,1-2,1.2-1.5,1.5-6,2-2.5,2-4.5,3-5-rayed,4,6-7,abaxially,acicular,anther,apex,bark,calyx,capitate,closely,cm,conical,coriaceous,corolla,cup-shaped,dark,deep,diameter,ellipsoid,elliptic,filament,flower,glabrous,growth,herb,heterostylous,inflorescence,internodal,lobed,long-styled,margin,membranous,minutely,mm,new,nodding,ovary,ovate,pedicel,peduncle,petiole,porrect,prickle,pubescent,reddish,scar,sessile,shallowly,short-styled,simple,spaced,sparsely,stellate,stem,stigma,style,subshrub,surface,trichome,white,x,yellowish	0.5-0.6,0.8-3,1.1-1.4,1.5-4.5,3-5,4-5,5-6,<,abruptly,absent,acute,anthesi,apical,armed,articulated,base,brow,c.,clustered,creeping,curved,densely,eaf,eed,elongate,elongating,free,included,inflorescenc,know,known,like,lobe,long,long-triangular,lower,markedly,mature,midpoint,minute,nflorescence,node,oblique,older,outline,pair,papillo,per,plurifoliat,pore,poricidal,portion,prickly,primary,prominent,ray,reflexed,rooting,rootstock,ruit,scattered,side,slit,small,sometimes,tapering,tip,tooth,truncate,tube,ud,unarmed,unit,vein,way,woody,ympodial	/,abaxial,adaxial,arrangement,brown,bud,cell,center,colour,form,fruit,fruiting,height,history,leaf,length,life,na,number,papillose,perennial,plant,position,rachi,reproduction,seed,shape,spacing,staman,texture,width
162	wfo-0001026964	success	128	76	49	79	27	0.383	.5,0.5,0.5-1,10-30,2-2.5,3-5,7-8,acuminate,acute,anther,apex,axillary,base,cm,conical,corolla,diameter,elliptic,filament,filiform,flower,glabrous,green,greenish,herb,lobed,minutely,mm,nearly,obovate,ovary,papillate,pedicel,petiole,pinnate,pubescent,purple,rachi,rugose,shape,simple,smooth,somewhat,sparsely,stigma,style,surface,x,yellow	.2,0,1-1.2,1-2.5,10,2-4,3.5-7,4.5-8.5,?,along,anthesi,attenuate,basal,beak,bearing,berry,calyx,capitat,conspicuously,differentiated,distinct,eaf,edicel,equal,erec,exserted,fleshy,free,fruiting,glabrou,globose,horizontal,immature,known,lateral,leaflet,lenticellate,lightly,line,lobe,long,long-attenuate,lower,margin,nflorescence,noddin,often,one,onto,open,ot,pair,petiolule,poricidal,portion,primary,purpli,reflexed,ruit,scar,side,size,slender,small,tal,tem,terminal,time,tip,trichome,tub,tube,ud,unifoliat,uniseriate,unit,vein,winged,ympodial	abaxial,adaxial,arrangement,capitate,colour,form,fruit,growth,height,history,inflorescence,leaf,length,life,na,number,peduncle,perennial,plant,position,purplish,reproduction,seed,spacing,staman,texture,width
163	wfo-0001026965	success	157	107	70	87	37	0.446	-2.5,.6,0.5-1.5,0.7-1.1,0.7-1.5,1.1-1.65,1.7-2,3-,3.5-9,5-15,6.4-12,abaxially,abundant,acute,adaxially,anther,antrorse,apex,berry,broadly,calyx,campanulate,capitate,cm,diameter,elliptic,elliptical,evident,filament,flexuose,fruiting,globose,herb,herbaceous,long,longitudinally,margin,mm,narrowly,non-glandular,obovate,outer,ovate,pale,papery-scarious,papillose,petiole,pinnatifid,pinnatipartite,prostrate,pubescent,reticulate,ridged,seed,simple,stem,stigma,style,subglobose,surface,trans-ovoidal,trichome,tuberculate,uniseriate,venation,violet,white,winged,x,yellow	.3,.5,0.2,0.4,0.5-,0.6-1.1,0.6-2,0.7-1,0.8-1.25,1.3-2,1.5-2,1.5-4,1.9-2.4,2.5-4,2/3,25,3-4,3.5-6.2,8-17,accrescent,ag,appressed,articulated,basal,base,c.,coat,coiled,connectival,covering,cuneate-attenuate,cylindrical,difoliat,dorsal,eaf,eed,eglandular,ellipsoidal,embryo,exserted,glabrous,glandular,hig,latitudinally,lobe,longer,longitudinal,lower,mixed,multi-seeded,noticeable,opening,opposite,orolla,ovat,pair,papillae,partially,pore,poricidal,portion,procumbent,prolongation,ree,rounded,ruit,segment,short,similar,slightly,slit,small,smooth,straight,striate,strongly,styl,tem,time,tip,tube,unequal,unifoliate,unit,vary,wider,ympodial	abaxial,adaxial,arrangement,bark,bud,cell,center,colour,corolla,flower,form,fruit,growth,height,history,inflorescence,leaf,length,life,na,new,number,ovary,pedicel,peduncle,perennial,plant,position,prickle,rachi,reproduction,scar,shape,spacing,staman,texture,width
164	wfo-0001026981	success	252	125	104	148	21	0.413	-0.8,-2.5,-35,.2,0.3-0.5,0.3.6,0.5-30,0.6-2,1-2,1-3.3,1.8-2.8,1/3,11,2-3-branched,4,4-celled,7.5,abaxially,abundant,acute,adaxially,adpressed,along,anther,apex,appearance,articulated,articulation,base,beak,brown,capitate,cell,cm,conical,corolla,dark,densely,diameter,distal,filament,flower,fruit,giving,glabrescent,glandular,globose,green,hair-like,head,herb,imparipinnate,interrupted,lateral,leaf,like,lime,margin,maturity,minutely,mixed,mm,much,multicellular,narrowly,obovate,occasionally,orange,orbicular,outgrowth,ovary,ovate,pale,pedicel,peduncle,pentagonal,perennial,petiole,plant,pronounced,pubescent,rachi,shaggy,silky,simple,smaller,sometimes,sparsely,sparser,stem,stigma,style,surface,tangled,testa,transparent,trichome,uni-,uniseriate,velvety,wall,winged,without,yellow	-0.4,-14,-2,-4,-8,.2-0.2,0-5,0.05-0.1,0.1-0.2,0.1-0.3,0.15-0.2,0.2,0.2-0.4,0.2-2,0.25-0.4,0.4-0.5,0.4-0.7,0.4-2,0.45-1.3,0.5,0.5-0.3,0.6-1.4,0.7-0.8,0.8-1.2,0.8-6,0.9-1.4,0.9-1.5,1,1-2-cellular,1-3,1-3-celled,1-4,1.5-2.0,1.5-5,1.5-8.5,196.,2-3,2-locular,3-foliate,3.5-14,4-8,6-10,<,absen,absent,academy,accrescent,amongst,angled,anthesi,apical,appendage,appressed,asymmetric,axi,basiscopically,bay,becoming,bract,bracteole-like,calyx,citrus-like,coastal,column,composed,cone,cordate,d,deltate,eaf,ebracteate,edicel,eed,entire,erect,exserted,fruiting,gree,half,halfway,included,initially,interjected,internode,irregularly,jointles,larger,later,leaflet,less,linear,lobe,lobed,lon,long,lower,mainly,nflorescence,pair,patent,per,petiolule,population,present,primary,procumbent,proximal,pseudostipule,pubescence,reflexed,rick,robust,rounded,ruit,scen,secondary,see,sessile,several,shaped,short,shorter,slender,specimen,spreadin,staminal,sterile,straight,strong,tem,terminal,tertiary,thick,tightly,tub,tube,type,unicellular,unit,upto,usually,variously,villous,viny,wide,ympodial,‘,’	abaxial,adaxial,arrangement,colour,form,growth,height,history,inflorescence,length,life,na,number,position,reproduction,seed,shape,spacing,staman,texture,width
165	wfo-0001026987	success	214	73	53	161	20	0.248	0-1,0.4-1,0.5-2,0.5-2.5,1-3,1.5-2,3.5-5,4-6,5.5-7,6-20,anther,bent,chartaceous,cm,deflexed,densely,diameter,erect,extra-axillary,filament,flower,fruit,glabrous,globose,green,inflorescence,leaf,length,lilac,mm,often,pale,pedicel,peduncle,perennial,petiole,purple,rachi,red,rhizomatous,shrub,simple,stellate,stellate-pubescent,stigma,style,surface,thin,twisted,unbranched,white,yellow,yellowish	%,0-0.1,0-0.2,0-10,0-4,0.05-0.1,0.2-0.4,0.2-0.5,0.2-1,0.25-0.4,0.4-0.5,0.4-0.7,0.5-0.7,0.5-1,0.7-0.8,0.7-1,0.7-1.5,1-11,1-2,1-4,1.1-2.6,1.1-6,1.4-3,15-35,2-5,2-7,2.5-11,2.5-6.5,3.5-3.8,4-7,4.5-6,5-10,5-8,5-merou,7-10,8-10,8-11.5,8-12,8-13,abaxially,absen,absent,abundant,accrescent,across,acute,adaxiall,adaxially,adult,alyx,apart,apex,articulated,ascending,axe,ba,basal,base,berry,blade,branch,branche,broad-based,calyx,capitat,connivent,cordate,cuneate,curved,cylindrical,decimetre,deltate,directed,distall,distributed,dm,eaf,eed,eglandular,entire,finger,fruiting,gland-tipped,glandular,glandular-hairy,grey,hair,half,hastate,homostylous,interpetalar,juicy,juvenile,lacking,lamina,lanceolate,lateral,less,lobe,lobed,long,longer,loosely,lower,margin,mature,mesocarp,mid-point,midpoint,minute,narrowly,nflorescence,oblique,obtuse,orolla,ovate,pair,part,per,perfect,pore,porrect,present,prickle,ray,ruit,scarcely,sessile,shallowly,shallowly-lobed,short,slightly,spaced,sparse,sparsely,stalk,stellae,straight,succulen,summit,tal,tamen,tem,thick,thickened,throughout,time,tissue,toward,triangular,tube,unarme,unarmed,unit,unknow,upper,upward,vary,wide,x,ympodial	abaxial,adaxial,capitate,colour,corolla,form,growth,height,history,life,number,ovary,plant,position,reproduction,seed,shape,staman,texture,unknown
166	wfo-0001026992	success	243	101	75	168	26	0.309	0.2-0.5,0.25-0.45,0.5-1.2,0.6-1.5,1-4,1.2-1.7,1.4-1.6,1.5-3.4,1.7-4.3,2-10,2.8-4.7,3-4,5.3-12.1,6-10,8-14,abaxial,abaxially,adaxially,anther,apart,apex,articulated,base,branched,broadly,brown,cm,corolla,dark,deltoid,diameter,drying,elliptic,filament,flower,fruit,glabrous,globose,hair,lance-ovate,leaf,length,many,mm,moderately,nearly,orange-tan,ovate,pedicel,peduncle,petiole,plant,pubescent,rachi,reniform,reticulate-punctate,ripe,scabridulous-,shrub,simple,small,stellate,stigma,style,surface,tan,terminal,time,tomentose,tree,velutinous,violet,white,x,yellow	-2.5,/7,0.8-3.4,00-170,1.2-1.4,1.3-2.6,1.3-4.3,1.4-1.9,1.7-1.9,1.7-2.4,1/2,10-12,12-33,2-5.6,2.3-3.3,2.6-4.6,2.8-4.6,3.3-5.5,3.3-5.6,4-8,5-15,5-merou,8,8-11,abruptly,accrescent,acuminate,acute,adaxiall,ag,along,alyx,angled,anthesi,apparently,appressed,approximately,around,attenuate,axe,axillary,ba,bark,berry,blade,blunt-tipped,branch,calyx,capitat,chartaceous,completely,coriaceous,covering,crown,cylindrical,densely,directed,distally,eaf,echinoi,echinoid,edge,eed,entire,enveloping,equal,evident,exserted,farinose,flat-topped,fleshy,forming,free,fruiting,geminate,glabrescen,granular-tomentose,greenish,grooved,high,homostylous,immature,inserted,lacking,lanceolate,lateral,lengthening,less,line,lobe,lobed,long,long-stalked,longitudinal,longitudinally,lower,m.,main,margin,mature,maturity,midrib,minute,mostly,multangulate,nflorescence,oblong,obtuse,occasional,occasionally,often,older,orolla,ovate-lanceolate,overlapping,perfect,plurifoliate,pore,poricidal,porrect-stellate,pubescence,rare,rather,ruit,runk,semi-ovate,sessile,short,short-,short-stalked,shorter,side,size,slit,sometimes,somewhat,spaced,sparingly,split,spreading,stalked,stamen,stem,stout-stalked,subcampanulate,subglobose,suture,tamen,terete,thin-textured,tip,tube,ud,unarme,unarmed,unequal,unit,usually,vary,vein,way,weakly,whitish,wide,yellowish,ympodial,young,½	100-170,5-merous,adaxial,arrangement,capitate,colour,form,glabrescent,growth,height,history,inflorescence,life,na,number,ovary,perennial,position,reproduction,seed,shape,spacing,sparing,staman,texture,width
167	wfo-0001026994	success	266	83	62	204	21	0.233	-30,0.5,0.5-0.8,0.5-2,1,1-1.4,1-1.6,2-2.6,20-50,4,4-15,6-20,abaxially,anther,apex,beneath,bright,brown,capitate,cm,corolla,dark,densely,diameter,elliptic,filament,flower,fruit,globose,grayish,green,greenish,hair-like,herb,imparipinnate,inflorescence,interrupted,leaf,less,mm,moderately,narrowly,obovate,outgrowth,ovary,paler,pedicel,peduncle,perennial,petiole,pubescent,purple,rachi,rotate-stellate,sparsely,stigma,stripe,style,surface,velvety,white,yellow	-0.7,-10,-20,-foliate,.2,.5,0.05-0.1,0.05-0.2,0.1,0.1-0.2,0.1-0.3,0.15-0.2,0.2-0.4,0.2-0.5,0.25,0.3-0.4,0.4-0.5,0.4-1.2,0.5-0.6,0.5-0.7,0.5-0.9,0.5-1.2,0.5-1.3,0.7-2.5,0.9-1.2,0.9-1.3,1-1.2,1-1.5,1-2,1.2-1.6,1.2-3.5,1.4-2.1,10-20,12-,2,2-,2-4,2-5-locular,2.2-3.2,2.5-6.5,3,3-branched,4-celled,5,5-,5-7,7-13,8,8-12,absent,abundant,acroscopically,acuminate,acute,additional,adpressed,along,also,amongst,andscattered,anthesi,apical,apically,appearance,appendage,articulate,articulation,basal,basally,base,basiscopically,becoming,bent,berry,bifurcate,bifurcation,bract,bracteate,branched,broader,broadly,calyx,cell,celled,column,conical,crenat,crenate,crowded,darker,decreasing,decumbent,decurrent,deeply,developed,distal,eaf,ebracteate,edicel,eed,eglandular,erect,especially,essentially,exserted,fewer,fruiting,giving,glabrous,glandular,gree,habitat,hal,half,halfway,head,interjected,internode,investing,irregularly,lamina,lanceolate,large,larger,largest,lateral,leaflet,leave,like,lobe,lobed,locule,lon,long,loosely,lower,margin,markedly,medial,midvein,minutely,much,narrower,narrowing,nearly,nflorescence,node,oblique,occasionally,often,pair,papillate,petiolule,present,primary,pseudostipule,puberulent,rarely,reflexed,regularly,ripe,robust,rocky,secondary,sessile,set,shaggy,short,silky,simple,sinus,size,slightly,sometimes,specimen,spreadin,spreading,staminal,stem,sterile,straight,tall,tem,terminal,tertiary,testa,thick,tip,toward,trichome,tube,ud,unicellular,uniseriate,unit,usually,wall,weak-walled,well,wide,winged,woody,ympodial,young	abaxial,adaxial,arrangement,colour,form,growth,height,history,length,life,na,number,plant,position,reproduction,seed,shape,spacing,staman,texture,width
168	wfo-0001026996	success	188	90	65	123	25	0.346	0.6-1,1-2,1.8-4.4,14-33,15-28,3-10,3-5,3.3-6,4.5-10.5,5-8,abaxially,acumen,adaxially,anther,apex,blue,brownish,cell,clavate,cm,condition,coriaceous,corolla,covering,dark,deep,diameter,drying,elliptic,filament,flower,forked,fresh,fruit,glabrous,globose,green,greenish,hair-like,herb,lateral,leaf,lilac,medium,mm,odd-pinnate,ovate,ovoid,pedicel,peduncle,pentagonal,petiole,plant,rotate,seed,stigma,stripe,style,terminal,testal,thick,wall,white,whitish,yellow	0-6,0.9-2.7,1-3,1-4,1-5,1.2-1.8,1.3-7.7,2-3,3-7,3.8-14.1,4-4.4,4-8,5-merou,6-8,6.9-10.9,8.7-18.6,abaxiall,acuminate,acute,ag,along,alyx,apart,apparently,arranged,articulated,asymmetric,attenuate,axe,axillary,base,basiscopic,bead,berry,blade,bud,capitat,connivent,considerably,decreasing,digestion,distal,dorsally,eaf,edge,eed,enzyme,erec,exceeding,flat,folded,geminat,generally,glabrou,green-white,half,homostylous,honeycomb-shaped,interjected,lanceolate,larger,leaflet,lengthening,like,linear,living,lobe,long,lower,make,middl,moniliform,mottled,mucilaginous,multiple,necklace,nflorescence,orbicular,orolla,pair,perfect,petiolulate,plurifoliate,pore,poricidal,purple,removed,ripe,rounded,ruit,sessile,seudostipule,side,size,slightly,slit,sometimes,spaced,specimen,stamen,stolon,straight,subglabrou,subtending,symmetric,tall,tamen,tem,throughout,tip,tissue,toward,tri-,tube,tuber,typically,unit,unwinged,usually,vary,wet,x,ympodial	abaxial,adaxial,arrangement,capitate,colour,form,growth,height,history,inflorescence,length,life,na,number,ovary,perennial,position,rachi,reproduction,shape,spacing,staman,surface,texture,width
169	wfo-0001027009	success	226	80	61	165	19	0.27	0-0.3,0.4-1,0.5-2,0.8-2.1,2-3,4-6.5,5-23,5-merous,7-11,7-12.5,adaxially,andromonoecious,anther,black,brown,capitate,chartaceous,cm,densely,diameter,dimorphic,elliptical,erect,extra-axillary,filament,flower,fruit,glabrous,glandular,globose,green,grey,grey-green,hair,inflorescence,length,markedly,minutely,mm,ovate,pale,pedicel,peduncle,perennial,petiole,plant,pseudo-racemose,purple,reticulate,rhizomatous,ripe,rotate,shrub,slightly,stellate-pubescent,stigma,strongly,style,surface,yellow,yellowish-green	%,0-0.2,0-0.5,0-1.2,0-1.5,0-15,0-5,0-8,0.1-0.2,0.15-0.3,0.7-0.9,0.7-1,0.7-1.3,0.8-1.2,0.8-1.3,1-1.5,1-1.8,1-2,1-2.5,1-3,1-5,1-9,1.3-2.2,1.4-4,1.6-3.5,10-15,10-20,2-4,2-6,2-foliate,2.3-3,20-30,23-48,3-10,3-3.5,3-5,3.3-3.6,35-400,4-9.5,40-125,5,5-7,6-8,6-9,6.5-11,7-8,abaxially,absent,abundant,accrescent,acicular,acute,adaxiall,alyx,apart,apex,armed,articulated,ascending,attenuate,axe,ba,basal,base,bilobe,bisexual,blade,broad-based,broadly,calyx,connivent,cuneate,curved,cylindrical,d.,deeply,deflexed,deltate,directed,distal,distall,distributed,dult,eaf,eed,eglandular,entire,finger,fruiting,functional,geminate,gland-tipped,half,heterostylous,incised,index,interpetalar,juic,lamina,lanceolate,larger,lateral,lobe,lobed,lobing,lon,long,longer,lower,male,margin,mature,mesocarp,midpoint,midvein,minute,moist,nflorescence,oblique,obtuse,orolla,part,per,pore,porrect,presen,present,prickle,pricklie,probably,rarely,ray,ridged,ruit,shallowly,short,side,simple,spaced,stage,stalk,stellae,stem,straight,tal,tamen,terete,thick,throughout,time,tip,tissue,tube,unarmed,unbranched,unit,unknow,uvenile,vary,vein,white,wide,x,yellowish,ympodial	bilobed,colour,corolla,form,growth,height,history,leaf,life,na,number,ovary,position,reproduction,seed,shape,spacing,staman,texture
170	wfo-0001027010	success	198	82	58	140	24	0.293	0.4-5.1,0.5-1.5,1-2,10-60,14-46,2.1-4.3,2.2-12.9,3-10,3-5,4-12,4-8,abaxially,adaxially,anther,articulated,brownish,clavate,cm,coriaceous,corolla,deep,diameter,drying,elliptic,filament,flower,forked,fruit,glabrescent,glabrous,green,greenish,herb,leaf,light,mm,mucilaginous,occasionally,odd-pinnate,ovate,ovoid,pedicel,peduncle,pentagonal,petiole,plant,purple,rotate,scabrous,seed,stigma,stripe,style,terminal,wet,white,whitish,yellow	0-2,0-2.5,0-3,1-10,1-4,1-7,1.2-1.7,1.2-1.9,1.4-6.9,2-6,2-9.4,2.1-15.3,3-6,3-8,3.5-13.6,4.4-29,4.9-31,5-13,5-14,5-merou,acumen,acuminate,acute,adaxiall,ag,along,alyx,apart,apex,apparently,arranged,asymmetric,attenuate,axe,axillary,base,basiscopic,bead,blade,bud,capitat,cell,coloration,condition,connivent,covering,decreasing,digestion,distal,dorsally,eaf,edge,eed,enzyme,erec,exceeding,flat,folded,fresh,geminat,generally,glabrescen,glabrou,green-white,hair,hair-like,hal,half,high,homostylous,honeycomb-shaped,interjected,lanceolate,larger,lateral,leaflet,lengthening,like,living,lobe,long,lower,make,moniliform,multiple,narrow,necklace,nflorescence,orbicular,orolla,pair,perfect,petiolulate,plurifoliate,pore,poricidal,present,removed,ripe,rounded,ruit,scabrou,sessile,seudostipule,short,side,size,slightly,slit,sometimes,spaced,specimen,spot,stamen,stolon,straight,subequal,subtending,tall,tamen,tem,testal,thick,throughout,tip,tissue,toward,tri-,tube,tuber,typically,unit,usually,vary,wall,wide,wing,winged,x,ympodial	abaxial,adaxial,arrangement,capitate,colour,form,growth,height,history,inflorescence,length,life,na,number,ovary,perennial,position,rachi,reproduction,shape,spacing,staman,surface,texture
171	wfo-0001027019	success	142	76	50	92	26	0.352	0-0.5,1-1.5,1.5-2,2-8,4-5,abaxial,acute,anther,apex,branched,bright,capitate,cm,corolla,deflexed,densely,erect,filament,flattened,glabrous,globose,green,inflorescence,leaf,lobed,minutely,mm,obovate,opposite,ovary,ovoid-reniform,pale,papillose,pedicel,petiole,pitted,plant,pubescent,shrub,small,spaced,sparsely,stigma,style,surface,tan,tree,white,winged,x	.5,/4,0.5-1,1-2,1.5-3,1/2,10,10-40-flowered,12-30,2-3,2-5,4-8.5,7-14,abaxially,abruptly,adaxially,along,anthesi,apparent,attenuate,ba,bark,base,berry,calyx,constriction,cyathiform,deltoid,dia,difoliate,distal,eaf,edicel,eed,ellipsoid,elliptic,even,exserted,fleshy,free,fruiting,geminat,glabrate,golden,inflorescenc,largely,later,like,live,lobe,lon,long,lower,major,midrib,minor,narrowed,nflorescence,older,onto,overlapping,papillo,planar,pore,poricidal,portion,reddish-brow,rest,ruit,scar,shaped,somewhat,stem,straight,strongly,tall,tapering,tear-drop,third,tip,trichome,tub,tube,ud,unit,waxy,way,widest,wing,woody,ympodial,young	10-40,adaxial,arrangement,colour,diameter,flower,form,fruit,growth,height,history,length,life,na,number,peduncle,perennial,position,rachi,reproduction,seed,shape,spacing,staman,texture,width
172	wfo-0001027030	success	234	109	86	148	23	0.368	-11,-15,.5,0.2,0.4-0.5,0.4-0.8,0.5-1,0.6-0.7,0.7-1,0.8-0.9,1,1-3,1.6-2,2-7,abaxial,abundant,anther,articulated,branched,bright,brown,capitate,cell,cm,conical,corolla,crenate,dark,densely,denser,diameter,distal,due,elliptic,entire,evenly,filament,flower,fruit,globose,green,hair-like,half,herb,imparipinnate,inflorescence,interrupted,irregularly,lamina,lateral,like,margin,minutely,mm,narrowly,obovate,outgrowth,ovary,pale,paler,papillate,pedicel,peduncle,perennial,petiole,pseudostipule,pubescence,pubescent,rotate-stellate,simple,small,soft,sometimes,sparsely,spread,stem,stigma,style,surface,testa,trichome,uniseriate,vein,velvety,wall,yellow	.2,0-4,0.05-0.1,0.1-0.7,0.1-0.9,0.15-0.2,0.2-0.3,0.2-1,0.3-,0.3-0.5,0.3-0.7,0.4-1.5,0.5,0.5-,0.5-0.7,0.5-0.8,0.6-0.8,0.6-1.8,0.8-1,0.9-1.1,1-,1-1.2,1-1.3,1-3.4,1.2-1.6,1.5-,2-,2-3,2-4,2-4.8,2-6,2-foliate,2-locular,2.2-3.2,3-4-celled,3-8,3-9,4-celled,5-12,8-celled,abaxially,absent,acuminate,acute,adaxially,adpressed,angled,anthesi,apex,apical,appearance,appendage,articulation,axi,basal,base,basiscopically,beneath,berry,beyond,bract,calyx,column,crenat,crenation,darker,decurrent,deeper,deeply,diamete,eaf,edicel,eed,eglandular,exserted,extremely,fruiting,giving,gland,glandular,grayish,gree,growt,hal,halfway,interjected,internode,interspersed,investing,lanceolate,larger,leaflet,less,lobe,lon,long,longer,loosely,lower,multicellular,near,nflorescence,node,oblique,occasionally,often,pair,petiolule,present,primary,reflexed,robust,ruit,secondary,sessile,silky,similar,size,slender,slightly,smaller,somewhat,spreadin,spreading,staminal,sterile,straight,stripe,tall,tem,terminal,tertiary,thick,tiny,trailing,truncate,tube,ud,unicellular,unit,usually,weak,white,wide,winged,woody,ympodial,young	1-4,2-9,adaxial,arrangement,bud,colour,dioecious,form,growth,height,history,leaf,length,life,number,plant,reproduction,seed,shape,spacing,staman,texture,width
173	wfo-0001027035	success	199	90	66	133	24	0.332	0.1-0.9,0.3-2.3,0.4-12.8,1-2,1.8-5.2,10-80,2-38,3-10,3-5,4-18.5,acuminate,acute,anther,apex,blue,brownish,cell,clavate,cm,coloration,completely,corolla,covering,deep,diameter,drying,elliptic,filament,flower,forked,fruit,glabrescent,glabrous,globose,green,greenish,hair-like,herb,lateral,leaf,light,lilac,medium,mm,odd-pinnate,ovate,ovoid,pedicel,peduncle,pentagonal,petiole,plant,purple,rotate,seed,shape,sometimes,stigma,stripe,style,terminal,testal,thick,wall,whitish,yellow	0-36,0-7,0.5-3.4,0.5-5,0.5-7,0.8-3,0.8-4.2,0.9-3.1,1-3,1-3.4,1-8,1.5-5.9,1.7-8,2-7,2.8-10.3,4-18,4.9-23.5,5-merou,abaxially,acumen,adaxiall,adaxially,ag,along,alyx,apart,apparently,arranged,articulated,asymmetric,attenuate,axe,axillary,base,basiscopic,bead,blade,bud,capitat,condition,connivent,decreasing,digestion,distal,dorsally,eaf,edge,eed,enzyme,erec,exceeding,flat,folded,fresh,geminat,generally,glabrescen,glabrou,green-white,hair,hal,half,high,homostylous,honeycomb,interjected,lanceolate,larger,leaflet,lengthening,like,living,lobe,long,lower,make,moniliform,mucilaginous,multiple,necklace,nflorescence,orbicular,orolla,pair,perfect,petiolulate,plurifoliate,pore,poricidal,present,removed,ripe,rounded,ruit,second,sessile,seudostipule,shaped,short,side,size,slightly,slit,smaller,spaced,specimen,stamen,stolon,straight,subequal,subglabrous,subtending,tall,tamen,tem,throughout,tip,tissue,toward,tri-,tube,tuber,typically,unit,unwinged,usually,variable,vary,wet,white,wide,x,ympodial	abaxial,adaxial,arrangement,capitate,colour,form,growth,height,history,inflorescence,length,life,na,number,ovary,perennial,position,rachi,reproduction,spacing,staman,surface,texture,width
174	wfo-0001027050	success	244	101	79	165	22	0.324	-12,-9,/3,0.3-1.5,0.5-3,1-2,1.5-6,10-13.5,15-50+,2-5,2-8,5,5-9,5-merous,abaxial,acuminate,acute,adaxial,anther,apex,base,berry,branched,broadly,brown,capitate,chartaceous,closely,cm,conical,densely,diameter,drying,elliptic,ferruginous,filament,flattened-reniform,flower,fruit,glabrous,green,growth,heterostylous,inflorescence,lateral,leaf,leaf-opposed,length,lobed,minutely,mm,moderately,often,ovate,pale,pedicel,peduncle,petiole,plant,pubescent,ripe,several,shrub,small,spaced,spherical,stellate-pubescent,stigma,style,surface,time,touching,tree,unbranched,way,white,whitish,yellow,yellowish-green	.2,.5,0-0.2,0-3,0.1-0.3,0.1-3,0.2-0.5,0.2-1,0.8,0.9-2.1,1,1-1.5,1.5-2,12-15,2-2.5,2-3,2-4,2.5-3,3-5,4-20,4-8,5-10,5-6,5-7,50,6-8,7-30+,8-26,abaxially,absen,absent,abundant,adaxiall,adult,alyx,andromonoeciou,apar,arme,articulated,axe,bark,basal,blade,branch,broad,broad-based,brow,calyx,coarsely,connivent,cordate,cuneate,curved,deeply,difoliate,directed,distal,distall,distally,eaf,eed,eglandular,entire,equal,erec,erect,except,flattened,free,fruiting,geminat,glandular-puberulent,hair,half,infructescence,inside,interpetalar,juicy,juvenile,lanceolate,larger,least,less,like,lobe,long,long-styled,longer,lower,margin,markedly,mature,mid-way,midpoint,midrib,midvein,minute,moist,mucilaginous,multiseriate,narrowly,near,nflorescence,numerous,oblique,obtuse,occasionally,older,orolla,oung,ovate-lanceolate,papillat,per,pericarp,pore,poricidal,porrect,portion,present,prickle,pricklier,prickly,ray,rest,rounded,ruit,scar,scattered,secondary,sessile,shallowly,shiny,short-stalked,short-styled,shorter,side,slightly,somewhat,sparsely,stalk,stalked,stellate,stem,straight,tall,tamen,terete,thicker,tip,tissue,toothed,triangular,trichome,truncate,tube,unarmed,unit,usually,vary,weakly,wide,woody,ympodial,young,younger	alternate,apart,armed,arrangement,colour,corolla,form,height,history,life,na,number,ovary,papillate,perennial,position,reproduction,seed,shape,spacing,staman,texture
175	wfo-0001027050	success	234	90	70	164	20	0.299	0.5-1,0.5-3,1-2,1-5,1.5-2,1.5-6,10-13.5,15-50+,2-10,2-5,2-8,3-15,5,5-9,5-merous,andromonoecious,anther,apart,branched,broadly,brown,chartaceous,cm,contiguous,densely,diameter,elliptic,extra-axillary,ferruginous,filament,flattened,flower,forked,fruit,glabrous,globose,green,growth,inflorescence,leaf,leaf-opposed,length,minutely,mm,moderately,nearly,ovate,pale,pedicel,peduncle,petiole,pitted,plant,rachi,shrub,simple,small,spaced,stellate,stellate-pubescent,stigma,style,surface,tree,unbranched,white,whitish,x,yellow,yellowish-green	.2,0-0.2,0-0.5,0-1,0-3,0.1-3,0.2-0.6,0.2-1,0.3-0.6,0.4-1,0.5-0.8,0.8,1-1.5,10-30,11-21,12-15,14-20,16-40,2-2.5,2-3,2-3-locular,2-4,2-6,2-foliate,2.5-3,23-40+,3-5,4-19,4-40,4-8,5-10,5-6,5-7,6-8,7-30+,8-26,8-40+,abaxially,absen,absent,abundant,accrescent,across,acuminate,acute,adaxiall,adaxially,adult,anvil-shape,apex,armed,articulated,axe,ba,base,blade,branche,broad-based,calyx,capitat,coarsely,connivent,cordate,cross-section,cuneate,curved,cylindrical,deeply,directed,distall,distally,distributed,drying,eaf,eed,eglandular,entire,erect,except,exocarp,fruiting,functional,geminat,glandular-puberulent,hair,half,held,interpetalar,juicy,juvenile,lanceolate,lateral,less,like,lobe,lobed,long,longer,lower,margin,markedly,mature,mesocarp,midpoint,midvein,minute,moist,mucilaginous,multiseriate,narrowly,nflorescence,oblique,obtuse,often,orolla,ovate-lanceolate,pair,per,pinnatifid,placenta,pore,porrect,present,prickle,ray,rounded,ruit,scattered,sessile,shallowly,shorter,side,slightly,somewhat,sparsely,stalk,stalked,stellae,stem,straight,tal,tamen,tem,thick,thicker,throughout,time,tip,tissue,toothed,triangular,truncate,tube,unarme,unarmed,unit,upper,upright,usually,vary,weakly,wide,ympodial,younger	abaxial,adaxial,arrangement,capitate,colour,corolla,form,height,history,life,number,ovary,perennial,position,reproduction,seed,shape,spacing,staman,texture
176	wfo-0001027067	success	228	93	73	155	20	0.32	0-1.8,0-6,0-7,0.3-1,0.5-2,1.7-3.3,15-27,2-3,3-6,4-5.5,6-10,7-16,abaxial,acute,adaxially,andromonoecious,anther,apex,articulated,base,black,broadly,brown,chartaceous,cm,dark,densely,diameter,erect,extra-axillary,filament,finally,flattened,flower,fruit,glabrous,globose,green,hair,inflorescence,leaf,length,mm,obtuse,ovate,pale,pedicel,peduncle,perennial,petiole,plant,pseudo-racemose,purple,rachi,rhizomatous,rotate,scattered,simple,slightly,sparsely,sprawling,stellate,stellate-pubescent,stigma,streak,style,truncate,twisted,weakly,white,yellow,yellowish,yellowish-green	%,.05,0-0.1,0-0.2,0-0.5,0-12,0.2-0.4,0.35-0.5,0.4-0.5,0.4-0.7,0.5-1,0.5-1.5,0.8-1,0.9-2.5,1-2,1-4,1-7,1.2-1.4,1.4-2.5,1.5-2,1.7-2.8,11-16,11-20,13-65,15-60,2-10,2-4.5,2-7,2-foliate,2-locular,2.5-3.8,2.5-4,2.7-5,2.9-3.7,20-45,20-50,20-65,3-10,3-4,3-5,3.5-5.5,3.5-9,4-9,5-12.5,5-6,5-9.5,5-merou,5.5-12.5,6-7,6-8,7-11,7-8,8-14,abaxially,absent,abundant,accrescent,acicular,across,adaxiall,adult,alyx,apart,armed,attenuate,axe,ba,bilobe,blade,broad-based,calyx,connivent,cuneate,curved,cylindrical,decimetr,deeply,directed,distall,dult,eaf,eed,eglandular,exocarp,finger,firm,fruiting,functional,geminate,gland-tipped,grey,half,heterostylous,hig,index,interpetalar,juic,juvenile,lanceolate,lateral,less,lobe,lobed,lobing,lon,long,longer,lower,margin,mature,mesocarp,mid-point,midpoint,midvein,minute,moist,nflorescence,oblique,orolla,papery,part,per,pink,pore,porrect,presen,present,prickle,ray,ruit,sessile,short,shrub,side,skin,somewhat,spaced,stalk,stellae,stem,straight,tamen,thick,throughout,time,tissue,transparent,tube,unbranched,unit,vary,vein,wide,x,ympodial	adaxial,arrangement,bilobed,colour,corolla,form,growth,height,history,life,number,ovary,position,reproduction,seed,shape,spacing,staman,surface,texture
177	wfo-0001027069	success	200	112	87	113	25	0.435	0.15-0.8,0.5-1.5,0.8-3.3,1-10,1-2.5,1-7.7,10-25,2-6,3.5-6,4-9,7-10,abaxially,adaxially,along,anther,apex,axillary,blotch,brown,brownish,bud,cell,chartaceous,ciliate,cm,condition,corolla,covering,darker,diameter,drying,elliptic,elliptical-conical,especially,filament,flower,forked,fresh,fruit,glabrescent,glabrous,green,green-white,greenish,hair-like,herb,lateral,light,make,margin,membranous,midrib,minutely,mm,mucilaginous,narrowly,odd-pinnate,ovate,ovoid,pedicel,peduncle,petiole,plant,puberulent,pubescent,purple,rachi,seed,short,simple,sparsely,stellate,stigma,stripe,style,subtending,terminal,testal,thick,throughout,tip,vertical,wall,wet,white,whitish,yellow	0-4,0.2-3,0.5-5,0.5-5.5,1-2,1-5,1.5-12,1.5-3,1.5-5,1.5-6,2-5,2.5-12,3-11,3-19,4-8,5-merou,acumen,acuminate,acute,ag,alyx,apart,apparently,articulated,axe,base,berry,blade,borne,broadly,capitat,connivent,cordate,cuneate,decreasing,decurrent,digestion,distal,dorsally,eaf,edge,eed,end,enzyme,erect,exceeding,flat,folded,geminat,generally,glabrou,hair,half,homostylous,honeycomb-shaped,interjected,lanceolate,lax,leaflet,lengthening,like,linear,living,lobe,long,lower,middl,nflorescence,obtuse,orolla,pair,perfect,petiolule,plurifoliate,pore,poricidal,pubescen,rare,rarely,removed,ruit,seudostipule,singly,size,slightly,slit,sometimes,spaced,specimen,stamen,ste,stem,stolo,straight,subequal,tall,talle,tamen,tem,toward,tri-,truncate,tube,tuber,typically,unequal,unit,unwinged,usually,vary,wide,x,ympodial	abaxial,adaxial,arrangement,capitate,colour,form,growth,height,history,inflorescence,leaf,length,life,na,number,ovary,perennial,position,reproduction,shape,spacing,staman,surface,texture,width
178	wfo-0001027091	success	142	89	52	90	37	0.366	1-1.6,1.1-1.6,1/2-2/3,2.5-3.5,3-8,5-11,9-13,along,annual,anther,armed,beneath,blade,blue,broadly,brown,cm,dark,dm,few-rayed,glabrous,gland,glandular,herb,internodal,lenticular,long,low,main,mm,oriented,ovate,pedicel,petiole,pinnatifid,prickly,radially,reticulately,ridge,scattered,sessile,short-stipitate,spherical,stellae,stellate-pentagonal,surface,terminally,twice,undulate,vein,violet,wrinkled	.3,0.7,0.8,1.8-2.6,2.3-2.9,3-9,30-60,4-10,6-10,6-10-flowere,8.5-11.5,accrescent,across,acute-tipped,alyx,anthesi,arcuate,base,berry,branched,bristly,calyx,campanulate,capitate-glandular,cauline,deltoid,densely,developing,dia,difoliate,divided,dry,eaf,eed,enveloped,extended,fully,geminat,green,hair,high,invested,linear-lanceolate,lobe,lon,longer,maturity,mostly,narrowly,near,nflorescence,obtuse,occasionally,orolla,per,pinnatisect,rounded,ruit,short,simple,slende,sometimes,somewhat,sparsely,splitting,spreadingly,ste,stem,strait,suffused,tamen,tapering,taprooted,terete,tightly,tigma,tub,tube,tyle,unexpande,uniseriate,unit,usually,variously,vary,vestiture,wholly,yello,ympodial,younger	6-10-flowered,abaxial,adaxial,apex,arrangement,colour,corolla,diameter,filament,flower,form,fruit,growth,height,history,inflorescence,leaf,length,life,na,number,ovary,peduncle,plant,position,rachi,reproduction,seed,shape,spacing,staman,stigma,style,texture,unexpanded,width,yellow
179	wfo-0001027102	success	167	90	64	103	26	0.383	.5,0.2-2,0.5-1,0.5-2,1-1.5,1-2.5,1-4,1-6,1.5-2,10-20,15-35,3,3-4,4-5,4-7,abaxially,adaxial,adaxially,anther,apart,apex,chartaceous,cm,curved,diameter,difoliate,elliptic,filament,flattened,flower,forked,fruit,glabrous,globose,lanceolate,leaf,leaf-opposed,mm,moderately,narrowly,orange,pedicel,peduncle,petiole,pubescent,rachi,rarely,ripe,rugulose,shrub,simple,slender,somewhat,stellate,stigma,style,surface,truncate,unbranched,unit,white,x,yellow,yellow-brown	.5-6,0.5,0.5-3,1-2,1-3,15,2-2.5,2-3,3-12,3-5,5-12,<,absen,absent,accrescent,acuman,acuminate,acute,adaxiall,ag,aggregate,almost,alyx,appearance,articulated,axe,ba,base,blade,broad,broadly,calyx,cell,channe,ciliate,congested,connivent,corky,cuneate,cylindrical,deltate,densely,differing,dimorphic,directed,distally,eaf,eed,entire,few-,free,fruiting,geminat,giving,hair,ilament,lobe,long,long-tapered,longitudinal,m.,major,margin,minor,multiseriate,nflorescence,oblong,obtuse,often,one,opening,orolla,ovate,per,perfect,pore,portion,roughened,ruit,short,size,slit,small,spaced,sparsely,stem,stone,straight,subcoriaceous,tal,tem,time,tip,tomentose,triangular,truncat,tube,unarme,usually,vary,wide,ympodial,young	abaxial,arrangement,colour,corolla,form,geminate,growth,height,history,inflorescence,length,life,na,number,ovary,perennial,plant,position,reproduction,seed,shape,spacing,staman,sympodial,texture,width
180	wfo-0001027104	success	141	86	59	82	27	0.418	0.15-0.35,1-3,1-4,1.2-6,1.5-2.3,10-15,2-3,3-5.5,4-15,6-7.5,apex,articulate,branched,cell,cm,corolla,covering,cyme,diameter,dichasial,dichasially,distal,ebracteate,filament,finely,flower,forked,globose,green,green-white,hair-like,half,herbaceous,lateral,mm,monochasial,odd-pinnate,ovate,ovoid,pedicel,peduncle,perennial,petiole,plant,proximal,pubescent,seed,stellate,stigma,style,testal,thick,throughout,tone,wall,white,yellow,yellow-green,¼	0.5-0.8,1-1.5,1.5-4.2,2-6,2.2-5,3-6-foliat,5-15,abaxially,acumen,acuminate,acute,adaxially,apical,apically,attenuate,base,calyx,condition,connate,cordate,dehiscent,digestion,dorsally,eaf,edge,eed,emoval,enzyme,epiphyti,epiphytic-like,exceeding,flat,folded,generally,globo,growing,honeycomb,introrse,linear,living,lobe,lon,long,lower,make,maturing,mos,mucilaginous,mucronate,narrowly,nflorescence,nther,often,orolla,ovat,pattern,perfect,plan,poricidally,rarely,reveal,ruit,seudostipule,short,simple,slit,specimen,stamen,straight,tall,tem,terrestrial,throughou,truncate,tuber-bearing,typically,unit,vary,viole,wide,without,ympodial	abaxial,adaxial,anther,arrangement,colour,form,fruit,growth,height,history,inflorescence,leaf,length,life,na,number,ovary,position,rachi,reproduction,shape,spacing,staman,surface,texture,violet,width
181	wfo-0001027114	success	154	85	58	96	27	0.377	-2,.5,1-1.1,1-2,1.5-2,1/2,2-3,20-40,3-4,3-7,6-8,abaxial,acute,anther,apex,appearing,base,branched,bushy,capitate,cm,corolla,dark,dendritic,densely,elliptic,filament,flattened-reniform,glabrous,globose,green,inflorescence,leaf,lobe,lobed,long,margin,minute,minutely,mm,occasionally,opposite,ovary,pedicel,petiole,pitted,pubescent,reddish-brown,shoot-terminal,shrub,stigma,style,surface,tapering,thickened,trichome,way,white	-17,-30,0.5-1,1-1.2,1-1.5,1.5-1.7,13-21,2-2.5,5,6-9,7-10,7-9,abaxially,adaxially,along,alternating,anthesi,apar,axillary,ba,bark,berry,calyx,closely,commonly,conical,deltate,dia,differing,difoliate,drying,due,eaf,edicel,eed,erect,exserted,flowered,free,fruiting,geminate,glabrou,growt,halfway,inflorescenc,investing,lamina,lateral,like,lon,lower,main,major,many,minor,nflorescence,older,opening,pair,papillo,planar,plurifoliate,pore,poricidal,portion,projection,rapid,reddish,rest,ruit,scar,scattered,several,shoot,simple,size,slit,soft,spaced,stem,tall,time,tip,triangular,tub,tube,ud,unevenly,uniseriate,unit,vein,wide,woody,yellowish,ympodial,young	adaxial,apart,arrangement,colour,diameter,flower,form,fruit,growth,height,history,length,life,na,number,peduncle,perennial,plant,position,rachi,reproduction,seed,shape,spacing,staman,texture,width
182	wfo-0001027117	success	235	88	65	170	23	0.277	0-5,0.1-0.7,0.5-1.5,0.6-0.9,0.7-1.5,1-2,1-4,1.5-2.3,2-3,3-15,4.5-6.5,5-merous,abaxially,acute,almost,anther,apex,articulated,base,berry,black,brown,cell,cm,dark,densely,diameter,erect,evenly,filament,fine,flattened-reniform,flower,fruit,green,herb,lateral,leaf,length,lobed,maturity,mauve,mm,moderately,narrow-lanceolate,outline,ovate,pedicel,peduncle,petiole,pit,raised,rounded,shiny,small,smooth,spherical,staman,stellate,stellate-pubescent,style,surface,yellow,yellow-green,young	-1.5,-11,-12,-2.8,-3/4,.5,/3,0-10,0-15,0-20,0-25,0-40,0.1,0.1-,0.15-0.25,0.15-0.35,0.2,0.2-0.45,0.5,0.7-0.9,0.7-1.3,0.8-,1-6,1.2,1.5-,1.5-6.5,1.7-2.5,1.8-2.5,1/,1/3,1/4,1/8-1/2,10-20,2-6,2-8,2.3-2.8,25-100,3-10,3-6,4-6.5,4-7,4-8,4.5-8,5-11,5-14,6-10,6-9,7-,8,accrescent,acicular,alyx,ame,apar,apart,apically,apparently,attenuate,bark,beyond,blade,branched,brittle,c.,calyx,chartaceous,concolorous,connivent,cordate,curved,deltate,discolorous,distance,drying,eaf,eed,elongating,enclosing,extending,fifth,four,free,fruiting,gently,glabrescent,glabrous,gra,herbarium,infructescence,irregularly,less,lobe,lon,long,long-acuminat,longer,lower,margin,mature,membranous,midpoint,midvein,narrow-deltate,narrow-elliptic,nflorescence,oblong,obovate,older,one,open,orolla,oung,pair,pale,pendulous,per,perfec,pericarp,perpendicular,plurifoliat,poricidal,porrect,portion,prickl,prickle,prickly,primary,ray,red-brown,reduced,reflexed,ruit,scar,sessile,shallowly,shorter,side,sometimes,spaced,sparsely,specimen,spreading,stalk,stalked,stem,straight,tamen,tapering,tearing,terete,tertiary,time,tip,tissue,translucent,trichome,tube,unequal,unit,upper,variously,vary,vein,venation,visible,way,weakly,wide,woody,ympodial	abaxial,adaxial,arrangement,colour,corolla,form,growth,height,history,inflorescence,life,na,number,ovary,perennial,plant,position,reproduction,seed,shape,spacing,stigma,texture
183	wfo-0001027123	success	181	110	84	97	26	0.464	-10,-20,0.8-1.3,1,1-1.2,1-1.5,1.5-2,2-2.6,2-5.5,2-lobed,2.5-4,2.5-6,3-15,5-6,abaxial,acute,adaxial,adaxially,anther,apex,bark,branched,bright,brown,calyx,cell,clavate,cm,commonly,conical,corolla,cup-shaped,dark,dendritic,densely,diameter,elliptic,filament,flattened,flower,fruiting,glabrous,globose,green,inflorescence,leaf,less,margin,mauve-purple,minutely,mm,narrowly,ovary,papillate,pedicel,peduncle,petiole,pitted,pubescent,reddish,reniform,revolute,scar,shining,shiny,simple,soon,spaced,sparsely,stellate,stem,stigma,stoutish,strongly,style,subshrub,surface,terminal,trichome,turned,violet,widely,x,young	.3,.5,0.3-1.6cm,0.5,0.5-0.8,0.7-3.5,0.9-1.3,2-2.2,2-2.5,2-3,2.5-10.4,3-4,4-5,4-6,5-10,along,anthesi,appearing,attenuate,axe,axi,base,broadly,campanulate,completely,constricted,coriaceous,darker,deltate,denser,drying,eaf,edge,eed,enlarged,erect,exerted,fide,free,glandular,inserted,lamina,lax,lewi,like,lobe,lobed,lon,long,loose,loosely,lower,midvein,minute,monopodia,nflorescence,nodding,older,outline,pair,papillae,perfect,perhaps,petal,planar,plurifoliate,portion,primary,prominent,scatted,scattered,shin,shinin,short,sinuate,sleeve,slightly,sometimes,straight,testal,thick,time,tip,trailing,tub,tube,ud,unit,upper,usually,vein,warty,way,white,wood,ympodial,¾	0.3-1.6,arrangement,bud,center,colour,form,fruit,growth,height,history,length,life,na,new,number,plant,position,prickle,rachi,reproduction,seed,shape,spacing,staman,texture,width
184	wfo-0001027125	success	155	94	67	88	27	0.432	0,0.5,1,3,abaxially,acuminate,acute,adaxially,anther,anthesi,apex,armed,base,blue,branched,brown,clavate,cm,connivent,corolla,diameter,ellipsoid,elliptic,elongating,entire,filament,flattened,fleshy,flower,foveolate,fruit,glabrous,globose,green,internode,lateral,light,major,margin,mm,mostly,narrowly,oblong,pedicel,peduncle,petiole,prickle,rachi,recurved,rugose,side,simple,slender,somewhat,spreading,stem,stigma,strongly,style,surface,terminal,thick,truncate,vein,vine,yellow,×	.5,/4,0.3,0.3-0.6,0.8,1.2-2,10–,10–15,12,12–17,1–,25–50,3–,3–10,3–5,3–7,4,4–6,5,50,5–10,5–7,6,6–,6–9,?,absent,ag,alyx,apiculate,articulated,axe,ba,becoming,bilobe,blade,bud,calyx,campanulate,clustered,completely,coriaceous,cucullat,deeply,dr.,eaf,eed,equal,exserted,lengthening,lobe,lobed,long,long-styled,lower,middle,midrib,minutely,nflorescence,orolla,papillate,plurifoliat,pore,poricidal,recurve,robust,rounded,ruit,slit,stellate,stout,subwoody,tamen,terminally,thickened,time,tip,triangular,tube,unit,vary,way,wide,widest,woody,ympodial,youn,–9	0.3-0.8,1-7,10-15,10-50,3-10,3-5,4-6,6-17,6-9,9,abaxial,arrangement,bilobed,colour,dry,form,growth,inflorescence,leaf,length,ovary,position,seed,shape,staman,texture,width
185	wfo-0001027131	success	186	61	40	146	21	0.215	0.9-2.5,1-1.5,1.5-3.3,12-20,5.5-6.5,9.5-11.5,andromonoecious,anther,black,brown,cm,dark,densely,diameter,erect,extra-axillary,fruit,globose,green,grey,inflorescence,length,mm,ovate,pale,perennial,petiole,plant,pseudo-racemose,purple,rhizomatous,rotate,shrub,stellate-pubescent,streak,style,white,yellow,yellowish,yellowish-green	%,.05,.7,0-0.1,0-0.3,0-2,0-3,0-5,0.2-2.2,0.4-0.8,0.4-1,0.5-0.8,0.5-1,0.7-2.5,1-1.2,1-2,1-3,1-4,1.4-2,1.7-3.5,17-35,2-5,2.3-2.7,2.6-3,3-4,3-9,4-10,4-7,4-8,4-locular,4.5-8.5,5-merou,7-11,7-8,7-9,abaxially,absen,absent,across,acute,adaxiall,adaxially,alyx,anvil-shape,apart,apex,articulated,ascending,attenuate,axe,ba,base,blade,broad-based,calyx,chartaceous,circular,cordate,cross-section,cylindrical,d.,directed,distall,distally,distributed,dult,eaf,eed,eglandular,elliptical,entire,exocarp,finger,flower,fruiting,functional,geminat,gland-tipped,hair,half,heterostylous,hig,juicy,lamina,lateral,less,lobe,long,longer,lower,margin,markedly,mature,mesocarp,mid-point,midpoint,minute,moist,nflorescence,oblique,obtuse,onl,orolla,part,pedicel,peduncle,per,placenta,plurifoliate,pore,porrect,possibly,present,prickle,ray,ridged,ruit,rusty,short,simple,spaced,stage,stalk,stalked,stellae,stem,straight,tamen,terete,thick,thicker,thicknes,throughout,time,tube,unarme,unarmed,unbranched,unit,unknow,uvenile,vary,weakly,wide,x,ympodial	abaxial,adaxial,colour,corolla,filament,form,growth,height,history,leaf,life,na,ovary,position,reproduction,seed,shape,staman,stigma,surface,texture
186	wfo-0001027146	success	213	98	73	140	25	0.343	0.3-2.2,1-10,1-2,1-9.5,13-36,2-4.2,3.3-6.1,4-12.5,4-38,6-10,6-17.5,abaxially,acuminate,adaxially,anther,apex,articulated,brownish,cell,clavate,cm,coarsely,condition,conical,corolla,covering,dark,deep,diameter,drying,elliptic,filament,finely,flower,forked,fresh,fruit,glabrous,green,greenish,hair-like,herb,lateral,leaf,medium,minutely,mm,odd-pinnate,ovate,ovoid,pedicel,peduncle,pentagonal,petiole,plant,puberulent,pubescent,purple,ripe,rotate,seed,stigma,style,terminal,testal,thick,throughout,tinged,violet,wall,white,whitish,yellow	0-11,0.5-3.2,0.6-3.3,0.7-2.4,0.8,0.8-3.1,0.8-5.8,1-2.5,1.9-10,10,2-12.2,2-13,2-5,3.5-22,4-11,4-8,5-merou,6,6.5-52,acumen,ag,along,alyx,apart,apparently,arranged,asymmetrical,attenuate,axe,axillary,base,basiscopic,bead,berry,blade,bud,capitat,chartaceous,ciliate,commonly,connivent,darker,decreasing,digestion,distal,dorsally,eaf,edge,eed,enzyme,erec,especially,exceeding,flat,folded,fourt,fourth,geminat,generally,glabrou,gradually,green-white,hair,half,homostylous,honeycomb-shaped,interjected,lanceolate,leaflet,lengthening,like,living,lobe,long,lower,make,margin,membranous,midrib,minute,moniliform,mottled,mucilaginous,multiple,necklace,nflorescence,orbicular,orolla,pair,perfect,petiolule,plurifoliate,pore,poricidal,proximal,rarely,ray,removed,ruit,secondary,semierect,sessile,seudostipule,side,simple,size,slit,sometimes,spaced,specimen,stamen,ste,stem,stolon,straight,subequal,subglabrou,subglabrous,subsessile,subtending,symmetrical,tall,tamen,tem,tip,tissue,toward,tri-,tube,tuber,typically,unit,unwinged,usually,vary,wet,wide,wing,x,ympodial	abaxial,adaxial,arrangement,capitate,colour,form,growth,height,history,inflorescence,length,life,na,number,ovary,perennial,position,rachi,reproduction,shape,spacing,staman,surface,texture,width
187	wfo-0001027154	success	215	91	59	156	32	0.274	-16,0.4-0.5,1-1.3,2-6,26,5,8-11,anther,apart,apex,attenuate,chartaceous,clavate,cm,densely,diameter,extra-axillary,filament,flattened,flower,foveolate,fruit,globose,green,immature,leaf,length,mature,minutely,mm,ovate,pedicel,peduncle,petiole,plant,pubescent,rachi,reniform,rotate-pentagonal,rounded,sessile,shape,shrub,simple,slightly,sometimes,stellae,stellate-tomentose,stigma,style,sulcate,surface,tan,tomentose,unknown,white,x,yellow,yellowish	-15,.2,.5,.6,0,0.2,0.3–0.6,1.5–2.5,1.5–3,1.9,17–19,1–2,2,2.5-5,2.9,23,2–2.5,2–4,3-7,35,3–10,4.5–5,4.5–8,4–8,6–8,6–9-rayed,7.5-11,7–20,8,abaxially,absent,accrescent,acute,adaxiall,adaxially,ag,alyx,ample,armed,articulated,axe,ba,basal,base,berry,blade,branch,branched,broad,broad-based,calyx,capitat,color,connivent,curved,cylindrical,deltate,difoliate,directed,distally,eaf,eed,entire,evidently,except,ferruginous,finer,flowering,free,fruiting,geminat,glabrescen,glabrous,hair,highly,ilament,interpetalar,irregularly,juvenile,lanceolate,larger,less,lighter,like,linear,lobe,lobed,lognitudinal,long,m.,major,margin,midpoint,midrib,minute,mostly,much,near,nearly,nflorescence,normally,oblique,often,older,opening,orolla,outline,paler,part,per,perfect,pinnately,pore,prickle,rarely,ray,reaching,recurved,reflexed,repand,ruit,shiny,side,sinus,size,slit,smaller,spaced,sprout,ste,stem,stipe,stipitate,stout,straight,tal,tardily,tem,third,three,tissue,truncate,tube,unarme,unarmed,underside,uniform,unit,usually,variable,vary,vein,within,ympodial,young,–4	1-2,1.5,1.5-3,10,17-19,2-2.5,2-4,4-8,4.5-5,abaxial,adaxial,arrangement,capitate,colour,corolla,form,growth,height,history,inflorescence,life,na,number,ovary,perennial,position,reproduction,seed,spacing,staman,texture,width
188	wfo-0001027157	success	207	95	70	137	25	0.338	0.15-0.3,0.9-2.8,1-10,1-2,1.5-6.5,10-30,2-15,2-3,3-12,4-5,9-12,abaxially,acute,adaxially,anther,apex,articulated,brownish,cell,chartaceous,clavate,cm,condition,conical,corolla,covering,deeply,diameter,drying,filament,flower,forked,fresh,fruit,glabrous,green,greenish,hair-like,herb,lateral,leaf,membranous,minutely,mm,obtuse,odd-pinnate,orbicular,ovate,ovoid,pedicel,peduncle,petiole,plant,puberulent,pubescent,ripe,seed,sometimes,stellate,stigma,style,terminal,testal,thick,tinged,violet,wall,white,whitish,yellow	0-3,0.7-2,1,1-3,1-3.8,1-6,2,2-2.5,2-5,2.3-4,2.5-3,3-7,3.3-7.8,3.8-8.3,5-merou,6.5-14.5,absent,acumen,acuminate,ag,along,alyx,among,apart,apparently,attenuate,axe,axillary,base,berry,blade,broadly,bud,capitat,ciliate,connivent,cordate,cuneate,decreasing,decurrent,densely,digestion,distal,dorsally,eaf,edge,eed,elliptic,end,enzyme,erec,especially,exceeding,flat,folded,geminat,generally,glabrou,grassland,greatly,green-white,hair,half,homostylous,honeycomb-shaped,interjected,lanceolate,leaflet,lengthening,like,living,lobe,long,low-growing,lower,make,margin,markedly,middl,midrib,mucilaginous,narrowly,nflorescence,oblique,one,orolla,pair,perfect,petiolulate,petiolule,placed,plurifoliate,pore,poricidal,rarely,removed,rounded,ruit,semi-rosette,sessile,seudostipule,shady,short,situation,size,slightly,slit,spaced,specimen,stamen,ste,stem,stolo,straight,subsessile,subtending,sunny,tall,tamen,tem,throughout,tip,toward,tri-,tube,tuber,typically,unequal,unit,unwinged,usually,vary,wet,wide,woodland,x,ympodial	abaxial,adaxial,arrangement,capitate,colour,form,growth,height,history,inflorescence,length,life,na,number,ovary,perennial,position,rachi,reproduction,shape,spacing,staman,surface,texture,width
189	wfo-0001027184	success	219	121	96	123	25	0.438	.3,.5,.7,0-0.2,0.2-0.4,0.4-2,0.5-2,0.8,1.5-5,19,2,4,5-7,abaxially,acute,adventitious,anther,apart,apex,base,brown,calyx,chartaceous,cm,connivent,covered,cylindrical,diameter,elliptic,entire,epidermal,extension,fasciculate,filament,flattened,fleshy,flower,foliaceous,fruit,glabrescent,glabrous,globose,hair,hairlike,herbaceous,imparipinnate,lanceolate,leaf,leaflet,least,light,margin,membranous,meter,minutely,mm,mostly,narrowly,oblong,older,opposite,orange,ovate,pedicel,peduncle,petiole,pilose,prominently,pseudostipule,puberulent,pubescent,rachi,red,reticulate,revolute,ripe,root,several,shape,size,slightly,sparsely,stellate,stem,stigma,straight,style,subopposite,surface,tip,unbranched,vine,wall,x,yellow,young	.8,0-,0.4–0.9,0.8–1.6,0–3,1-2,1.5,1.8–3.5,13–18,1–2,1–2.5,1–4,2.8–4.1,2–4-celled,3-4-,3-foliolate,3.5–8,3–,3–4-celled,4–12,5,7,9,absent,accrescent,adaxiall,adaxially,ag,along,always,alyx,appressed,articulated,axe,axi,axillary,ba,basal,blade,blue,borne,bract-like,branch,broad,broadly,cell,clavat,cluster,cordat,densely,directed,eaf,eed,especially,free,fruiting,geminat,generally,glabrou,grading,half,ilament,introrsely,larger,largest,lateral,leafy,less,like,lobe,long,longitudinal,lower,m.,midrib,much,nearly,nflorescence,node,obtuse,often,opening,orolla,ower,per,petiolule,plurifoliate,pore,portion,prominent,raised,rarely,ruit,scarcely,secondary,shoot,short,simple,slit,small,soft-woody,somewhat,spaced,sulcate,terminal,tertiary,tightly,tree,truncate,trunk,tube,unarme,unequal,uniform,unit,usually,vary,vein,visible,weak,white,ympodial,–9	0-3,1-4,13-18,3-9,3.5-8,4-12,abaxial,adaxial,arrangement,clavate,colour,cordate,corolla,form,growth,height,inflorescence,length,number,ovary,plant,seed,spacing,texture,type
190	wfo-0001027186	success	168	117	91	77	26	0.542	0.5-1,1-1.5,1-2.5,1.4-1.6,1.5-2,2-6,2-lobed,3.5-4,30-40,4-9,5-10,6-7,abaxial,abaxially,adaxially,anther,apart,apex,bark,berry,branch,broadly,brown,calyx,clavate,cm,conical,corolla,dark,dendritic,diameter,dry,ellipsoid,elliptic,entire,filament,filiform,flower,fruit,fruiting,glabrous,globose,golden,green,growth,lamina,lobed,loose,margin,maturity,minutely,mm,narrowly,new,occasionally,ovary,ovoid,pale,pedicel,peduncle,petiole,pitted,plane,pointed,pubescent,rachi,reddish,reniform,scar,scattered,seed,shiny,short,simple,slightly,sparsely,spreading,stalk,stem,stigma,style,surface,terminal,tip,tree,trichome,uniseriate,variably,white,woody,yellow	-6,.4,.5,1.5,1.5-2.5,1.6-5,15,2.5-3,3-4,4-15,9-10,?,acute,age,always,anthesi,apparently,attenuate,axil,base,branched,dbh,deflexed,deltate,denditic,densely,denser,eaf,enlarging,exerted,free,glabrescent,immature,incrassat,irregularly,keeled,lengthening,less,like,lobe,longer,lower,m.,midrib,much,nflorescence,pair,papillat,papillate,pendent,perfect,pericarp,planar,plurifoliat,pore,poridical,portion,primary,pubescen,rough,ruit,slit,small,soon,spaced,straight,strongly,time,treelet,tub,tube,ud,unit,vein,way,x,ympodial	0.5,adaxial,arrangement,bud,cell,center,colour,form,height,history,inflorescence,leaf,length,life,na,number,perennial,plant,position,prickle,reproduction,shape,spacing,staman,texture,width
191	wfo-0001027187	success	224	89	53	171	36	0.237	0.6,5-merous,andromonoecious,anther,apex,blue,broadly,cm,darker,deflexed,deltoid-ovate,densely,diameter,downward,extra-axillary,filament,finely,flattened-reniform,flower,forked,foveolate,fruit,glabrous,globose,green,herb,leaf,lenticular,light,maturity,mm,moderately,mottling,obtuse,pedicel,peduncle,perennial,petiole,rotate-stellate,rounded,simple,sky,sparsely,stellate,stellate-pubescent,stigma,style,subglobose,surface,unbranched,weakly,yellow,young	.5,0,0.05–0.1,0.15–0.4,0.2,0.3–1,0.4,0.5,0.5–1,0.5–1.5,0.8–2,1,1-celled,1.0,1.2,1.5–3.5,12,13–18,1–1.5,1–1.8,1–2,1–3,1–3-celled,2,2-,2.5–4,2.5–6,2–2.5,2–3,2–5,2–7,3-foliate,3.2,3.5–10,3–10,3–10.5,3–6,3–7,4,4.5–8,4–5,5,5.4,5.5,5–10,5–11,5–15,5–6,5–8,6,6–8,7,7–12,7–15,9,abaxially,accrescent,acute,acute-acuminate,adaxiall,adaxially,alyx,apart,armed,articulated,axe,base,berry,blade,branched,bud,calyx,capitat,central,chartaceous,completely,connivent,continuum,cordate,covering,cuneate,cylindrical,decumbent,deltate,deltate-lanceolate,directed,distal,distall,eaf,eed,equal,erect,exserted,fruiting,geminat,glandular-puberulent,grading,hair,hermaphroditic,irregularly,lanceolate,lateral,like,lobe,lobed,lon,long,long-stalked,lower,major,margin,minutely,morphology,narrowly,nflorescence,node,offset,often,one,open,orolla,outline,perfect,plurifoliate,pore,prickle,prickle-like,producing,proximal,pubescent,rarely,ray,rind,root,rooting,ruit,serrate,sessile,shallowly,short-stalked,showing,side,sinus,small,sometimes,spaced,spreading,stalk,staminate,stem,stout,straight,strongly,subequal,subsessile,tall,tamen,tapered,tem,toug,triangular,truncate,tube,unequal,unit,usually,vary,vein,wide,ympodial,×	0.5-1.5,0.8-2,1.5-3.5,2-3,2-7,3-10,3-7,3.5-10,5-15,7-12,abaxial,adaxial,arrangement,capitate,colour,corolla,form,growth,height,history,inflorescence,length,life,na,number,ovary,plant,position,rachi,reproduction,seed,shape,spacing,staman,texture,width
192	wfo-0001027198	success	191	113	86	105	27	0.45	.4,.5,0.5-0.75,0.8-1,1-1.5,1-10,1.5-10,3/4,5-6,abruptly,acuminate,acute,anther,apart,apex,axil,base,beneath,broadening,bushy,calyx,channeled,clavate,cm,corolla,cyathiform,decurrent,dia,elliptic,entire,eye,filament,flower,furcate,glabrous,globose,golden,green,inflorescence,invisible,leaf,like,lobed,long,many,medium,minute,minutely,mm,naked,nearly,obovate,often,opposite,ovary,ovoid-reniform,pale,paler,papillose,pedicel,petiole,pitted,plant,puberulent,pubescent,shining,short,shrub,size,slender,slightly,small,stigma,style,styled,surface,tannish-yellow,time,tree,trichome,tube,two,vein,way,white,x	0.05-1.0,0.5-1,0.7-1,1-5,1.5-2,10-11,11-20,2-5.5,4-9,5-120-flowered,7.5-9,always,anthesi,attenuate,ba,beginning,berry,caly,closely,complex,constriction,corky,corresponding,deltoid,dendritic,densely,differing,difoliate,dry,eaf,edge,edicel,eed,erect,evenly,exserted,extremely,female,found,free,fruiting,geminat,glabrate,impressed,inflorescenc,large,lateral,live,lobe,lon,lower,main,major,male,margin,meet,middle,minor,nflorescence,older,overlapping,ovoid,papillo,pendan,planar,pore,poricidal,portion,pubescence,rather,reddi,reflexed,rest,rounded,ruit,scar,sessile,set,shaped,simple,soon,spaced,speciman,specimen,stem,straight,strong,tall,tear-drop,testae,thickened,thin,tip,top,type,ud,undersurface,uniseriate,unit,usually,widest,woody,yellowish,ympodial,young	5-120,abaxial,adaxial,arrangement,colour,diameter,form,fruit,geminate,growth,height,history,length,life,na,number,peduncle,perennial,position,rachi,reproduction,seed,shape,spacing,staman,texture,width
193	wfo-0001027200	success	139	72	45	94	27	0.324	0.25-0.5,0.6-1,1-1.4,1-1.5,1.5-5,3-3.5,6-8,acute,anther,apex,beneath,brown,capitate,cm,corolla,dark,deeply,elliptic,filament,glabrous,globose,green,inflorescence,leaf,lobed,minutely,mm,ovary,ovoid-reniform,papillose,pedicel,petiole,pitted,puberulent,shrub,small,stigma,style,surface,tree,unifoliate,vein,white,x,yellowish	0.05-0.25,0.5-0.75,0.5-1,0.7-2.5,1.2-1.5,1.5-2,1.6-6,2-3,2.5-3,3.5-6,8-15,9-11,across,anthesi,aspec,ba,bark,base,berry,branch,branche,broadly,calyx,conical,converging,decurrent,deflexed,deltoid,densely,dia,differing,eaf,eed,except,flattened,free,fruiting,geminate,giving,golden,grey-brown,horizontally,impressed,lateral,lightly,like,lobe,lon,long,lower,main,major,margin,middle,minor,minute,near,nearly,node,non-reproductive,occasionally,older,onto,papillo,planar,pore,poricidal,portion,prominent,reflexed,rest,ruit,shaped,size,slightly,sparse,sparsely,spreading,stem,straight,tall,tear-drop,tip,trichome,tube,unicellular,uniseriate,unit,widened,widest,winged,woody,ympodial,young	abaxial,adaxial,arrangement,colour,diameter,flower,form,fruit,growth,height,history,length,life,na,number,peduncle,perennial,plant,position,rachi,reproduction,seed,shape,spacing,staman,texture,width
194	wfo-0001027204	success	154	97	68	86	29	0.442	-40,.5-1,0.5-4,1-10,1-14,1-3.5,1.5-3.5,1.5-9,2-2.5,3-20,5-30,5-9,6-10,acuminate,acute,adaxial,along,angled,apex,branched,brown,calyx,chartaceous,cm,dense,diameter,distally,elliptic,especially,expanded,flower,forked,fruit,glabrate,glabrous,globose,greenish,margin,membranaceous,mm,moderately,nearly,orange,pedicel,peduncle,perfect,petiole,pink,pseudohair,pubescent,pubescent-pilose,purplish,rachi,reddish,rugose,shrub,simple,stellate,stellate-campanulate,stigma,style,twice,unbranched,violet,white,x,yellow,yellowish	-4.5,-8,.8-2,1,1-7,1.5-6.5,15-35,2-4,2-5,2-8,3-5,4-5-foliat,4-6,5-19,6-12,8-15,abaxially,absen,adaxially,aggregate,apart,articulated,axe,base,blade,cell,channe,connivent,cuneate,cylindrical,decurrent,densely,denser,directed,distall,eaf,eed,eglandular,entire,except,glandular,hair,lanceolate,leaving,lobe,lon,long,lower,midrib,narrowed,narrowly,near,nflorescence,nther,obtuse,often,orolla,ovate,peg,pore,present,puberulent,pubescen,radiu,ripe,ruit,scar,short,spaced,sparsely,stone,subacute,subcoriaceous,tal,tem,time,tip,triangular,triangular-deltate,truncat,tube,unit,vary,wide,x1-2,ympodial	abaxial,anther,arrangement,colour,corolla,filament,form,growth,height,history,inflorescence,leaf,length,life,na,number,ovary,perennial,plant,position,reproduction,seed,shape,spacing,staman,surface,texture,truncate,width
195	wfo-0001027213	success	231	103	78	153	25	0.338	-19,-230,-3.3,-4.5,0-2.5,0.2-0.4,0.2-0.5,0.7-2.3,0.8-1.8,1-2,1-5,1.2-2.5,12.3-16.3,2-5,2.9-3.8,2.9-4.8,4-9.5,5.7-6.2,8-24,abaxially,acute,adaxially,anther,apart,apex,articulated,base,branched,broadly,brown,cm,conical,corolla,dark,deltoid,diameter,drying,elliptic,filament,flower,fruit,glabrescent,glabrous,globose,green,leaf,length,many,mm,oblanceolate,pale,pedicel,peduncle,petiole,pseudo-terminal,pubescent,rachi,reniform,reticulate-punctate,scabrous,short-attenuate,shrub,simple,sometimes,stellate,stigma,style,surface,time,tomentose,tree,violet,white,whitish-green,x,yellow,yellow-green,yellow-tan	/10,0-160,1.1-1.7,1.2-1.6,1.2-1.7,1.3-2.2,1.7-3.6,1.7-3.9,1.8-2.8,1.8-3.2,1/2-2/3,10-24,2.4-4.7,2.5-5.1,2/3,3.5-5,3.5-8,4.2-5.9,5-7.5,5-8,5-merou,8.2-10.5,9-13,accrescent,acuminate,ag,along,alyx,anthesi,apparently,ark,around,attenuate,axe,axillary,ba,basal,blade,blunt-tipped,branch,calyx,capitat,cell,completely,covering,cuneate,cylindrical,decurrent,directed,distally,eaf,early,edge,eed,entire,enveloping,epidermal,eventually,exserted,farinose,few-rayed,free,fruiting,glabrescen,granular,grayish-brown,group,hair,high,homostylous,immature,inserted,lackin,lanceolate,lateral,lengthening,lobe,lobed,long,long-,long-stalked,longitudinal,lower,m.,main,margin,midrib,mixed,moderately,mostly,multangulat,multangulate,nearly,nflorescence,obovate,obscured,obtuse,often,older,orbicular,orolla,ovate,ovate-lanceolate,partly,perfect,plurifoliate,pore,poricidal,porrect-stellat,porrect-stellate,prominent,pubescence,rather,relatively,ruit,sessile,short,short-,short-stalked,side,slit,somewhat,spaced,sparsely,stamen,stem,subcampanulate,suture,tamen,terete,thick,thick-stalked,thin-stalked,ti,tip,tomentose-pubescent,tomentu,touching,tube,ud,unarme,unarmed,unit,unwinged,vary,vein,vestigial-rayed,way,whitish,wide,yellowish,ympodial,young	5-merous,90-160,abaxial,adaxial,arrangement,capitate,colour,form,growth,height,history,inflorescence,life,na,number,ovary,perennial,plant,position,reproduction,seed,shape,spacing,staman,texture
196	wfo-0001027214	success	181	76	54	127	22	0.298	0.5-0.8,0.7-2.5,1-1.5,1.5,10-13,2,2-9,3-6,abaxially,adaxially,anther,apex,cm,conical,corolla,densely,diameter,elliptic,filament,finely,flattened-round,flower,fruit,glabrous,green,greenish,height,herb,inflorescence,length,lobed,long-conical,minutely,mm,nodding,occasionally,once-branched,ovary,papillate,pedicel,petiole,pinnate,pointed,pubescent,rachi,rugose,seed,sharply,simple,stigma,style,surface,white,x	-20,-38,-9,..,.25,.5,0,0-16,0.25,0.3-1.5,0.3-1.7,0.5-1,0.7-2,0.8-1,1-2.8,1.2-3,1.5-1.8,1.5-6,10-,12-17,15-25,3-,4-5,5-6,6-,6-12,7-12,8-9,absent,acuminate,acute,along,anthesi,anticlinal,apical,basal,base,berry,broadly,calyx,capitat,cell,climbing,composed,conspicuously,decurrent,deltate,dr.,drying,eaf,edicel,eed,epidermal,erect,exserted,extending,free,fruiting,globose,groove,grown,horizontal,inflorescenc,irregular,lamina,lanceolate,lateral,leaflet,less,like,lobe,lon,long,long-acuminate,lower,margin,markedly,midrib,narrowly,nearly,nflorescence,noddin,oblique,obovate,often,onto,open,opposite,pair,paired,papilla,per,perfectly,petiolule,poricidal,portion,projection,reflexed,rest,rugosity,ruit,scar,scattered,scrambling,sinuous,smaller,somewhat,tem,terminal,thickening,time,tip,triangular,trichome,truncate,tub,tube,ud,unevenly,unifoliat,uniseriate,unit,vein,white-lenticellate,whitish,without,ympodial	abaxial,adaxial,arrangement,capitate,colour,form,growth,history,leaf,life,na,number,peduncle,perennial,plant,position,reproduction,shape,spacing,staman,texture,width
197	wfo-0001027219	success	143	105	74	69	31	0.517	/4,0.3,0.4-0.6,0.5,0.5-0.8,1-15,1-2,1-3,1.5-2,2,2-2.5,2-4,6-8,anther,apex,bark,base,berry,bright,broadly,brown,calyx,capitate,closely,cm,conical,corolla,cup-shaped,densely,diameter,elliptic,entire,erect,filament,flower,fruiting,glabrescent,glabrous,globose,green,greyish,growth,leaf-opposed,lobed,long-conical,long-styled,margin,mm,new,ovary,pale,papillose-pubescent,pedicel,peduncle,petiole,purple,scar,shrub,simple,somewhat,spaced,stem,stigma,stout,style,surface,tip,trichome,uniseriate,violet,way,white,woody,–1/3	.5,1,1.5-2.5,2-3,2-3.5,3-5,3-6,7-8,absent,acuminate,acute,age,anthesi,axillary,berr,c.,completely,deltate,drying,eaf,edge,eed,exerte,exfoliatin,free,glabrou,hard,heterostylous,known,lengthening,less,lobe,lower,maturity,minutely,nflorescence,overlappin,pair,papillo,pendent,pericarp,planar,plurifoliat,pointed,pore,poricidal,portion,primary,pubescent,ruit,sharply,shoot,short,short-styled,slightly,slit,sometimes,soon,terminal,thickened,tube,tuft,ud,unit,vein,weight,x,yellowish,ympodial	abaxial,adaxial,arrangement,bud,cell,center,colour,dense,exfoliating,form,fruit,height,history,inflorescence,leaf,length,life,na,number,overlapping,plant,position,prickle,rachi,reproduction,seed,shape,spacing,staman,texture,width
198	wfo-0001027221	success	261	92	55	206	37	0.211	0.3-0.6,1,1-4,2.2-3.2,25-30,4,abaxial,andromonoecious,anther,apart,apex,berry,blue,branched,bright,chartaceous,clavate,cm,diameter,extra-axillary,filament,flattened-reniform,flower,fruit,glabrous,glandular-pubescent,globose,intensity,leaf,light,minutely,mm,orange,ovate,pale,pedicel,peduncle,peripherally,petiole,pitted,plant,rachi,shrub,simple,stellate,stellate-tomentose,stigma,style,sulcate,surface,unbranched,variable,violet,x,yellow	-9.5,.5,0,0.4,0.4–0.6,0.5–2,0.8–1,1.4-2,1.5-2,1.6–2,11-17,11–14,13–16,14–17,1–2,2,2.5–2.8,2.5–5,2.9–3.6,2/3,2–2.5,2–3,2–5,3.1-4.8,3–6,4.5–11,4–8-rayed,5-8,5-merou,6-8,6.5–7,8.5–18,9,abaxiall,abaxially,acicular,actually,acute,acutely,adaxially,along,also,always,alyx,ample,apparent,apparently,appear,armed,aromatic,articulated,attenuate,ba,base,becoming,blade,blunt-tipped,broad-based,bud,calyx,capitat,caudate,central,closely,common,contrasting,coroll,curved,cylindrical,darker,deeply,delicate,dense,densely,development,difoliate,directed,discrete,distally,eaf,eed,entire,equal,eventually,evidently,exceeding,expanded,fewer,frequently,fresh,fruiting,geminat,glabrescent,gland,hair,half,herbarium,hermaphrodite,homostylous,interpetalar,juic,lanceolate,lateral,least,like,likely,lobe,lobed,long,lower,main,major,margin,material,microscope,midpoint,midrib,midvein,minor,mostly,much,nearly,nerve,nflorescence,obtuse,often,older,orolla,outline,ovate-oblong,ovate-triangular,pair,paired,per,perfect,perhaps,persistently,plurifoliate,pore,predominately,prickle,probably,rarely,ray,reflexed,repand,rounded,ruit,sessile,short-stalked,side,similar,sinus,size,slightly,smaller,sometimes,somewhat,soon,source,spaced,sparsely,specimen,splitting,sprout,stalk,stalked,stamen,stellae,stellate-pubescent,stem,straight,subcordate,tal,tapered,tem,thick-textured,thickened,time,tip,tissue,tomentose,toward,triangular-caudate,tube,unarmed,underside,unequal,unit,unpleasantly,usually,vary,vein,viscid,viscidity,way,weakly,white,wide,ympodial,youn,young,–11.5,–15,–3,–4	0.5-2,1-2,1.6-2,11-14,11.5,13-16,2-2.5,2-3,2.5-5,3-6,5-merous,6.5-7,9.5,adaxial,arrangement,capitate,colour,corolla,form,growth,height,history,inflorescence,length,life,na,number,ovary,perennial,position,reproduction,seed,shape,spacing,staman,texture,width
199	wfo-0001027223	success	189	107	82	107	25	0.434	0.19-0.75,1-2,1.8-3.5,16-41,3-10,3-5,3-5.2,3.7-9.3,5-8,9-15,9-35,abaxially,adaxially,anther,apex,articulated,attenuate,axillary,brownish,bud,cell,clavate,cm,condition,conical,corolla,covering,deep,densely,diameter,distal,dot,drying,elliptic,filament,flower,forked,fresh,fruit,glabrous,green,greenish,hair,hair-like,half,herb,hyaline,lanceolate,lateral,leaf,light,long,make,middle,mm,mucilaginous,odd-pinnate,ovoid,pedicel,peduncle,pentagonal,petiole,plant,pubescent,purple,ripe,rotate,rounded,seed,sometimes,stigma,stripe,style,subtending,terminal,testal,thick,wall,wet,white,whitish,yellow	.5,0.3-1.2,1-3,1.3-2,1.5-3.5,2-4,2-7,3-11,3.5-4,3.5-6,3.5-7,4-6,5-10,5-21,5-merou,5.9-12.2,9-22,acumen,acuminate,adaxiall,ag,alyx,apart,apparently,asymmetric,axe,base,basiscopic,berry,blade,capitat,connivent,decreasing,digestion,dorsally,eaf,edge,eed,end,enzyme,erec,exceeding,flat,folded,geminat,generally,glabrou,green-white,hal,homostylous,honeycomb-shaped,interjected,larger,leaflet,lengthening,like,living,lobe,lower,nflorescence,one,orbicular,orolla,ovate,pair,perfect,petiolulate,placed,plurifoliate,pore,poricidal,present,removed,ruit,sessile,seudostipule,short,shortly,side,size,slightly,slit,spaced,specimen,stamen,ste,stolo,straight,subequal,tall,tamen,tem,throughout,tip,tissue,toward,tri-,tube,tuber,typically,unit,unwinged,usually,vary,wide,x,ympodial	abaxial,adaxial,arrangement,capitate,colour,form,growth,height,history,inflorescence,length,life,na,number,ovary,perennial,position,rachi,reproduction,shape,spacing,staman,surface,texture,width
200	wfo-0001027229	success	206	81	57	149	24	0.277	0.1-3,1-1.5,1.5-3,1.8-2.7,2-10,3-6,3.5-5,3.5-6,4-7,5-6,adaxially,anther,apex,broadly,chartaceous,cm,densely,diameter,erect,especially,extra-axillary,filament,flower,fruit,glabrous,globose,green,herbaceous,inflorescence,length,lilac,margin,minutely,mm,ovate,pale,pedicel,peduncle,pentagonal,petiole,prostrate,pseudo-racemose,rachi,reniform,resprouter,reticulate,simple,sparsely,sprawling,stellate,stellate-pubescent,stigma,style,surface,tan,toward,yellow	%,0-0.1,0-0.2,0-8,0.1-0.3,0.1-0.6,0.1-1,0.1-1.4,0.2-0.4,0.2-1.7,0.2-2,0.5-0.7,0.5-0.9,0.5-3,0.6-0.7,0.6-1,1-2,1-6,1-7,1-8,1.1-1.2,1.3-1.7,1.5-2.5,12-17,2-4,2-5,2-foliate,2-locular,2.5-6,20-65,25-35,30-145,30-300,4-10,4-5,4-6,40-55,5-15,5-9,5-merou,7-11,8-12,8.5-12,abaxially,absen,absent,abundant,accrescent,acicular,across,acute,adaxiall,adult,alyx,apart,armed,articulated,attenuate,axe,ba,base,blade,branche,calyx,capitat,circular,cordate,cross-section,cylindrical,decimetre,directed,distall,eaf,eed,eglandular,elliptica,exceeding,exocarp,finger,flattened,fruiting,geminat,gland-tipped,glandular,hair,homostylous,index,interpetalar,juicy,lamina,lanceolate,lateral,lobe,lobed,lobing,lon,long,longer,lower,mature,mesocarp,mid-point,midpoint,midvein,minute,moderately,moist,nflorescence,oblique,obtuse,orolla,part,per,perfect,placenta,pore,porrect,presen,present,prickle,ray,ruit,shallowly,short,side,spaced,stage,stalk,stalked,stellae,straight,tal,tamen,tem,thick,throughout,time,tissue,transparent,triangular,tube,unbranched,unit,uvenile,vary,vein,wide,x,ympodial	abaxial,adaxial,arrangement,capitate,colour,corolla,form,growth,height,history,leaf,life,na,number,ovary,plant,position,reproduction,seed,shape,spacing,staman,texture,width
201	wfo-0001027232	success	195	92	67	128	25	0.344	0-7,0.3-0.4,0.7-1.5,1.8-3.9,14-30,2-3.4,4-10,4-5.5,4-8,4.5-6.5,5-8,5-merous,7-9,adaxially,anther,apex,black,bluntly,broadly,brown,chartaceous,cm,cordate,diameter,discoid,erect,extra-axillary,filament,flattened,flower,forked,fruit,glabrous,globose,green,inflorescence,irregularly,length,lilac,long,minutely,mm,obtuse,orbicular,outline,ovate,pale,pedicel,peduncle,perennial,petiole,purple,reticulate,rhizomatous,shrub,simple,sparsely,stellate,stellate-pubescent,stigma,style,surface,thick,throughout,triangular,unbranched,yellow	%,0-0.1,0.15-0.3,0.25-0.4,0.3-0.45,0.3-0.5,0.4-0.8,0.45-0.6,0.5-0.8,0.6-0.9,0.7-1.3,0.8-3.2,0.9-7.5,1-10,1-locular,1.1-1.5,1.5-2.5,1.5-3,10-30,14-18,15-100,2-25,2.1-2.8,2.5-3,25-35,3-5,3-9,3.5-10,350-800,4-6,5-11.5,6-8,abaxially,absen,absent,accrescent,acicular,across,acute,adaxiall,adult,apart,apparen,armed,articulated,axe,ba,base,blade,branche,calyx,capitat,confined,cylindrical,decimetre,deeply,deltate,directed,distall,distributed,eaf,eed,eglandular,exocarp,finger,fruiting,gland-tipped,hair,half,incomplete,index,juicy,lamina,lancolate,lateral,less,lobe,lobed,lobing,longer,lower,margin,mature,mesocarp,mid-point,midpoint,midrib,midvein,minute,moderately,nflorescence,oblique,orolla,part,per,perfect,placenta,pore,porrect,present,prickle,ray,rostrate,ruit,septum,sessile,short,side,spaced,sparse,stalk,stellae,straight,succulent,tal,tamen,tem,time,transparent,tube,unarme,unit,unknow,vary,vein,wide,x,ympodial	abaxial,arrangement,capitate,color,corolla,form,growth,height,history,leaf,life,na,number,ovary,plant,position,reproduction,seed,shape,spacing,staman,stem,texture,unknown,width
202	wfo-0001027234	success	206	102	77	129	25	0.374	-2,0.15,0.2-1.3,0.3-1,0.5-0.7,0.5-3,0.8-0.9,0.9-1.6,1,1-2,1-4,1.5-4,2/3-4/5,3-5,4-5-merous,absent,acute,almost,anther,apart,apex,apparently,base,berry,black,brown,cell,cm,concolorous,dark,diameter,drying,erect,filament,filiform,flattened-reniform,flower,fruit,glabrescent,glabrous,green,herb,lateral,leaf,length,lobed,maturity,mauve,membranous,mm,near,orbicular,outline,ovate,pedicel,peduncle,petiole,pit,purple,raised,red,rounded,scandent,shrub,simple,smooth,sometimes,sparsely,spherical,stellate,stellate-pubescent,style,surface,trichome,unarmed,way,yellowish	-0.15,-1.5,-3,-3.5,-6,.5,0-20,0-4,0.05-0.1,0.1,0.1-2,0.3-0.4,0.5-2,0.6-0.8,0.7-1.3,0.7-1.5,1.2-2,1.5-2.2,1.5-3.5,1.8-3,1/3,1/4-1/3,12-18,2-4,3-10,3-6.5,8-15,8-16,abaxially,acuminat,alyx,apar,apically,articulated,attenuate,bark,beyond,blac,blade,branched,broad-deltate,calyx,cordate,curved,deltate,difoliate,dot,eaf,eed,elongating,entire,equal,eye,free,fruiting,geminat,glabrou,glan,gland,globular,gray,herbaceous,infructescence,lobe,long,longer,lower,margin,mature,midpoint,moderately,multangulate,naked,narrowly,nflorescence,oblong,obtuse,older,one,open,orolla,oung,pair,pale,pendulous,per,perfec,pericarp,perpendicular,poricidal,porrect,portion,prickle,prickly,primary,protruding,ray,reduced,reflexed,ruit,scar,scattered,sessile,shorter,slightly,spaced,spreading,stalk,stalked,stem,straight,tamen,tapering,terete,tertiary,time,tip,tube,unarme,unit,vary,vein,venation,visible,white,wide,winged,yellow,ympodial	abaxial,adaxial,arrangement,colour,corolla,form,growth,height,history,inflorescence,life,na,number,ovary,perfect,plant,position,rachi,reproduction,seed,shape,spacing,staman,stigma,texture
203	wfo-0001027235	success	189	90	56	133	34	0.296	1,35,abaxial,adaxial,adaxially,anther,apart,apex,black,chartaceous,chocolate-brown,cm,deeply,diameter,difoliate,extra-axillary,filament,flower,fruit,glabrous,globose,green,hair,herb,leaf,length,like,lobed,midvein,mm,moderately,obtuse,pedicel,peduncle,petiole,pinnatifid,pinnatisect,pubescent,rachi,raised,reniform,ridge,rotate-stellate,rounded,shallowly,sparsely,stellate,stem,stigma,style,surface,turning,unbranched,white,yellow,zygomorphic	.5,0.5,1.2,1.5,10,11,12,13,14,18,2,2.5,3,30,4,40,5,5-merous,6,8,9,?,abaxially,absent,abundant,accrescent,acicular,acute,alternating,alyx,armed,articulated,asymmetrical,axe,ba,base,berry,blade,brown,burr-like,c.,calyx,completely,cordate,covering,creating,curved,cylindrical,densely,dimorphic,directed,distally,dry,drying,eaf,eed,enantiostylou,four,fruiting,geminate,glabrou,gland-tipped,interpetalar,introrsely,invested,irregularly,larger,left-handed,linear-lanceolate,lobe,lon,long,longitudinal,lower,lowermost,margin,maturity,midpoint,midrib,multicellular,multiseriate,narrowly,nearly,nflorescence,occasional,occasionally,often,one,opening,opposite,orolla,pair,per,pinnate,pore,prickle,prickly,ray,right,ruit,secondary,side,simple,slightly,slit,spaced,stalk,ste,straight,strongly,tamen,tan,tapering,tearing,tem,tightly,tissue,triangular,tube,undulate,unequa,unicellular,uniseriate,unit,upper,upward,usually,vary,vein,venation,wid,ympodial,×	0.5-3,1-2,10-14,10-18,2-2.5,2-3,4-10,5-8,6-12,8-12,9-11,arrangement,colour,corolla,enantiostylous,form,growth,height,history,inflorescence,life,na,number,ovary,perennial,plant,position,reproduction,seed,shape,spacing,staman,texture,wide
204	wfo-0001027236	success	199	97	79	120	18	0.397	-4.5,1-2,1-2.5,1-3,10,10-20,2-2.5,2-5,2-6,3-3.5,3-8,4-5,5-6,8-10,abaxially,adaxially,anther,anthesi,base,becoming,berry,blue,branched,brown,clavate-truncate,closely,cm,cordate,corolla,diameter,filament,flattened,flower,foveolate,fruit,glabrous,globose,green,growth,heterostylous,lanceolate,length,lobed,long-styled,minutely,mm,nearly,ovary,ovate-cordate,pedicel,peduncle,petiole,plant,pubescent,reniform,reticulate,ripe,runcinate,rusty,short-styled,shrub,simple,stellate,stigma,style,subglobose,suborbicular,surface,tapering,unevenly,velutinous,villous-glandular,violet,viscid,woody,woolly,x,yellow,yellow-orange	-5,-82,/6,0.2-0.3,0.6-0.7,1,1-1.5,1.2-1.5,1.5-2,2-,2-3,2.5-,3-4,30-50,5-,5-8,5-9,7-14,acute,apex,armed,articulated,asymmetric,bark,basal,brow,caly,calyx,chartaceous,compressed,dark,densely,discolorous,distal,eaf,eed,eglandular,erect,exserted,free,fruiting,fused,glabrescent,gland-tipped,glandular,glandular-hirsute,internodal,lateral,lengthening,light,like,lobe,lobed-angulate,long,lower,margin,middle,midpoint,minute,mixed,multangulate,new,nflorescence,obverse,ochraceous,older,ovate-turbinate,papillo,partially,per,perfect,pericarp,plurifoliat,pore,poricidal,porrect,portion,prickle,prickly,pubescence,raise,ray,recurved,reflexe,rounded,ruit,scandent,scar,sessile,slightly,slit,smooth,somewhat,space,sparsely,stalked,staminate,stellate-glandular,stellate-pilose,stem,striped,subcoriaceous,subsagittate,tall,terete,testa,tiny,tip,trichome,tube,ud,unarmed,unit,upper,villous,viscid-tomentose,ympodial,young,¼,½	abaxial,colour,form,height,history,inflorescence,leaf,life,number,papillose,perennial,reproduction,seed,shape,spaced,spacing,staman,texture
205	wfo-0001027237	success	122	82	53	69	29	0.434	.5,/4,1.5-2.5,3-3.5,6-11,6-8,8,anther,apart,base,branched,brown,calyx,clavate,cm,corolla,dark,filament,flattened,glabrous,globose,green,greenish-white,inflorescence,internodal,leaf,lobed,long,many,margin,minutely,mm,ovary,paler,papillose,pedicel,pitted,regularly,reniform,shining,shrub,slender,small,stigma,style,surface,tapering,time,tree,tube,way,white,x	0.5-1,1-1.2,1.5-2,2-3,3-4,30-100-flowered,5,anthesi,apiculae,apiculate,appearing,ba,bark,berry,blac,black,branc,broadly,completely,cucullate,cup-shaped,deflexed,deltoid,dia,difoliate,drying,edicel,eed,ellipsoid,erect,exsertion,free,fruiting,geminate,greyi,later,lobe,lower,nflorescence,occasionally,older,papillate,papillo,part,plurifoliat,pore,poricidal,portion,reflexed,regulary,ruit,scar,shaped,spaced,stem,straight,tall,tear-drop,terminal,tip,ud,unit,upper,usually,widely,woody,x.,ympodial,young	30-100,abaxial,adaxial,apex,arrangement,colour,diameter,flower,form,fruit,growth,height,history,length,life,na,number,peduncle,petiole,plant,position,rachi,reproduction,seed,shape,spacing,staman,texture,width
206	wfo-0001027238	success	204	94	67	137	27	0.328	-25,.3,0-0.7,0-1,0-1.5,0.5-1,1-1.5,1.5-3,1.5-4,15-30,3-6,5-15,6-15,abaxially,anther,apex,black,brown,chartaceous,cm,contiguous,dark,densely,diameter,elliptic,elliptic-ovate,extra-axillary,filament,flower,fruit,glabrescent,glabrous,globose,green,greenish,lavender,leaf,light,membranaceous,minutely,mm,nearly,outline,pale,pedicel,peduncle,petiole,pitted,pubescent,purple,rachi,reniform,shiny,shrub,simple,small,sparsely,stellate,stellate-pubescent,stigma,style,surface,tree,unbranched,white,x,yellow	-5,.5,0.3-0.5,0.3-0.8,0.3-1,0.3-5,0.5-16,0.5-2,1-2,1.5-7,10,2-3,2-4,3-4,3-5,4-,4-10,4-16,4-5,4-8,5-7,5-merou,6-8,accrescent,acuminate,acute,adaxiall,adaxially,ag,alyx,apparently,articulated,axe,ba,base,berry,blade,branch,calyx,capitat,connivent,covering,cuneate,cylindrical,deltate,differentiated,directed,discolorous,distally,eaf,eed,entire,equal,flattened,fleshy,foliaceous,fork,free,frui,fruiting,geminate,gland,gland-tipped,growt,hair,homostylous,interpetalar,introrsely,juic,large,lighter,like,lobe,long,longitudinal,lower,major,margin,midpoint,minor,mixed,multangulate,narrowly,near,new,nflorescence,oblique,oblong,obtuse,often,one,opening,orolla,paired,part,perfect,pericarp,plurifoliate,pore,porrect-stellate,ray,ripe,rounded,ruit,scandent,sessile,short-stalked,side,similar,slit,sometimes,somewhat,sparse,sprawling,ste,stem,straight,strongly,subtending,tamen,tem,time,tip,tissue,toward,triangular,tube,unarme,unequal,unit,vary,vein,whitish,wide,without,yellowish,ympodial	5-merous,abaxial,adaxial,arrangement,capitate,colour,corolla,form,growth,height,history,inflorescence,length,life,na,number,ovary,perennial,plant,position,reproduction,seed,shape,spacing,staman,texture,width
207	wfo-0001027242	success	238	87	68	170	19	0.286	0-0.7,0.2-1,0.25-0.5,0.3-1.1,0.6-3,1.5,1.5-2,3-12,4-5.5,5.5-7,6-21,acute,anther,apex,articulated,base,chartaceous,cm,contiguous,cylindrical,densely,diameter,erect,extra-axillary,filament,flattened,flower,fruit,glabrous,globose,green,inflorescence,leaf,length,light,minutely,mm,moderately,nearly,orange,ovate,pale,pedicel,peduncle,perennial,petiole,pink,plant,pseudo-racemose,pseudo-umbellate,purple,rachi,red,reticulate,rhizomatous,smooth,sprawling,stellate,stellate-pubescent,stigma,style,subcoriaceous,surface,white,whitish,x,yellow,yellowish	%,.05,.2,0-1.5,0-15,0-20,0-5,0.15-0.25,0.2-0.7,0.3-0.5,0.5-1,0.6-0.9,0.7-1.2,1-1.2,1-1.5,1-2,1-2.5,1-locular,1.5-3,1.9-5,10-22,12-16,15-25,2,2-2.9,2-3,2.5-3,2.8-3.7,3-4.5,3-6,3-7,3.5-4.5,4-30,4-7,4.5-10.5,4.5-11,5-merou,6-14,6-7,6-8,7-8,8-15,9-11,abaxially,absen,absent,accrescent,acicular,across,adaxially,adult,alyx,andromonoecious,apart,apparen,axe,ba,blade,bract-like,branch,branche,calyx,capitat,confined,connivent,cuneate,deltate,directed,distall,dm,eaf,eed,entire,exocarp,finger,forked,fruiting,geminate,gland-tipped,hair,half,heterostylous,incomplete,index,interpetalar,juicy,juvenile,lamina,lateral,less,lobe,lobed,lobing,long,longer,loosely,lower,margin,mature,mesocarp,mid-point,midpoint,midrib,midvein,minute,mixed,much,narrowly,nflorescence,oblique,obtuse,occasionally,often,one,orolla,pair,part,per,perfect,placenta,plurifoliate,pore,porrect,present,prickle,ray,rooting,rostrate,rounde,ruit,septum,sessile,shallowly,short,shrub,side,simple,slightly,smaller,spaced,sparse,sparsely,stellae,straight,strongly,succulent,tall,tamen,tapered,tem,thick,throughout,time,tip,tissu,tissue,toward,triangular,tube,unarme,unarmed,unbranched,unit,upper,usually,vary,vein,weakly,wide,ympodial	abaxial,adaxial,capitate,colour,corolla,form,growth,height,history,life,number,ovary,position,reproduction,seed,shape,spacing,staman,texture
208	wfo-0001027244	success	294	81	60	234	21	0.204	-12,-2,-3.2,0.2-1,0.45-0.6,0.5,0.7-1.5,1,1.1-1.3,1.5-2.4,2.1-8,4-12,8-16,anther,apex,branched,broadly,brown,capitate,cm,corolla,dark,densely,diameter,elliptic,filament,flower,fruit,glandular,globose,green,greenish,hair-like,herb,imparipinnate,inflorescence,interrupted,length,mm,obovate,orbicular,outgrowth,ovary,pedicel,peduncle,perennial,petiole,pubescent,rachi,rotate-stellate,simple,sparsely,stigma,style,surface,usually,velvety,vivid,white,yellow	-1.2,.5,0-,0.02-,0.04-,0.05,0.05-1,0.07-0.15,0.1-,0.1-0.3,0.1-0.5,0.1-0.6,0.15-0.2,0.2,0.2-,0.25-0.4,0.3,0.3-0.4,0.3-0.5,0.3-0.6,0.3-0.8,0.4-,0.4-0.6,0.4-1,0.5-0.8,0.5-1,0.6-0.9,0.6-09,0.7-1,0.7-2,0.7-3,0.8-1.2,0.9-1.3,0.9-1.7,1-2-celled,1-2.5,1-3.5,1-celled,1.2-1.6,1.5-2,1.5-2.1,1.5-6.5,1.7-3.0,1/2,2-,2-4,2-4-celled,2-9,2-foliate,2-locular,3-5,3.5-13,3/4,4-celled,5-,5-10,5-9-celled,7-12,8-celled,abaxially,absent,abundance,abundant,acroscopically,acuminate,acute,adaxially,adpressed,alfway,along,also,always,amongst,angled,anthesi,apical,apparently,appearance,appendage,arequipa,around,articulated,articulatio,articulation,axi,basal,base,berr,berry,bifurcate,bract,bracteate,c.,cage,calyx,cell,column,common,conical,cordate,crenate,curved,deciduous,decumbent,decurrent,deeper,deltate,dense,density,dentate,developed,diamete,distal,eaf,edicel,eed,eglandular,either,elliptical,erect,exserted,extremely,flushed,forming,fruiting,general,giving,glabrescent,glabrous,gland,gree,half,halfway,head,hyaline,interjected,internode,investing,irregularly,lamina,lanceolate,larger,largest,lateral,leaflet,leave,like,lobe,lobed,lobing,lon,long,longer,lower,margin,middle,midvein,minute,mixed,mixture,multicellular,narrowly,near,node,oblique,occasionally,often,onto,pair,papillate-pubescent,patent,petiolule,population,present,primary,pseudostipule,purple,reflexed,rest,ripe,rounded,ruit,scattered,secondary,sessile,shaggy,short,shorter,silky,sinus,size,slender,small,sometimes,somewhat,sparse,sparser,spreading,staminal,stem,sterile,stout,straight,stripe,strongly,tall,tem,terminal,tertiary,testa,thick,tiny,tip,tipped,toward,trichome,truncate,tube,two,ud,undulate,unicellular,uniseriate,unit,united,upper,variable,variety,vein,wall,wide,winged,woody,ympodial	abaxial,adaxial,arrangement,colour,form,growth,height,history,leaf,life,na,number,plant,position,reproduction,seed,shape,spacing,staman,texture,width
209	wfo-0001027248	success	158	91	64	94	27	0.405	.5,0.5-1,0.5-2.5,0.7-1.2,1-2,1-5,3-4,3-7,6.5-8,abaxial,abaxially,acute,adaxially,anther,apex,arachnoid,arachnoid-pubescent,area,base,beneath,broadened,brown,brownish,closely,cm,corolla,dark,difoliate,dirty,elliptic,filament,fruit,geminate,glabrous,globose,green,leaf,lobed,merely,minutely,mm,nearly,occasionally,opposite,ovary,ovoid-reniform,patch,pedicel,petiole,pitted,pubescence,scattered,shrub,simple,small,spaced,sparsely,stigma,style,surface,top,tree,unifoliate,white	0,1-1.5,1-3,2-2.5,2-4.5,3-7-flowered,3.5-4,4-8,5-5.5,6-13,7-9,along,anthesi,ape,appearing,arachnoid-pubescen,bark,beige,berry,broadly,brownish-gra,calyx,conical,deflexed,deltate,densely,denser,dia,differing,eaf,edicel,eed,ellipsoid,erect,exserted,felty,fleshy,free,fruiting,glabrescent,grayish-green,impressed,lamina,later,lateral,lightly,lobe,long,lower,main,major,margin,minor,nflorescence,node,older,overlappin,pair,pale,papillo,papillose,per,planar,pore,poricidal,portion,present,pubescent,ruit,scar,shaped,shoot,size,somewhat,soon,specimen,stem,strongly,tall,tear-drop,thick,tip,trichome,tub,tube,ud,unit,vein,wid,wide,winged,woody,ympodial,young	adaxial,arrangement,colour,diameter,flower,form,growth,height,history,inflorescence,length,life,na,number,overlapping,peduncle,perennial,plant,position,rachi,reproduction,seed,shape,spacing,staman,texture,width
210	wfo-0001027258	success	178	100	67	111	33	0.376	.5,0.6-2,0.9-1.3,1.5-1.6,4-5,4.5-5,6-8,abaxially,adaxially,anther,apex,axil,bark,calyx,capitate,cm,corolla,ellipsoid,elliptic,filament,flattened-reniform,fruit,fruiting,glabrous,globose,green,greenish-yellow,internodal,large,lateral,leaf,length,lenticel,lobed,main,margin,minutely,mm,occasionally,opposite,ovary,ovate,pale,papillose,pedicel,petiole,pitted,pubescent,reddish,scar,shrub,simple,slender,sparsely,stem,stigma,strongly,style,surface,swollen,treelet,trichome,tuft,uniseriate,vein,white,yellowish-tan	.25,/4,0.25-0.5,0.5-1,1-1.5,1-2.3,1-4,1.2-2,2-2.5,2.5-8,3-4,3-6,3.5-4,5-10-flowered,7-13,7-9,abruptly,acuminate,acute,age,along,anthesi,apar,apical,apiculae,attenuate,ba,base,beneath,berry,broadly,crystal,darker,decurrent,deflexed,deltate,dense,densely,deposit,dia,differing,difoliate,dissecting,drying,eaf,edicel,eed,enlarge,entire,evenly,exserted,extending,fide,fragrant,free,geminat,glabrou,incrassate,lamina,lengthening,lobe,long,lower,major,microscope,middle,minor,minute,nee,nflorescence,often,older,onto,pair,papillo,planar,pore,poricidal,portion,projection,prominent,red-papillose,ruit,sand,scattered,size,slightly,slit,small,spaced,speck,straight,sweetly,tall,tiny,tip,tub,tube,ud,unit,urceolate,visible,way,widening,widest,winged,woody,x,yellowish,ympodial,young	5-10,abaxial,adaxial,apart,arrangement,bud,cell,center,colour,diameter,enlarged,flower,form,growth,height,history,inflorescence,life,na,new,number,peduncle,plant,position,prickle,rachi,reproduction,seed,shape,spacing,staman,texture,width
211	wfo-0001027260	success	176	88	59	117	29	0.335	-17,-60,0.5-3,1.5-13,10-25,2-18,3-10,3-4.5,3-6,4-6,4.5-14,5-merous,6-20,acuminate,acute-,apex,articulated,base,branched,chartaceous,clavate,cm,densely,diameter,ellipsoidal,elliptic-ovate,flattened,flower,fruit,glabrate,glabrous,globose,greenish,membranaceous,mm,moderately,ovate,pedicel,peduncle,petiole,pilose,pink,puberulent,pubescent,purple,rachi,shrub,simple,small,stellate,stigma,style,tree,truncate,unbranched,white,yellow,yellow-green,yellowish	-2,-7,0.25-1,0.5-1,0.5-6.5,0.75-1,0.8-2,1-,1-2,1-3,1-4,1-6,1-7,1.5-2,15-30,2-,2-10,2-2.5,2.5-14,2.5-3.5,3-,3-11,3.5-25,4-25,4-32,4-5-foliat,5-,5-25,5-40,abaxially,absent,acute,adaxially,age,aggregate,also,alyx,apart,ape,axe,basal,berry,beyond,blade,cell,connective,connivent,cordate,cylindrical,darker,diamete,directed,distally,eaf,eed,eglandular,elliptic,entire,equal,exceeding,exserted,fading,hair,lanceolate,lavender,leaving,lobe,lon,long,longitudinal,lower,margin,narrowly,nearly,nflorescence,nther,obtuse,often,orolla,pedicellar,perfec,perfect,pilo,pore,presen,puberulent-pubescen,puberulent-pubescent,pubescent-pilose,radiu,remnant,ruit,shorter,slightly,spaced,sparsely,stamen,stone,stripe,strongly,subcoriaceous,tal,tapered,tem,thecae,time,tomento,triangular,tube,ud,unit,usually,vary,vein,wide,x,yellow-orang,ympodial	15-40,abaxial,adaxial,anther,arrangement,colour,corolla,filament,form,growth,height,history,inflorescence,leaf,length,life,na,number,ovary,plant,position,reproduction,seed,shape,spacing,staman,surface,texture,width
212	wfo-0001027265	success	159	82	57	102	25	0.358	.2,0.1–2,0.2-0.4,0.5,0.5-1,1-3,1.2-2,1.5–2,2,2-3,20-30,2–2.5,4–7-branched,acute,anther,apart,apex,base,berry,chartaceous,cm,diameter,extra-axillary,filament,flattened-reniform,flower,fruit,glabrous,globose,herb,hermaphroditic,leaf-opposed,light,minutely,mm,orange,ovate-lanceolate,pedicel,peduncle,petiole,pitted,puberulent,purple,rachi,recurved,red,rotate-stellate,seed,simple,sparsely,stigma,style,subcoriaceous,surface,white,x,yellow	-2.5,.3,.5,0.5–0.6,1-1.3,1-2.5,1.2-1.3,1.2–1.4,1.5-2.5,1.5–1.8,1.5–4,2-,2-4,2/3,2–3,3-,3-lobed,30–50,4-5,4.5–8,4–6,5-merou,58409,abaxially,accrescent,adaxiall,adaxially,alyx,apparently,articulated,axe,ba,blade,broad,calyx,capitat,ciliate,connivent,covering,croat,cylindrical,dehiscent,eaf,eed,entire,erect,foliate,frui,fruiting,geminat,granule,hair,juic,larger,lobe,lon,long,long-attenuate,longitudinall,low,lower,margin,mesocarp,near,nearly,nflorescence,node,numerous,oblong,obtuse,orolla,paired,partially,pore,present,prominent,pubescent,rarely,ripe,rooting,ruit,scarcely,sclerotic,slightly,sometimes,somewhat,spaced,tall,tamen,tem,time,tip,triangular,tube,unit,usually,vary,weak,white-puberulent,wide,winged,ympodial	30-50,abaxial,adaxial,arrangement,capitate,colour,corolla,form,growth,height,history,inflorescence,leaf,length,life,number,ovary,perennial,plant,position,reproduction,shape,spacing,staman,texture
213	wfo-0001027265	success	156	81	56	100	25	0.359	.2,0.1–2,0.2-0.4,0.5,0.5-1,1-3,1.2-2,1.5–2,2,2-3,20-30,2–2.5,4–7-branched,acute,anther,apart,apex,base,chartaceous,cm,diameter,extra-axillary,filament,flattened-reniform,flower,fruit,glabrous,globose,herb,hermaphroditic,leaf-opposed,light,minutely,mm,orange,ovate-lanceolate,pedicel,peduncle,petiole,pitted,puberulent,purple,rachi,recurved,red,rotate-stellate,seed,simple,sparsely,stigma,style,subcoriaceous,surface,white,x,yellow	-2.5,.3,.5,0.5–0.6,1-1.3,1-2.5,1.2-1.3,1.2–1.4,1.5-2.5,1.5–1.8,1.5–4,2-,2-4,2/3,2–3,3-,3-lobed,30–50,4-5,4.5–8,4–6,5-merou,58409,abaxially,accrescent,adaxiall,adaxially,alyx,apparently,articulated,axe,ba,blade,broad,calyx,capitat,ciliate,connivent,covering,croat,cylindrical,dehiscent,eaf,eed,entire,erect,foliate,frui,fruiting,geminat,granule,hair,juic,larger,lobe,lon,long,long-attenuate,longitudinall,low,lower,margin,mesocarp,near,nearly,nflorescence,node,numerous,oblong,obtuse,orolla,paired,partially,pore,prominent,pubescent,rarely,ripe,rooting,ruit,scarcely,sclerotic,slightly,sometimes,somewhat,spaced,tall,tamen,tem,time,tip,triangular,tube,unit,vary,weak,white-puberulent,wide,winged,ympodial	30-50,abaxial,adaxial,arrangement,capitate,colour,corolla,form,growth,height,history,inflorescence,leaf,length,life,number,ovary,perennial,plant,position,reproduction,shape,spacing,staman,texture
214	wfo-0001027276	success	219	71	52	167	19	0.237	1,10,2,5-merous,6,80,alternate,anther,bifid,black-green,broadly,brown,clonal,cm,conspicuously,corolla,cyme,dark,dense,diameter,drying,filament,flower,fruit,glabrous,globular,green,growth,inflorescence,lanceolate,least,length,lighter,linear,minutely,mm,ovary,petiole,plant,purple,reticulate,rotate,scabrous,short,slightly,staman,stellate,stigma,style,subshrub,surface,trichome	-22,.5,0,0.5,0.5–1,1.2–1.5,1.5,1.5–2,1–1.5,1–2,2–5,2–6,4–5,4–9,5,5–10,5–12mm,5–7,7,9–12,absent,acuman,acumen,acute,ale,along,alyx,anthesi,apex,apparently,armed,around,aspect,ba,base,becoming,beneath,berry,beyond,boht,borne,branche,c.,caly,calyx,central,cone,covered,densely,detaching,different,dioeciou,drop,eaf,eduncle,eed,ending,entire,erect,even,eventually,except,expanding,exserted,extending,falling,female,filiform,fine,following,functionally,fused,gra,gray-green,growt,hermaphrodite,inaperturate,including,indumentum,ingle,largest,lobe,lobed,lon,long,loose,lower,margin,mostly,mout,near,new,newer,next,oblong-lanceolate,older,open,opening,orphologically,pedicel,petal,plurifoliat,pollen,poricidal,porrect-stellate,prickle,prickly,producing,proportion,ra,rarely,red-tinged,remaining,resprout,retained,rickle,ruit,ruiting,scarcely-rooted,scattered,seaso,shed,shor,side,slender,small,solitary,somewhat,sparsely,splitting,stalked,stamen,staminate,stellate-funnelform,stellate-pubescent,stem,stigmatic,stolon,straight,successively,surrounding,suture,taminate,tapered,tapering,tem,tending,throughout,time,tip,toward,type,unarme,underground,unequal,unit,verall,vestigial,wavy,wide,widened,without,woody,yellow-green,ympodial,×,–	-,1-1.5,1.5-2,2-5,abaxial,adaxial,arrangement,colour,dioecious,form,height,history,leaf,life,na,reproduction,seed,shape,texture
215	wfo-0001027284	success	172	88	65	107	23	0.378	.3,0.1–0.5,0.1–2,1.2–1.5,1.5–2,1–1.5,1–3,2–16,3–4,4,4–12,4–6,5-merous,9–18,abaxially,acuminate,adaxially,anther,apex,axillary,branched,brownish,cm,diameter,elliptic,extra-axillary,filament,flattened-reniform,flower,fruit,glabrous,globose,green,inflorescence,maturity,minutely,mm,near,nearly,orangish,ovate,ovoid,pale,pedicel,peduncle,petiole,pubescent,rachi,rarely,reticulate-rugulose,scandent,shortly,shrub,simple,sparsely,stellate,stem-terminal,stigma,style,surface,tan,unbranched,vine,white,x	0.2–,0.7–0.9,0.7–1,1.5–2.5,1.5–5.5,1.5–8,1.8–2,1–2,2.5–3,2.5–3.5,2–2.2,3.5–14,5–7,5–8,accrescent,acute,alyx,anthesi,axe,base,berry,blade,branch,c.,calyx,capitat,ciliat,climbing,conspicuous,contiguousl,cordate,cylindrical,deflected,deltoid,densely,distally,eaf,eed,enlarged,entire,fine,flattened,fleshy,fruiting,glabrescen,glabrou,gradually,herbaceous,immature,leafy,lobe,long,lower,m.,margin,midvein,nflorescence,nternode,oblique,one,orolla,pair,pendulou,perfec,pink,pinnate,planar,plurifoliate,pointed,prominent,pubescence,reduced,rounded,ruit,sand-punctat,sand-punctate,scar,secondary,seen,side,size,slightly,sometimes,somewhat,soon,spaced,spreading,tamen,tem,thickened,thickly,time,tip,toward,tree,truncate,tube,understory,unifoliat,unit,vary,vein,venation,weakly,wide,woody,ympodial	abaxial,adaxial,arrangement,capitate,colour,contiguously,corolla,form,growth,height,leaf,length,na,number,ovary,plant,position,seed,shape,spacing,staman,texture,width
216	wfo-0001027289	success	194	69	47	147	22	0.242	0.3-1,0.5-1.4,0.8-2.6,10.5-12.5,12-17,5.5-7.5,andromonoecious,anther,apex,black,broadly,brown,chartaceous,cm,cordate,densely,diameter,fruit,glabrous,globose,green,grey,inflorescence,leaf-opposed,length,lobed,mm,obtuse,ovate,perennial,petiole,pink,plant,pseudo-racemose,purple,shallowly,shrub,simple,solitary,stellate,stellate-pubescent,style,unbranched,white,yellow,yellowish,yellowish-green	%,.05,0-0.7,0-1,0-3,0.05-0.1,0.25-0.7,0.3-0.9,0.4-0.8,0.5-0.7,1,1-2,1-5,1.1-1.5,1.2-2.5,1.3-1.5,1.4-1.8,1.5-2,1.5-2.3,1.5-3.5,10-16,16-35,2-foliate,2.4-3,2.5-2.8,3.5-5,3.5-7.5,30-160,4-11,4-7,4-locular,5-merou,6-8,6-9,7-10,7-13,7-8,abaxially,absen,absent,accrescent,acicular,across,acute,adaxiall,adaxially,alyx,apart,articulated,ascending,axe,ba,bark,base,blade,calyx,circular,connivent,cork,cross-section,cylindrical,deltate,directed,distall,distally,distributed,dm,eaf,eed,eglandular,elliptica,entire,erect,exocarp,finger,flower,fruiting,functional,furrowed,geminate,glabrou,gland-tipped,hair,half,heterostylous,juicy,lamina,lanceolate,lateral,less,lobe,long,longer,lower,margin,markedly,mature,mesocarp,mid-point,midpoint,minute,moist,nflorescence,oblique,orolla,part,pedicel,peduncle,per,placenta,pore,porrect,present,prickle,probably,ray,rhizomatous,ruit,rusty,short,spaced,stage,stalk,stalked,stellae,straight,strongly,tal,tamen,tem,thick,thicker,thicknes,throughout,time,transparent,tube,unarme,unarmed,unit,unknow,uvenile,vary,weakly,wide,x,ympodial	abaxial,adaxial,arrangement,colour,corolla,filament,form,growth,height,history,leaf,life,na,ovary,position,reproduction,seed,shape,staman,stigma,surface,texture
217	wfo-0001027290	success	165	58	36	129	22	0.218	.8,0.3-0.5,1.1-4.4,8-10,anther,apex,broadly,cm,cordate,densely,diameter,extra-axillary,flower,fruit,glabrous,globose,green,grey-green,inflorescence,length,lobed,mm,obtuse,ovate,perennial,petiole,pseudo-racemose,purple,shallowly,shrub,sparsely,stellate-pubescent,style,unknown,yellow,yellowish-green	%,0-0.7,0-1,0-2.5,0-3,0.05-0.25,0.1-0.9,0.2-0.4,0.7-0.9,0.7-1.2,0.8-1.2,0.9-1.2,1-1.7,1-2,1-5,1.4-1.6,1.5-1.8,1.5-2,1.6-1.8,11-15,180-420,2-11,2-6,2.8-5.5,20-45,3-35,3-5,3-6,3.5-5,4-6,5-20,5-9.5,5-merou,50-70,6-8,7-8,8-9,abaxially,absent,acicular,across,adaxiall,adaxially,alyx,apart,armed,articulated,ascending,attenuate,axe,ba,base,blade,calyx,chartaceous,cylindrical,d.,directed,distall,distributed,eaf,eed,eglandular,entire,erect,finger,fruiting,functional,gland-tipped,hair,half,juic,lamina,lateral,lobe,lon,long,longer,lower,margin,mature,mesocarp,mid-point,midpoint,midvein,minute,moist,nflorescence,oblique,onl,orolla,part,pedicel,peduncle,per,pore,porrect,presen,present,prickle,ray,rhizomatous,ruit,rusty,short,simple,spaced,stage,stalk,stellae,straight,tal,tamen,tem,thick,throughout,time,tube,unbranched,unit,unknow,uvenile,vary,vein,white,wide,x,yellowish,ympodial	5-merous,abaxial,adaxial,colour,corolla,filament,form,growth,height,history,leaf,life,ovary,plant,position,reproduction,seed,shape,staman,stigma,surface,texture
218	wfo-0001027299	success	237	94	57	180	37	0.241	25-30,abaxial,abaxially,anther,apart,apex,asymmetric,cm,densely,diameter,elongating,erect,expanded,filament,flower,fruit,glabrous,globose,hirsute,inflorescence,intense,lanceolate,lateral,leaf,length,lenticular,minutely,mm,ovate,pedicel,peduncle,pentagonal,petiole,pitted,plump,pubescent,purplish,racemose,reniform,rotate,short-stalked,shrub,simple,slightly,stellae,stellate,stellate-pubescent,stigma,style,sun,surface,tan,violet,weakly,yellow,young,×	.5,0.2–3,0.3–0.8,0.5–1.5,0.8–1,0.8–1.2,0–10,1.2–1.5,1.3–1.7,1.5,1.5–3,1.5–4,11–17,15,15–19,1–2,1–3.5,1–4,2.5–4,2.5–5,2.7,2–13,2–2.7,3–3.5,4.5–13,4–10,5,5-merou,5.2,5–10,5–12,6,6–10,6–8,6–9,7–11,7–9,8–13,8–20,9–25,accrescent,acicular,acuminate,adaxially,along,alyx,apiculate,apparently,appearing,articulated,ascending,axe,barely,base,becoming,blade,branch,branched,bristle,bristle-like,broadly,c.,calyx,campanulate,cauline,common,composed,conduplicate,contiguous,cordate,coriaceous,deciduou,delicate,deltate,deltoid,dense,densest,developed,directed,distall,distally,eaf,eed,entire,equalling,erry,exceeding,falcate,filiform,fruiting,geminat,glabrou,hair,initially,intergrading,internode,intervening,interwoven,like,linear,lobe,long,long-stalked,lower,margin,maturit,midpoint,midvein,midzone,mixed,narrowly,nearly,nflorescence,obtuse,often,one,orange,orolla,overtopped,ovoid,perfect,plurifoliate,pore,prickle,prickly,principal,pubescence,rachise,rarely,ray,reaching,repand,ripe,secondary,short,shorter,side,similar,slender,smaller,sometimes,somewhat,some­what,soon,spaced,sparse,spreading,spreadingly,stalk,stalked,stellate-tomentose,stem,stipitate-stellate,straight,styl,tall,tamen,tapering,tardily,tem,terminal,thick-textured,tippe,truncate,tube,ud,ultimate,unarme,unarmed,undulate,usually,vary,varying,vein,well,wooll,woolly,ympodia,–7,–9	0-10,0.8-1,1-2,1-3.5,1.3-1.7,1.5-3,1.5-4,2.5-4,5-10,5-12,7-11,7-9,8-20,9,adaxial,arrangement,colour,corolla,form,growth,height,history,life,maturity,na,number,ovary,plant,position,rachi,reproduction,seed,shape,spacing,staman,texture,width
219	wfo-0001027302	success	188	79	57	131	22	0.303	0.4-5,0.5-1,0.6-1,1-1.3,1-1.5,1.2-2.5,10-20,2-6,2.2,3.5-5,abaxial,adaxial,anther,apex,appearing,bright,capitate,clavate,cm,corolla,densely,diameter,filament,flat-topped,flattened,flower,glabrous,globose,growth,later,lateral,leaf,length,lenticular,lobed,minutely,mm,narrowly,ovary,ovate,petiole,pitted,plant,plurifoliate,puberulent,pubescent,pyramidal,red,reddish-brown,shrub,small,stigma,style,surface,terminal,tree,violet	.5,0.5,0.8-1,1,1-2,1-3,1.2-1.6,1.5-2,10,2,2-3,2.7-7.5,3/4,5-7,6-12,7,7/8,abaxially,acuminate,acute,adaxially,age,along,anthesi,apical,ba,bark,basal,base,becoming,berry,blade,branching,broader,brownish-yellow,calyx,conical,cordate,crispate,cultivation,decurrent,deflexed,deltoid,dendritic,denser,dichasia,discussion,eaf,edicel,eed,elliptic,entire,especially,ew,exserted,fine,free,fruiting,growing,inserted,juvenile,larger,lax,less,like,lobe,lon,long,long-triangular,lower,m.,main,margin,monochasial,nflorescence,nodding,occasionally,older,otherwise,overtopping,pair,pale,papillo,pedicle,per,pericarp,planar,pore,poridical,portion,prominent,reflexed,ruit,scar,scattered,scrambling,secondary,see,shade,shin,shoot,simple,sleeve,slit-like,somewhat,sparsely,stamen,stem,strongly,tall,tapering,thin,time,tiny,tip,trichome,truncate,tub,tube,ud,undulate,unit,usually,vein,way,wide,winged,woody,x,ympodial,young	arrangement,colour,form,fruit,height,history,inflorescence,life,na,number,pedicel,peduncle,perennial,position,rachi,reproduction,seed,shape,spacing,staman,texture,width
220	wfo-0001027310	success	215	96	78	137	18	0.363	/3,0.6-1,0.7-2,1-1.2,1-1.7,1-6,2-10,2-3.1,20-60,4-9,4.5-5.5,5-20,5-merous,abaxial,abaxially,adaxial,andromonoecious,anther,apex,articulated,base,berry,branched,branching,chartaceous,cm,connivent,curved,dark,densely,diameter,erect,evenly,filament,flattened-reniform,flower,fruit,gently,glabrous,glaucous,green,green-brown,lanceolate,leaf,length,lobed,maturity,mauve,minutely,mm,moderately,orange-brown,pedicel,peduncle,petiole,pitted,plant,poricidal,primary,purple,rounded,secondary,shallowly,shrub,spherical,stellate,stellate-pubescent,stout,straight,style,surface,tapering,tip,tree,truncate,way,yellow,young	-2.2,-20,.8,0,0-20,0-5,0.05,0.05-0.15,0.1,0.1-0.2,0.15-0.3,0.9-0.17,1.1-1.5,1.5-2.2,1.5-5,1/10-1/6,1/3-1/2,1/3-3/4,11-16,2-4,2-5,2.2-2.5,2.8-3,2/3,22-30,3-15,4-10,4.5-7,5-10,5-7,6-8,7-10,8-10,9-13,acut,acute,alyx,apar,apart,apically,apparently,bark,blade,broadly,calyx,cuneate,deltate,discolorous,distal,drying,eaf,eed,elongating,entire,equal,faint,flattened,foliaceous,free,fruiting,fused,glabrescent,glabrou,gray,hair,hermaphrodite,heterostylous,inflated,infructescence,lateral,less,lobe,long,long-styled,longer,lower,lowermost,margin,mature,midpoint,nflorescence,older,one,open,orolla,oung,pair,pale,pendulous,per,pericarp,plurifoliat,porrect,porrect-lepidote,portion,prickle,prickly,pubescent,ray,red,reddi,reflexed,ruit,scar,sessile,short-styled,shorter,simple,smooth,sometimes,spaced,sparse,sparsely,spreading,stalk,stalked,staminat,stem,strongly,tamen,terete,terminal,tertiary,time,toward,trichome,tube,unarme,unarmed,unit,vary,vein,venation,visible,wide,woody,ympodial	colour,corolla,form,growth,height,history,inflorescence,life,number,ovary,perennial,reproduction,seed,shape,spacing,staman,stigma,texture
221	wfo-0001027313	success	173	97	58	115	39	0.335	.7,1.5,4,50,abaxially,adaxially,anther,apex,atenuate,cm,densely,diameter,dull,filament,flower,fruit,glabrous,globose,green,hair,high,interpetalar,lanceolate,lateral,leaf,little,long,loosely,minutely,mm,ovate,pedicel,peduncle,persistently,petiole,pitted,purplish,shrub,simple,small,sparse,stellate,stellate-pubescent,stellate-tomentose,stigma,style,surface,thick-chartaceous,tissue,tomentose,tree,unarmed,violet,weak,whitish,yellow,yellowish,×	.5,0.15,0.1–0.3,0.5–0.6,0.8–1,1.2–1.3,1.2–1.4,1.5–2,1–1.3,1–2,1–4,2–3-branched,2–4.5,2–8.5,3–3.5,3–4,3–5.5,3–9,4.5–5,5,5-merou,5.5–16,5.5–7,5–6,6–11,6–8,acute,adaxiall,along,alyx,apar,apical,apparently,articulated,attenuate,axe,base,blade,branch,branched,broadbased,capitat,cordate,dbh,difoliate,directed,distall,eaf,eed,entire,filiform,finely,geminat,half,homostylous,immature,internode,irregularly,like,lobe,lon,lower,margin,maturing,midpoint,midvein,minute,much,narrowly,nearly,nflorescence,obtuse,orolla,ovoid,perfect,pore,porrect,prickle,principal,rarely,ray,ruit,scar,sessile-stellate,short-stalked,short-stipitate,shorter,side,similar,sinuate,sinus,slender,sometimes,splitting,stalk,stellae,stellate-tomento,stem,tamen,tem,time,triangular,tube,ud,unarme,undulate,usually,vary,vein,vigorous,whitish-tomentose,wide,ympodia,–12,–3	0.5,0.8-1,1-1.3,1-4,1.2-1.3,1.2-1.4,2-3-branched,3-5.5,4.5-5,5-merous,5.5-7,6-11,abaxial,adaxial,apart,arrangement,capitate,colour,corolla,form,growth,height,history,inflorescence,length,life,na,number,ovary,plant,position,rachi,reproduction,seed,shape,spacing,staman,texture,width
222	wfo-0001027315	success	217	81	62	155	19	0.286	.5,0.15-0.2,0.3-0.6,0.3-1,0.4-0.7,0.6-0.8,2,2-2.5,2-5,3-7,?,anther,apex,blue-green,brown,capitate,cm,conical,corolla,densely,diameter,dioecious,elliptic,entire,filiform,flattened,flower,glabrous,globose,growth,immature,inflorescence,internodal,length,margin,minutely,mm,ovary,paler,pedicel,peduncle,petiole,pitted,plant,pubescent,purple,reddish,reniform,ripe,shiny,shrub,simple,stellate,stem,stigma,style,surface,thin,trichome,unisexual,white,yellowish	.15,.5x,.9,0.2,0.2-0.5,0.25-0.4,0.3-0.5,0.5,0.6-0.6,0.6-0.7,0365,1-1.3,1-1.5,1-2,1.3-3,1.5-1.7,1.5-2,1.5-3,10-20,2-7.5,2/3,3,3-3.5,3-5,5-7,8,<,abaxially,acute,adaxially,age,almost,along,anthesi,arching,armed,articulated,bark,base,berry,broad-based,calyx,consisting,correlated,dark,deltate,dense,difoliate,discolorous,drying,eaf,echinoid,eed,ekman,ellipsoid,especially,exerted,female,fide,filament,free,fruiting,fused,geminat,glabrescen,globular,greyish-white,half,hangin,highly,impressed,lamina,lengthening,lepidote,like,lobe,lobed,long,lower,male,marginal,markedly,midpoint,midrib,minute,mixture,new,nflorescence,oblique,obscuring,occasionally,often,older,overlappin,packed,pair,pale,papillo,pentagonal,per,pericarp,pistillate,plan,planar,pore,poricidal,porrect,portion,present,prickle,pricklines,primary,prominent,ray,rest,rhachi,rounded,ruit,scar,scattered,sessile,shoot,short,short-stalked,shorter,similar,slit,smaller,solitary,somewhat,sparse,sparsely,stalked,staminate,stellate-lepidote,straight,strongly,throughout,tightly,tip,tube,ud,unarmed,unit,vein,venation,vestigial,visible,way,without,woody,x,ympodial,young,½	abaxial,colour,form,fruit,height,history,leaf,life,na,number,perennial,position,rachi,reproduction,seed,shape,spacing,texture,width
223	wfo-0001027317	success	144	73	44	100	29	0.306	0.4-1.5,1,1-1.5,1-2,1.4-1.6,3-3.5,4.5-5,?,abaxial,acuminate,acute,anther,apex,bilobed,closely,cm,corolla,densely,elliptic,filament,filiform,fruit,glabrous,globose,golden,green,leaf,lobed,mm,offset,opposite,ovary,pedicel,petiole,pubescent,shrub,simple,slightly,spaced,sparsely,stigma,style,surface,white	.25,.5,0.1-0.2,0.3-1,0.5-1,0.5-3,0.8-3.5,1-5,1.5-2,2-3-flowered,2-9,7-9,adaxially,along,anthesi,apical,apically,arch,ba,bark,base,beneath,berry,broadly,calyx,conical,cucullate,deciduous,deflexed,deltoid,dia,differing,difoliate,drying,eaf,edicel,eed,ellipsoid,elongated,erect,expanded,free,fruiting,geminat,greyish-whit,immature,inflorescenc,joined,known,lateral,like,lobe,lon,long,long-exserted,lower,main,major,margin,mature,minor,minute,minutely,nearly,nflorescence,older,overlappin,pair,pale,papillo,papillose,pointed,pore,poricidal,portion,projection,prominent,reflexed,rest,ruit,scar,series,shaped,size,soon,stem,strongly,tall,tear-drop,tip,trichome,tub,tube,ud,uniseriate,vein,woody,x,ympodia,young	0.25,2-3,adaxial,alternate,arrangement,colour,diameter,flower,form,growth,height,history,inflorescence,length,life,na,number,peduncle,perennial,plant,position,rachi,reproduction,seed,shape,spacing,staman,texture,width
224	wfo-0001027323	success	175	84	57	118	27	0.326	/3,0.5-1,1-1.5,1.2-1.5,2-3,2-6,2.5-3,5-7,acute,adaxial,anther,apex,area,base,berry,broadened,closely,cm,corolla,densely,elliptic,erose,filament,fleshy,flower,fruit,furcate,glabrous,globose,leaf,lobed,minutely,mm,occasionally,opposite,ovary,overlapping,ovoid-reniform,papillose,pedicel,petiole,pinkish-grey,pitted,plant,reddish-grey,spaced,stigma,style,surface,tan,thin,tip,treelet,way,white,winged,x	.75,1-2,10-15,14-21,20-45,3-5,5-20-flowered,6-11,7-9,along,anthesi,apparent,appearing,arising,asymmetric,attenuate,ba,bark,bud,calyx,campanulate,character,closed,cork,decurrent,deflexed,dia,differing,difoliate,dried,dry,eaf,edicel,eed,elongate,entire,erect,exserted,five-pointed,flopping,free,fruiting,geminat,glabrate,grey,growing,held,higher,hood,hooded,immature,interpetalar,lateral,like,live,lobe,lon,long,long-triangular-deltoid,lower,main,major,margin,matte,mature,measured,middle,minor,nflorescence,older,one,onto,ovoid,pair,papillae,papillo,partially,persistent,planar,pore,poricidal,portion,prominent,proximal,rather,red-papillose,rest,ridge,ruit,scar,secondary,seen,shaped,sinus,size,slightly,small,smoot,soon,specimen,stem,straight,tall,tear-drop,thickened,tiny,trunk,tube,two,ud,unit,upper,vein,visible,widest,woody,ympodial,young	5,5-20,7,abaxial,arrangement,colour,diameter,form,growth,height,history,inflorescence,length,life,na,number,peduncle,perennial,position,rachi,reproduction,seed,shape,spacing,staman,texture,width
225	wfo-0001027340	success	189	92	66	123	26	0.349	0.5-0.9,1-10,1-2,16-22,2-4,3.5-5,5-11,5-6,7-8,8-14,8-9.5,abaxially,adaxially,anther,apex,axillary,bud,cell,chartaceous,cm,cordate,corolla,covering,dark,diameter,elliptic,filament,flower,forked,fruit,glabrous,globose,green,greenish,hair-like,herb,lateral,lilac-purple,membranous,minutely,mm,odd-pinnate,ovate,ovoid,pedicel,peduncle,petiole,plant,puberulent,pubescent,purple,rotate,rounded,seed,sparsely,stigma,style,subtending,terminal,testal,thick,tinged,truncate,wall,whitish,yellow	1-3,1.5-2.7,10-16,2-3,2-3.5,2.5-4.5,2.7-4.5,3-4,3.5-9,4-6,4-7.5,5-merou,6-8.5,7-18,abruptly,absent,acumen,acuminate,ag,along,alyx,apart,apparently,articulated,articulation,auriculate,axe,base,berry,blade,brownish,capitat,ciliate,condition,connivent,decreasing,developing,digestion,distal,distinct,dorsally,drying,eaf,edge,eed,enzyme,especially,exceeding,flat,folded,fresh,geminat,generally,glabrou,green-white,hair,hal,half,high,homostylous,honeycomb-shaped,indistinct,interjected,lanceolate,leaflet,lengthening,like,living,lobe,long,lower,make,margin,midrib,minute,mucilaginous,narrow,narrowed,nflorescence,orolla,pair,papillose,perfect,petiolulate,plurifoliate,pointed,pore,poricidal,purpl,removed,ripe,ruit,semi-erec,semi-rosette,sessile,seudostipule,short,shortly,size,slightly,slit,spaced,specimen,splotched,stamen,ste,stem,straight,tall,tamen,tem,throughout,tip,tri-,tube,unit,usually,vary,wet,wing,x,ympodial,young	abaxial,adaxial,arrangement,capitate,colour,form,growth,height,history,inflorescence,leaf,length,life,na,number,ovary,perennial,position,rachi,reproduction,shape,spacing,staman,surface,texture,width
226	wfo-0001027354	success	166	90	69	97	21	0.416	0.5-2,0.7-1.3,1-1.5,1-7,1.5-1.8,10-20,3.4-4,4-10,5-7,abaxial,abaxially,acute,adaxial,anther,apex,appearing,bi-lobed,branch,cm,corolla,dark,dendritic,densely,diameter,elliptic,filament,flattened,flower,fork,fruit,glabrous,globose,golden,growth,later,lateral,leaf,length,lenticular,lobed,minutely,mm,narrowly,occasionally,ovary,pedicel,pericarp,petiole,pitted,plurifoliate,pubescent,purplish-black,pyramidal,reddish-brown,shrub,small,sparsely,stigma,style,surface,tapering,terminal,thin,tiny,tree,tree-like,trichome,violet,white	.5,0,0.5,1,1-1.2,1.5-2,1.7-5,10,2.5-3.5,3-4,3/4,6.5-13,8-12,absent,age,along,anthesi,apical,ba,bark,basal,base,becoming,belo,berry,blade,branching,calyx,conical,covered,deltoid,denser,dichasia,drying,eaf,edicel,eed,entire,erect,ew,exserted,free,fruiting,glabrate,inserted,less,like,lobe,long,loose,loosely,lower,m.,monochasial,mostly,near,nflorescence,nodding,older,pair,papillo,per,planar,pore,poricidal,portion,pubescen,raised,ruit,scar,secondary,side,simple,sleeve,slightly,slit-like,somewhat,stamen,stem,strongly,tall,thecalyx,time,tip,tub,tube,type,ud,unit,vein,way,wide,winged,woody,x,ympodial,young	arrangement,colour,form,height,history,inflorescence,life,na,number,papillose,peduncle,plant,position,rachi,reproduction,seed,shape,spacing,staman,texture,width
227	wfo-0001027359	success	224	86	66	158	20	0.295	-2,.5,0-9,0.1-1.5,0.3-1.2,0.5-2,1-1.2,1-5,1.2-1.5,2.5-3.5,3-10,4-,5-6.5,6-8,abaxially,acute,anther,apex,berry,branched,bright,cell,chartaceous,cm,densely,diameter,dull,erect,filament,filiform,flattened-reniform,flower,fruit,lateral,leaf,length,lobed,maturity,membranous,minutely,mm,moderately,orange-brown,outline,ovate,pedicel,peduncle,petiole,pit,purple,rachi,raised,red,reticulate,scandent,shrub,small,smooth,spherical,stellate,stellate-pubescent,style,surface,terminal,white,yellow	-0.25,-20,-3,-4,-7,-9,.1,.2,/3,/4,0,0-2,0-3,0-5,0.1,0.1-0.2,0.3-0.5,0.5,0.5-1,0.6-0.8,0.6-1,1-2,1-3,1-4,1.2-2,1.5-2,1.5-2.5,1.8-3.2,1/5-1/4,2-10,2-3,2-4,2.5-5.5,4-5,5-,5-merous,7-8,acut,alyx,apar,apart,apically,apparently,articulated,ba,bark,base,blade,brow,calyx,concolorous,coroll,cream,cuneate,curved,dark,deltate,difoliate,distinctive,drying,eaf,eed,elongate,elongating,entire,equal,eye,flattened,free,fruiting,geminat,glabrescent,glabrous,gray,green,herbaceous,infructescence,less,like,lobe,long,longer,lower,margin,marking,mature,midpoint,naked,narrow-deltate,narrow-ovate,near,nflorescence,obtuse,occasional,often,older,one,open,orolla,oung,ovoid,pair,pale,per,perfec,pericarp,poricidal,porrect,portion,prickle,prickly,primary,rarely,ray,reflexed,ruit,scar,sessile,shallowly,shorter,simple,slender,slightly,sometimes,spaced,sparsely,spreading,stalk,stalked,stem,stump,tamen,tapering,terete,tertiary,time,tinge,tip,trichome,tube,ud,unarme,unarmed,undulate,unit,usually,variously,vary,vein,venation,visible,way,weakly,wide,woody,yellow-brown,ympodial,young	abaxial,adaxial,colour,corolla,form,growth,height,inflorescence,na,number,ovary,plant,position,reproduction,seed,shape,spacing,staman,stigma,texture
228	wfo-0001027365	success	233	83	52	181	31	0.223	5-merous,abaxial,adaxial,andromonoecious,anther,apparently,blue,branched,brown,capitate,chartaceous,cm,dark,densely,diameter,elliptic,filament,flower,fruit,glabrous,globose,golden-tan,green,inflorescence,juicy,lanceolate,leaf,length,light,lighter,mm,orange,pedicel,peduncle,petiole,plant,pubescent,rachi,reniform,rotate-stellate,rugose,slightly,sparsely,stellate,stigma,style,subcoriaceous,surface,tree,unbranched,violet,yellow	.1,.1–0.3,.2,.5,0,0.1–0.3,0.2–0.5,0–0.03,0–0.1,1,1.1–1.4,1.5–1.8,10–15,11–14,14–15,15–30,1–1.9,1–4,2,2.2–2.3,2.3–4.2,2.5–4.5,2.6–3,2.8,2–,2–5,3,3–10,3–3.5,3–3.9,4.5–5,4–4.5,4–5,5–5.5,5–8,6–7.5,7–1,7–15,8–15,8–9,abaxially,absent,acuminate,acute,adaxially,ag,along,alyx,andromonoeciou,anthesi,apart,apex,articulated,axe,ba,bark,base,becoming,berry,bilobe,blade,broad-based,broadly,calyx,central,column,congested,connivent,cuneate,curved,cylindrical,db,difoliate,directed,discolorous,distally,dried,eaf,eed,eglandular,either,emergent,entire,equal,extraaxillary,flattened,flowering,free,fresh,frui,fruiting,functionally,geminat,glandular,hair,half,hermaphroditic,heterstylous,included,inflated,interpetalar,knobby,like,lobe,lobed,long,longitudinal,lower,major,margin,maturity,membranaceous,midpoint,midvein,moderate,moderately,mostly,mpodial,multangulate,multangulate-stellate,multiseriate,multiseriate-stalked,nearly,nflorescence,oblique,obtuse,often,one,opening,orolla,outline,part,pericarp,pore,porrect-stellate,portion,prickle,pronounced,ray,reduced-stellate,reflexed,repand,ruit,runk,sessile,shallowly,sharp,shiny,short-stalked,side,simple,slit,somewhat,spaced,stalk,stalked,staminate,stellate-pubescent,stem,stout,straight,strongly,subtending,tamen,tan,tapered,thi,time,tissue,truncate,tube,unarmed,unit,vary,vein,wide,within,young,×,–2,–20	1-4,1.5-1.8,10-15,13,14-15,2-5,2.3-4.2,2.5-4.5,20,3-10,4-5,4.5-5,8-15,bilobed,colour,corolla,form,growth,height,history,life,na,number,ovary,perennial,reproduction,seed,shape,spacing,staman,texture
229	wfo-0001027366	success	136	75	46	90	29	0.338	0.5-1,0.7-1,1-2,1-3,2-2.5,4-5,5-7,abaxially,adaxially,anther,apex,bright,broadly,brown,capitate,cm,corolla,dark,drying,elliptic,filament,glabrous,globose,golden,green,greenish-white,internodal,leaf,lobed,minutely,mm,opposite,orbicular,ovary,ovoid-reniform,pedicel,petiole,pitted,shining,shrub,simple,sometimes,somewhat,stigma,style,surface	.5,/2,/4,0.25-0.5,1-1.5,1.5-2,11-21,3-10-flowered,3-9,4-4.5,6-19,603,acute,anthesi,ape,axe,ba,bark,base,berry,calyx,closely,conical,conspicuously,deflexed,deltate,dia,eaf,edicel,eed,erect,et,except,exserted,fide,free,fruiting,lamina,lateral,less,lobe,lon,long,long-triangular,lower,main,margin,middle,nflorescence,older,overlappin,ovoid,packed,pair,pale,papillo,papillose,parallel,planar,pointed,pore,poridical,portion,ramo,reddish,rounded,ruit,scar,secondary,shaped,stem,straight,tall,tear-drop,tip,trichome,tub,tube,ud,unifoliat,unit,vein,venation,way,wide,widest,woody,yellowish-gre,ympodial,young	3-10,abaxial,adaxial,arrangement,colour,diameter,flower,form,fruit,growth,height,history,inflorescence,length,life,na,number,peduncle,plant,position,rachi,reproduction,seed,shape,spacing,staman,texture,unifoliate,width
230	wfo-0001027368	success	145	85	53	92	32	0.366	-15,-20,-5,.5,0.3-2.5,0.5-3.5,0.5-5,1-2,1.5-2,3,4-6,5-15,5-6,apart,apex,chartaceous,cm,densely,diameter,ellipsiodal,elliptic,elliptic-ovate,forked,glabrous,globose,lanceolate,lenticular,margin,mm,narrowly,nearly,otherwise,ovoid-fusiform,pedicel,peduncle,petiole,puberulent,pubescent,purple,rachi,shrub,simple,sparsely,stellate,stigma,style,subcoriaceous,truncate,unbranched,unknown,white,x,yellow	-10,-2,0.8-2,1-15-flower,1-6,1.5-2.5,2,2-2.5,2-3,2-4,2-9,3-12.5,4-many-foliat,5-10,8-13,abaxially,abruptly,absen,acuminate,acute,adaxiall,adaxially,aggregate,also,articulated,axe,ba,base,blade,branched,calyx,cell,color,connivent,contiguous,cuneate,cylindrical,darker,decurrent,deltate,dendritically,denser,directed,distally,eaf,eed,entire,except,gland,hair,lighter,lobe,long,long-stalked,lower,midvein,moderately,narrowed,nflorescence,nther,oblong,obtuse,occasionally,often,orolla,pore,pubescen,radiu,ray,ruit,small,sometimes,spaced,stalked,star,stone,subcapitat,subhastate,tal,tem,terminal,three,time,tip,triangular,tube,unit,usually,vary,vein,wide,ympodial	1-15,abaxial,adaxial,anther,arrangement,colour,corolla,filament,flower,form,fruit,growth,height,history,inflorescence,leaf,length,life,na,number,ovary,plant,position,reproduction,seed,shape,spacing,staman,subcapitate,surface,texture,width
231	wfo-0001027369	success	191	77	51	140	26	0.267	.5,/4,0-1,0.5-0.8,0.6-0.8,1-2.5,1.5-2,2-4,2-5,5-merous,anther,apart,apex,articulated,base,berry,cm,diameter,erect,filament,flower,fruit,glabrous,glaucous,green,lateral,leaf,length,lobed,mauve,membranous,mm,moderately,orbicular,pedicel,peduncle,petiole,reniform,rounded,scandent,shrub,simple,smooth,sparsely,spherical,stellate,stellate-pubescent,style,surface,terminal,way	-1,-10,-11,-2,.1,.4,.7,0,0-15,0-3,0-5,0-6,0.05-0.15,0.1,0.1-0.2,0.1-0.3,0.2-0.5,0.25-0.4,0.3-1.5,0.5,0.5-1.5,1-,1-2,1-3,1-4,1.2-2.5,1.2-3,1/3,2-3,3,3-10,3-4,4-5,4-8,5,7-15,abaxially,acut,almost,alyx,ame,apar,apically,apparently,bark,blade,branched,broad-deltate,c.,calyx,color,concolorous,cordate,curved,deltate,densely,difoliate,distance,drying,eaf,eed,elongating,equal,extending,eye,filiform,free,fruiting,geminat,glabrou,gra,hair,herbaceous,infructescence,know,known,lanceolate,less,lobe,lon,long,lower,margin,mature,midpoint,midvein,multangulate,naked,narrowly,nflorescence,older,one,open,orolla,oung,pale,pendulous,per,perfec,pericarp,perpendicular,poricidal,porrect,portion,prickl,prickle,prickly,ray,reflexed,ruit,scar,sessile,side,slender,slightly,spaced,spreading,stalk,stalked,stem,straight,strongly,tamen,tapering,terete,time,tip,trichome,tube,unarmed,unequal,unit,vary,venation,visible,wide,wider,winged,yellow,ympodial	-5.5,abaxial,adaxial,arrangement,colour,corolla,form,growth,height,history,inflorescence,life,na,number,ovary,plant,position,rachi,reproduction,seed,shape,spacing,staman,stigma,texture,width
232	wfo-0001027378	success	149	82	45	104	37	0.302	.2,5-8,abaxially,acuminate,adaxial,adaxially,anther,apex,blue,broadly,chartaceous,cm,diameter,extra-axillary,filament,fleshy,flower,fruit,glabrous,herbaceous,leaf,light,membranous,mm,ovate,ovoid,pedicel,peduncle,pentagonal,petiole,pubescent,rachi,rotate-stellate,simple,slender,somewhat,sparsely,stigma,style,terrestrial,unbranched,unknown,vine,white,x	0.5–1,0.7–1,0.8–2.5,1.2–1.5,1.2–1.8,1.5–1.8,1.5–8,15–35,1–1.5,1–3,2.3–5,2.5–7,2–11,2–2.2,2–2.5,3–4.5,3–5,3–6,4–6,4–9,5-merous,5–10,5–13,5–7,6–10,6–7,acute,alyx,apar,apicall,axe,base,berry,blade,c.,calyx,capitat,ciliate,clavate,climbin,color,cordate,cylindrical,deeply,deltoid,densely,eaf,eed,flattened,fruiting,glabrou,hair,hair-tipped,half,lanceolate,like,lobe,lon,long,longer,lower,m.,margin,markedly,minutely,moderately,narrowly,nflorescence,nternode,obscure,often,orolla,palmate,papillose,perfec,plurifoliat,pointed,primary,revolute,rounded,ruit,sand-punctat,sand-punctate,scattered,short,side,slightly,small,spaced,stem,tamen,tem,tip,tooth,trichome,tube,unit,unknow,vary,vein,venation,wide,widely,ympodial	0.7-1,0.8-2.5,1.5-1.8,15-35,2-11,2-2.2,2.5-7,3-6,4-6,5-13,abaxial,arrangement,capitate,climbing,colour,corolla,form,growth,height,history,inflorescence,length,life,na,number,ovary,perfect,plant,position,reproduction,seed,shape,spacing,staman,surface,texture,width
233	wfo-0001027378	success	141	78	52	89	26	0.369	.2,0.7-1,0.8-2.5,1.5-1.8,15-35,2-11,2-2.2,2-4,2.5-7,3-6,4-6,5-13,5-8,anther,apart,apex,blue,broadly,chartaceous,climbing,cm,diameter,extra-axillary,filament,fleshy,flower,fruit,glabrous,herb,leaf,light,mm,ovate,pedicel,peduncle,petiole,pubescent,rachi,rotate-pentagonal,simple,slender,somewhat,sparsely,stigma,style,terrestrial,trailing,unbranched,unknown,white,x,yellow	1-1.5,1-3,1.2-1.5,1.5-8,2.3-5,3-4.5,3-5,4-9,5-merou,6-10,6-7,abaxially,acuminate,acute,adaxially,ag,alyx,apicall,apparently,articulated,axe,ba,basally,base,blade,calyx,capitat,ciliate,clavate,connivent,cordate,cylindrical,deeply,deltoid,densely,directed,distally,eaf,eed,equal,fruiting,geminat,hair,hair-tipped,lanceolate,large,lobe,long,longer,longitudinal,lower,margin,minutely,moderately,multicellular,narrowly,nflorescence,node,oblong,obscure,often,opening,orolla,perfect,plurifoliate,pore,pubescen,revolute,rooting,rounded,scattered,short,slightly,slit,small,spaced,tamen,tem,tip,tooth,tube,unit,unknow,vary,vein,weakly,wide,widely,ympodial	abaxial,adaxial,arrangement,capitate,colour,corolla,form,growth,height,history,inflorescence,length,life,na,number,ovary,plant,position,reproduction,seed,shape,spacing,staman,surface,texture,width
234	wfo-0001027380	success	134	83	56	78	27	0.418	.5,2-3,2-3.5,30-35,4-6.5,5,5-merous,?,abaxially,adaxially,anther,apex,base,berry,broadly,chartaceous,cm,conical,deeply,diameter,distally,extra-axillary,filament,flattened,flower,forked,fruit,glabrous,globose,homostylous,leaf,minutely,mm,orange-red,ovate-lanceolate,paler,pedicel,peduncle,petiole,pubescent,rachi,red,reticulate,shrub,simple,slender,slightly,small,sparsely,stellate,stigma,style,thickening,tree,unbranched,white	0,1-1.5,11-17,1136.,2.5-3,3-4,5-8,9-10,accrescen,acuminate,adaxiall,almost,alyx,apparently,armed,articulated,axe,ba,bark,blade,brown,calyx,capitat,developed,drying,eaf,eed,entire,erect,fruiting,geminate,greenish-brown,hair,hartley,hooked,len,lobe,lon,long,loose,lower,margin,minute,mpodial,nflorescence,oblique,occasionally,open,orolla,oung,pair,perfec,perfect,prickle,primary,rip,rounded,ruit,scarcely,scattered,scramblin,shallow,smooth,somewhat,sparse,stem,structure,tall,tamen,testa,triangular,truncate,unarmed,unknown,vary,vein,visible,x	abaxial,adaxial,arrangement,capitate,colour,corolla,form,growth,height,history,inflorescence,length,life,na,number,ovary,plant,position,reproduction,ripe,seed,shape,spacing,staman,surface,texture,width
235	wfo-0001027381	success	262	89	66	196	23	0.252	.8,0-1,0-1.5,0.5,0.5-0.6,0.5-1,1-2.5,1.5-4,3.5-4,5-11,anther,apex,blackish,brown,capitate,clavate,cm,cream,dark,diameter,distributed,drying,dull,elliptic,erect,evenly,filament,flower,fruit,glabrous,globose,green,lateral,leaf,length,less,lobed,marking,maturity,mauve,mm,oblong,obtuse,orange,orange-green,ovate,pale,pedicel,peduncle,petiole,plant,rachi,rounded,shiny,shrub,simple,smooth,stellate,stellate-pubescent,stigma,style,surface,white,yellow,yellow-green,young	.3,.4,/5,0.1,0.2,0.3-0.5,0.4-0.6,0.5-0.7,0.6-0.7,0°,1-1.5,1-2,1/3-1/2,1/4-1/3,2,2-2.5,2-3,2-4,2-6,3-4,3-5,3-7.5,4-5,4-8,5-8,5-merou,7-8,8-10,abaxially,absent,accrescent,acute,adaxially,age,almost,along,alyx,angle,apically,apparently,area,articulated,attachment,bark,base,berry,blade,branch,branched,calyx,chartaceous,clearly,concolorous,cordate,covering,curved,delineated,deltoid,densely,density,difoliate,dilated,distance,divided,eaf,eed,ellipsoi,elongated,elongating,epidermi,equal,even,exserted,extending,eye,faint,fertile,filiform,flat,flattened,free,fruiting,geminat,gland,grey,greyi,higher,inconspicuous,indumentum,infructescence,irregula,known,lamina,lanceolate,lengthening,light,like,lobe,long,long-deltoid,longer,longitudinal,lower,main,margin,mature,midpoint,midvein,minute,mostly,naked,never,nflorescence,obconical,oblique,obscuring,often,orolla,pair,papillose,part,pendulous,per,perfect,pericarp,point,pore,poricidal,porrect,portion,present,prickle,primary,prominently,protruding,puffy,raised,rarely,ray,reduced,region,rest,right,ruit,scar,sessile,shallow,side,sinus,size,slender,slightly,slit,small,smoot,sometimes,sparse,sparsely,spreading,stalk,stem,straight,striate,stump,surrounded,tamen,tapering,terminal,tertiary,thin,time,tip,tissue,translucent,trichome,truncate,tube,ud,unarme,unarmed,unit,usually,variable,variously,vary,vein,venation,visibl,visible,wide,widening,without,woody,x,yellowish,ympodial	abaxial,adaxial,arrangement,colour,corolla,form,greyish,growth,height,history,inflorescence,life,na,ovary,perennial,position,reproduction,seed,shape,spacing,staman,texture,unknown
236	wfo-0001027384	success	155	82	53	102	29	0.342	.5,0.4-1.1,0.9-1,1-3,1-4,1.5-2,3/4,5-5.5,7.5-8,anther,apart,apex,base,brown,calyx,capitate,clavate,cm,corolla,filament,flattened-reniform,glabrous,globose,green,hard,leaf,lobed,long,minutely,mm,narrowly,obovate,opposite,ovary,pale,papillose,pedicel,petiole,pitted,pseudo-terminal,shrub,simple,slender,small,stigma,style,sulcate,surface,tapering,tree,tube,way,white	.25,.75,/3,0.5-1,1-1.3,1-1.5,2.5-6.5,3-3.5,3-4,4-7,5-15-flowered,7-14,abov,acute,anothe,anthesi,ba,bark,beginning,beneath,berry,breaking,broadly,bud,closely,cuneate,deep,dia,difoliate,distal,drying,eaf,edicel,eed,ellipsoid,equal,erect,free,fruiting,geminate,herbarium,incrassate,inflorescenc,later,lateral,lobe,long-exserted,lower,main,margin,member,middle,mustard,nflorescence,occasionally,older,overlapping,pair,paler,papillo,peeling,planar,pore,poricidal,portion,prominent,rarely,reddish-purple,rounded,ruit,scar,section,shaped,shining,siz,spaced,specimen,stem,straight,subcoriaceous-fleshy,tall,tear-drop,thick,tip,transverse,triangular,trichome,tub,tuft,ud,uniseriate,unit,vein,widely,widest,without,woody,x,yellow,yellowish,ympodial,young	5-15,abaxial,adaxial,arrangement,colour,diameter,flower,form,fruit,growth,height,history,inflorescence,length,life,na,number,peduncle,perennial,plant,position,rachi,reproduction,seed,shape,spacing,staman,texture,width
237	wfo-0001027389	success	154	75	46	108	29	0.299	.5,0.25-0.3,0.5-1.5,0.6-1,1-1.5,1-2,3-3.5,5-7,anther,apart,apex,broadening,brown,cm,corolla,dark,elliptic,filament,filiform,glabrous,globose,green,hispidulous,inflorescence,leaf,lobed,minutely,mm,opposite,ovary,ovate,ovoid-reniform,pedicel,petiole,pitted,puberulent,shrub,slight,sparsely,stigma,style,surface,thread-like,top,white,winged	.1,.25,0.25-0.5,0.5-0.75,1,1.8-1.9,11-14,2-2.5,3-4.5,4-5-flowered,7-8,acuminate,acute,along,anthesi,ba,bark,base,beneath,berry,broadly,bud,calyx,conical,decurrent,deflexed,deltoid,dia,dry,eaf,edicel,eed,ellipsoid,erect,evenly,except,expanded,exserted,foetid,foliage,free,fruiting,geminate,lateral,like,lobe,lon,long,lower,main,making,margin,material,middle,nearly,nflorescence,node,non-reproductive,obovoi,occasionally,often,older,one,pair,paler,papillo,papillose,pore,poricidal,portion,prominent,prominently,proximal,raise,raised,reddish-golden,reflexed,rest,ruit,scar,shaped,shin,side,simple,slender,slightly,soon,spaced,stem,straight,tall,tapering,tear-drop,tip,trichome,truncate,tube,ud,unifoliat,uniseriate,unit,vein,widest,woody,x,yellowish,ympodial,young	4-5,abaxial,adaxial,arrangement,colour,diameter,flower,form,fruit,growth,height,history,length,life,na,number,peduncle,perennial,plant,position,rachi,reproduction,seed,shape,spacing,staman,texture,unifoliate,width
238	wfo-0001027395	success	153	85	56	97	29	0.366	.25,.5,1-1.5,1-5,1.1-1.5,1.5-1.9,2-3,3.5-4,anther,apex,base,beneath,berry,black,capitate,closely,cm,corolla,densely,drying,filament,fleshy,fruit,glabrous,globose,green,leaf,lobed,minutely,mm,narrowly,nearly,obovate,occasionally,once-furcate,opposite,ovary,overlapping,papillose,pedicel,petiole,primary,pubescent,robust,secondary,shrub,simple,somewhat,spaced,stigma,style,thick,vein,white,woody,x	0.25-0.5,0.6-1.1,0.75-1,1-2,1.5-2.5,1.6-2.9,10-20-flowered,11-15,12.5-17.3,2.2-7,4-6,5-6.5,8,acute,anthesi,apically,apiculate,attenuate,bark,becoming,beginning,caly,calyx,conical,constricted,cucullate,decurrent,deflexed,deltoid,depressed,dia,differing,difoliate,eaf,edicel,eed,enlarging,erect,exfoliating,exserted,free,fruiting,geminat,immature,imperceptibly,inflorescenc,known,large,lateral,lobe,lon,long,lower,main,major,margin,midrib,minor,nflorescence,older,ovoid,pair,papillo,partially,piece,planar,pointed,pore,poricidal,portion,raised,restricted,ruit,rusty-papillate,scar,shaped,shining,shiny,size,small,stem,straight,tall,tapering,tear-drop,thickened,tip,transverse,trichome,tube,ud,uniseriate,unit,within,without,ympodial,young	10-20,abaxial,adaxial,arrangement,colour,diameter,flower,form,growth,height,history,inflorescence,length,life,na,number,peduncle,perennial,plant,position,rachi,reproduction,seed,shape,spacing,staman,surface,texture,width
239	wfo-0001027396	success	244	79	63	181	16	0.258	0-3,0-4,0.5-1,0.5-1.5,0.8-1.3,2-3,3.5-6,4-7,5-10,6.5-7.5,abaxial,abaxially,acute,adaxial,almost,andromonoecious,anther,apart,apex,black,brown,chartaceous,cm,densely,diameter,elliptic,elongate,filament,flattened-reniform,flower,fruit,glabrous,herb,leaf,length,lobed,margin,maturity,mauve,mm,moderately,obtuse,orange,pale,pedicel,peduncle,petiole,plant,pubescent,purple,rotate,shrub,smooth,sometimes,somewhat,sparsely,spherical,stellate-pubescent,style,surface,unbranched,white,yellow	-2,-5,-6,/3,0-100,0-30,0-5,0.1-0.5,0.1-1,0.4-0.7,0.5-2,0.5-2.5,0.7-2.5,0.8,1,1-4,1.2-2,1.5-3,1.5-3.5,1.8-3,1/2-2/3,1/3,1/4-1/3,1/6,10-15,10-25,10-30,10-35,12-25,15-40,2-3.5,2-7,2.5-4,2.8-4.5,20-100,3-,3-9,4,4-5,4-6,5-20,5-30,5-50,5-8,5-merous,5.5-7.5,6-20,7-10,7-15,8-20,alyx,ame,apar,apically,apparently,articulated,attenuate,ba,bark,base,berry,blade,broad,broad-deltate,bulbous,c.,calyx,concolorous,connivent,cream,cuneate,curved,dark,decurrent,deltate,difoliate,discolorous,distal,distance,drying,eaf,eed,elongating,equal,erect,extending,extensive,fewer,flattened,free,fruiting,fully,geminat,glabrescent,glandular,gray-brow,green,hair,hermaphrodite,heterostylous,infructescence,lateral,less,lignified,lobe,lobing,lon,long,long-acuminat,long-styled,longer,lower,lowermost,marking,mature,midpoint,midvein,near,nflorescence,often,older,one,open,opening,orolla,oung,pair,pendulous,per,pericarp,perpendicular,poricidal,porrect,portion,prickl,prickle,prickly,primary,ray,red-brown,reflexed,ruit,scar,secondary,sessile,short-styled,side,simple,spaced,spreading,stalk,stalked,staminat,stem,stout,straight,tamen,tapering,tearing,terete,tertiary,time,tip,trichome,tube,unarmed,unit,upper,usually,variously,vary,vein,venation,visible,way,wide,woody,yellow-green,yellowish,ympodial,young	colour,corolla,form,growth,height,inflorescence,na,number,ovary,reproduction,seed,shape,spacing,staman,stigma,texture
240	wfo-0001027416	success	137	82	53	84	29	0.387	0.2-0.4,0.3-0.5,0.5-1.0,1.3-2.0,1.5-2.0,2.6-3.0,3-7,4-7,4-8,5.5-8.5,8-10,annual,anther,apically,blue,branching,broadly,calyx,campanulate,capitate,capitate-glandular,cm,dm,dry,foveolate,glabrous,hair,herb,internodal,lenticular,minutely,mm,ovary,ovate,pentagonal-stellate,pinnatifid,prickle,prickly,sessile,spherical,splitting,stem,straight,strigulose,terete,thrice,twice,uniseriate,villous,violet,viscid-villous,weakly,yellow	.5,1.0,1/2-2/3,4.0-5.5,5-10,5-9-flowere,accrescent,across,acute,along,alyx,anthesi,appearance,base,beneath,berry,blade,borne,brown,cauline,dark,deltoid,developing,dia,difoliate,divided,eaf,eed,enveloped,erect,externally,few-rayed,fine,geminat,gland,green,heteromorphic,incurved,invested,lanceolate,linear,lobe,lon,long,main,maturity,much-dissected,narrowly,nflorescence,often,orolla,otherwise,pedicel,quantity,reticulately,ruit,scattered,short,short-stipitate,simple,slende,slender,slightly,smooth,somewhat,spreading,stellae,strait,tall,tamen,taprooted,tightly,tigma,tub,tube,tyle,ultimate,unit,usually,varying,vein,wholly,wrinkled,ympodial	5-9,abaxial,arrangement,colour,corolla,diameter,filament,flower,form,fruit,growth,height,history,inflorescence,leaf,length,life,na,number,plant,reproduction,seed,shape,staman,stigma,style,surface,texture,type
241	wfo-0001027432	success	215	97	74	141	23	0.344	0.5-1,1-1.5,1-3,1.4-2,2-2.5,3-10,3-5,3-6,30,6-7,8-10,abaxially,anther,apart,apex,base,berry,branching,brownish,c.,chartaceous,clavate,cm,corolla,densely,diameter,filament,flower,fruit,glandular,glandular-pubescent,globose,green,greenish,growth,leaf,light,lobed,many,maturing,mm,mucilaginous,ovary,ovate,ovate-elliptic,pedicel,peduncle,perfect,petiole,plant,reniform,reticulate,shrub,simple,stellate,stigma,style,sub-coriaceous,subglobose,surface,tan,terete,terminal,time,tomentose,trichome,velutinous,villose,way,white,woody,x,yellow,young	-1.5,.5,0.1,0.2-0.3,0.3-0.4,0.3-1.0,0.3-3.5,0.5-0.1,0.8-1.0,1-multicellular,1.5-,1.5-2,1/3,1/4,10-22,2-3-lobed,20-30,3,3-4,3-7,3.5-4.5,4-5,4.5-,5-10,6-10,7-,8-16,acicular,acute,adaxially,angulate,apical,armed,articulate,attenuate,bark,basal,blade,branched,brow,calyx,campanulate,confined,conical,coriaceous,cream,curved,cuspidate,distal,eaf,eed,eglandular,entire,epidermi,erect,especially,exserte,ferruginous,fewer,flattened,free,fruiting,glabrescent,glabrous,heterostylous,hirsute,irregularly,juvenile,laterally,leave,lengthening,like,linear-lanceolate,lobe,long,long-styled,lower,many-celled,margin,midpoint,minute,much,multangulate,multiangulate,near,new,nflorescence,ochraceous,older,one,partially,per,pericarp,plurifoliat,pore,poricidal,porrect,porrect-stellate,portion,prickle,prickly,prominent,puberulent,pubescent,raise,rarely,ray,recurved,ruit,scabrous,sessile,short-styled,similar,slightly,somewhat,spaced,sparsely,staminate,stellate-pubescen,stellate-pubescent,stellate-tomentose,stem,stipitate,straight,subsessile,tapering,testa,thick,tip,tomentose-floccose,tomentose-scabrous,tube,ud,unarmed,unevenly,unicellular,unit,upper,visible,yellowish,ympodial	1.5-7,abaxial,adaxial,arrangement,colour,form,height,history,inflorescence,length,life,na,number,perennial,position,rachi,reproduction,seed,shape,spacing,staman,texture,width
242	wfo-0001027437	success	193	91	67	126	24	0.347	0,1-1.5,1-2,1-4,2-2.5,2-4.5,2.5,30,4-5,5-12,6-8,abaxially,acuminate,acute,anther,apex,base,beige,berry,brown,clavate,cm,corolla,corymbose,cyme,dark,diameter,elliptic,erect,filament,flower,fruit,glandular-viscous,globose,green,growth,internodal,lateral,lenticulate,linear-lanceolate,lobed,mm,oblanceolate,ovary,pedicel,peduncle,petiole,pubescent,reticulate,rugose,scabrous,shrub,spaced,sparsely,stellate-rotate,stigma,style,subreniform,subspherical,surface,tomentose,unevenly,velutinous,white,within,woody,yellow	0.2-0.4,0.4-0.5,1,1-3,1.2-1.5,2-2.5mm,2-3,2-several,2.8-6,4,4-4.5,5-6,7-17,adaxially,anthesi,antrorse,armed,articulated,attenuate,bark,basal,beneath,branched,calyx,chartaceous,compressed,cordate,curved,decurrent,densely,diamete,discolorous,distal,eaf,eed,egalndular,elongate,entire,erec,exceeding,free,fruiting,glabrous,glandular,heterostylous,hirsute,impressed,inserted,laterally,leaving,lengthening,like,lobe,long,long-styled,lower,margin,middle,midpoint,minute,mixed,mixture,near,nerve,new,nflorescence,oblong,older,one,ovate,partially,perfect,pericarp,plurifoliat,pore,poricidal,porrect,portion,prickle,prickly,prominent,puberulent,pubescence,raise,ray,recurved,reddish,reduced,reflexed,ruit,rusty,scar,scarce,sessile,short-styled,simple,slightly,slit,sparse,stalked,staminate,stellate,stem,stipitate,straight,strongly,subcampanulate,tall,terete,testa,thick,three,time,tinge,tip,triangular-lanceolate,trichome,tube,ud,unarmed,unicellular,unit,upper,venation,x,ympodial	abaxial,adaxial,arrangement,colour,form,height,history,inflorescence,leaf,length,life,na,number,plant,plurifoliate,position,rachi,reproduction,seed,shape,spacing,staman,texture,width
243	wfo-0001027447	success	197	71	50	147	21	0.254	0-0.4,0.6-1,1-2.5,17-28,3-4.5,3.5-4.5,4-8,5-13,5-8,acuminate,acute,andromonoecious,anther,apex,chartaceous,cm,densely,diameter,elliptical,erect,extra-axillary,flower,fruit,globose,green,inflorescence,leaf,length,mm,moderately,ovate,pale,pedicel,peduncle,perennial,petiole,plant,pseudo-racemose,red,rhizomatous,shrub,sparsely,stellate,stellate-pubescent,style,surface,unbranched,weakly,white,yellow	%,.25,0-0.5,0-1,0-10,0-2.5,0-4,0.15-0.25,0.2-0.6,0.2-1,0.25-0.3,0.25-0.5,0.4-0.6,0.5-1.7,0.6-0.8,1-1.4,1-10,1-2,1-locular,1.2-1.7,1.3-1.7,1.5-3,10-20,13-18,2.1-3.2,2.3-5,2.5-4,25-30,3-6,3.8-4.3,4-6,4-9,5-merou,6-10,7-10,7-14,7-14.5,7-8,8-13,abaxially,absen,absent,acicular,across,adaxiall,adaxially,adult,alyx,apart,articulated,axe,ba,base,blade,branch,branche,brown,calyx,confined,cross-section,cuneate,cylindrical,decimetre,directed,distall,distally,dm,eaf,eed,eglandular,elliptica,entire,exocarp,finger,fruiting,functional,glabrous,gland-tipped,hair,half,heterostylous,incomplete,index,juicy,juvenile,lamina,lateral,less,lobe,lobed,lobing,long,longer,lower,margin,markedly,mature,mesocarp,midpoint,midrib,midvein,minute,nflorescence,oblique,obtuse,orolla,pair,part,per,placenta,pore,porrect,present,prickle,pubescence,ray,rostrate,ruit,septum,sessile,shallowly,short,side,simple,spaced,stellae,straight,succulent,tal,tamen,tem,thick,thicker,throughout,time,transparent,tube,unarme,unarmed,unit,unknow,upper,vary,vein,wide,x,ympodial	abaxial,adaxial,colour,corolla,filament,form,growth,height,history,life,na,number,ovary,position,reproduction,seed,shape,spacing,staman,stigma,texture
244	wfo-0001027449	success	160	74	48	112	26	0.3	.4,0.5-1,0.8-1.5,0.9-1.1,1.4-1.5,2-4,3-3.5,5-6,acute,anther,apex,beneath,brown,cm,corolla,dark,densely,elliptic,filament,fruit,glabrous,globose,green,inflorescence,leaf,lobed,minutely,mm,narrowly,opposite,ovary,ovoid-reniform,papillose,pedicel,petiole,pitted,pubescent,shrub,simple,small,sparsely,stigma,style,surface,tapering,tree,white,x	.5,.75,/3,0.5-1.5,1.2-1.5,1.5-2.5,10-15-flowered,2-3,3,3-7,4-6,8-15,acuminate,anthesi,appearing,area,arising,around,axil,bark,base,becoming,beginning,berry,bud,calyx,closely,cup,deciduous,deflexed,dense,density,dia,differing,difoliate,dry,eaf,edicel,eed,ellipsoid,erect,exserted,extreme,forming,free,frui,fruiting,geminat,glabrate,inflorescenc,lamina,later,lateral,like,lobe,lon,long,long-acuminate,long-triangular,lower,main,major,material,minor,nflorescence,obconic,oblique,often,older,one,orangish,overlapping,packed,pair,pale,persistent,pointed,pore,poricidal,portion,prominent,raised,red-papillose,reddish-brow,reflexed,rest,ruit,scar,shaped,size,slender,soon,sparse,stem,straight,styl,tall,tear-drop,tip,trichome,trunk,tube,tuft,ud,uniseriate,unit,varying,vein,way,woody,ympodial,young	10-15,abaxial,adaxial,arrangement,colour,diameter,flower,form,growth,height,history,length,life,na,number,peduncle,plant,position,rachi,reproduction,seed,shape,spacing,staman,texture,width
245	wfo-0001027452	success	152	89	56	96	33	0.368	0.5-1,0.5-1.5,0.5-2,1,1-3,1-5,1.5-3,10-20,2-foliate,4,4-6,5-12,absent,anther,apex,brown,calyx,cell,center,chartaceous,cm,diameter,dm,drying,elliptic,elliptic-ovoid,entire,filament,flower,fruit,glabrous,globose,herb,immature,long,margin,maturing,membranaceous,mm,moderately,nearly,new,pedicel,peduncle,petiole,pubescent,rachi,rotate,seed,semitransparent,sparsely,stigma,style,white,x,yellow	.5,0.5-2.5,1-2,1-4.5,1.5,2-4,2-6,3-6,3-9,5-20,abaxially,abundant,acute,adaxiall,adaxially,along,axe,base,berry,beyond,blade,branched,celled,ciliate,connected,cordate,decurrent,dehiscing,densely,denser,eaf,eed,emarginat,equal,explosively,exserted,flat,frui,geminat,growt,hair,held,interpetalar,large,linear-lanceolate,lobe,lower,lying,maturit,mesocarp,nfloresence,notched,oblong,obtuse,often,one-,orolla,outer,parallel,per,perpendicular,placenta,pressure,pubescen,raised,ridge,rounded,ruit,running,short,significantly,single,slightly,smaller,smoother,sometimes,stamen,straight,swollen,tal,tamen,tem,tissue,triangular,tube,two-celled,unbranched,unit,usually,vary,vein,wall,watery,wid,woody,ympodial	abaxial,adaxial,arrangement,bark,bud,colour,corolla,form,fruiting,growth,height,history,inflorescence,leaf,length,life,na,number,ovary,perennial,plant,position,prickle,reproduction,scar,shape,spacing,staman,stem,surface,texture,trichome,width
246	wfo-0001027471	success	165	90	71	94	19	0.43	.5,/4,0.1-0.2,0.2-0.5,0.4-1,0.5-0.6,0.5-1.5,0.9-1,2-2.5,2-3,2-lobed,4-5,anther,anthesi,base,berry,bifid,brittle,closely,cm,conical,corolla,densely,diameter,elliptic,filament,flattened,flower,glabrous,globose,growth,herb,inflorescence,internodal,leaf,leaf-opposed,lobed,maturity,minutely,mm,nodding,ovary,ovate,overlapping,pedicel,peduncle,perfect,petiole,pitted,pubescent,rachi,red-orange,reniform,shape,shrub,simple,small,somewhat,spaced,sparsely,stigma,style,subshrub,surface,tan,thin,tip,way,white,x,yellowish	0.2-0.4,0.5,0.5-0.7,0.7-0.9,1-1.2,1-1.5,1-1.6,1.4-3,1.5-2,3-4,3-7,6-7,abaxially,acute,adaxially,age,along,apex,appressed,ascending,bark,branched,c.,calyx,deltate,dendritic,desnsely,differing,difoliate,distant,drying,eaf,eed,entire,erec,erect,especially,free,fruiting,furcate-dendritic,geminate,included,lamina,lengthening,less,like,lobe,long-triangular,lower,major,margin,midvein,minor,mixture,new,nflorescence,node,occasionally,open-conical,orbicular,pair,pale,papillat,pericarp,petal,planar,plane,pore,poridical,portion,primary,pubscent,reflexed,ruit,scar,scattered,similar,size,slender,slightly,slit,stem,straight,thickened,trichome,trifoliat,tube,ud,uniseriate,unit,usually,vein,woody,ympodial	abaxial,adaxial,arrangement,colour,form,fruit,height,history,length,life,na,number,plant,position,reproduction,seed,spacing,staman,texture
247	wfo-0001027473	success	138	62	37	101	25	0.268	0.5-1,0.8-1,1.3-2,3.5-5,?,anther,apex,brown,clavate,cm,corolla,densely,filament,flattened-reniform,globose,green,leaf,lobed,minutely,mm,obovate,ovary,pedicel,petiole,pitted,pubescent,rootstock,rusty,shape,shrub,sparsely,stigma,style,subshrub,surface,white,woody	.25,/2,0.25-0.5,1-1.5,1-2,1.5-2,1.8-2,1/3,2-2.5,2.5-3,4.5-13,5,6-9,8.5-37,abaxially,absen,acute,adaxially,along,anthesi,ape,apparently,bark,base,berry,calyx,conical,deccurent,decurrent,deep,deflexed,dendritic,denser,di-,dia,differing,drying,eaf,eed,empty,erect,free,fruiting,geminat,giving,glabrous,incrassate,later,lateral,less,like,lobe,long,long-triangular,lower,main,major,margin,middle,minor,minute,near,occasionally,older,overall,pair,pale,papillo,planar,pointed,pore,poricidal,portion,pubesent,ruit,sac,sessile,shaped,somewhat,stem,sterile,strongly,tall,tear-drop,thick,tip,trichome,trifoliate,tube,unit,usually,vein,way,wide,widest,wing,winged,yellowish,yellowish-brow,ympodial,young	abaxial,adaxial,colour,diameter,flower,form,fruit,growth,height,history,inflorescence,length,life,na,number,peduncle,plant,position,rachi,reproduction,seed,spacing,staman,texture,width
248	wfo-0001027483	success	164	99	79	85	20	0.482	0.2-1.9,0.6,1.2-2.5,1.5-2.6,1.5-3,2-3,2-4,2-4.5,3-15,3-6,5-10,5-6,abaxially,adaxially,articulate,branched,cell,cm,coarsely,corolla,covering,cyme,diameter,dichasial,dichasially,distal,dot,ebracteate,elliptical,finely,flower,forked,globose,green,green-white,hair-like,herbaceous,interpetiolar,lateral,leaf,leaflet,light,lighter,long,medium,mm,monochasial,odd-pinnate,ovate,ovoid,pedicel,peduncle,perennial,petiole,plant,proximal,pubescent,purple,ray,rotate,seed,size,smooth,sometimes,stigma,style,terminal,testal,thick,throughout,tuber-bearing,uniform,violet,violet-purple,wall,white,wide,yellow,¼	0-1.,1,1-2,1-2.5,1-4,1-5,1.5-10,2,3-6-foliat,3.5-20,4.5-8,acumen,acute,apex,apical,apically,basal,base,calyx,connate,cuneate,decurrent,dehiscent,digestion,diminishing,dorsally,eaf,edge,eed,emoval,enzyme,erec,exceeding,filament,flat,folded,generally,globo,gradually,half,honeycomb,interjected,introrse,living,lobe,lon,lower,lunat,make,maturing,minute,mucilaginous,nflorescence,nther,obtuse,often,orolla,pair,pattern,perfect,petiolule,plan,poricidally,rachi,reveal,rosette,rounded,ruit,sessile,seudostipule,short,slit,specimen,stamen,straight,subsessile,tall,tem,tissu,toward,typically,unit,vary,varying,ympodial	anther,arrangement,colour,form,fruit,growth,height,history,inflorescence,length,life,number,ovary,reproduction,shape,spacing,stem,surface,texture,tissue
249	wfo-0001027503	success	197	83	63	134	20	0.32	.5,0.4-0.7,0.5,0.5-0.6,0.5-0.7,0.8-1,1,1-3,20-40,4,anther,beige,branched,broad-based,clavate,cm,conical,corolla,densely,diameter,dioecious,echinoid,elliptic,erect,filament,flower,fruit,glabrous,globose,greenish,growth,inflorescence,internodal,leaf,lobed,mm,narrowly,ovary,pale,pedicel,peduncle,petiole,plant,prickle,pubescent,shiny,shrub,small,sparsely,stellate,stem,stigma,straight,style,surface,tan,thin,tree,trichome,unisexual,white,x,yellowish	0.15-0.2,0.2,0.6-0.7,0.9-1.2,1-1.2,1.1-1.5,1.2-2.5,10,2-3,2.5-3,2.5-5.5,549,8-11,<,abaxially,acute,adaxially,age,almost,along,anthesi,apex,armed,articulated,bark,base,beneath,berr,berry,bluntly,broadly,calyx,common,consisting,coriaceous,deflexed,deltate,dense,distally,due,eaf,eed,ellipsoid,elongate,enclosing,entire,expanding,female,fide,foliose,free,fruiting,glabrescen,greatly,grey,included,juvenile,known,lamina,lanceolate,large,lengthening,lepidote,less,like,likely,lobe,long,lower,male,margin,midrib,minutely,mixture,nearly,new,nflorescence,occasionally,often,older,overlappin,packed,pair,papillo,partially,peguero,pericarp,pistillate,planar,plurifoliat,pore,poricidal,porrect,portion,prickly,primary,prominent,pubescence,ray,rest,rhachi,ripe,rounded,rudimentary,ruit,scar,seen,shoot,short,similar,simple,slit,solitary,somewhat,staminate,stout,thick,tightly,time,tiny,tip,truncate,tube,tubular,ud,unarme,unarmed,underside,unit,vein,visible,without,ympodial,½	abaxial,adaxial,colour,form,height,history,length,life,na,number,perennial,position,rachi,reproduction,seed,shape,spacing,staman,texture,width
250	wfo-0001027506	success	215	88	68	147	20	0.316	/6,0-10,0.5-1.5,0.5-6,0.7-1.3,0.8-1.5,1-4,1.2-1.5,2-3.2,3-10,3-5,5-merous,abaxially,andromonoecious,anther,apart,base,berry,branched,cell,cm,cream,dark,densely,diameter,entire,filament,fine,flattened-reniform,flower,fruit,glabrous,green,leaf,length,lobed,margin,marking,maturity,mauve,mm,occasionally,orange-brown,outline,ovate,pale,pedicel,peduncle,petiole,pit,plant,purple,raised,shrub,small,smooth,sometimes,spherical,stellate,stellate-pubescent,style,subentire,surface,tree,twice,way,yellow,young	-0.35,-1,-20,-3,-7,-7.5,.2,.5,/2,0,0-2,0-6,0-60,0.1-,0.1-0.3,0.2,0.2-0.3,0.25,1-2,1-3,1.5-2.2,1.8,1/3,1/6-1/4,10-40,2.2-3.5,2.5-5,2.5-8,3-6,3.5-5,5-10,5-7,6-13,6.5-10,7-8,7-9,8-10,9-13,acuminat,acuminate,acute,alyx,ame,apar,apex,apically,apparently,articulated,bark,becoming,blade,brow,brown,c.,calyx,chartaceous,concolorous,connivent,cordate,cuneate,curved,distal,dry,drying,eaf,eed,elongating,equal,erect,flattened,free,fruiting,glabrescent,hard,hermaphrodite,heterostylous,infructescence,lateral,lengt,lobe,long,long-styled,longer,lower,lowermost,mature,midpoint,moderately,multangulate,narrow-deltate,nflorescence,older,one,open,orange,orolla,oung,pair,pendulous,per,pericarp,plurifoliat,poricidal,porrect,portion,prickl,prickle,prickly,primary,ray,reddish,reduced,reflexed,ruit,scar,sessile,short-styled,simple,spaced,spreading,stalk,stalked,staminat,stem,stout,tamen,tapering,terete,terminal,tertiary,time,tip,trichome,truncate,tube,unarmed,unit,upper,variously,vary,vein,venation,visible,wide,woody,yellow-green,ympodial	abaxial,colour,corolla,form,growth,height,history,inflorescence,life,na,number,ovary,perennial,reproduction,seed,shape,spacing,staman,stigma,texture
251	wfo-0001027510	success	195	88	68	127	20	0.349	.5,0-0.4,0-0.5,0-5,0.4-0.9,0.9-3.4,1.5-2,2-2.2,2.5-3,4-5.5,4-9,6-7.5,9-12,abaxially,absent,adaxially,anther,apex,base,broadly,capitate,chartaceous,cm,contiguous,cordate,densely,diameter,erect,extra-axillary,filament,flower,fruit,glabrous,globose,green,inflorescence,interpetalar,juicy,leaf,length,lobe,minutely,mm,nearly,obtuse,ovate,pale,pedicel,peduncle,perennial,petiole,purple,rachi,red,reticulate,rhizomatous,rotate-stellate,shrub,stellate-pubescent,stigma,style,succulent,surface,tissue,unbranched,usually,x,yellow	%,.7,0-0.9,0-2,0.1-0.3,0.2-0.4,0.5-0.6,0.5-1.1,0.7-1.5,0.7-1.6,0.8-1.8,1-2,1-3,1-locular,1.5-2.5,1.5-3,1.5-4,1.6-2,10-12,10-13,10-15,17-35,2-3,2-5,2-foliate,2.6-5.5,2.6-6,3-5,3-6,4-5,4-6,4-8,5-10,5-merou,6,6-13,6-8,absen,abundant,accrescent,across,acute,adult,alyx,apart,apparen,articulated,axe,ba,blade,calyx,connivent,cylindrical,deltate,directed,distall,distributed,eaf,eed,eglandular,elliptic,entire,exceeding,finger,forke,fruiting,geminat,gland-tipped,grey,hair,homostylous,incomplete,juvenile,lamina,lanceolate,lateral,leafy,lobed,long,lower,margin,mature,mesocarp,midpoint,minute,nflorescence,oblique,orolla,pair,part,per,perfect,placenta,pore,porrect,prickle,pseudo-umbellate,pubescent,ray,ruit,septum,sessile,shallowly,short,simple,soliary,spaced,stalk,stellae,stellate,tal,tamen,tem,thick,throughout,time,tissu,transparent,tube,unarme,unarmed,unit,upper,vary,wide,without,ympodial	abaxial,adaxial,colour,corolla,forked,form,growth,height,history,life,na,ovary,plant,position,reproduction,seed,shape,spacing,staman,texture
252	wfo-0001027536	success	200	96	71	129	25	0.355	-15,0.4-2.0,1-1.5,1-2,2-,2-10,2-2.5,20,3-5,3-forked,4-10,5-10,5-6,8-10,abaxially,adaxially,anther,apart,apex,bicolored,brown,chartaceous,cm,densely,depressed-globose,diameter,eglandular,elliptic,epicarp,ferruginous,filament,fine,flower,fruit,glandular,globose,hair,inflorescence,leaf,leathery,lenticular,lower,mm,multiseriate-stalked,oblanceolate,ornamentation,pedicel,peduncle,perennial,persistently,petiole,pubescent,rachi,reddish,reticulated,shrub,similar,simple,slender,stellate,stigma,style,subreniform,surface,tomentose,trichome,unisexual,velutinous,white,yellow,yellowish	-3,1.5-2,2-3,2-4,2-5,3-3.5,3-4,30-50,4,4-12,4-5,4-8,5-7,8-,accrescent,acute,adaxiall,alyx,ape,apical,apiculate,armed,articulated,asymmetric,axe,ba,basal,base,berry,bisexua,blade,branch,branched,calyx,clavate-truncat,compressed,connivent,curved,dark,decurrent,distal,dry,eaf,eed,enlarged,entire,equal,erect,exceeding,ferruginous-tomentose,fleshy,free,fruiting,glabrous,gland-tipped,glandular-stellate,gynoecia,held,impressed,introrse,laterally,like,linear-lanceolate,lobe,long,longer,many-foliat,margin,maturit,midpoint,mixed,mostly,multiseriate,nflorescence,one,opening,orolla,part,per,perfect,persistent,pore,prickle,primary,prominent,recurved,reduced,reflexed,ruit,sessile,short,single,slightly,small,somewhat,spaced,sparsely,splitting,stalk,stamen,staminate,stem,straight,subcampanulate,subcoriaceous,subulate,surrounded,tal,tamen,tem,terete,thick,time,tip,tube,unarme,unarmed,unbranched,unit,upper,upright,usually,vary,vein,villose,wide,x,ympodial,zygomorphic	abaxial,adaxial,arrangement,bisexual,clavate-truncate,colour,corolla,form,growth,height,history,length,life,na,number,ovary,plant,position,reproduction,seed,shape,spacing,staman,texture,width
253	wfo-0001027538	success	137	57	28	109	29	0.204	.9,0.4-0.85,2-4,4-5,adaxially,anther,apex,cm,densely,diameter,extra-axillary,flower,fruit,glabrous,grey-green,inflorescence,length,mm,ovate,pedicel,peduncle,petiole,prostrate,stellate,stellate-pubescent,unbranched,yellow,yellowish	%,.5,0-0.1,0-1.5,0-2,0.05-0.15,0.1-0.2,0.3-0.4,0.3-0.45,0.4-0.5,0.5,0.5-1,0.5-1.5,0.6-1,0.9-1,0.9-1.2,0.9-1.8,1,1-4,1.5-3.5,1.9-2.4,20-25,5-merou,7-12,8,8-13,?,abaxially,absen,absent,acicular,across,acute,adaxiall,alyx,apart,armed,articulated,attenuate,axe,ba,base,blade,brown,calyx,chartaceous,cordate,directed,distall,distributed,eaf,eed,eglandular,entire,finger,fruiting,gland-tipped,globo,hair,half,lamina,lateral,less,lobe,lon,long,lower,margin,mature,mid-point,midpoint,midvein,minute,nflorescence,oblique,obtuse,orolla,part,per,pore,porrect,present,prickle,ray,ruit,rusty,sessile,short,shru,simple,spaced,stage,stalk,stellae,straight,tamen,tem,thick,throughout,time,tube,unarmed,unit,unknow,unknown,uvenile,wide,x,ympodial	abaxial,adaxial,colour,corolla,filament,form,globose,growth,height,history,leaf,life,na,number,ovary,plant,position,rachi,reproduction,seed,shape,shrub,spacing,staman,stigma,style,surface,texture,width
254	wfo-0001027548	success	216	95	70	146	25	0.324	0.3-1.2,0.5-2,1,1-1.5,1-10,10-50,4-8,6-9,acuminate,acute,almost,anther,apart,apex,berry,black,brown,capitate,cm,corolla,dark,dendritic,densely,depressed-elliptic,diameter,dull,elliptic,filament,flattened-reniform,flower,glabrous,globose,green,growth,immature,inflorescence,leaf,like,lilac,lobed,loose,loosely,matte,membranous,minutely,mm,narrowly,papillate,pedicel,peduncle,petiole,pitted,pubescent,rachi,ripe,simple,slender,stellate,stem,stigma,style,surface,terminal,tinged,trichome,vine,white,woody,x,yellow	-11.5,.3,0.2,0.5,1-2.5,1-3.5,1.2,1.5,1.5-2,1.5-2.5,10-12,3-7,4-6,4.5,5-merou,7-10,8-9,abaxiall,adaxially,ag,along,also,although,alyx,anthesi,apical,apparently,appearing,area,ark,articulated,articulation,attenuate,axi,basal,base,beneath,bent,branch,branched,branching,bu,c.,calyx,cell,conical,connivent,darker,deflexe,deltate,denser,drying,eaf,early,eed,ellipsoid,elongate,em,entire,exserted,extending,flexuous,free,fruiting,geminat,glabrescen,glandular,half,herbarium,ilament,irregularly,lamina,leaving,lengthening,less,lobe,lon,long,long-styled,lower,many,margin,minute,mixed,near,new,nflorescence,occasionally,older,orolla,outline,pair,pale,papillae,papillo,per,perfect,pericarp,planar,plurifoliate,point,pore,poricidal,portion,primary,prominent,puberulent,rectangular,reddish,revolute,ruit,scar,scattered,size,slit,small,sometimes,somewhat,spaced,sparse,sparsely,specimen,spreading,strongly,swollen,tapering,testal,thickened,thin,time,tiny,tip,transparent,tube,twinin,type,ud,uniseriate,unit,upper,usually,vary,vein,warty,way,ympodial	1.2-2.5,8,abaxial,adaxial,arrangement,colour,form,fruit,height,history,length,life,na,number,ovary,perennial,plant,position,reproduction,seed,shape,spacing,staman,texture,width
255	wfo-0001027581	success	200	89	57	143	32	0.285	100+,abaxial,acute,adaxial,anther,anthesi,apex,berry,branched,broadly,brown,clavate,cm,corolla,dark,densely,diameter,elliptic,evenly,filament,flattened-reniform,flower,globose,golden,green,growth,inflorescence,leaf,length,lobed,many,minutely,mm,moderately,nodding,pedicel,peduncle,perfect,petiole,pitted,pubescent,purple,reddish,ripe,shrub,simple,small,stellate,stigma,stout,style,surface,terminal,time,tree,unevenly,yellow	0.2–0.3,0.3,0.3–1,0.5–1,0.5–1.5,1,1.2–1.5,1.3–1.5,1.5,1.5–2,1.5–3,10,10–16,12,12–30,15–20,1–1.5,1–3-rayed,2.5–3,200,3.5–4.5,3–3.5,4.5–16,4–8,5-merou,6–7,7–10,7–9,8,8–10,9–11,9–9.5,>,abaxially,ag,along,alyx,apar,ark,articulated,axe,base,beneath,branching,brow,bulbous,c.,calyx,clearly,closely,connivent,cup-shaped,deltate,dichasia,discolorous,distally,drying,eaf,echinoid,eed,ellipsoidal,entire,erec,exserted,free,fruiting,glabrescent,glabrous,gradually,greyish,ilament,lamina,largest,lengthening,less,like,lobe,long,longest,loosely,lower,margin,midvei,minute,mixed,multangulate,multiseriate,narrowing,near,new,nflorescence,older,orolla,pair,papillo,part,per,pericarp,plane,plurifoliate,pore,poricidal,porrect-stellate,portion,primary,ray,reflexed,rhachi,ruit,scar,scarcely,sessile,shiny,short-stalked,size,slit,smaller,spaced,sparsely,spreading,stalk,stem,tall,tem,thin,tip,trichome,tube,ud,undersurface,unit,upper,vary,varying,vein,visible,way,weak,whit,wide,woody,yellowish,ympodial	1.3-1.5,1.5-3,15-20,2.5-3,3-3.5,4-8,5-merous,7-10,7-9,9-9.5,apart,arrangement,colour,form,fruit,height,history,life,na,number,ovary,perennial,plant,position,rachi,reproduction,seed,shape,spacing,staman,texture,width
256	wfo-0001027584	success	144	79	52	92	27	0.361	-2,0.5-1.5,0.9-1,0.9-2.5,1.5-2,2,2-10,3,3-.,4-7,anther,apex,base,branched,cm,conical,corolla,darker,densely,diameter,ellipsoid,elliptic,filament,flattened,flower,four,fruit,glabrous,green,herb,lobed,minutely,mm,nearly,ovary,ovate,pale,papillate,pedicel,peduncle,petiole,reddish,reniform,smooth,stigma,stripe,style,suffruticose,surface,tan,time,white	-16,..,.5,0.5-1,1-1.2,1.2-1.4,1.5-8,1.6-1.9,10-15,100,11.5-45,2.5-3,4-6,4.5-20,7-10,8-9,abruptly,absent,acuminate,anthesi,apical,attenuate,bark,becoming,beginning,beneath,branch,brittle,broadly,brow,c.,calyx,capitat,cell,cucullate,deflexe,deltate,dry,eaf,edicel,eed,erec,fruiting,irregular,lamina,lobe,long,lower,margin,markedly,narrowly,nflorescence,open,outer,outline,pair,per,pericarp,planar,plurifoliat,pointed,present,primary,regularly,ruit,scar,scattered,shrub,single,single-stemmed,sinuate,small,sparse,sparsely,stem,striate,testal,thickening,thin,tip,triangular,trichome,tube,tuft,ud,uniseriate,unit,vein,wall,without,x,ympdoial	1,abaxial,adaxial,arrangement,capitate,colour,form,growth,height,history,inflorescence,leaf,length,life,na,number,plant,plurifoliate,position,rachi,reproduction,seed,shape,spacing,staman,texture,width
257	wfo-0001027585	success	217	87	64	153	23	0.295	0-1,0-2,1,1-4,12-23,2-5,29-40,3-4,5-17,5-8,7-10,acuminate,acute,andromonoecious,anther,apex,articulated,base,chartaceous,cm,cylindrical,densely,diameter,elliptic,erect,extra-axillary,flattened,flower,fruit,glabrous,globose,green,inflorescence,leaf,length,lilac,mm,oblate,ovate,pale,pedicel,peduncle,perennial,petiole,plant,rachi,rhizomatous,ripe,shrub,simple,sparsely,sprawling,stellate,stellate-pubescent,stigma,style,surface,unbranched,unripe,vine,weakly,white,yellow,yellowish	%,.05,0,0-0.5,0-15,0-4,0.15-0.25,0.2-0.3,0.2-0.4,0.25-0.35,0.5-1,0.6-0.9,0.7-4.5,0.9-1.8,1-3,1.9-2.5,10-25,11-15,13-18,15-20,15-30,2-3,2-6,2-foliate,2-locular,2.3-2.8,22-25,3-3.5,3-7,3.8-4.2,4-8,4.5-20,5-7,5-merou,6-7,6-8,7-14.5,7-9,8-10,8-14,abaxially,absen,absent,accrescent,acicular,across,adaxiall,adaxially,adult,alyx,anvil-shape,apart,axe,ba,blade,branch,branche,broad-based,brown,calyx,capitat,confined,connivent,cross-section,cuneate,curved,decimetre,deltate,directed,distall,distributed,dm,eaf,eed,eglandular,entire,exocarp,finger,fruiting,functional,geminat,gland-tipped,hair,half,heterostylous,interpetalar,juicy,juvenile,lamina,lanceolate,lateral,less,lobe,lobed,long,longer,loosely,lower,margin,mature,mesocarp,mid-point,midpoint,midrib,midvein,minute,moist,narrowly,nflorescence,oblique,orolla,pair,part,per,placenta,pore,porrect,present,prickle,pubescent,purple,ray,rounded,ruit,scarcely,sessile,shallowly,short,side,spaced,sparse,stalked,stellae,straight,tal,tamen,tem,thick,throughout,time,tissue,transparent,triangular,tube,unarme,unarmed,unit,upper,vary,vein,wide,x,ympodial	5-merous,abaxial,adaxial,arrangement,capitate,colour,corolla,filament,form,growth,height,history,life,na,number,ovary,position,reproduction,seed,shape,spacing,staman,texture
258	wfo-0001027594	success	168	101	64	104	37	0.381	0.3-1.2,0.7-1,1-2,1.5-2,3-4,4-5,acute,anther,apex,bark,becoming,berry,bright,brown,calyx,capitate,closely,cm,corolla,dark,filament,flattened-reniform,fleshy,fruiting,glabrous,globose,green,hard,immature,lavendar,leaf,lobed,margin,maroon,minutely,mm,oblanceolate,often,opposite,orange,ovary,pale,papillose,pedicel,petiole,pitted,ripe,scar,seed,shrub,simple,spaced,stem,stigma,style,surface,tapering,tinged,trichome,uniseriate,white,winged,yellow-tan,young	.1,.2,.5,0.6-1.4,0.7-1.2,0.9-2.5,1,10-15,2-2.2,2-3,2-5,2.5,2.5-4,3/4,4.7-6.8,5-20-flowered,across,age,anthesi,attenuate,ba,base,bi-lobed,body,branch,constriction,curved,decurrent,deltoid,dia,difoliate,distal,eaf,edicel,eed,elliptic,erect,especially,extending,free,geminat,geminate,glandular,incrassate,interpetalar,junction,lateral,lenticellat,less,lobe,locule,lon,long,lower,main,major,middle,minor,minute,nflorescence,non-reproductive,oblong,obovate,obovoid,occasionally,older,one,ovate,overlappin,pair,paler,papillo,pore,poricidal,portion,prominent,puberulent,raised,reflexed,reproductive,rounded,ruit,shaped,shoot,sinus,slender,slightly,small,straggly,straight,tall,tear-drop,thin,tip,tube,two,ud,unit,vein,way,widest,woody,x,ympodial	0.1,0.5,5,5-20,abaxial,adaxial,arrangement,bud,cell,center,colour,diameter,flower,form,fruit,growth,height,history,inflorescence,length,lenticellate,life,na,new,number,peduncle,perennial,plant,position,prickle,rachi,reproduction,shape,spacing,staman,texture,width
259	wfo-0001027600	success	185	117	89	96	28	0.481	-10,0.5-1.5,1-14,1-2,1-4,1-5,1.5-2,10-,10-20,15-25,2-11,2-3,2-4,2-4.5,2-5,3-15,3-5,3-5-lobed,abaxially,adaxial,adaxially,along,apart,apex,apical,articulated,base,campanulate,cm,collection,concave,densely,diameter,ellipsoidal,especially,except,fading,flattened,flower,forked,fruit,glabrescent,glabrous,gland,glandular-puberulent,greenish-white,leaf,leaving,long,main,margin,mature,midrib,minutely,mm,occasionally,older,orange,papillose,pedicel,pedicellar,peduncle,petiole,pilose,pinnately,puberulence,puberulent,pubescent,purple,purplish,rachi,rarely,remnant,simple,sparsely,stigma,style,subcoriaceous,surface,tree,two,unbranched,unlobed,vein,white,x,yellow,yellow-green,young	-3,0.5-1,1,1.5-2.5,1/2-3/4,2-18,2-3.5,2-6,2.5-21,2.5-6,20-30,3-6,4-6,4-foliat,5-13,8-17,abruptly,absen,absent,acuminate,acute,adpressed,aggregate,ape,apiculate,axe,basal,beyond,blade,brow,calyx,cell,channe,connective,cordate,coriaceous,cream,cuneate,deltate,dilated,directed,distally,divided,eaf,eed,elliptic,entire,exceeding,exserted,fleshy,laterally,lobe,lobed,lon,lower,moderately,narrowed,nflorescence,nther,obconical,oblong,obtuse,orolla,ovate,ovoid,perfect,pilo,pore,puberulen,radiu,rounded,ruit,shorter,sinus,slightly,small,somewhat,spaced,stamen,stone,strongly,tal,tem,thecae,time,tip,tomento,triangular,truncate,tube,ud,unit,vary,wide,yellowish,ympodial	abaxial,anther,arrangement,channel,colour,corolla,filament,form,growth,height,history,inflorescence,length,life,na,number,ovary,perennial,plant,position,reproduction,seed,shape,spacing,staman,texture,tomentose,width
260	wfo-0001027601	success	204	84	62	142	22	0.304	0-3,0.4-2,0.5-2,1.5-2,2-15,2.5-6,7-20,acuminate,acute,andromonoecious,angularly,anther,apex,articulated,base,buff,chartaceous,cm,congested,contiguous,densely,diameter,ellipsoidal,elliptical,erect,extra-axillary,filament,flattened,flower,fruit,glabrous,globose,green,inflorescence,leaf-opposed,length,lilac,mm,nearly,ovate,pale,pedicel,peduncle,perennial,petiole,plant,pseudo-racemose,rachi,red,reniform,reticulate,rhizomatous,short,shrub,stellate,stellate-pubescent,stigma,style,surface,white,yellow,yellowish	%,.05,0-0.1,0-10,0-7,0.1-0.5,0.2-0.4,0.2-0.8,0.25-0.4,0.3-0.5,0.4-0.5,0.5-0.8,0.5-1,0.5-1.5,1-1.3,1-1.4,1-2,1-locular,1.6-5,10-16,13-25,2-6,2.3-4.3,2.5-3,2.6-4,3-5,3-6,3-7,3-foliate,4-10,5-merou,6-8,7-18,7-8,8-9,abaxially,absen,absent,accrescent,acicular,across,adaxiall,adaxially,adult,alyx,apart,apparen,around,axe,ba,blade,branche,brown,calyx,capitat,confined,connivent,cuneate,cylindrical,decimetre,deltate,directed,distall,eaf,eed,eglandular,entire,exocarp,finger,fruiting,functional,geminate,gland-tipped,hair,half,heterostylous,incomplete,index,juicy,lamina,lanceolate,lateral,less,lobe,lobed,lobing,long,longer,lower,margin,mature,mesocarp,midpoint,midrib,midvein,minute,narrow,nflorescence,oblique,obtuse,orolla,outer,part,per,placenta,pore,porrect,present,prickle,ray,ruit,septum,sessile,shallowly,side,simple,spaced,sparsely,stalk,stellae,straight,strongly,succulent,tal,tamen,tem,thick,throughout,time,toward,tube,unarme,unarmed,unbranched,unit,vary,vein,weakly,wide,wing,x,ympodial	5-merous,abaxial,adaxial,capitate,colour,corolla,form,growth,height,history,leaf,life,na,number,ovary,position,reproduction,seed,shape,spacing,staman,texture
261	wfo-0001027606	success	192	79	55	137	24	0.286	0-0.2,0.3-0.8,0.3-1.2,0.5-0.75,0.5-1,1-1.5,1-2,1-5,10-19,2-5,2.5-4,4-6.5,6-8,anther,apart,apex,base,broadly,chartaceous,cm,diameter,erect,extra-axillary,filament,flattened,flower,fruit,glabrous,globose,green,inflorescence,leaf,length,lilac,mm,ovate,pale,pedicel,peduncle,perennial,petiole,pinkish,pseudo-racemose,rachi,red,reniform,rhizomatous,shrub,simple,stellate,stigma,style,surface,x,yellow	%,-10,0-1.5,0-4,0.2-0.3,0.2-2.5,0.2-4,0.4-0.5,0.7-0.9,1,1-2.5,1-7,1-locular,1.5-2.9,12-25,2,2-,2-3,2-4,2-5.5,2-7,3-10,3-4,3-4.1,3-foliate,4-11,5-merou,5.5-7,6-9,7-10,7-22,9-13,abaxially,absen,absent,accrescent,acicular,acute,adaxiall,adaxially,adult,alyx,apparen,apparently,articulated,axe,ba,blade,branch,branche,branched,brown,calyx,cuneate,cylindrical,deeply,depression,directed,distall,distally,dm,eaf,eed,entire,exocarp,finger,fruiting,geminat,gland-tipped,grey,hair,half,incomplete,index,juicy,juvenile,lamina,lanceolate,less,lobe,lobed,lobing,long,longer,lower,margin,markedly,mature,mesocarp,mid-point,midpoint,midvein,minute,narrowly,nflorescence,oblique,obtuse,occasionally,orolla,pair,part,per,perfect,placenta,pore,present,prickle,pubescence,rostrate,ruit,scarcely,septum,short,side,spaced,straight,succulent,tal,tamen,tem,thick,thicker,throughout,time,triangular,truncat,tube,unarme,unarmed,unbranched,unit,upper,usually,vary,vein,wide,ympodial	5-merous,abaxial,adaxial,arrangement,colour,corolla,form,growth,height,history,life,na,number,ovary,plant,position,reproduction,seed,shape,spacing,staman,texture,truncate,width
262	wfo-0001027607	success	167	71	46	121	25	0.275	.25,.5,0.8-1,1-4,1.5-3,2-3,2-4,3-3.5,5-10,8-9,acuminate,acute,anther,apex,base,brown,cm,corolla,dark,elliptic,filament,filiform,glabrous,globose,green,leaf,lobed,minutely,mm,narrowly,ovary,ovoid-reniform,papillose,pedicel,petiole,pitted,plant,shrub,simple,stigma,style,surface,tan,treelet,white,winged	.1,0.25-0.5,0.5,0.5-1,1,1.2-1.5,2-2.5,2.5-3,3/4,4-10-flowered,5-7,age,anthesi,apar,arching,area,aspect,ba,bark,basal,becoming,berry,branch,branche,calyx,corky,curling,decurrent,deflexed,deltoid,densely,dia,dry,eaf,edicel,eed,ellipsoid,elongate,erect,evenly,except,exserted,f,flattened,free,fruiting,geminate,gently,giving,glabrate,golden,lamina,lateral,lenticellat,less,like,lobe,lon,long,lower,m.,main,material,middle,midrib,minute,narrow,nflorescence,non-reproductive,obovoid,occasionally,older,opposite,pagoda-like,pair,pore,poricidal,portion,present,prominent,pubescent,raised,rarely,reddish-brown,reflexed,ruit,scar,shaped,short,slender,slight,slightly,small,soon,spaced,stem,straight,strongly,styl,tall,tapering,tear-drop,tip,trichome,tub,tube,ud,unifoliate,uniseriate,unit,vein,way,widened,widening,widest,woody,x,yellowish,ympodial,young,zig-zag	4-10,apart,colour,diameter,flower,form,fruit,growth,height,history,inflorescence,length,life,na,number,peduncle,perennial,rachi,reproduction,seed,shape,spacing,staman,texture,width
263	wfo-0001027613	success	238	98	78	160	20	0.328	.5,0.1-0.6,0.2-1.6,1.5-2,2-2.5,2-5,2-5.6,3-4,4-5,5-18,9-10.5,absent,and/or,andromonoecious,anther,apex,articulated,base,broadly,brown,campanulate,chartaceous,circular,cm,contiguous,cordate,corolla,dark,densely,diameter,extra-axillary,filament,flower,fruit,glabrous,gland-tipped,glandular,globose,green,hair,herbaceous,inflorescence,length,lilac,minutely,mm,moderately,nearly,obtuse,ovate,pale,pedicel,peduncle,petiole,plant,prostrate,pubescent,purple,rachi,reniform,resprouter,reticulate,rotate,short,sparsely,sprawling,stellate,stellate-pubescent,stigma,streak,style,surface,tan,unbranched,weakly,x,yellow,yellowish-green	%,0-0.1,0.1-0.7,0.3-0.4,0.3-1,0.4-0.5,0.4-1,0.4-1.2,0.4-1.5,0.5-0.6,0.5-0.7,0.7-1.5,0.8-1.7,1-1.5,1-1.7,1-10,1-2,1-7,1.2-1.4,1.2-2,1.3-1.8,1.5-3,10-17,12-15,15-100,15-28,2-2.2,2-3,2-7,2-8,2-foliate,2-locular,2.3-2.6,20-50,3-5,3-6,30-100,36-70,4-7,4-8,4.5-9.5,5,5-6,5-8,5-merou,6-12.5,7-12,7-8,80-180,9-17,abaxially,absen,abundant,accrescent,acicular,across,acute,adaxially,adult,alyx,anvil-shape,apart,armed,attenuate,axe,ba,bitter,blade,branche,calyx,capitat,clear,connivent,cross-section,curved,cylindrical,decimetre,deltate,directed,distall,distally,distributed,eaf,eed,eglandular,exocarp,finger,flattened,fruiting,functional,geminat,half,heterostylous,index,inserted,interpetalar,juicy,lamina,lateral,less,lobe,lobed,lobing,lon,lonf,long,longer,lower,margin,markedly,mature,mesocarp,mid-point,midpoint,midvein,minute,moist,nflorescence,oblique,orolla,part,per,placenta,pore,porrect,presen,present,prickle,ray,ruit,sessile,shallowly,side,simple,somewhat,spaced,stage,stalk,stalked,stellae,straight,tal,tamen,tem,thick,thicker,throughout,time,tissu,tissue,transparent,triangular,tube,unit,uvenile,vary,vein,watery,wide,ympodial	5-merous,abaxial,adaxial,capitate,colour,form,growth,height,history,leaf,life,number,ovary,position,reproduction,seed,shape,spacing,staman,texture
264	wfo-0001027618	success	202	91	66	136	25	0.327	1-13,1-14,1-23,1-5,2-11.5,3-30,3-5,4,5-7.5,5-merous,6-40,8-16,8-35,abaxially,adaxially,apart,apex,articulated,base,branched,campanulate,capitate,cm,compound,densely,diameter,ellipsoidal,flower,fruit,fusiform,glabrous,globose,greenish,leaf,length,minutely,mm,near,orange,papillose,pedicel,peduncle,per,perfect,petiole,pinnately,puberulent,puberulent-pubescent,pubescent-pilose,purple,rachi,reticulate,shrub,simple,stigma,style,sympodial,tomentose,tree,truncate,unbranched,unit,urceolate,white,width,yellow	-10,-pubescent,0-10,0.5,0.5-1,0.5-6,1,1-,1-1.5,1-3,1-9,1.4-4,1.5-13,1.5-3,1.5-7,1.5-8.5,11-16,11-22,11-pinnate,12-27,15-30,15-35,2-11,2-12,2-27,2-5,2-8.5,2-9,2.5-6,3-18,3-7,3-7-pinnate,3.5-6,4-8,5-18,5-20,5-30,5.5-12,6-25,7-25,acuminat,acut,acute,aggregate,also,alyx,ape,ascending,axe,basal,beyond,blade,bud,cell,chartaceous,connective,cordate,cuneate,cylindrical,darker,deltate,dia,diamete,dilated,directed,distally,eaf,eed,elliptic,elliptic-ovate,entire,exceeding,exserted,fleshy,lateral,laterally,leaflet,leaving,less,lobe,lon,long,longitudinal,lower,margin,membranaceous,mesocarp,moderately,nflorescence,nther,oblong,obovate,obtu,obtuse,often,orolla,ovate,pedicellar,perfec,petiolule,pilo,pilose,pore,presen,puberulent-pilo,pubescent,radiu,ranch,ratio,remnant,ripe,rown,ruit,runk,shallowly,shorter,slightly,small,sometimes,somewhat,spaced,sparsely,spreading,stamen,stone,stripe,tal,terminal,thecae,triangular,tube,uni,vary,wide,without,x	abaxial,adaxial,anther,arrangement,colour,corolla,filament,form,growth,height,history,inflorescence,life,na,number,ovary,plant,position,reproduction,seed,shape,spacing,staman,surface,texture
265	wfo-0001027622	invalid_json	203	115	79	124	36	0.389	0-14,0.3-10,1-10,1.5-3.5,2.5-3.5,3-4.5,3.5-11,6-17,6-7,8-20,abaxially,adaxially,along,anther,apex,blue,blue-purple,broadly,brownish,cell,ciliate,clavate,cm,condition,corolla,covering,diameter,drying,elliptical,especially,filament,flower,forked,fresh,fruit,glabrescent,glabrous,globose,green,green-white,greenish,herb,lateral,light,make,margin,middle,midrib,minutely,mm,mucilaginous,narrowly,odd-pinnate,ovate,ovoid,pale,pedicel,peduncle,pentagonal,petal,petiole,plant,puberulent,pubescent,seed,stellate,stigma,striped,style,subglabrous,terminal,testal,thick,throughout,tip,wall,wet,whitish,yellow	.5,0-16,1,1-2,1.5-4.2,1.6-4.5,1/,12-23,2-25,2-3,2-6,3-16,3-4,4-5,4-9.5,5-11,5-merou,8-16,acumen,acuminate,acute,ag,alyx,apart,apparently,articulated,axe,axillary,base,berry,blade,borne,bud,capitat,chartaceous,connivent,decumben,different,digestion,distal,dorsally,eaf,edge,eed,elliptic,end,enzyme,erect,exceeding,except,flat,folded,geminat,generally,glabrou,greatly,hair,hair-like,half,homostylous,honeycomb-shaped,interjected,lanceolate,leaflet,lengthening,like,living,lobe,long,lower,membranous,mottled,nflorescence,oblique,often,orolla,ovate-lanceolate,pair,perfect,petiolule,plurifoliate,population,pore,poricidal,proximal,purple,reduced,removed,rounded,ruit,seudostipule,shortly,singly,size,slightly,slit,sometimes,spaced,specimen,stamen,star,ste,stem,stolo,straight,subequal,subtending,tall,tamen,tem,tri-,truncate,tube,tuber,typically,unit,unwinged,usually,vary,varying,wide,wing,x,ympodial	'','hair-like,'star,[,],``,abaxial,adaxial,arrangement,capitate,characteristic,colour,form,growth,height,history,inflorescence,leaf,length,life,na,number,ovary,perennial,position,rachi,reproduction,shape,spacing,staman,surface,texture,value,width,{,}
266	wfo-0001027624	success	189	94	70	119	24	0.37	0.3-1,0.5-1.5,1-2,1.1-8.4,2-20,2.4-4.8,3-10,3-5,4-15.2,4-8,9-41,acumen,anther,apex,axillary,brownish,bud,cell,clavate,cm,condition,corolla,covering,deep,densely,diameter,drying,elliptic,filament,flower,forked,fresh,fruit,glabrous,globose,green,greenish,hair,hair-like,herb,lanceolate,lateral,leaf,light,mm,odd-pinnate,ovoid,pedicel,peduncle,pentagonal,petiole,plant,pubescent,purple,rachi,rotate,seed,short,sometimes,stigma,style,subtending,terminal,testal,thick,usually,wall,white,whitish,yellow	0-3,0-7,0.1-0.9,0.4-3,0.8-5.6,1-3,1-5,1.2-2.6,1.3-2.9,1.5-6.6,2-5,2-7,2.9-12,3-11,3-4,4-7,5-9,5-merou,6-18.5,abaxially,acuman,acuminate,acute,adaxially,ag,along,alyx,apart,apparently,arranged,articulated,axe,base,bead,berry,blade,capitat,connivent,considerably,cuneate,decreasing,decumben,decurrent,digestion,distal,dorsally,eaf,edge,eed,entirely,enzyme,erect,exceeding,flat,folded,geminat,glabrou,green-white,half,homostylous,honeycomb-shaped,interjected,larger,leaflet,leave,lengthening,like,living,lobe,long,lower,make,middl,moniliform,mottled,mucilaginous,multiple,necklace,nflorescence,onto,orbicular,orolla,ovate,pair,perfect,plurifoliate,pore,poricidal,present,removed,ruit,sessile,seudostipule,size,slightly,slit,spaced,specimen,stamen,stolon,straight,tall,tamen,tem,throughout,tip,toward,tri-,tube,tuber,typically,unit,unwinged,vary,wet,wide,widely,x,ympodial	abaxial,adaxial,arrangement,capitate,colour,form,growth,height,history,inflorescence,length,life,na,number,ovary,perennial,position,reproduction,shape,spacing,staman,surface,texture,width
267	wfo-0001027626	success	152	95	68	84	27	0.447	.3,.5,0.2–0.6,0.5-1,0.7–1,1,1.5–8,13–14,14–116,2–49,2–5,3–4,3–55,5-merous,5–6,8,abaxially,adaxially,along,anther,apex,arrangement,center,chartaceous,cm,color,cordate,coriaceous,diameter,distichous,elliptical,extra-axillary,filament,fleshy,flower,fruit,glabrous,greenish-white,leaf-opposed,liana,membranous,mm,moderately,nearly,ovate,pedicel,peduncle,petal,petiole,possibly,pubescent,rachi,rounded,sand-punctate,scandent,shrub,slender,somewhat,spindle-shaped,stellate,stigma,style,terminal,truncate,unbranched,unknown,white,x	0.1–0.2,0.5–1,0.7–2.8,1.3–4.5,1.5–2,2–3,3–4.5,3–5,4.4–11,4–6,9–18,accrescen,acuminate,acute,alyx,apar,axe,base,berry,blade,broadly,c.,calyx,capitat,ciliat,clavate,climbing,densely,distant,distinct,eaf,eed,entire,frequently,fruiting,glabrou,immature,lamina,lanceolate,line,lobe,long,lower,m.,margin,maturity,midvein,minutely,mor,nflorescence,nternode,oblique,orolla,pair,perfec,pinnate,plurifoliat,pointed,reflexed,ruit,sand-punctat,scar,secondary,seen,shortly,side,simple,spaced,sparsely,ste,tamen,tem,time,tip,trichome,tube,two,unit,vary,vein,venation,wide,wiry-woody,ympodial	abaxial,adaxial,apart,capitate,corolla,form,growth,height,history,inflorescence,leaf,length,life,na,number,ovary,perfect,plant,position,reproduction,seed,shape,spacing,staman,surface,texture,width
268	wfo-0001027627	success	245	113	76	169	37	0.31	.1,.5,5-angled,abaxially,adaxially,ampliate,anther,apart,apex,band,base,bifurcate,borne,branched,broadly,brown,cm,corolla,densely,diameter,distally,erect,extensively,extra-axillary,filament,flattened-reniform,flower,fruit,glabrescent,glabrous,globose,green,half,internode,interpetalar,lateral,lavender,leaf,lighter,linear-lanceolate,loosely,lower,middle,minutely,mm,narrow,narrowly,near,occasionally,ovary,ovate,pedicel,peduncle,petiole,pitted,pubescent,purple,shrub,simple,small,sparsely,stellate,stellate-tomentose,stigma,style,subeaqually,surface,tardily,tissue,tomentose,tree,unequally,velvety,violet,yellow,×	0.05–0.25,0.1–1,0.3,0.4,0.6–1,0–,1.5,1.5–2,1.5–2.5,1.8–2.5,11–14,12–25,13–17,1–1.5,1–5,2,2.5–4,2–15,2–4,2–5,2–6,3.5,3–3.5,3–6,4–,4–12,5-merou,5–7,6–,6–15,7–10,7–15,9,9–13,9–15,abundant,accrescent,across,acuminate,along,alyx,apparently,articulated,ascending,axe,ba,based,becoming,berry,blade,branch,briefly,broad,bud,c.,calyx,capitat,caudate,central,chartaceous,contiguous,cordate,dense,difoliate,distal,eaf,eed,entire,evident,except,exposed,fertile,filiform,flowering,free,geminat,grayish,growt,hair,high,homostylous,interwoven,juvenile,larger,like,line,linear,lobe,long,longer,major,margin,midpoint,midvein,minor,minute,mostly,much,nearly,nflorescence,numerous,oblong,obtuse,often,ovoid,paired,par,portion,present,prickle,principal,prominently,pubescence,ray,recurved,reduced,rounded,ruit,scattered,shallowly,short,shorter,side,single,sinuate,sinus,slender,smaller,sometimes,somewhat,spaced,sparse,splitting,spreading,stalk,stalked,stellae,stellate-pubescent,stellate-tomento,stellate-velvety,stem,stemmed,stipe,stout,tamen,tapering,tawny,thick,thickened,time,tip,triangular,trunk,tube,ud,unarmed,usually,vein,visible,weakly,wide,yello,ympodia,young,zone,×1.5–1.7,–2.5,–30,–5	0-2-15,1-5,1.5-2,2-4,2-6,2.5-4,30,5,6-15,7-10,7-15,9-13,abaxial,adaxial,arrangement,capitate,colour,form,growth,height,history,inflorescence,length,life,na,number,perennial,plant,position,rachi,reproduction,seed,shape,spacing,staman,texture,width
269	wfo-0001027630	success	149	70	48	101	22	0.322	0.5-1,0.5-1.2,0.5-2,1-5,1.4-1.7,1.5-2,4-6,5.5-11.2,8-9,anther,apart,apex,climbing,cm,corolla,erose,filament,fruit,glabrous,globose,internodal,lanceolate,leaf,linear,lobed,long-acuminate,margin,minutely,mm,occasionally,opposite,ovary,papillose,pedicel,petiole,puberulent,pubescent,shrub,simple,sparsely,stigma,style,tapering,tip,trichome,uniseriate,white,winged	.1,.2,.5,0.05-0.1,1-1.5,2-3,2-6-flowered,3/4,6-10,acute,also,anthesi,arising,bark,base,beginning,berry,blunt,branchlet,broadly,calyx,ciliate,de,decurrent,deflexed,deltoid,densely,dia,distinguishable,eaf,edicel,eed,elongat,except,extreme,free,fruiting,glabrate,globo,golden,green,hirsute,immature,indistinct,inflorescenc,irregularly,knob-like,known,lateral,lobe,lon,long,lower,main,middle,midrib,near,nflorescence,novo,older,pair,paler,partially,pore,poricidal,portion,prominent,proximal,raised,reflexed,rest,rounded,ruit,scar,seen,shaped,slender,spaced,stem,straight,strongly,swollen,tall,tear-drop,terminal,thickened,ti,tube,ud,ultimate,unifoliat,unit,vein,way,wide,widest,wing,x,yellowish,ympodial,young	2-6,colour,diameter,flower,form,growth,height,inflorescence,length,na,number,peduncle,plant,position,rachi,seed,shape,spacing,staman,surface,texture,width
270	wfo-0001027646	success	166	69	42	124	27	0.253	0-0.1,0.2-1.1,1-2,1-3,6-7,adaxially,anther,apex,chartaceous,cm,densely,diameter,erect,extra-axillary,flattened,flower,fruit,glabrous,globose,green,inflorescence,length,mm,ovate,pale,pedicel,peduncle,perennial,petiole,pseudo-umbellate,red,reniform,rhizomatous,shrub,simple,solitary,stellate,stellate-pubescent,style,unbranched,yellow,yellowish	%,.4,0-0.2,0-1,0-10,0-2,0.1-0.25,0.15-0.25,0.4-0.5,0.4-0.6,0.5-0.6,0.6-0.7,0.7-1.2,0.7-1.5,0.7-2,1,1-6,1-locular,10-18,15-20,2-4,2-6,2-foliate,2.1-3.2,3.5-4,4-11,5-10,5-merou,6-13,6-8,abaxially,absen,absent,acicular,across,acuminate,acute,adaxiall,adult,alyx,apart,articulated,axe,ba,base,blade,branche,brown,calyx,confined,cuneate,cylindrical,directed,distall,dm,eaf,eed,eglandular,entire,finger,fruiting,functional,geminat,gland-tipped,grey,hair,half,incomplete,juicy,lamina,lateral,less,lobe,long,longer,lower,margin,mature,mesocarp,midpoint,midrib,midvein,minute,moderately,multiradiate,nflorescence,oblique,obtuse,onl,orolla,part,per,pore,porrect,present,prickle,probably,ray,ruit,septum,short,spaced,sparsely,stage,stalk,stellae,straight,succulen,tal,tamen,tem,thick,throughout,time,transparent,unarme,unarmed,unit,unknow,uvenile,vary,wide,x,ympodial	abaxial,adaxial,arrangement,colour,corolla,filament,form,growth,height,history,leaf,life,na,number,ovary,plant,position,rachi,reproduction,seed,shape,spacing,staman,stigma,surface,texture,width
271	wfo-0001027661	success	222	93	69	153	24	0.311	+,-10,0.5,0.5-2,1-5,1.5-2,4-15,4.5-6,40,5-9,6-12,8-10,anther,apart,apex,bright,capitate,cm,corolla,deeply,densely,diameter,ellipsoid,extremely,filament,flattened,flower,glabrous,globose,growth,herbaceous,lateral,leaf,leaf-opposed,lobed,minutely,mm,moderately,pale,papillate,pedicel,peduncle,petiole,pinnatifid,pitted,pubescent,purple,rachi,red,reniform,shape,shiny,simple,slender,sparsely,stellate,stigma,style,surface,tan,terminal,ternately,thin,variable,vine,violet,white,woody,yellow	0.5-,0.6-1.1,0.6-1.5,1-,1-1.5,1-7,1.2-6,1.3,1.5,2,2.5-3,2.5-7,30,4-8-celled,5-merou,6-8,6-9,<,>,abaxially,acuminate,acute,adaxiall,ag,along,alyx,anthesi,ark,articulate,axi,basal,base,berry,branch,branched,broadly,calyx,cell,column,commonly,conical,connivent,cordate,creeping,dendritic,denser,density,eaf,eed,elliptic,entire,even,free,fruiting,fused,gre,green,grey,ground,hue,ilament,irregularly,lamina,leaving,lengthening,like,lobe,long,long-exserted,lower,many,margin,markedly,membraneous,minute,mixture,narrowing,near,new,nflorescence,occasionally,often,older,open,orolla,outline,ovate,pair,papillat,papillo,peg,pentagonal,per,perfect,pericarp,plurifoliat,pointed,pore,poricidal,portion,primary,prominent,pubescen,pubescence,purplish,rarely,reflexed,ripe,ruit,scar,short,single,sinus,size,sleeve,slit,small,spaced,spot,spreadin,spreading,stem,strongly,swollen,tangled,tem,testa,tightly,time,tip,trailing,triangular,trichome,truncate,tube,turbinate,two,type,ud,underground,unieriate,uniseriate,unit,upper,usually,vary,vein,way,wide,yellowish,ympodial,zig-za,¾	0.5-7,5-merous,abaxial,adaxial,arrangement,colour,form,fruit,height,history,inflorescence,length,life,na,number,ovary,plant,position,reproduction,seed,spacing,staman,texture,width
272	wfo-0001027714	success	251	97	76	175	21	0.303	+,1-1.6,1.5-3,1.5-5,14-16,2-,2.5-4,3-3.5,4.5-5,5,5-10,7-20,80,abaxial,acuminate,adaxial,anther,apex,berry,branched,bright,brown,capitate,cm,corolla,deep,densely,diameter,elliptic,filament,flattened,flower,fruit,glabrous,globose,growth,hairy,inflorescence,irregularly,juicy,lateral,leaf,many,minutely,mm,obovate,ovary,pale,papillate,pedicel,peduncle,petiole,pitted,pubescent,purple,red,reddish,reniform,seed,shiny,simple,slender,small,spaced,stellate-rotate,stigma,style,surface,terminal,thin,time,vine,violet,woody,x,yellow	.5,/3,0,0.4,0.5,0.5-0.7,0.6-0.7,0.9-1.5,1,1-,1-1.5,1-2,1.5-2,1.5-2.5,2-2.5,2-8,2.5-,2373.,4-10,4-5,5-6,5-merou,6-7,<,abaxially,acute,adaxially,age,aid,almost,along,alyx,angle,anthesi,apar,apice,appearance,ark,around,articulated,axi,basal,base,calyx,canop,cell,channelled,climbin,confined,conical,connected,connivent,cordate,corky,creating,cucullate,cupped,deflexed,dendritic,denser,drying,eaf,eed,ellipsoid,elongate,enlarged,entire,especially,exserted,fide,fleshy,free,fruiting,furcate,giving,glabrate,glabrou,groove,hanging,ilament,immature,individual,inflated,lamina,large,leaving,lengthening,like,lobe,lobed,lon,long,longer,loosely,lower,margin,marginal,mature,mere,minute,mpodial,nee,new,nflorescence,nodding,occasionally,often,older,orolla,otherwise,outline,pair,papillo,peg,per,perfect,pericarp,petal,petiolule,pinnatifid,plat,plurifoliat,pore,poricidal,portion,primary,prominent,pubescence,reaching,rectangular,rim,ripe,ruit,scar,showy,similar,sleeve,slightly,slit,somewhat,sparsely,spreading,stem,strongly,tangled,tem,testa,testal,thecae,thick,thickened,third,tiny,tip,tooth,trichome,truncate,tube,twining,ud,uniformly,uniseriate,unit,upper,usually,vein,visible,wall,way,weak,weight,widest,wing,yellowish,younger	5-merous,apart,arrangement,colour,form,height,history,length,life,na,number,perennial,plant,position,rachi,reproduction,shape,spacing,staman,texture,width
273	wfo-0001027719	success	172	75	49	123	26	0.285	0.15-0.4,0.3-0.5,0.6-2.8,1-3,10-24,4-5,5-6,7-11,8-13,acute,adaxially,andromonoecious,anther,apex,broadly,chartaceous,cm,densely,diameter,extra-axillary,flower,fruit,globose,green,greenish-white,herbaceous,inflorescence,length,lilac,lobed,mm,obtuse,ovate,pale,pedicel,peduncle,petiole,plant,pseudo-racemose,resprouter,shallowly,simple,solitary,sparsely,stellate-pubescent,strongly,style,unbranched,yellow	%,.25,0-0.15,0-0.2,0-1,0-20,0-7,0.25-0.4,0.25-0.6,0.3-0.7,0.4-1.7,0.6-0.8,0.8-1,0.9-1.1,1-1.5,1-2,1.1-2,1.6-1.9,13-20,13-25,2-2.3,3-5,3-7,3-7.5,30-70,4-6,4-7,4.5-12.5,5-8,5-merou,6-10,6-8,abaxially,absent,acicular,across,adaxiall,alyx,apart,armed,articulated,attenuate,axe,ba,base,blade,brown,calyx,cuneate,d.,difoliate,directed,distall,distributed,dult,eaf,eed,eglandular,entire,erect,exocarp,finger,fruiting,functional,geminat,gland-tipped,hair,half,heterostylous,hig,juic,lamina,lateral,less,lobe,long,longer,lower,margin,mature,mesocarp,mid-point,midpoint,midvein,minute,moist,nflorescence,oblique,orolla,part,per,pore,porrect,presen,present,prickle,ray,ruit,sessile,short,spaced,sprawling,stage,stalk,stellae,stellate,stem,straight,tamen,thick,throughout,time,tube,unarme,unit,unknow,uvenile,vary,vein,white,wide,x,ympodial	5-merous,abaxial,adaxial,arrangement,colour,corolla,filament,form,growth,height,history,leaf,life,na,number,ovary,perennial,position,reproduction,seed,shape,spacing,staman,stigma,surface,texture
274	wfo-0001027720	success	184	81	58	126	23	0.315	0.5-0.8,0.5-1,1-1.5,1-2,1-3.5,15-25,2-3,2-4,2-branched,4-,4-5.5,4-7,5-merous,7-8,adaxially,anther,apex,chartaceous,cm,diameter,elliptic,erect,extra-axillary,filament,flattened,flower,fruit,glabrous,globose,green,homostylous,inflorescence,leaf,length,lilac,mm,notched,ovate,pale,pedicel,peduncle,perennial,petiole,pubescent,rachi,red,rhizomatous,shrub,simple,slightly,sparsely,stellate,stellate-pubescent,stigma,style,subreniform,surface,yellow	%,.25-0.3,0,0-15,0.15-0.25,0.25-0.35,0.3-5,0.4-0.7,0.4-0.8,0.6-1.2,0.8-1,1-locular,1.5-2,13-23,13-35,2-7,2-foliate,2.8-3.1,23-35,3-13,4.3-15,4.3-7.5,6,7-10,7-9,8-11,8-16,9-15,abaxially,absen,absent,acute,adaxiall,adult,alyx,apparently,articulated,axe,ba,base,berry,blade,brown,calyx,capitat,confined,connivent,cuneate,cylindrical,deltate,densely,directed,distall,distally,eaf,eed,eglandular,entire,finger,fruiting,geminat,gland-tipped,hair,half,hig,incomplete,intepetalar,juicy,juvenile,lamina,lanceolate,lateral,less,lobe,long,loosely,lower,margin,markedly,mature,mesocarp,mid-point,midpoint,midrib,minute,narrowly,nflorescence,oblique,orolla,part,per,perfec,perfect,pore,porrect,present,prickle,ray,ruit,scarce,septum,sessile,short,stellae,straight,succulen,tamen,tem,thick,thicker,time,tissue,toward,triangular,tube,unarme,unarmed,unit,upper,vary,white,wide,without,x,yellowi,ympodial	abaxial,adaxial,arrangement,capitate,colour,corolla,form,growth,height,history,life,na,number,ovary,plant,position,reproduction,seed,shape,spacing,staman,texture,width
275	wfo-0001027720	success	272	102	63	209	39	0.232	0,2.0,anther,apex,attachment,bilobed,bud,cancellate,capitate,cm,conical,corolla,cream,developed,diameter,elliptic,entire,extra-axillary,filament,flattened-irregular,flattened-orbicular,flattened-reniform,flower,fruit,glabrous,globose,growth,hair,interpetalar,lateral,lavender,leaf,margin,mm,notched,orange,ovate,pedicel,peduncle,petiole,point,poorly,prickle,red,scattered,shrub,simple,slightly,small,stellae,stellate,stigma,straight,style,subcoriaceous,surface,tissue,tree,violet,wavy,yellow,yellow-ferruginous,yellow-tan	.0,.04,.2,.3,.5,.9,0.1–0.6,0.2–0.4,0.3–0.4,0.7–0.9,0.7–1.1,0.7–1.2,0.8–1.3,0.8–1.9,0.8–2.0,0.9,1.4–1.9,1.5–1.7,1.5–2.0,1.5–2.5,1.5–3.3,1.5–9.0,1.7–1.8,1.7–2.0,1.7–2.5,1.8–2.0,1.9–2.2,1/2,1/3,1/3–1/2,10.0,10.8–18.2,12–16,13.0,19.7–30.0,2.5,2.5–2.8,2.5–2.9,2–3,3.2,3.6,3.7–5.7,3.9,4.0–12.6,4.0–18.0,4–5-merou,5.1–18.6,6.5–9.5,6–8,8.0,8.0–11.9,8.2–10.5,8.5–9.4,9.5–16.0,abaxially,acuminate,acute,adaxially,adnate,aequilateral,alyx,anthesi,apical,apiculate,apparently,appearing,armed,articulated,attenuate,axe,ba,base,becoming,berry,blade,branch,broad,broad-based,brochidodromous,calyx,channel,channeled,colore,concave,congested,connivent,crisped,curved,deciduous,dehiscence,densely,dentate,difoliate,distally,dorsally,dry,eaf,eed,either,emerging,endocarp,erect,especially,exocarp,fertile,filiform,free,geminat,glandular,glossy,gradually,heavily,homostylous,hooked,inclined,increasing,internode,intersepalar,juic,juvenile,lamina,large,least,like,line,lobe,lon,long,longer,lower,m.,major,mature,midpoint,midrib,midvein,minor,minute,moderately,narrowly,nearly,nflorescence,oblique,oblong,occasionally,often,orolla,part,per,perforate,pore,porrect,porrect-stellate,portion,potentially,presumably,proximal,pubescent,raised,ray,reflexed,rigid,rip,row,ruit,sessile,short,shorter,side,sinus,soon,sparsely,splitting,spread,stamen,stellate-pubescen,stellate-pubescent,stem,subacute,suture,tall,tamen,tem,thin,time,tip,toward,translucent,triangular,truncate,tube,twice-branched,two,ud,unarmed,upper,vary,vein,way,weakly,white,wide,yellow-ferruginou,ympodia,young,youngest,±equal,×,–4	0.8-1.9,1.5-3.3,1.5-9.0,1.8-2.0,2-4,3.7-5.7,4.0-12.6,4.0-18.0,5.1-18.6,6.5-9.5,abaxial,adaxial,arrangement,bark,colored,colour,form,fruiting,habit,height,history,inflorescence,length,life,na,number,ovary,perennial,plant,position,rachi,reproduction,seed,shape,spacing,staman,texture,trichome,width
276	wfo-0001027735	success	166	65	37	129	28	0.223	.75,0-5,1.3-3.5,1.7-3.5,10-14,12-15,5-5.8,8-11,anther,apex,chartaceous,cm,diameter,extra-axillary,flower,fruit,green,inflorescence,length,mm,moderately,obtuse,ovate,pale,pedicel,peduncle,perennial,petiole,pseudo-racemose,rotate-stellate,shrub,sparsely,stellate,stellate-pubescent,style,white,yellow	%,.7,0-0.1,0-1,0-4,0.15-0.2,0.25-0.5,0.3-0.6,0.4-0.8,0.5-0.8,0.5-3,1,1-2,1.3-1.6,1.9-2.2,11-17,2-2.5,2-3.5,2-8,2.5-3,20-35,25-50,3-8,3.5-5,30-50,4-5,4-6,4-8,5,5-merou,7-10.5,9-12,abaxially,absent,abundant,acicular,across,acuminate,acute,adaxially,adult,alyx,apart,armed,articulated,attenuate,axe,ba,base,blade,branche,brown,calyx,directed,distall,distributed,dm,eaf,eed,eglandular,erect,finger,fruiting,geminat,glabrou,gland-tipped,globo,hair,half,index,lamina,lateral,less,lobe,lobed,lobing,long,longer,lower,margin,mature,mid-point,midpoint,midvein,minute,nflorescence,oblique,orolla,part,per,pinkish,pore,porrect,presen,present,prickle,purpl,ray,rhizomatous,ruit,sessile,shallowly,short,side,simple,spaced,sparse,stage,stalk,stellae,straight,tal,tamen,tem,thick,throughout,time,transparent,tube,unarme,unbranched,unctional,unit,unknow,uvenile,vein,wide,x,ympodial	abaxial,adaxial,colour,corolla,filament,form,globose,growth,height,history,leaf,life,na,number,ovary,plant,position,purple,rachi,reproduction,seed,shape,spacing,staman,stigma,surface,texture,width
277	wfo-0001027742	success	239	93	69	170	24	0.289	-20,-8,0.1-0.5,0.5-5,1-2,1-5,2-3,2-5,2.5-5,3-9,3.5-10,4-6,4-lobed,7-10,adaxially,annual,anther,apex,black,broadly,brown,chartaceous,cm,densely,depressed,diameter,drying,especially,extra-axillary,filament,finally,flower,fruit,glabrous,globose,grey-green,inflorescence,ivory-green,length,lilac,margin,minutely,mm,ovate,ovate-lancelate,pale,pedicel,peduncle,perennial,petiole,pseudo-racemose,purple,rachi,reticulate,shrub,simple,somewhat,square,stellate-pentagonal,stellate-pubescent,stigma,style,surface,toward,truncate,white,yellow,yellowish,yellowish-green	%,-13,-9,0-0.2,0-0.8,0-1.1,0-12,0-3.5,0-9,0.05-0.1,0.1-0.4,0.4-0.8,0.6-0.8,0.6-0.9,0.7-0.9,0.8-1.8,1-,1-1.1,1-1.2,1-1.5,1-1.8,1-3,1-4,1-8,1.7-2,10-18,10-20,2-,2-2.3,2-2.5,2-5.5,2-6,2-foliate,200-660,25-55,3-4,3-5,3-6,3.5-9.5,4-locular,5-12,5-merou,60-300,7-8,7-9,9-14,abaxially,absent,abundant,accrescent,acicular,acute,adaxiall,alyx,anthesi,anvil-shape,apart,armed,articulated,attenuate,axe,ba,base,bent,blade,broad,calyx,capitat,cone,connivent,cordate,cross-section,curved,cylindrical,decimetr,directed,distall,distally,distributed,dult,eaf,eed,eglandular,enclosing,entire,erect,exceeding,exocarp,finger,fruiting,geminat,gland-tipped,hair,homostylous,index,interpetalar,juicy,lamina,lanceolate,lateral,lobe,lobed,lobing,lon,long,longer,loosely,lower,markedly,mature,mesocarp,mid-point,midpoint,midvein,minute,moderately,moist,nflorescence,oblique,obtuse,one,orolla,outside,part,per,perfect,placenta,pore,porrect,presen,present,prickle,prostrate,ray,rhizomatous,rostrate,rounded,ruit,rusty,shallowly,short,side,slightly,spaced,stage,stalk,stalked,stellae,stem,straight,strongly,tal,tamen,thick,thicker,thicknes,throughout,time,tip,tissue,tube,unbranched,unit,unknow,uvenile,vary,vein,wide,x,ympodial	abaxial,adaxial,arrangement,capitate,colour,corolla,form,growth,height,history,leaf,life,na,number,ovary,plant,position,reproduction,seed,shape,spacing,staman,texture,width
278	wfo-0001027757	success	186	88	50	136	38	0.269	abaxially,anther,anthesi,apart,apex,axillary,blue,branching,brown,campanulate,chartaceous,clavate,cm,colour,dark,deeply,diameter,erect,filament,flattened,flower,fruit,glabrous,globose,leaf,lilac,long,mm,moderately,oblong,ovate,pale,pedicel,peduncle,perennial,petiole,pitted,pubescent,rotate,shrub,simple,sparsely,stigma,style,surface,unbranched,unknown,violet,x,yellow	0.2,0.2–0.3,0.3–2.0,0.5,0.6,0.6–1.0,0.7,0–1.4,1.0–1.1,1.0–2.5,1.2–4.0,1.5–1.6,1.5–2.5,1.6–2.4,1.9–2.7,12,1–1.5,1–11,1–2,1–3,2,2.5,2.5–4,2.5–5.5,2.5–7,2–,2–10,3–12,3–5,4–9,5,5–,60–100,6–9,7–8,8–16,absen,accrescent,acute,adaxiall,adaxially,ag,along,apical,arising,articulated,axe,ba,basal,base,blade,borne,calyx,cell,concave,connivent,convex,cylindrical,decurrent,densely,directed,distally,eaf,eed,elliptic,entire,equal,erose,fleshy,geminat,glabrescen,glabrou,hair,irregularly,lanceolate,leafy,lobe,lobed,lon,longitudinal,lower,m.,margin,multicellular,narrowly,nflorescence,obtuse,occasionally,often,opening,opposed,orolla,pair,perfect,plurifoliate,pore,poricidal,primary,probably,regularly,rootstock,ruit,secondary,serrate,shoot,side,slit,smaller,sometimes,spaced,stone,straight,tall,tamen,tem,thic,thickened,time,tip,toward,tube,unicellular,uniseriate,unit,vary,white,wide,woody,ympodial,–19,–2.7,–3.2,–4.0,–5.5,–6,–9	0-1.4,0.2-0.3,1-1.5,1-11,1.5-2.5,19,2-10,2.5-4,2.5-5.5,3-12,3.2,4-9,60-100,8-16,abaxial,adaxial,arrangement,corolla,form,growth,height,history,inflorescence,length,life,na,number,ovary,plant,position,rachi,reproduction,seed,shape,spacing,staman,texture,width
279	wfo-0001027765	success	167	80	56	111	24	0.335	-44,0.8,1-11.5,1-4,10-13,2-2.5,2-3,2.5-4.2,20-30,3-20,5-6,abaxial,apex,branched,cm,corolla,cyme,diameter,dichasial,dichasially,distal,ebracteate,filament,flower,forked,glandular,globose,green,green-white,hair,half,herbaceous,leaf,light,mm,monochasial,mucilaginous,odd-pinnate,ovate,ovate-lanceolate,ovoid,pedicel,peduncle,perennial,petiole,pilose,plant,seed,simple,stellate,stigma,style,tone,violet,white,yellow	-30,-4,0-.,1,1-,1-10,1-2,1-5,1.5-6,2-4,2.5-4,3-,3-12,3-6-foliat,5,5-15,5-8,7-20,abaxially,abruptly,acumen,acuminate,acute,apical,apically,apiculate,articulate,base,calyx,cell,connate,cordate,covering,cuneate,dehiscent,digestion,diminishing,dorsally,eaf,edge,eed,elliptic,elliptic-lanceolate,emoval,enzyme,exceeding,flat,folded,generally,globo,hair-like,honeycomb,interjected,introrse,lateral,leaflet,living,lobe,lon,long,lower,lunat,make,maturing,nflorescence,nther,oblique,obtuse,often,orolla,ovate-elliptic,pair,pattern,perfect,petiolate,petiolule,plan,poricidally,proximal,reveal,rounded,ruit,sessile,seudostipule,short,side,size,slightly,slit,specimen,stamen,straight,tal,tem,terminal,testal,thick,throughou,throughout,tip,toward,truncate,tuber-bearing,typically,unit,vary,wall,wide,without,ympodial,¼	adaxial,anther,arrangement,colour,form,fruit,growth,height,history,inflorescence,length,life,na,number,ovary,position,rachi,reproduction,shape,spacing,staman,surface,texture,width
280	wfo-0001027767	success	184	83	58	126	25	0.315	1-1.5,1.0-2,1.5-1.8,1.5-2,15-25,3.5-5,5-6,5-merous,7-8,abaxial,anther,apex,beige,brown,clavate,cm,coriaceous,cyme,dark,dark-green,diameter,ferruginous,filament,flower,fruit,glabrous,globose,helicoid,lanuginose,leaf,mm,oblanceolate,oval-elliptic,pedicel,peduncle,persistently,petiole,plant,rachi,reniform,rugose,shrub,solitary,stellate,stigma,style,sub-globose,sub-truncate,subreniform,terete,terminal,tomentose,villous,viscid-glandular,white,winged,within,yellowish	0.3-0.5,1,1-2,10-12,10-20,2-2.5,2-3,2.6-3,3,3-6-branched,30-many-flowered,4-5,4-many-celled,5-7,5-8,8-9,accrescent,across,acute,along,alyx,anthesi,armed,articulate,attenuat,attenuate,base,bicolorous,blade,branch,calyx,campanulate,central,curved,deeply,distal,eaf,eed,enlarged,entire,epicarp,equal,erect-branched,exceeding,floral,free,fruiting,geminat,glandular,glandular-stalke,glandular-stalked,glandular-stellate,gynoeci,hirsute-glandular,indument,irregularly,lobe,lobed,long,long-exserted,longer,lower,many-celled,midrib,minutely,multiangulate,nflorescence,numerous,oblong-lanceolate,orolla,papillo,part,parted,peduncl,pendent,perennia,perfect,persistent,plurifoliate,porrect-stellate,prickle,primary,prominent,pubescent,ranch,ray,recurved,reduced,reflexed,ruit,secondary,sessile,shiny,short,similar,small,somewhat,sparse,sparsely,stalked,stamen,staminate,stem,straight,sub-conic,sub-sessile,subcoriaceous,surfac,surrounded,tall,tamen,thick,trichome,tube,unarmed,uniseriate,unit,vary,vein,viscid-villous,wide,withi,without,yellow,ympodial,young	30-many,adaxial,arrangement,colour,corolla,form,growth,height,history,inflorescence,length,life,na,number,ovary,perennial,position,reproduction,seed,shape,spacing,staman,surface,texture,width
281	wfo-0001027768	success	214	91	71	143	20	0.332	.5,0-0.1,0.1-0.3,0.1-0.4,0.25-1,1-2.5,1.5-2,3-15,4-5,6-6.5,absent,anther,black,brown,chartaceous,cm,contiguous,dark,densely,diameter,elliptical,filament,flattened,fruit,glabrous,gland-tipped,globose,green,greenish-white,grey,grey-green,hair,inflorescence,leaf,leaf-opposed,length,light,margin,minutely,mm,nearly,pale,pear-shaped,pedicel,peduncle,perennial,petiole,purple,rachi,reticulate,rhizomatous,sessile,short,shrub,smooth,solitary,sparsely,stellate,stellate-pubescent,stigma,streak,style,subcoriaceous,surface,toward,turning,violet,white,x,yellow,yellowish	%,0,0-0.2,0-0.3,0-2,0.15-0.25,0.15-0.3,0.2-0.3,0.3-0.6,0.3-0.7,0.3-1.5,0.5-1.5,0.5-3.4,0.6-0.9,0.6-1.5,1,1-2,1.2-1.4,1.2-1.8,1.2-3.4,1.7-2.6,10-15,11-14,15-50,18-35,2-2.5,2-7,2-locular,2.9-3.7,3,3-4.5,4-,5-7,5-merou,6-12,6-15,7-10,8-10,8-12,8-16,abaxiallly,abaxially,accrescent,acicular,across,adaxiall,adaxially,adult,alyx,apart,apex,articulated,attenuate,axe,ba,base,blade,branchlet,calyx,capitat,confined,connivent,cuneate,curved,cylindrical,deltate,difoliate,directed,distall,distributed,dm,eaf,eed,eglandular,entire,erect,exocarp,finger,flower,fruiting,geminat,half,hig,juicy,juvenile,lamina,lanceolate,lateral,less,lobe,long,longer,loosely,lower,mature,mesocarp,mid-point,midpoint,midrib,midvein,minute,moist,narrowly,nflorescence,oblique,obtuse,orolla,part,per,perfect,placenta,pore,porrect,present,prickle,pseudo-racemose,pubescent,ray,reddish,ruit,semi-circula,simple,somewhat,spaced,spongy,sprawling,stellae,straight,tamen,tem,thick,throughout,time,triangular,tube,unarme,unarmed,unbranched,unit,vary,wide,winged,ympodial	abaxial,adaxial,capitate,colour,corolla,form,growth,height,history,life,ovary,plant,position,reproduction,seed,shape,spacing,staman,stem,texture
282	wfo-0001027770	success	242	79	58	184	21	0.24	0.2-2,0.5-1,0.8-1.5,0.8-2.5,1-3,2,2.5-3,3-5,4,5-merous,6,6-10,7-15,anther,apart,base,clavate,cm,concolorous,dark,densely,diameter,elliptic,filament,flattened,flower,fruit,glabrous,globose,herbaceous,lateral,leaf,length,lobed,mm,narrowly,orange,orange-brown,ovoid,pale,pedicel,peduncle,petiole,plant,pubescent,reniform,simple,smooth,spherical,stellate-pubescent,stigma,style,surface,terminal,violet,white,woody,yellow	0-45°,0.1-0.15,0.1-0.3,0.15,0.3,0.3-2,0.5,0.5-2,0.6-1.2,1-2,1-2.5,1-5,1.5,1.5-2,1/2-1/6,10-14,12,12-14,16,2-3,2-4,2-6,2/3,20,3,3-4,3-6,4-6,4-7,4-8,5-30,50,7,9,abaxially,acute,adaxially,ag,almost,alyx,anthesi,apex,apically,apparently,armed,articulated,bark,berry,blade,branching,brown,c.,calyx,cuneate,cuspidate,deltate,dense,difoliate,dilated,distance,drying,eaf,eed,elongating,entire,equal,erect,extending,eye,filiform,flat,free,fruiting,geminat,gray,green,horizontal,infructescence,irregular,lanceolate,lengthening,less,like,lobe,lon,long,longer,lower,margin,markedly,mature,maturity,midpoint,midvein,mostly,naked,nflorescence,oblique,obscured,obtuse,often,older,orolla,oung,ovate,pair,papillate,papillo,pendulous,per,perfect,pericarp,pore,poricidal,porrect,portion,present,prickle,prickly,primary,prominent,pubescenc,raised,rare,rarely,ray,red,reduced,reduced-multangulat,reflexed,rounded,ruit,scar,sessile,shallowly,short-styled,side,slightly,small,sometimes,somewhat,spaced,sparse,sparsely,spreading,stalk,staminat,stellate,stem,stolon,straight,stump,subsessile,tall,tamen,tapering,terete,tertiary,thin,throughout,time,tip,toward,trichome,tube,unarme,unarmed,underground,uniform,unit,usually,variously,vary,vein,venation,visibl,visible,way,white-green,wide,yellow-green,ympodial,young,½	20-50,abaxial,adaxial,arrangement,colour,corolla,form,growth,height,history,inflorescence,life,na,ovary,position,reproduction,seed,shape,spacing,staman,texture
283	wfo-0001027807	success	116	90	57	59	33	0.491	0-0.2,0.1-1,0.2-0.9,2-5,2-6,apex,bark,brown,bud,closely,cm,diameter,dry,elliptic,flattened,flower,fruiting,glabrous,globose,gray,grayish,green,growth,internodal,lanceolate,leaf,leaf-opposed,margin,material,minutely,narrowly,new,occasionally,overlapping,pale,papillate,pedicel,peduncle,petiole,pitted,plane,rachi,reddish,reniform,revolute,scar,shrub,simple,slender,slightly,small,spaced,sparsely,stem,surface,tree,winged	.5,0.2-0.3,0.3-0.4,0.9-1,0.9-2.5,1-1.5,15-30,3.5-9,abaxially,acuminate,acute,adaxially,almost,attenuate,barely,base,berry,brittle,decurrent,deflexe,deflexed,difoliate,drying,eaf,eed,ellipti,geminat,know,known,maturity,midrib,mm,nflorescence,older,ot,pair,paler,papillae,parallel,primary,prominent,reddi,reproductive,ruit,seemingly,shoot,somewhat,thickened,ud,unifoliate,unit,usually,vein,visible,white,x,yellowish,ympodial,young	abaxial,adaxial,anther,arrangement,calyx,cell,center,colour,corolla,filament,form,fruit,height,history,inflorescence,length,life,na,number,ovary,plant,position,prickle,reproduction,seed,shape,spacing,staman,stigma,style,texture,trichome,width
284	wfo-0001027808	success	178	73	48	130	25	0.27	.5,0.6-1.2,1-2,1.6-3,12-18,23-28,5.5-6.5,7-10,9-14,acuminate,acute,andromonoecious,anther,apex,articulated,base,broadly,chartaceous,cm,densely,diameter,extra-axillary,flower,fruit,globose,green,inflorescence,lavender,length,mm,ovate,pale,pedicel,peduncle,perennial,petiole,plant,pseudo-racemose,simple,sparsely,stellate,stellate-pubescent,stigma,style,vine,white,yellow,yellowish	%,.2,.7,0-0.1,0-7,0.05-0.2,0.2-0.3,0.2-0.35,0.25-0.35,0.3-0.6,0.4-0.8,0.4-1,0.5-0.6,0.5-1,0.5-3,0.6-1.4,1,1-1.3,1.1-1.3,1.4-1.8,1.9-2.4,15-30,2-4,2-foliate,2.5-3.5,2.5-4,20-30,3-11,40-120,5-7,5-7.5,5-merou,6-8,7-8,70-90,8-12,abaxially,absent,acicular,across,adaxiall,adaxially,alyx,apart,armed,axe,ba,blade,broad-based,brown,calyx,capitat,cuneate,curved,d.,deltate,directed,distall,distributed,eaf,eed,eglandular,finger,fruiting,functional,geminat,gland-tipped,hair,half,heterostylous,index,lamina,lateral,less,lobe,lobed,lobing,long,longer,lower,margin,mature,mid-point,midpoint,midvein,minute,nflorescence,oblique,orang,orolla,part,per,pore,porrect,presen,present,prickle,purple,ray,rostrate,ruit,sessile,shallowly,short,side,spaced,sprawling,stage,stalk,stellae,straight,tal,tamen,tem,thick,throughout,time,tube,unarme,unarmed,unbranched,unit,unknow,uvenile,vary,vein,weakly,wide,x,ympodial	abaxial,adaxial,arrangement,capitate,colour,corolla,filament,form,growth,height,history,leaf,life,na,number,orange,ovary,position,reproduction,seed,shape,spacing,staman,surface,texture
285	wfo-0001027816	success	187	110	87	100	23	0.465	.5,0.2,0.5-1,0.6-0.8,0.7-1,1,1-1.5,1-3,1-4,1.5-2,2-4,2/3,4-5,5-30,<,almost,along,anther,apex,base,becoming,berry,bluish,branched,brown,capitate,cm,confined,corolla,dark,dense,densely,diameter,filament,filiform,flattened,flower,glabrous,globose,growth,inflorescence,irregularly,lanceolate,lateral,leaf,less,like,linear,lobed,margin,minutely,mm,orange,pedicel,peduncle,petiole,pitted,plant,pubescent,purple,reddish,reniform,ripe,several,shiny,shrub,simple,spaced,sparse,sparsely,stellate,stem,stigma,style,surface,terminal,thin,time,tip,trichome,uniformly,uniseriate,variable,vein,way,x,½	..,0.5,0.5-2,1-1,1.2-2,1.8-6,12-14,2-2.5,3-3.5,3.5-4,5-merou,6-9,acuminate,acute,ag,alyx,anthesi,apar,ark,articulated,attenuate,axi,calyx,cell,conical,connivent,cupped,drying,eaf,eed,ellipsoid,em,entire,erect,exserted,fleshy,free,fruiting,gland-tipped,glandular,half,ilament,leaving,lengthening,lobe,loosely,lower,m.,markedly,minute,new,nflorescence,nodding,occasionally,often,older,orolla,pair,papillo,patent,peg,per,perfect,perhaps,pericarp,plurifoliat,pore,poricidal,portion,primary,prominen,pubescen,rectangular,red,rounded,ruit,scar,sleeve,slightly,slit,small,sometimes,somewhat,spreadin,spreading,square,testal,triangular,tube,twinin,ud,ultimate,unit,upper,usually,vary,viscous,woody,yellowish,ympodial	abaxial,adaxial,apart,arrangement,colour,form,fruit,height,history,length,life,na,number,ovary,position,rachi,reproduction,seed,shape,spacing,staman,texture,width
286	wfo-0001027819	success	199	100	75	124	25	0.377	-100,1-,10-20,10-50,16-25,2-15,20-35,20-40,3-40,4,4-10,5-merous,8-10,9-12,abaxially,adaxially,apart,apex,apical,articulated,base,branched,cm,concave,densely,diameter,ellipsoidal,especially,fading,finely,fleshy,flower,forked,fruit,glabrous,globose,green,leaf,length,lobed,margin,mm,moderately,near,pedicel,peduncle,per,perfect,petiole,probably,protuberance,puberulent,purple,purplish,rachi,rarely,rugose,simple,sparsely,stellate,stigma,style,subcoriaceous,sympodial,tree,two,umbrella-shaped,unbranched,unit,unknown,unlobed,whitish,width,yellow,young	0.5-1,1,1-2,1-5,1.5-2,12-21,15-22,2,2-,2-3,20-25,22-35,25-35,3-5,3-5-lobed,4-15,4-25,4-5,5,5-6,acute,aggregate,also,alyx,ape,apiculat,axe,ba,basal,beyond,blade,cell,ciliate,color,connective,cordate,cuneate,cylindrical,deeply,denser,dia,diamete,dilated,directed,distally,divided,eaf,eed,eglandular,eglandular-pilose,elliptic,elliptic-ovate,entire,equal,exceeding,except,exserted,hair,halfway,leaving,lobe,lon,long,lower,main,mesocarp,midrib,narrow,narrowly,nflorescence,nther,oblique,oblong,obtu,obtuse,occasionally,often,orolla,ovate,pedicellar,perfec,pilose,pinnately,pore,present,prominent,puberulen,puberulence,radiu,ranch,ratio,remnant,ripe,rounded,rown,ruit,runk,shallowly,short-acuminat,shorter,sinus,slightly,small,sometimes,spaced,stamen,stone,strongly,swelling,tal,thecae,toward,triangular,truncate,tube,ud,uni,usually,vary,vein,villous,wide,without,x	abaxial,adaxial,anther,arrangement,colour,corolla,filament,form,growth,height,history,inflorescence,life,na,number,ovary,plant,position,reproduction,seed,shape,spacing,staman,surface,texture
287	wfo-0001027829	success	197	110	89	108	21	0.452	0.1-0.8,0.6-0.9,1-3,1.5,1.7-2,1/3,12,30,5,5.5-6,6-6.5,abaxially,acuminate,anther,apex,axi,base,berry,black,cell,clavate,cm,corolla,densely,denser,diameter,directed,distally,elliptic,elongate,entire,evenly,filiform,flattened,flower,glabrous,gland-tipped,globose,growth,inflorescence,larger,length,like,lobed,lower,margin,midpoint,minute,minutely,mm,narrowly,nearly,ovary,pair,pale,pedicel,peduncle,petiole,pitted,pore,poricidal,porrect,pubescence,pubescent,rectangular,reniform,ripe,sessile,shiny,short-stalked,shrub,simple,sinuate,small,somewhat,spaced,sparsely,stellate,stigma,style,surface,tan,testal,thin,tip,tree,trichome,white,yellowish	.1,.5,0.5,0.6-0.7,0.7,0.7-0.8,1,1-,1-1.5,1.5-2,1.5-2.5,10-20,2,20-31,3-7,4-6,5-18,5-8,8-10,acute,adaxially,along,anthesi,apar,armed,articulated,bark,beneath,bent,bright,brown,calyx,commonly,conical,dense,drying,eaf,eed,enmeshing,equal,erect,exceeding,exserted,filament,free,fruiting,glabrescen,hang,lateral,lobe,long,midrib,midvein,mixed,mixture,multicellular,new,nflorescence,nodding,oblique,often,older,one,open,orange,papillat,per,perfect,pericarp,plurifoliat,pointed,porect,portion,prickle,primary,prominent,ray,reddish,reflexed,regular,ruit,scar,scattered,sharply,short,shorter,side,stem,straight,strongly,tangled,tapering,time,triangular,truncate,tube,twice,ud,un,unarmed,unit,upper,usually,vein,weak,within,x,ympodial	abaxial,apart,color,form,fruit,height,hermaphroditic,history,leaf,life,na,number,papillate,perennial,plant,regularly,reproduction,seed,shape,spacing,texture
288	wfo-0001027834	success	236	91	66	170	25	0.28	-6.1,0-110,0.2-0.3,0.2-0.4,0.2-0.6,0.5-2,1-1.6,1-1.9,1-10,1.1-1.8,1.6-2.7,2-8,2.3-3.4,4-5.2,5-20,5-merous,6.9-18.1,abaxial,abaxially,adaxial,anther,apex,articulated,base,branched,cm,corolla,deltoid,diameter,filament,finely,flower,fruit,globose,granular-tomentose,leaf,lenticular,light,mm,ovate,ovate-elliptic,pedicel,peduncle,persistent,petiole,rachi,reticulate-punctate,scabridulous,semi-spherical,shrub,simple,small,soft,stellate,stigma,style,surface,tomentum,tree,velutinous-tomentose,white,whitish-tomentose,x,yellow,yellowish-tan,yellowish-tomentose	.5-3,0.4-1.1,0.9-1.8,1-2.5,1.1-1.6,1.4-2,1.8-4.9,1/2,10-25,2-3.8,2.2-4.3,2.4-6.2,2.7-7.3,2.9-4.2,25,3-15,3-4.3,4-6,4.8-6.9,5.1-8,9-11.9,9-13,absent,accrescent,acuminate,acute,adaxially,ag,alyx,angled,anthesi,apar,apical,around,attenuate,axillary,ba,bark,becoming,berry,blade,blunt-tipped,branch,branching,brown,bud,calyx,capitat,closely,completely,concentrated,connivent,coriaceous,covering,crown,cylindrical,dendritic-echinoi,dendritic-echinoid,densely,dichasia,directed,discolorous,distally,drying,eaf,echinoi,echinoid,edge,eed,ellipsoid,enclosing,entire,enveloping,equal,erec,exserted,farinose,flat-topped,fleshy,forming,fruiting,glabrescent,glabrous,gray,grooved,hair,high,included,inserted,lengthening,less,lobe,lobed,long,long-stalked,longitudinal,longitudinally,lower,many,margin,mostly,multangulat,multangulate,near,nflorescence,numerous,obovate,obscured,obtuse,older,orbicular,orolla,ovate-lanceolate,pair,perfec,plurifoliate,pore,poricidal,porrect-stellate,primary,pseudo-terminal,pubescence,pubescent,rarely,ray,ripe,rounded,ruit,runk,scar,semi-ovate,sessile,short,short-stalked,slit,sometimes,somewhat,spaced,sparsely,spreading,stalked,stamen,stellate-pubescent,stem,subcampanulate,subcoriaceous,suture,tamen,though,time,tip,tomentose,tomentu,toward,trichome,tube,turbinoid,ud,unarme,unit,usually,vary,vein,villous,way,whitish,wide,yellowish,ympodial,young	apart,arrangement,capitate,colour,form,growth,height,history,inflorescence,length,life,na,number,ovary,perennial,plant,position,pseudoterminally,reproduction,seed,shape,spacing,staman,texture,width
289	wfo-0001027843	success	154	68	41	113	27	0.266	0.5-1,0.8-3.5,1-1.3,1-1.5,1.2-1.5,2-2.5,5-6,6-9,anther,apart,apex,clavate,cm,corolla,densely,filament,flower,glabrous,globose,green,leaf,lobed,mm,opposite,ovary,ovate,pedicel,petiole,pubescent,shape,shrub,slender,sparsely,stigma,style,surface,tapering,trichome,white,winged,x	.5,.75,/3,0.5-0.75,1-1.2,1.2-2.5,2-4,3-15-flowered,3-6,6-13,acute,along,anthesi,apiculate,ba,bark,base,bearing,becoming,beginning,beneath,berry,broadly,calyx,conical,coroll,curly,deflexed,deltoid,denser,dia,differing,difoliate,distally,eaf,edicel,eed,ellipsoid,erose,exsertion,free,fruiting,geminat,glabrate,hairy,impressed,irregularly,known,lamina,larger,later,lateral,like,lobe,lon,long,long-acuminate,lower,main,major,margin,middle,minor,minutely,near,nearly,nflorescence,occasionally,older,one,orbicular,pair,papillo,papillose,pleated,pore,poricidal,portion,prominent,proximal,reddish-gre,reflexed,rounded,ruit,scar,shaped,simple,sinus,size,slightly,somewhat,spaced,sparser,stem,stiff,straight,strongly,tall,tear-drop,time,tip,tipped,tube,two,ud,uniseriate,unit,vein,way,widest,woody,ympodial,young	3-15,abaxial,adaxial,arrangement,colour,diameter,form,fruit,growth,height,history,inflorescence,length,life,na,number,peduncle,perennial,plant,position,rachi,reproduction,seed,spacing,staman,texture,width
290	wfo-0001027847	success	219	92	68	151	24	0.311	-2.5,-5,/3,0-2,0.4-1,0.8-1.2,1-2,1.5-2,2-2.8,2.5-3.5,4-5-merous,5.5-8,abaxially,almost,anther,apex,articulated,base,berry,branched,cm,densely,diameter,dull,elliptic,erect,evenly,filament,finely,flattened-reniform,flower,fruit,glabrous,green,lateral,leaf,length,lobed,maturity,mauve,middle,mm,moderately,orange,orange-brown,ovate,pedicel,peduncle,petiole,pitted,purple,red,scandent,seed,shrub,simple,smooth,sparsely,spherical,stellate,stellate-pubescent,style,surface,terminal,way,white,yellow,young	-0.8,-2,-3,-4,-6,.35,.7,/2,0,0-7,0.1-0.4,0.15-0.2,0.2,0.5,0.5-1,0.8,0.8-0.9,1,1-2.5,1.5-2.5,1.5-5,1.9-2.3,1/2,1/4,1/6-1/3,2-3,2-4,2-5,2.2-3,2/,3-15,3-5,3-6,3.5-6,5-25,5-6,6-11,6-8,7-10,acute,alyx,ame,apar,apart,apically,apparently,bark,blade,broadly,brow,c.,calyx,chartaceous,connivent,cordate,curved,deltate,dimorphic,discolorous,distance,drying,eaf,edge,eed,elongating,equal,extending,faint,filiform,filiform-acuminat,flattened,free,fruiting,geminate,glabrescent,gray,increasing,infructescence,lobe,lon,long,longer,lower,margin,mature,midpoint,midvein,minor,narrow-deltate,nflorescence,older,one,open,orbicular,orolla,oung,pair,pendulous,per,perfec,pericarp,perpendicular,pit,plurifoliat,poricidal,porrect,portion,prickl,prickle,prickly,primary,ray,red-brown,reddish,retrorse,rounded,ruit,scar,sessile,side,size,slender,sometimes,spaced,spreading,stalk,stalked,stem,straight,strongly,tamen,tapering,terete,tertiary,time,tip,toward,trichome,tube,unarmed,unit,upper,usually,variously,vary,vein,venation,visible,weakly,wide,ympodial	abaxial,adaxial,arrangement,colour,corolla,form,growth,height,history,inflorescence,life,na,number,ovary,plant,position,rachi,reproduction,shape,spacing,staman,stigma,texture,width
291	wfo-0001027850	success	221	111	89	132	22	0.403	-10,-4,-5,-6,0.5-1,0.6-1,1-3,1-4,1.5-2,2-2.5,2-4,2-5,3-6,3-7,4-5,6-7,8-10,abaxially,adaxially,anther,apart,apex,berry,blue,branched,brown,clavate,cm,corolla,dark,diameter,elliptic,filament,flattened,flower,glabrous,glandular,globose,green,growth,inflorescence,internodal,laxly,length,like,long-styled,loosely,mature,minute,minutely,mixture,mm,obovate,ornamented,ovary,ovate-lanceolate,pedicel,peduncle,petiole,plant,pubescence,purple,reddish,reniform,reticulate,rugose,rusty-pubescent,scabrous,sessile,short-styled,shrub,simple,stellate,stem,stigma,style,subglobose,subreniform,subsessile,subtruncate,surface,tomentose,trichome,velutinous,whitish,woody,x,yellow,yellowish	-22,0.2-0.5,0.3-0.35,1,1-1.5,1-2,1-multicellular,2-3,2-6,2.5-3,3-4,3.5-13,4-6,50,6-10,7-18,<,>,acuminate,acute,adult,almost,angled,anthesi,armed,articulated,bark,basal,base,brow,caly,calyx,cell,channelled,charataceous,coriaceous,curved,discolorous,distal,dry,eaf,eed,eglandular,enclosed,entire,erect,expanding,flowering,foliaceous,free,fruiting,glabrescent,heterostylous,hirsute,impressed,juvenile,leaving,lengthening,linear,lobe,lobed,lobed-angulate,long,longer,lower,margin,material,midpoint,mixed,multicellular,new,nflorescence,obliqu,oblong,oblong-lanceolate,obverse,occasionally,older,one,papillo,partially,per,perfect,pericarp,persistent,plurifoliat,pore,poricidal,porrect,portion,prickle,prickly,prominent,pubescent,raised,reduced,reflexed,rest,rounded,ruit,rusty,sagittate,scandent,scar,single,slightly,slit,spaced,sparse,sparsely,stalked,staminate,stellate-apiculate,straight,strongly,tall,tapered,testa,time,tip,triangular-lanceolate,tube,turbinate,ud,unevenly,unit,upper,vein,venation,wood,ympodial,¼	abaxial,adaxial,arrangement,colour,form,fruit,height,history,leaf,life,na,number,papillose,position,rachi,reproduction,seed,shape,spacing,staman,texture,width
292	wfo-0001027864	success	222	86	63	159	23	0.284	0.1-0.4,0.25-0.5,0.4-1.4,1-2,1-3,1.4-4,1.5-8,3-6,3.5-5,4,5-9,6-7,anther,chartaceous,cm,deflexed,densely,diameter,ellipsoidal,extra-axillary,filament,finely,flower,fruit,glabrous,globose,green,grey,grey-green,hair,herbaceous,inflorescence,lanceolate,length,lilac,linear,lobed,mm,nearly,pale,pedicel,peduncle,petiole,pseudo-racemose,purple,rachi,reniform,resprouter,reticulate,scattered,shallowly,simple,smooth,stellate,stellate-pubescent,stigma,style,surface,white,x,yellow,yellowish,yellowish-green	%,0-0.1,0-0.2,0-100,0-2,0-3,0.05-0.4,0.3-1,0.4-0.7,0.5-0.7,0.5-0.8,0.5-1,0.6-0.7,0.7-0.9,0.7-1,0.7-1.4,0.9-1.1,1-1.1,1-1.3,1-1.5,1-3.5,1-4,1.2-1.5,13-20,2-3,2-foliate,2-locular,2.5-3,3-10,3-4,3-4.2,3-5,3-5.5,3.8-14,4-,5-merou,6-12,6-8,6-9,7-10,7-20,8-12,8-13,8-14,abaxially,absen,absent,abundant,accrescent,acicular,acute,adaxially,alyx,anvil-shape,apart,apex,articulated,attenuate,axe,ba,base,blade,broad-based,brown,calyx,capitat,connivent,cross-section,cuneate,curved,cylindrical,decimetr,deltate,directed,distall,distributed,dult,eaf,eed,eglandular,entire,erect,exocarp,finger,flattened,fruiting,geminate,gland-tipped,half,homostylous,index,interpetalar,juicy,lamina,lateral,less,lobe,lobing,lon,long,longer,loosely,lower,margin,mature,mesocarp,mid-point,midpoint,minute,moderately,moist,nflorescence,oblique,oblong,obtuse,orolla,part,per,perfect,placenta,pore,porrect,present,prickle,ray,ridged,rostrate,ruit,rusty-brown,sessile,short,side,slightly,spaced,sprawling,stage,stalk,stalked,stellae,stem,straight,tal,tamen,tapered,terete,thick,throughout,time,tip,tissu,tissue,tube,unarmed,unbranched,unit,uvenile,vary,wide,ympodial	abaxial,adaxial,arrangement,capitate,colour,corolla,form,growth,height,history,leaf,life,na,number,ovary,perennial,plant,position,reproduction,seed,shape,staman,texture
293	wfo-0001027872	success	190	85	55	135	30	0.289	1,1-4,1-8,10,12-35,2.2-3.5,5-7,6-20,8-11,apex,branched,cm,cyme,deep,densely,diameter,dichasial,dichasially,distal,ebracteate,elliptic,filament,flower,glabrescent,glandular-pubescent,globose,gray-green,green,green-white,half,herbaceous,homogeneously,lanceolate,light,mm,moderately,monochasial,mucilaginous,narrowly,odd-pinnate,ovate,ovoid,pedicel,peduncle,perennial,plant,purple,rhizomatous,rotate,seed,shape,stigma,style,yellow,yellowish-green	0.5,1-1.2,1.0-1.3,1.5-4,15,2,2-3,2.8,20,3-6-foliat,35,4-6,5-10,5-8,5-lobed,abaxially,acumen,acuminate,acute,adaxially,angular,apical,apically,apiculate,articulate,b,ba,basal,base,becoming,ca,calyx,caudate,cell,celled,clasping,commonly,connate,cordate,covering,cuneate,decreasing,dehiscent,digestion,eaf,eed,emoval,enzyme,erect,exceeding,externally,forked,four-celled,generally,gland,glandular,globo,hair-like,honeycomb,interjected,introrse,lateral,leaflet,living,lobe,lon,long,longer,lower,make,maturing,middle,mottled,nearly,nflorescence,nther,obliquely,oblong,often,orolla,pair,pattern,pentagonal,perfect,petiolate,petiolulate,petiolule,poricidally,puberulent,pubescent,purpl,rarely,reduced,reveal,rhizome,rotate-,rounded,ruit,semi-lunate,sessile,seudostipule,short,single,size,slightly,slit,sometimes,somewhat,specimen,stamen,ste,straight,subequal,symmetrically,tem,terete,terminal,testal,thick,tinged,tip,trailing,type,typically,unbranched,uniformly,unit,usually,vary,viole,wall,wid,wide,wider,ympodial	abaxial,adaxial,anther,arrangement,colour,corolla,form,fruit,growth,height,history,inflorescence,leaf,length,life,na,number,ovary,petiole,position,rachi,reproduction,rotate-pentagonal,spacing,staman,surface,texture,violet,wet,width
294	wfo-0001027880	success	185	90	67	118	23	0.362	.25,0.5-5,0.6-1.5,0.8-1.5,1-14,1-15,1-2,1-3,10-15,2-3,2-80,4-10,4-6,8,acute,anther,apart,apex,apiculate,chartaceous,clavate,cm,contiguously,densely,diameter,distichous,epiphytic,extra-axillary,filament,flower,fruit,glabrous,globose,greenish,inflorescence,leaf,leaf-opposed,mm,nearly,oblong-ovate,ovate,ovoid,pedicel,peduncle,perfect,petiole,pink,pubescent,purple,rachi,red-brown,ripe,rounded,rugulose,shrub,somewhat,stellate,stigma,style,surface,tan,truncate,unbranched,vine,white,x,yellow	-3,-3.5,0.3-3,0.5-1.5,0.6-1,1-2.5,1.5-2,1.5-3,2/,3-4,5-11,5-8,5-merou,abaxially,absen,accrescen,acuminate,adaxially,ag,aggregate,along,alyx,apparently,articulated,axe,ba,base,blade,branch,branching,calyx,cell,ciliat,conical,connivent,cordate,coriaceous,curled,cylindrical,deltate,dense,diminishing,directed,discolorous,distally,distinct,distinctly,eaf,eed,entire,equal,flattened,fruiting,geminat,green,growing,hair,increasing,internode,line,lobe,long,longer,longitudinal,lower,margin,midvein,minutely,multicellular,nflorescence,node,oblique,oblong,occasionally,often,opening,orolla,pair,pale,papillose,plurifoliate,point,pore,pubescen,reddish,revolute,rooting,ruit,scar,secondary,simple,size,slender,slightly,slit,sometimes,spaced,sparsely,ste,stone,tamen,tem,thickened,time,tip,trailing,tree,trunk,tube,typically,undulate,uniseriate,unit,usually,vary,vein,wide,ympodial	abaxial,adaxial,arrangement,colour,corolla,form,growth,height,history,length,life,na,number,ovary,plant,position,reproduction,seed,shape,spacing,staman,texture,width
295	wfo-0001027880	success	170	100	72	98	28	0.424	.25,0.5,0.6–1.5,0.8–1.5,10–15,1–14,1–15,1–2,2-80,2–3,4–10,4–6,8,abaxially,absent,acuminate,acute,adaxially,anther,apex,apiculate,arrangement,bluish-purple,chartaceous,cm,contiguously,coriaceous,densely,diameter,distichous,extra-axillary,filament,flattened,flower,fruit,glabrous,globose,greenish,leaf,leaf-opposed,margin,mm,mottled,nearly,oblong-ovate,ovate,ovoid,pedicel,peduncle,petiole,pink,pubescent,rachi,red,reddish-brown,rounded,rugulose,sand-punctate,shrubby,slightly,sometimes,somewhat,stellate,stigma,style,surface,tan,truncate,unbranched,vine,white,x	0.2-0.5,0.3–3,0.5–1.5,0.5–5,0.6–1,1.5–2,1.5–3,1–2.5,1–3,2/3,3–4,5-merous,5–11,5–8,accrescen,along,alyx,apar,axe,base,berry,blade,c.,calyx,capitat,ciliat,clavate,climbing,conical,cordate,curled,cylindrical,deltate,dense,discolored,distinct,distinctly,eaf,eed,entire,fruiting,green,hair,lanceolate,line,lobe,long,longer,lower,m.,membranous,midvein,minutely,nflorescence,nternode,oblique,occasionally,often,orolla,pair,pale,papillose,perfec,pinnate,plurifoliat,reddish,revolute,rip,ruit,sand-punctat,scar,secondary,simple,slender,spaced,sparsely,ste,tamen,tem,thickened,time,tip,tree,trichome,trunk,tube,typically,undulate,uniseriate,unit,vary,vegetatio,vein,venation,wide,woody,ympodial,–3.5	abaxial,adaxial,apart,capitate,ciliate,colour,corolla,form,growth,height,history,inflorescence,length,life,na,number,ovary,perfect,plant,position,reproduction,ripe,seed,shape,spacing,staman,texture,width
296	wfo-0001027881	success	215	93	58	157	35	0.27	-3,almost,anther,apex,attenuate,berry,blackish,chartaceous,cm,contiguous,cordate,cordiform,diameter,drying,extra-axillary,filament,flattened,flower,fruit,glabrous,globose,greenish,groove,herb,immature,lateral,leaf,light-brown,margin,maturity,membranaceous,mm,moderately,ovate-elliptic,parallel,pedicel,peduncle,petiole,projection,pubescent,rachi,raised,reniform,rotate,seed,sessile,short,simple,sparsely,staman,stigma,style,subopposite,surface,translucent,white,yellow,×	.3–0.5,0.5–2.2,0.8–1.5,1-celled,1.3–2,1.8–2.9,10–25,1–2,1–2-celled,1–2.5,1–2.6,1–3,1–3-celled,1–4,2.5–3.6,20–40,2–4,2–6,2–7,4–6,4–9.5,5,5-merous,6–10,7–14,7–9,8,abaxially,absent,abundant,accrescent,acuminate,acute,adaxiall,adaxially,alyx,appressed,articulated,asymmetric,axe,ba,barely,base,blade,bulge,calyx,camptodromous,capitat,case,central,ciliate,closely,commonly,connected,connivent,curved,cylindrical,decurrent,dehiscing,densely,denser,difoliate,directed,dorsally,eaf,ed,eglandular,emarginate,emerging,entire,equal,erect,exceeding,exclusively,explosively,eye,few-,fewer,forming,frequent,geminate,giving,glandular,hair,half,held,hollow,impression,interpetalar,introrsely,larger,less,like,lobe,long,longer,longitudinal,lower,mainly,many-branched,maturit,mesocarp,mixed,much,multicelled,multicellular,naked,near,netlike,nflorescence,normally,one,opening,orolla,other,pair,part,per,perfec,placenta,pore,pressure,primary,prominent,pubescence,ruit,secondary,side,similar,size,slightly,slit,small,smaller,solitary,sometimes,stalk,stamen,stem,subapically,tal,tamen,tem,tissue,triangular,tube,two,unbranched,unit,vary,vein,venation,visible,watery,winged,woody,ympodial	0.5-2.2,1-2,1-2.5,1-4,1.3-2,20-40,4-6,6-10,7-14,7-9,abaxial,adaxial,arrangement,capitate,colour,corolla,form,growth,height,herbaceous,history,inflorescence,length,life,na,number,ovary,perennial,plant,position,reproduction,shape,spacing,texture,width
297	wfo-0001027882	success	184	110	87	97	23	0.473	0.1,0.5-1,1,1-5,1.5-2,1.5-2.2,1.5-6,10-40,2-6,2-lobed,2.1-2.6,3-4,3.5-5,6-9,abaxially,adaxially,anther,anthesi,apart,apex,apparently,appearing,base,berry,branch,branched,c.,clavate,cm,completely,conical,corolla,cucullate,densely,diameter,elliptic,erect,filament,flattened,flower,fork,glabrous,globose,green,growth,hairy,hooked,inflorescence,leaf-opposed,less,lobed,margin,maturity,minutely,mm,nodding,occasionally,ovary,ovoid,pale,papillate,pedicel,peduncle,petiole,pitted,rachi,rarely,reniform,shiny,shrub,simple,slender,small,sometimes,sparse,sticky,stigma,style,surface,time,tree,trichome,uniseriate,way,white,x,yellow	.25,.5,06a,1-1.5,1.5-,1.6-2.2,10-25,2-3,2.5-3,3.2-6,3.5-4,4-5,7-,9-13,absent,acuminate,age,along,attenuate,axil,bark,branching,broadly,brown,caly,calyx,dark,deltate,dense,difoliate,dry,drying,eaf,eed,entire,et,exerted,fide,free,fruiting,fusiform,geminat,glabrou,hollow,irregularly,junction,kallunki,lamina,lengthening,lobe,lower,markedly,midrib,new,nflorescence,pair,papillat,paulo,penden,perfect,planar,plane,pointed,population,pore,poricidal,portion,primary,pulp,red-papillat,reddish,ruit,scar,shattering,slit,spaced,sparsely,specimen,stem,stout,straight,strongly,structurally,sweet-scented,swollen,são,thickened,tip,tube,tuft,ud,unit,usually,vein,woody,yellowish,ympodial	1.5-4,abaxial,adaxial,arrangement,colour,form,fruit,height,history,leaf,length,life,na,number,perennial,plant,position,reproduction,seed,shape,spacing,texture,width
298	wfo-0001027889	success	151	101	76	75	25	0.503	0.5-1,0.5-11,1,1-3,1.5,10-12,10-30,3-4,3-8,3-9,abaxially,acute,acute-acuminate,adaxially,apart,apex,articulated,basal,base,chartaceous,cm,connective,connivent,cylindrical,densely,diameter,dilated,distally,eglandular-pubescent,elliptic,entire,finely,flower,fruit,glabrous,glandular-,green,greenish,immature,length,light,lobe,margin,mm,moderately,oblong,ovate,ovoid,pedicel,peduncle,perfect,petiole,probably,puberulent,puberulent-pubescent,rachi,ripe,shrub,simple,slightly,somewhat,sparsely,stellate,stigma,style,subcordate,subcoriaceous,tomentose,tree,truncate,unbranched,unknown,violet,white,x,yellowish	-2.5,-pubescent,.5,.5-2,0,0.7-2,1-10,1-3.5,1.5-2,10-20,2-20,2-3,4-foliat,5-10,acuminate,aggregate,ape,apiculate,axe,beyond,blade,calyx,capitat,cell,color,darker,deltate,directed,eaf,eed,eglandular-puberulent,equal,exceeding,exserted,extending,introrse,laterally,leaving,lon,long,longitudinal,lower,narrow,nflorescence,nther,orolla,pedicellar,pore,presen,present,puberulen,puberulent-pubescen,radiu,remnant,ruit,small,spaced,stamen,stone,stripe,swelling,tal,tem,thecae,time,tip,tomento,triangular,tube,ud,unit,vary,wide,yello,ympodial	1-2.5,abaxial,adaxial,anther,arrangement,capitate,colour,corolla,form,growth,height,history,inflorescence,leaf,life,number,ovary,perennial,plant,reproduction,seed,shape,spacing,surface,texture
299	wfo-0001027900	success	227	85	65	162	20	0.286	0.2–0.5,1.5–1.8,14–15,18–22,1–3,1–4,2.8,2–8,3,3.5–4.5,3–5,3–9.5,4–10,5-merous,8–15,abaxial,adaxial,adaxially,andromonoecious,anther,blue,capitate,cm,coriaceous,densely,diameter,extraaxillary,filament,flower,fruit,globose,green,hair,inflorescence,lanceolate,leaf,length,light,lighter,likely,maturity,mm,moderately,pedicel,peduncle,petiole,plant,powdery,pubescent,rachi,rotate-stellate,shrub,simple,slightly,small,stellate,stigma,style,surface,tree,unbranched,violet,yellow,×,–4	.1,.1–0.2,.1–0.3,.5,0,0.1–0.3,0.2–0.4,0–0.1,16–19,16–23,1–,2,2–3,3.5–4,3–8,5–,5–10,5–6,5–7.5,6–8.2,7–10,7–10+,7–15,7–17,7–8,9–25,abaxially,absent,abundant,abundantly,accrescent,acute,age,alyx,anthesi,apart,apex,armed,articulated,axe,ba,bark,base,becoming,beneath,berry,bilobe,blade,broad-based,brown,calyx,congested,connective,connivent,cordate,curved,cylindrical,db,deeply,deltate,difoliate,directed,discolorous,distally,dried,eaf,eed,either,enclosing,entire,equal,falcate,flowering,free,fresh,frui,fruiting,functionally,geminat,glabrous,glandular,golden-tan,grey-brown,half,hermaphroditic,heterstylou,interpetalar,like,lobe,lobed,long,long-stalked,longitudinal,lower,major,margin,membranaceous,midpoint,midvein,mixed,multangulate,multangulate-stellate,multiseriate,multiseriate-stalked,nearly,nflorescence,oblique,obtuse,often,older,one,opening,orolla,part,pore,porrect-stellate,prickle,pronounced,pubescence,ray,reddish-dark,reflexed,repand,roughened,ruit,runk,sessile,sharp,short,short-stalked,side,slit,smooth,spaced,sparsely,stalk,stalked,staminate,stellate-pubescen,stellate-pubescent,stem,stout,strongly,subtending,tamen,tan,tapered,thickened,time,tissue,tube,unarmed,unit,unknown,vary,vein,vestigial,wide,ympodial,young,–5,–6.2	arrangement,bilobed,colour,corolla,form,growth,height,heterstylous,history,life,na,number,ovary,position,reproduction,seed,shape,spacing,staman,texture
300	wfo-0001027901	success	156	91	64	92	27	0.41	.25,0.3-1.2,0.8-1,1-2.5,2.5-3,3-5,4-5,abaxial,abaxially,adaxially,anther,apex,area,base,berry,bright,broadened,brown,closely,cm,corolla,dark,dry,elliptic,filament,fresh,glabrous,globose,green,immature,inflorescence,leaf,lobe,lobed,material,minutely,mm,nearly,opposite,ovary,ovoid-reniform,papillose,pedicel,petiole,pitted,pubescent,ripe,shape,shiny,shrub,simple,slender,spaced,sparsely,stigma,style,surface,tip,translucent,trichome,uniseriate,white,x,yellow	.5,0.5-1,0.8-2,0.9-2.3,1-1.5,1-2,1.5-1.8,1.8-4.5,4-10-flowered,4.7-12,6-7,?,acuminate,acute,anthesi,attenuate,ba,bark,beneath,brow,calyx,conical,curled,deflexed,densely,dia,differing,difoliate,direction,drying,eaf,edicel,eed,ellipsoid,exserted,firm,fleshy,free,fruiting,geminat,imbedded,keeled,later,lateral,like,lon,long,lower,main,major,matrix,middle,midrib,minor,nflorescence,older,orbicular,oriented,overlappin,pair,papillo,planar,pore,poricidal,portion,prominently,reddish,reflexed,rest,rounded,ruit,scar,shaped,single,size,stem,straight,strongly,swollen,tall,tear-drop,triangular,tub,tube,ud,unit,usually,vein,widest,woody,ympodial,young	4-10,adaxial,arrangement,colour,diameter,flower,form,fruit,growth,height,history,length,life,na,number,overlapping,peduncle,perennial,plant,position,rachi,reproduction,seed,spacing,staman,texture,width
301	wfo-0001027902	success	128	80	52	76	28	0.406	-2.5,0.5-1,10-20,2-12,2-15,2-8,2-9,20-50,3-5,4-5,5-20,7-9,angled,apart,apex,articulated,base,branched,chartaceous,cm,densely,diameter,flower,forked,fruit,globose,margin,mm,moderately,ovate,pedicel,peduncle,petiole,puberulent,pubescent,purple,purplish,rachi,reticulate,shrub,simple,small,stellate,stigma,style,subcoriaceous,tree,truncate,unknown,whitish,x,yellow	1-1.5,1-2,1-6,1.5-3,10-15,15-30,2,2-3,3-4,3-foliat,4-25,6-37,8-13,abaxially,absen,acuminate,acute,adaxiall,adaxially,aggregate,axe,blade,calyx,cell,color,connivent,cordate,cylindrical,deeply,directed,distall,distally,eaf,eed,eglandular,entire,glabrous,glandular,hair,inflated,leaving,like,lobe,lon,long,lower,narrowly,nearly,nflorescence,nther,obtuse,orolla,pedicellar,pore,pubescen,radiu,remnant,ripe,ruit,spaced,sparsely,ste,stone,tal,tem,time,tip,triangular,truncat,tube,unbranched,unit,usually,vary,wide,ympodial	abaxial,adaxial,anther,arrangement,colour,corolla,filament,form,growth,height,history,inflorescence,leaf,length,life,na,number,ovary,plant,position,reproduction,seed,shape,spacing,staman,surface,texture,width
302	wfo-0001027920	success	228	97	75	153	22	0.329	0.1-0.5,0.5-1,1-2,1-4,1.4-2.5,1.5-3,11-28,12-25,2-5,20-40,3-5,3.5-4,4-11,4-7,7-11,7-18,8-12,almost,anther,apart,articulated,base,black,bristly,broadly,brown,campanulate,cm,coarsely,dark,densely,dentate,diameter,ellipsoidal,extra-axillary,flower,fruit,hair,hirsute,indument,inflorescence,leaf,length,lenticular,margin,minutely,mm,oblong,obovoid,orange,outline,ovate,pedicel,peduncle,perennial,persistently,petiole,pitted,prickly,pubescent,rachi,ripe,singled-stemmed,small,stellate,stellate-pubescent,stigma,style,surface,thin-textured,tree,unbranched,white,x,yellow	-25,-3,.1-1.4,0.1-0.2,0.2-0.8,1-2.5,1/5-1/3,12-18,17-25,2-,2-7,2-8,2-foliate,25-45,3.5-4.5,4-10,4-6,4-locular,4.5-7,5-7,8-18,8-30,abaxially,acicular,acute,acute-,acute-tipped,adaxiall,adaxially,along,apex,appressed,approximately,ascending,attenuate,axe,ba,basally,blade,bristle-like,bristly-hirsute,broad-based,bulbou,calyx,capitat,cauline,class,close,concealed,concentrated,connivent,cylindrical,deltoid,depressed-deltoid,descending,directed,distal,distall,distinct,divergently,eaf,eed,elongate,enlarging,entire,equaling,erect,female-sterile,few-branched,flesh,frui,geminat,glabrous,green,inserted,interlobal,intermixed,lanceolate,large,larger,lateral,less,lignescent,lobe,locule,long,long-stalked,longitudinal,lower,major,midpoint,minute,much,multiseriate,narrowly,nearly,nflorescence,obtuse,obtuse-tipped,occasionally,often,one,orolla,ovate-lanceolate,pair,per,persistent,pore,prickle,principal,proliferation,radiu,ray,receptacular,recurved,rigid,ruit,scattered,section,sessile,short,side,similar,simple,sinus,smaller,spaced,sparse,spreading,stalk,stalked,stella,stellae,stem,swollen,tal,tamen,tawny,tem,termination,time,trichome,truncate,tube,two,unit,usually,vary,vein,vestitur,weakly,wide,ympodial	abaxial,adaxial,capitate,colour,corolla,filament,form,growth,height,history,life,number,ovary,plant,position,reproduction,seed,shape,spacing,staman,texture,width
303	wfo-0001027929	success	193	103	76	117	27	0.394	1,1-10,1-4,10,2-3,2.0-3.0,3.5-5,4-30,4-5,6-15,along,apex,articulate,base,beyond,branched,cell,center,cm,corolla,covering,cyme,dark,darker-violet-blue,deep,diameter,dichasial,dichasially,distal,ebracteate,elliptic,except,filament,flower,forked,glabrous,globose,green,green-white,hair,hair-like,half,herbaceous,lanceolate,lateral,light,mm,monochasial,narrowly,occasional,odd-pinnate,ovate,ovoid,pedicel,peduncle,perennial,plant,puberulent,purple,rhizomatous,rotate,seed,shape,sometimes,spot,stigma,style,testal,thick,tinged,usually,vein,violet,violet-blue,wall,yellow	0.2-0.9,1-8,1.0-1.3,1.5-4,15,2,20,3-6-foliat,35,4-6,5-10,5-6,5-lobed,abaxially,acumen,acuminate,acute,adaxially,angular,apical,apically,apiculate,ba,basal,becoming,calyx,caudate,cente,clasping,coat,color,connate,cordate,cuneate,decreasing,dehiscent,digestion,eaf,eed,embryo,emoval,enzyme,erect,exceeding,formed,generally,globo,honeycomb,included,interjected,introrse,leaflet,living,lobe,lon,long,lower,make,maturing,middle,mostly,mucilaginous,nearly,nflorescence,nther,obliquely,oblong,often,orolla,pair,pattern,pentagonal,perfect,petiolate,petiolulate,petiolule,poricidally,purpl,radiating,rarely,reduced,reveal,rhizome,rotate-,rounded,ruit,semi-lunate,sessile,seudostipule,short,size,slightly,slit,somewhat,specimen,stamen,star,ste,straight,subequal,symmetrically,tem,terete,terminal,tip,trailing,typically,unbranched,unit,vary,visible,white,wid,wide,wider,without,ympodial	abaxial,adaxial,anther,arrangement,colour,form,fruit,growth,height,history,inflorescence,leaf,length,life,na,number,ovary,petiole,position,rachi,reproduction,rotate-pentagonal,spacing,staman,surface,texture,width
304	wfo-0001027930	success	210	90	68	142	22	0.324	-2,0-0.5,0-0.7,0-2,0.2-0.4,0.4-1,0.4-1.5,2-10,2-2.5,3-3.6,3.5-5.5,4.5-6.5,6-13,acute,adaxially,andromonoecious,anther,apex,articulated,base,chartaceous,cm,densely,diameter,erect,extra-axillary,filament,flower,fruit,glabrous,gland-tipped,globose,green,hair,inflorescence,leaf,length,lilac,linear,linear-hastate,mm,obtuse,pale,pedicel,peduncle,perennial,perfect,petiole,plant,rachi,red,rhizomatous,scattered,short,shrub,simple,sparsely,stellate,stellate-pubescent,stigma,strongly,style,unbranched,weakly,white,x,yellow,yellowish	%,.1,.4,0,0-0.8,0-1,0-4,0.05-0.7,0.2-0.7,0.2-1.2,0.25-0.35,0.25-0.4,0.3-0.5,0.4-0.8,0.5-0.6,0.5-1,0.6-0.9,0.7-1.5,0.8-1.2,1-2,1-4,1-locular,13-16,15-60,2-3,2-6,2-9,2-foliate,3-12,3-7.5,4-,4-8,5-merou,6-12,6-8,7-12,7-8,8-20,9-13,9-26,abaxially,absen,absent,acicular,across,adaxiall,adult,alyx,and/or,apart,apparen,axe,ba,basal,blade,branch,branche,brown,calyx,capitat,confined,connivent,cuneate,cylindrical,decimetre,deltate,directed,distall,distributed,dm,eaf,eed,eglandular,entire,exocarp,finger,fruiting,functional,geminat,grey,half,hastate,heterostylous,homo-,incomplete,interpetalar,juicy,juvenile,lamina,lanceolate,lateral,less,lobe,long,longer,loosely,lower,margin,mature,mesocarp,mid-point,midpoint,midrib,midvein,minute,moderately,narrowly,nflorescence,oblique,orolla,part,per,placenta,pore,porrect,present,prickle,ray,rostrate,ruit,septum,sessile,spaced,sparse,stellae,straight,succulent,tal,tamen,tem,thick,throughout,time,tissue,triangular,tube,unarme,unarmed,unit,vary,wide,ympodial	abaxial,adaxial,arrangement,capitate,colour,corolla,form,growth,height,history,life,na,number,ovary,position,reproduction,seed,shape,spacing,staman,surface,texture
305	wfo-0001027943	success	208	98	74	134	24	0.356	-4,0.2-2,0.5-1,0.5-1.5,0.5-4,0.5-6,1-1.5,1-3,1-4,1-5,2-3,3-15,4-20,5-9,7-10,abaxially,adaxially,anther,apart,apex,brown,cm,densely,diameter,elliptic,elliptic-ovate,extra-axillary,ferruginous,filament,flattened,flower,forked,fruit,glabrescent,glabrous,glandular,globose,green,inflorescence,leaf,mature,minutely,mm,moderately,nearly,outline,pedicel,peduncle,petiole,plant,pubescent,rachi,reniform,ripe,rugulose,shrub,simple,smooth,sparsely,stellate,stellate-pubescent,stigma,strongly,style,surface,tan,truncate,turning,unbranched,white,whitish,x,yellow,young	-1.5,.1,.5,0,0.3-0.5,0.8-1.5,1.5-3,10-15,2-10,2-14,2-2.5,2-3-lobed,2-4,3-20,3-8,4-6,4-7,5-8,5-merou,6-.,7-15,accrescent,acute,ag,alyx,andromonoecious,armed,articulated,axe,ba,base,berry,blade,broad,broad-based,brownish,calyx,capitat,chartaceous,coarsely,connivent,covering,curved,cylindrical,difoliate,directed,distally,eaf,eed,entire,equal,erect,free,frui,fruiting,geminat,gland-tipped,hair,half,heterostylous,homo-,initially,interpetalar,interspersed,interwoven,like,linear-acuminate,linear-apiculate,lobe,long,longitudinal,lower,major,margin,membanaceous,midline,midpoint,midrib,narrowly,nflorescence,numerous,oblique,obtuse,often,opening,orolla,part,perfect,pericarp,pore,porrect-stellate,prickle,rarely,ray,recurved,reflexed,rounded,ruit,sessile,shallowly,short,short-stalked,side,sinus,slightly,slit,small,somewhat,spaced,sparse,splitting,staminate,stem,straight,subtending,tamen,tapered,tem,thi,time,tip,tissu,tissue,toward,triangular,tube,unarme,unarmed,unit,vary,vein,wide,woody,ympodial	5-merous,abaxial,adaxial,arrangement,capitate,colour,corolla,form,growth,height,history,length,life,membranaceous,na,number,ovary,position,reproduction,seed,shape,spacing,staman,texture
306	wfo-0001027944	success	175	66	42	133	24	0.24	0-0.3,0.4-0.8,1-2,3-4.5,4-7,5-7,7-20,acute,anther,apex,chartaceous,cm,densely,diameter,extra-axillary,flower,fruit,glabrous,globose,green,inflorescence,lanceolate,lavender,length,mm,ovate,pale,pedicel,peduncle,perennial,petiole,pseudo-racemose,red,rusty,shrub,stellate,stellate-pubescent,stigma,style,unbranched,yellow,yellowish	%,.8,0-4,0.1-0.2,0.2-0.3,0.2-0.4,0.25-0.4,0.3-0.4,0.4-0.5,0.5-0.8,0.5-1,0.5-1.2,0.9-1.2,1-1.2,1-3,1-locular,1.5-2,13-16,15-23,2-3,2-4.5,2-6,2-foliate,2.5-5.2,3-20,3-3.5,3-4,3-5,3-7,5-merou,7-8,7.5-14,abaxially,absen,absent,acicular,across,adaxiall,adaxially,adult,alyx,apart,apparen,articulated,axe,ba,base,blade,branche,brown,calyx,capitat,confined,cuneate,cylindrical,deltate,directed,distall,dm,eaf,eed,eglandular,entire,erect,exocarp,finger,fruiting,geminat,gland-tipped,hair,half,incomplete,index,juicy,lamina,lateral,less,lobe,lobed,lobing,long,longer,lower,margin,mature,mesocarp,mid-point,midpoint,midrib,minute,nflorescence,oblique,obtuse,orolla,part,per,perfect,placenta,pore,porrect,present,prickle,ray,rhizomatous,ruit,septum,sessile,shallowly,short,side,simple,spaced,stage,stellae,straight,succulent,tal,tamen,tem,thick,throughout,time,tube,unarme,unarmed,unit,unknow,uvenile,vary,white,wide,x,ympodial	abaxial,adaxial,capitate,colour,corolla,filament,form,growth,height,history,leaf,life,number,ovary,plant,position,reproduction,seed,shape,spacing,staman,surface,texture,unknown
307	wfo-0001027948	success	186	68	40	146	28	0.215	0.5-2,1-1.2,1.3-1.8,1.5-4.5,3.7-4,7.5-10,abaxially,adaxially,anther,apex,campanulate,cm,corolla,diameter,elliptical,filament,globose,herb,leaf,length,light,margin,mm,narrowly,non-glandular,ovate,ovoid,petiole,pubescence,pubescent,purple,seed,simple,stigma,style,sub-shrub,tip,trichome,violet,x	-15,-16,-6,.5,0-,0.4,0.5-0.7,0.6,0.8-,1-2,1.2-2.2,1.6,1/10,10-14,13,14,2-,2.2-,2.5-,3-8.2,3.2-5.2,3.5,5,5-,6-celled,7,7-15,8-celled,abundant,accrescen,acuminate,ag,aggregate,antrorse,ape,articulate,attenuate,ature,basal,base,berry,bicellular,branch,c.,calyx,cell,connectival,crushed,cuticle,dark,delicate,diamete,difoliate,directed,dorsally,eaf,edentate,ellipsoidal,erect,finely,flexuous,fragrance,free,fruiting,generally,glabrous,glandular,head,herbaceous,hig,hollow,ill-smelling,inconspicuous,inserted,lamina,lobe,long,long-stalked,longer,longitudinal,longitudinally,lower,many-,midvein,narrow,near,occasionally,odorles,opening,orolla,pair,papillate,patent,pericarp,pore,poricidal,portion,prolongation,reduced,ree,ridged,ruit,saddle-shape,scarce,scarcely,secondary,seeded,seen,separated,serrulate,short-stalked,shorter,single-celled,sinus,slightly,slit,small,smooth,solitary,spur-like,stalk,stem,stone,straight,striat,striate,sub-opposite,tem,thecae,thickened,time,tooth,triangular,tube,twice,unequal,unit,upward,vary,vein,ventrifixed,verrucate,viscid-pubescent,ympodial,¼,½	abaxial,adaxial,arrangement,colour,flower,form,fruit,growth,height,history,inflorescence,life,na,number,ovary,pedicel,peduncle,plant,position,rachi,reproduction,saddle-shaped,shape,spacing,staman,surface,texture,width
308	wfo-0001027961	success	177	101	74	103	27	0.418	0.5-1,1-1.5,1-5,1-9,10-50,2-2.5,2.3-2.5,3-3.5,4.5-5,8-10,?,abaxially,anther,apex,base,berry,branched,c.,clavate,cm,corolla,curling,densely,diameter,elliptic,fading,filament,flower,glabrous,globose,green,growth,immature,inflorescence,lateral,lobed,many,maturity,membranous,minutely,mm,obovate,occasionally,one,other,pedicel,peduncle,petiole,pinnatifid,probably,pubescent,purple,rotate-stellate,shiny,simple,slender,sparsely,stigma,style,surface,terminal,time,triangular,trichome,twining,uniseriate,vine,violet,way,white,white-pubescent,woody,x,yellow	.5,0.25,0.25-0.5,0.9-1,1,1-3,1-4,2.5-9,5-8,5-merou,6-9,7-9,<,acute,adaxiall,adaxially,age,always,alyx,anthesi,apar,ark,articulated,asymmetric,axil,broadly,brow,calyx,clear,conical,connivent,cordate,deltate,distributed,eaf,early,eed,ellipsoid,entire,equalling,exserted,free,fruiting,fusiform,geminat,ilament,irregularly,lamina,lengthening,lobe,lon,long,loosely,lower,margin,mature,midrib,minute,new,nflorescence,observed,often,older,orolla,pair,papillo,pendan,perfect,pericarp,pinched,planar,plurifoliate,pore,poricidal,portion,present,primary,pubescen,reddish,ruit,scar,sleeve,slightly,slit,small,spaced,spreading,stem,tem,thin,tip,transition,truncate,tube,tuft,twinin,ud,unequal,unit,upper,vary,vein,ympodial	5-merous,abaxial,adaxial,apart,arrangement,colour,form,fruit,height,history,leaf,length,life,na,number,ovary,papillose,plant,position,rachi,reproduction,seed,shape,spacing,staman,texture,width
309	wfo-0001027965	success	265	96	78	187	18	0.294	.7,.9,0.4,0.5,0.8-1.6,1-8,1.2,1.5-2,2-2.5,2-3.5,3.5,abaxial,adaxial,along,anther,apex,berry,branch,branched,brown-green,capitate,chartaceous,clavate,clustered,cm,corolla,densely,diameter,discolorous,distributed,drying,dull,evenly,fasciculate,filament,filiform,finely,flattened,flower,fruit,glabrous,green,grey-brown,inside,lateral,leaf,length,liana,lobed,mm,oblong,orange,orange-brown,outside,ovate,pale,pedicel,peduncle,petiole,pitted,pubescent,rachi,red-brown,reniform,rounded,shiny,shrub,somewhat,spheroidal,stellate,stellate-pubescent,stigma,style,surface,tip,toward,wrinkled,x	-2,.1,.2,.25,.3,.5,/3,0.1-0.2,0.15,0.15-0.3,0.2,0.3,0.4-0.5,0.5-3,0.6-0.9,0°,1,1-2,1.5-2.5,1.5-3.2,1/3-1/4,1/3-2/3,1/4-1/3,2-3,2-4,2.2-2.6,2.8-3.3,3.5-10,4-7,4-merou,4.5,6-9,7-8,abaxially,absent,accrescent,acicular,acuminate,acute,adaxially,adjacent,age,almost,alternate,alyx,ame,anthesi,apar,ape,apically,apparently,armed,articulated,bark,base,becoming,beneath,brown,c.,calyx,canaliculate,cordate,covered,cupular,curved,deltoid,dense,density,detaching,development,divided,dry,eaf,early,eed,ellipsoi,elongated,entire,equal,erect,even,except,extending,fairly,fissure,flat,flexuous,forming,free,fruiting,glabrescent,increasing,indumentum,leave,lengt,lengthening,less,like,lobe,long,loop,lower,m.,main,mature,maturity,midpoint,midvein,minor,mixture,nflorescence,nther,obconical,oblique,occasional,often,orolla,pair,papillose,patch,pendulous,perfect,pericarp,pit,plurifoliat,pore,poricidal,porrect,portion,present,prickle,primary,protruding,raised,ray,reduced,regular,remnant,ridged,ruit,scar,series,sessile,short,simple,sinus,small,smooth,sometimes,sparse,sparsely,spreading,stalk,stalked,stem,straight,strongly,stump,tapering,tearing,terete,tertiary,thin,throughout,translucent,transverse,trichome,tube,ud,unarme,unarmed,underneath,unequal,uneven,unit,usually,variable,vary,vein,venation,visible,white,wide,widening,ympodial,young,youngest	arrangement,colour,form,growth,height,inflorescence,na,number,ovary,plant,position,reproduction,seed,shape,spacing,staman,texture,width
310	wfo-0001027966	success	207	78	52	155	26	0.251	1-10,1-2,1-4.2,1-5,10-30,2.2-2.9,3-4,40-80,5-10,5-6,5-9.5,abaxially,adaxially,anther,apex,blue-violet,chartaceous,cm,conical,corolla,densely,diameter,elliptic,filament,flower,forked,fruit,glabrous,green,greenish,herb,leaf,light,medium,membranous,mm,odd-pinnate,ovate,ovoid,pedicel,peduncle,pentagonal,petiole,plant,pubescent,purple,rotate,seed,stigma,terminal,whitish,yellow	0.4-0.5,0.7-3,0.8,0.8-2.5,1-1.8,1-3,1.2-4.5,1.3-2.2,1.5-3,1.5-5.2,10,2.5-10.5,2.8-9,3-5,3-7,4,5-merou,5.5-14,6-11,absent,acumen,acuminate,ag,along,alyx,apart,apparently,arranged,articulated,asymmetrical,attenuate,axe,axillary,base,basiscopic,bead,berry,blade,brownish,bud,capitat,cell,ciliate,commonly,condition,connivent,covering,decreasing,digestion,distal,dorsally,drying,eaf,edge,eed,enzyme,erec,especially,exceeding,flat,folded,fresh,geminat,generally,glabrou,gradually,green-white,hair,hair-like,half,homostylous,honeycomb-shaped,interjected,lanceolate,larger,lateral,leaflet,lengthening,less,like,living,lobe,long,lower,make,margin,middle,minute,moniliform,mottled,mucilaginous,multiple,narrow,necklace,nflorescence,orbicular,orolla,pair,pale,perfect,petiolule,plurifoliate,pore,poricidal,proximal,rarely,ray,removed,ripe,ruit,secondary,semierect,sessile,seudostipule,shorter,side,size,slightly,slit,somewhat,spaced,sparsely,specimen,stamen,ste,stem,stolon,straight,subequal,subsessile,subtending,symmetrical,tall,tamen,tem,testal,thick,throughout,tip,tissue,tri-,tube,tuber,tyle,typically,unit,usually,violet,wall,wet,white,wide,wing,x,ympodial	abaxial,adaxial,arrangement,capitate,colour,form,growth,height,history,inflorescence,length,life,na,number,ovary,perennial,position,rachi,reproduction,shape,spacing,staman,style,surface,texture,width
311	wfo-0001027978	success	197	98	79	118	19	0.401	0.5-1,1-1.5,1-2,1-6,1.5-2.5,10-14,2.5-5.5,3-5,3-6,4-10,4-6,5-8,6,7-10,7-9,abaxial,absent,acute,adaxial,andromonoecious,anther,apex,becoming,brown,chartaceous,cm,dark,densely,diameter,extra-axillary,filament,flower,fruit,functionally,glabrous,globose,green,hair,hermaphroditic,immature,initially,leaf,length,lilac,lobed,male,many,mature,mm,moderately,nearly,netlike,orange-red,ovary,ovate,pedicel,peduncle,petiole,pit,plant,pubescent,rachi,raised,ridge,round,scattered,separated,shrub,simple,small,stellate,stigma,style,surface,unbranched,white,wide,x,yellow	0.2-0.5,0.5-1x,1,1-3,1.5,1/6,11,2-2.5,2-3,2.5-3,20-40,4-5,4-8,6-10,8-12,abaxially,absen,accrescent,adaxially,along,alyx,andormonoeciou,apar,apical,apparently,armed,asymmetrical,attenuate,axe,base,berry,beyond,blade,calyx,connivent,cordate,cut,cylindrical,difoliate,directed,discolorous,distal,eaf,eed,either,end,entire,except,exserted,filiform,flattened,frui,fruiting,geminate,glabrou,gree,heteromorphic,introrsel,less,like,lobe,long,lower,major,margin,midpoint,midrib,midvei,midvein,multicellular,multiseriate,narrowly,nflorescence,obtuse,occasionally,often,orange,orolla,pair,per,pore,porrect-stellate,prickle,proximal,ray,recurved,reflexed,roselike,ruit,scandent,short,side,sinus,slightly,spaced,sparsely,stalk,stamen,staminate,ste,stem,straight,tamen,tan,tapering,tem,thin-skinned,triangular,tube,unarmed,unequa,unicellular,unit,vary,vegetatio,vein,way,ympodial	apart,arrangement,colour,corolla,form,growth,height,history,inflorescence,life,number,perennial,position,reproduction,seed,shape,spacing,staman,texture
312	wfo-0001027997	success	174	82	53	121	29	0.305	.2,.5,.6,0.2-2,0.9-1,1-4,1.5-1.7,anther,apex,becoming,bi-lobed,black,cm,corolla,densely,dirty,dry,filament,glabrous,globose,green,greenish-yellow,inflorescence,leaf,live,lobed,minutely,mm,obovate,opposite,ovary,ovoid-reniform,pale,pedicel,petiole,pitted,plant,pubescent,ripe,shrub,simple,small,sparsely,specimen,stigma,style,surface,tan,tapering,tree,trichome,uniseriate,white	.1,0.1-0.7,0.1-0.8,1,1-2,1.5-1.8,1.5-2,10-20-flowered,10-23,2,3.5-10,7-10,7/8,abaxially,acute,along,anthesi,apar,attenuate,auriculate,ba,bark,base,beneath,berry,blade,breaking,bright,brittle,calyx,consisting,corky,decurrent,deflexed,deltoid,dense,denser,dia,distal,eaf,edicel,eed,entire,erect,even,evenly,exserted,free,fruiting,glabrate,impressed,inflorescenc,keel,keeled,later,lateral,like,living,lobe,long,long-acuminate-triangular,long-ellipsoid,lower,main,margin,middle,nflorescence,occasionally,often,old,older,onto,ovoid,pair,papillose,partially,planar,pore,poricidal,portion,prominent,pubesent,raised,reddish-brown,remaining,rest,ribbed,ruit,scar,scattered,sessile,shaped,short,slender,slightly,soft,somewhat,soon,spaced,stem,straight,strongly,tall,tear-drop,tip,trunk,tube,ud,ultimately,unifoliat,unit,vasculature,vein,way,widest,wing,winged,woody,x,ympodial,young	10-20,abaxial,adaxial,apart,arrangement,colour,diameter,flower,form,fruit,growth,height,history,length,life,na,number,peduncle,perennial,position,rachi,reproduction,seed,shape,spacing,staman,texture,unifoliate,width
313	wfo-0001028014	success	222	90	67	155	23	0.302	-15,-2.5,/5,0.2-1,0.2-1.6,0.5-1,0.5-1.5,0.7-1,0.9-1.2,1-4,1.3-2.4,2-20,2-6.5,4.5-7,5-merous,abaxially,almost,anther,apart,apex,apparently,articulated,base,berry,black,brown-green,cm,densely,diameter,erect,filament,flattened-reniform,flower,fruit,glabrous,gray-green,lateral,leaf,length,lobed,maturity,mauve,mm,moderately,obtuse,orange,ovate,pedicel,peduncle,petiole,purple,red,rough,rounded,seed,shiny,shrub,simple,smooth,spherical,stellate-pubescent,style,surface,terminal,visibly,way,yellow-green	-0.5,-1,-1/2,-10,-3,-4,-5,-6,.5,0,0.1-0.2,0.15,0.15-0.3,0.2,0.2-0.4,0.25,0.3-0.4,0.5,0.5-2,0.5-3,0.6-0.9,0.7-1.6,1-,1-10,1-2,1-3,1.5,1.5-2,1.8-3,1/4,1/4-2/3,2,2-3,2-4.5,2.5-4,3-10,4-10,6-10,6-11,acuminat,alyx,ame,apar,apically,around,bark,blade,branched,broad-deltate,brown,c.,calyx,cell,chartaceous,concolorous,connivent,cordate,curved,decurrent,deltate,difoliate,discolorous,distance,drying,eaf,edge,eed,elongating,equal,extending,eye,flattened,free,fruiting,geminat,glabrescent,glabrou,gland,globular,gray,herbaceous,infructescence,lobe,lon,long,longer,lower,margin,mature,membranous,midpoint,midvein,naked,nflorescence,occasionally,older,one,open,orange-gra,orolla,oung,outer,outline,pair,pale,pendulous,per,perfec,pericarp,pit,poricidal,porrect,portion,prickl,prickle,prickly,primary,raised,ray,reduced,reflexed,ruit,scandent,scar,sessile,shorter,side,slender,sometimes,spaced,spreading,stalk,stalked,stellate,stem,straight,strongly,tamen,tapering,terete,tertiary,time,tip,trichome,tube,unit,vary,vein,venation,visible,weakly,wide,winged,yellow,ympodial	abaxial,adaxial,arrangement,colour,corolla,form,growth,height,history,inflorescence,life,na,number,ovary,perennial,plant,position,reproduction,shape,spacing,staman,stigma,texture
314	wfo-0001028017	success	158	92	60	98	32	0.38	0.3-1,1-10,1-3,1.5-2,15-35,2-4,2.5-5,3-12,3-14,5-7,6-8,apex,articulated,base,brown,chartaceous,clavate,cm,densely,diameter,eglandular-puberulent,eglandular-pubescent,ellipsoidal,elliptic,flattened,flower,forked,fruit,fusiform,glabrous,glandular-,glandular-puberulent,green,greenish,immature,mm,moderately,near,ovate,pedicel,peduncle,perfect,petiole,purplish,rachi,rarely,ripe,simple,sparsely,stellate,stellate-campanulate,stigma,style,subcoriaceous,tree,truncate,unbranched,white,x,yellow	-2.5,1,1-2,10-22,13-40,15-50-flower,2,2-3,3,3-4,3-foliat,40-50,5,5-9,6-7,9-11,abaxially,absen,absent,acuminate,acute,adaxially,aggregate,apart,ape,apiculate,axe,basal,beyond,blade,calyx,cell,ciliat,connective,connivent,cream,cuneate,cylindrical,directed,distally,eaf,eed,eglandular,entire,exceeding,exserted,fleshy,glandular,hair,introrse,lanceolate,leaving,lobe,lon,long,lower,margin,narrowly,nflorescence,nther,oblique,obtuse,orolla,ovoid,pedicellar,pointed,pore,puberulen,pubescent,purple,radiu,remnant,ruit,short-acuminate,shorter,slightly,small,sometimes,spaced,stamen,stone,tal,tan,tem,thecae,time,tip,tomentose,triangular,truncat,tube,ud,unit,vary,vein,wide,without,ympodial	1-2.5,15-50,abaxial,adaxial,anther,arrangement,colour,corolla,filament,form,growth,height,history,inflorescence,leaf,length,life,na,number,ovary,perennial,plant,position,puberulent,reproduction,seed,shape,spacing,staman,surface,texture,width
315	wfo-0001028025	success	182	73	45	137	28	0.247	.8,0,0.1-2.2,1.6-3.5,12-17,2-6,2.5-4,5-,6-,7-13,9-14,anther,apex,chartaceous,cm,cordate,diameter,extra-axillary,flower,fruit,glabrous,globose,green,inflorescence,lavender,length,lobed,mm,obtuse,ovate,pale,pedicel,peduncle,perennial,petiole,pseudo-racemose,shallowly,shrub,sparsely,stellate,stellate-pubescent,style,white,yellow,yellowish-green	%,0-0.5,0-11,0.15-0.25,0.2-0.3,0.2-0.7,0.3-0.8,0.3-1,0.4-3,0.5-0.7,0.9-1.2,1-1.4,1-8,1.1-1.4,1.4-2.2,1.5-7,1.9-2.4,10-140,11-18,13-21,16-23,2-2.3,2-locular,3-5,3-6,3.5-4.5,4-10,4-8,5-11,5-20,5-7,50-90,6.5-10,7-8,7-9,abaxially,absen,absent,acicular,across,acute,adaxiall,adaxially,alyx,anvil-shape,apart,armed,articulated,attenuate,axe,ba,base,blade,broad-based,brown,calyx,cross-section,cylindrical,d.,directed,distall,distributed,dult,eaf,eed,eglandular,erect,exocarp,finger,fruiting,gland-tipped,hair,half,hig,index,juicy,lamina,lateral,less,lobe,lobing,lon,long,longer,lower,margin,mature,merou,mesocarp,mid-point,midpoint,midvein,minute,moderately,moist,nflorescence,oblique,onl,orolla,part,per,perfect,placenta,pore,porrect,present,prickle,ray,rhizomatous,ridged,ruit,sessile,short,side,simple,spaced,stage,stalked,stellae,stem,straight,tamen,thick,throughout,time,transparent,tube,unarmed,unbranched,unit,unknow,uvenile,vary,vein,wide,x,ympodial	abaxial,adaxial,colour,corolla,filament,form,growth,height,history,leaf,life,merous,na,number,ovary,plant,position,rachi,reproduction,seed,shape,spacing,staman,stigma,surface,texture,unknown,width
316	wfo-0001028033	success	157	80	53	104	27	0.338	1.4–1.8,1–4,2–4,4–12,4–5,50,6–12,anther,apex,attenuate,base,brown,chartaceous,cm,cyme,darker,decurrent,diameter,elliptic,filament,flower,fruit,glabrous,green,greenish,growth,herb,lateral,length,light,like,membranaceous,mm,nearly,pedicel,petiole,pubescence,pubescent,rhizomatous,shiny,simple,slightly,solitary,sparsely,stellate,stem,stigma,style,surface,unbranched,white,woody,yellow	.6,1.5,1–5,2–3,2–foliate,3,3–11,3–4,3–5,5-merou,5–7,abaxially,acuminate,acute,adaxiall,adaxially,along,alyx,anthesi,ark,ascending,becoming,blade,branch,brochidodromous,calyx,capitat,cell,ciliate,connivent,contiguou,cordate,cylindrical,deeply,densely,denser,directed,discolorous,drying,eaf,eed,emarginate,entire,equal,eye,few-branched,florescence,geminat,glabrescent,high,hispid-pubescent,introrsely,know,known,linear-lanceolate,lobe,lobed,long,longitudinal,lower,mainly,margin,midrib,naked,new,oblong,older,onto,opening,order,orolla,ovate-lanceolate,perfect,pore,poricidal,prominent,prostrat,recurved,ruit,secondary,sessile,shin,shorter,shrub,slit,spreading,straight,strongly,subapical,tamen,tem,trichome,tube,uniseriate,unit,unknown,upright,vary,vein,venation,visible,wide,ympodial,×	5-merous,abaxial,adaxial,arrangement,capitate,colour,contiguous,corolla,form,height,history,inflorescence,leaf,life,na,number,ovary,peduncle,plant,position,rachi,reproduction,seed,shape,spacing,staman,texture
317	wfo-0001028035	success	172	85	47	125	38	0.273	1,1.3-1.8,1.5,1/4-1/3,3-6,4.2-5.5,5-10,7-10-flowered,annual,anther,blade,brown,calyx,capitate,cm,dark,diameter,flattened-ovoid,flower,foveolate,fruit,glabrous,herb,internodal,leaf,long,minutely,mm,oblong,ovate,pedicel,pentagonal,petiole,pinnatifid,prickle,reticulately,seed,slightly,spherical,stellate-pubescent,stem,stout,surface,twice,undulate,wrinkled,yellow	2,2.5-3.1,2.5-4,2/3,3,3.7-4.2,4-8,5,50-90,6-13,7-10,9-13,accrescent,acicular,across,almost,along,alyx,ample,anthesi,apically,armed,base,berry,bristle,bristly,broad,broad-based,broadly,campanulate,cauline,closely,confluent,congested,da,dark-based,deep,densely,developing,dia,difoliate,distinct,divided,dry,eaf,erect,exceeding,externall,felty,flattened,geminat,hardly,hilum,incurved,interpetalar,invested,lanceolate,lobe,lon,long-rayed,m.,main,markedly,maturity,midpoint,n,narrowly,nflorescence,notch,noticeably,numerous,often,one,orolla,other,per,pigmentation,plicate,prickly,prominent,purple,ray,reaching,recurved,red,rounded,ruit,scattered,short,shorter,slende,sometimes,somewhat,spaced,splitting,spreading,stalk,stellae,stellate,stellate-wooll,styl,suffused,sunken,symmetrically,tall,tamen,tapering,taprooted,terminal,tightly,tigma,tissue,tub,tube,tyle,ultimate,unit,upper,usually,vary,vein,well,wide,yello,ympodial	abaxial,adaxial,apex,arrangement,bark,bud,cell,center,colour,corolla,filament,form,fruiting,growth,height,history,inflorescence,length,life,margin,na,new,number,ovary,peduncle,plant,position,rachi,reproduction,scar,shape,spacing,staman,stigma,style,texture,trichome,width
318	wfo-0001028044	success	195	86	62	133	24	0.318	.9,0.3,0.4-0.5,1.2-1.4,1.3-2.2,1.4-1.6,1.5-2,19-22,2-3,2.8-3.3,20-21,3-4,3-6,50,abaxial,anther,apart,apex,articulated,attenuate,base,black,branched,brown,cm,corolla,creamy,dark,diameter,drying,filament,flower,fruit,glabrate,globose,green,greenish,leaf,length,long,many,mm,obovate-elliptic,pedicel,peduncle,petiole,pubescent,rachi,seed,shrub,simple,sparsely,stellate,stigma,style,surface,thin-textured,time,unknown,white,x,yellow	-3.5,-5,.6,1/3-1/2,11-13,11-16,16,2-4,2.7-4,3.4-4.3,3.5-4.6,31-46,4-5,5-merou,6-8,6.5-7.2,7.5-9,9.5-13,abaxially,accrescent,acute,adaxiall,adaxially,ag,along,alyx,anthesi,around,ature,axe,axillary,becoming,berry,blade,blunt-tipped,branch,bud,bulbous-based,calyx,capitat,closely,concentrated,connivent,cylindrical,decurrent,dendritic,directed,distally,eaf,edge,entire,except,exserted,few-rayed,fleshy,frui,fruiting,geminate,glabrescen,glabrous,hair,high,homostylous,immature,lackin,lateral,lengthening,lobe,lobed,long-attenuate,long-stalked,longitudinal,lower,main,margin,midrib,moderately,mostly,much,multangulat,multangulate,nearly,nflorescence,oblong,obscured,obtuse,occur,orolla,ovate-lanceolate,pale,plurifoliate,pore,poricidal,porrect-stellate,presumably,rather,resorption,rough-granular,ruit,runk,semi-obtuse,side,slender,slit,somewhat,spaced,sparse,stalked,stamen,subcampanulate,suture,tamen,terete,thick,thick-stalked,tip,tissue,tomentose,tomentu,tube,unarme,unbranched,unit,vary,vein,way,weakly,wide,winged,yellow-brown,yellowish,ympodial,young	0.6,adaxial,arrangement,capitate,colour,form,glabrescent,growth,height,history,inflorescence,life,na,number,ovary,perennial,plant,position,reproduction,shape,spacing,staman,texture,width
319	wfo-0001028046	success	186	89	68	118	21	0.366	0.5-1,1-1.5,1-7,12-13,2-3,2.5-3,20,3-12,4-5,8-9,abaxially,acute,anther,apex,approximately,attenuate,blue,brown,clavate,cm,corolla,cylindrical,densely,diameter,elliptic,filament,flattened,flower,glandular,globose,green,growth,inflorescence,leaf,length,like,lilac,long-styled,mm,obovate,opposite,ovary,pedicel,peduncle,petiole,pubescent,reniform,rest,rusty-red,scabrous,short-styled,shrub,simple,slightly,spaced,stellate,stem,stigma,style,sub,subglobose,subhirsute,surface,tomentose,trichome,truncate,unevenly,x	0.2-0.3,0.3-0.5,0.4-0.5,1-1.3,1-multicellular,1.2-1.5,1.5-2,10,10-15,13-38,2-4,5-18,6-7,acuminate,adaxially,anthesi,armed,articulated,bark,basal,base,berry,c.,calyx,campanulate,chartaceous,compressed,coriaceous,dark-brown,decurrent,deflexe,denser,difoliat,distal,eaf,eed,entire,erect,exserted,foliaceous,foveolate,free,fruiting,glabrescent,glabrous,gland-tipped,grayish,half,heterostylous,lanceolate-subulate,large,lengthening,lightly,lobe,lobed,long,lower,margin,midpoint,minute,minutely,mixed,multangulate,multicellular,nearly,new,nflorescence,obverse,occasionally,older,ovoid,papillo,per,perfect,pericarp,pore,poricidal,porrect,portion,prickle,prickly,prominent,pubescence,raise,ray,red,reduced,reflexed,rigid,ruit,rusty,scar,sessile,slit,somewhat,sparse,sparsely,stalked,staminate,subcordate,subscandent,subsessile,tall,tapering,testa,thick,tip,tomentose-scabrous,tube,ud,unarmed,unicellular,unit,upper,winged,yellow,ympodial,¼	abaxial,adaxial,arrangement,colour,form,fruit,height,history,life,na,number,plant,position,rachi,reproduction,seed,shape,spacing,staman,texture,width
320	wfo-0001028059	success	221	89	69	152	20	0.312	-4.5,0-1.2,0-2,0.5-0.7,0.5-1.3,1,1-3,1.5-2,2-10,2-3,2.5-2.6,2.5-3.5,4.5-7,5-9,8.5-10,adaxially,andromonoecious,anther,apex,articulated,base,brownish,chartaceous,cm,contiguous,cylindrical,densely,diameter,elliptic,erect,filament,flower,fruit,glabrous,glandular,globose,green,hair,inflorescence,leaf,leaf-opposed,length,lilac,mm,nearly,oblate,ovate,pale,pedicel,peduncle,perennial,petiole,plant,pseudo-racemose,purple,rachi,rhizomatous,shrub,sparsely,stellate,stellate-pubescent,style,surface,toward,unbranched,weakly,x,yellow,yellowish-green	%,.4,0-0.2,0-0.3,0-15,0-7,0.1-0.3,0.1-0.6,0.1-0.7,0.4-0.7,0.4-0.8,0.4-0.9,0.5-0.8,0.6-0.8,0.6-1,1-1.5,1-2,1.1-12,1.1-4.5,1.5-2.1,1.5-3.5,15,2-2.6,2-5,2-foliate,2-locular,2.1-2.7,2.5-12,3-10,3-11.5,3-17,4-10,4-7,4-8,5-7,5-merou,6-17,60-90,8-18,9-12,9-17,abaxially,absen,absent,accrescent,acicular,across,acuminate,acute,adaxiall,adult,alyx,anvil-shape,apart,ascending,attenuate,axe,ba,bark,blade,branch,branche,brown,calyx,connivent,corky,cross-section,cuneate,decimetre,deltate,directed,distall,distributed,dm,eaf,eed,eglandular,entire,exocarp,finger,fruiting,functional,furrowed,geminat,gland-tipped,half,heterostylous,interpetalar,juicy,juvenile,lamina,lateral,less,lobe,lobed,long,longer,loosely,lower,margin,mature,mesocarp,mid-point,midpoint,midvein,minute,moderately,moist,nflorescence,oblique,oblong,obtuse,often,orolla,pair,part,per,placenta,pore,porrect,present,prickle,ray,ruit,rusty,shallowly,short,simple,somewhat,spaced,sparse,stalk,stalked,stellae,straight,tal,tamen,tem,thick,throughout,time,tissue,transparent,tube,unarme,unarmed,unit,upper,vary,wide,yellowish,ympodial	5-merous,abaxial,adaxial,colour,corolla,form,growth,height,history,life,number,ovary,position,reproduction,seed,shape,spacing,staman,stigma,texture
321	wfo-0001028067	success	139	79	52	87	27	0.374	-30,0.5-1,0.5-2,1-10,1-11,1-7,1.5-2.5,10-25,2-2.5,3-7,5-7,6-12,6-18,7-11-compound,7-9,apart,apex,chartaceous,cm,dark,diameter,elliptic-fusiform,elliptic-ovate,flattened,flower,fruit,glabrous,leaf,mm,moderately,pedicel,peduncle,petiole,pink,pinnately,puberulent,purple,rachi,rarely,shrub,simple,sparsely,stellate,stigma,strongly,style,tomentulose,truncate,unbranched,unknown,x,yellow	0.5-1.5,1,1-2,1-3,2,2-3,2.5-3,3-17,3-4,3-5,4-foliat,7-20,8-13,abaxially,acuminate,acute,adaxiall,adaxially,aggregate,along,articulated,axe,base,basiscopically,blade,calyx,cell,color,compound,connivent,cuneate,cylindrical,decurrent,directed,distall,eaf,eed,entire,especially,glabrou,hair,lateral,leaflet,leaving,lobe,lon,long,lower,margin,midrib,narrowly,nearly,nflorescence,nther,obtuse,often,orolla,pedicellar,per,pore,puberulen,radiu,remnant,ripe,ruit,several,slightly,smal,spaced,stone,subcoriaceous,tal,tem,time,tip,triangular,triangular-deltate,truncat,tube,unequal,unit,upper,usually,vary,wide,ympodial,zigzag	abaxial,adaxial,anther,arrangement,colour,corolla,filament,form,growth,height,history,inflorescence,length,life,na,number,ovary,plant,position,reproduction,seed,shape,spacing,staman,surface,texture,width
322	wfo-0001028069	success	253	98	76	177	22	0.3	0.3-0.45,0.4-0.8,0.5-1.8,0.6-4,1-2.7,1-3.5,1.6-3.2,10,12,2-3-branched,3,along,anther,apex,articulated,bright,brown,cell,cm,conical,corolla,deep,densely,diameter,eglandular,filament,flower,fruit,glabrescent,glandular,globose,green,hair-like,herb,imparipinnate,interrupted,lateral,leaf,length,like,lime,long,midvein,minute,mm,obovate,occasionally,orange,outgrowth,ovary,ovate,pale,patent,pedicel,peduncle,pentagonal,perennial,petiole,plant,pubescent,shorter,simple,smaller,stem,stigma,style,surface,tangled,testa,transparent,trichome,unicellular,uniseriate,wall,weak,yellow	-0.4,-30,-6,.1,.1-0.2,.2,.5,0.05-0.1,0.1-0.15,0.1-0.2,0.1-0.3,0.1-0.5,0.1-0.6,0.2-0.3,0.2-0.5,0.3,0.3-0.4,0.3-0.6,0.3-0.7,0.3-1,0.4,0.4-0.5,0.4-1,0.5,0.5-0.7,0.5-2,0.6-1.1,0.7-1,0.7-1.3,0.7-1.5,0.8-1.2,1-2-celled,1-4.5,1.4,1.5-2.0,1.5-3.5,10-12,10-30,2-17,2-4,2-7,2-locular,3-,3-foliate,4-celled,5-22,5-25,6-,<,abaxially,absen,abundant,accrescent,acute,adjacent,adpressed,alternate,always,among,anthesi,apical,appearance,appendage,appressed,axi,ba,basal,base,basioscopically,becoming,berry,bilaterally,bract,bracteole-like,calyx,citru,column,composed,cone-shaped,cordate,cuneate,curving,decurrent,deeply,dense,due,eaf,ebracteate,edicel,eed,erect,exserted,forming,fruiting,fusion,giving,gland,gland-tippe,gland-tipped,glandular-villous,gree,half,halfway,head,included,initially,interjected,internode,larger,later,leaflet,less,linear,lobe,lobed,lon,longer,longest,lower,margin,maturity,middl,minutely,multicellular,narrowly,nflorescence,oblique,often,one,pair,per,petiolule,population,present,primary,procumbent,pseudostipule,pubescence,quaternary,rarely,reflexed,robust,rounded,ruit,scarcely,scent,secondary,sessile,several,shaggy,short,silky,single-celled,size,slender,somewhat,staminal,sterile,straight,strong,subopposite,symmetric,tem,terminal,tertiary,thick,tightly,toward,tube,ud,unit,usually,varying,viny,wide,winged,ympodial	abaxial,adaxial,arrangement,colour,form,growth,height,history,inflorescence,life,middle,na,number,position,rachi,reproduction,seed,shape,spacing,staman,texture,width
323	wfo-0001028070	success	185	74	50	135	24	0.27	0-0.4,0.2-0.3,0.3-0.4,0.5-1.5,3.5-4,4-5.5,4-6,4-9,5-9,7-11,8-9.5,andromonoecious,anther,chartaceous,cm,dark,densely,diameter,erect,extra-axillary,flower,fruit,globose,green,inflorescence,lavender,length,linear,long,mm,moderately,pale,pedicel,peduncle,perennial,petiole,plant,pseudo-racemose,pseudo-umbellate,rhizomatous,shrub,sparsely,stellate,stellate-pubescent,stigma,streak,style,thick,white,yellow	%,.05,0-0.1,0-0.15,0-2,0-6,0.15-0.4,0.25-0.35,0.3-0.6,0.35-0.5,0.4-0.5,0.4-0.6,0.4-0.8,0.5-0.9,0.5-1,0.6-1.4,0.7-1.3,1-1.5,1-2,1-4,1-locular,1.5-2.5,1.5-7,10-40,3-7,3-8,4-7,5-7,5-merou,7-8,8-13,8-9,8.5-17,abaxially,absen,absent,accrescent,acicular,across,acute,adaxiall,adaxially,alyx,apart,apex,articulated,axe,ba,base,blade,brown,calyx,connivent,cross-section,cuneate,cylindrical,d.,deltate,directed,distall,distributed,dult,eaf,eed,eglandular,entire,exocarp,finger,fruiting,functional,geminat,gland-tipped,hair,half,heterostylous,hig,incomplete,juicy,lamina,lanceolate,lateral,less,lobe,longer,lower,margin,mature,mesocarp,mid-point,midpoint,midvein,minute,moist,nflorescence,oblique,obtuse,orolla,part,per,placenta,pore,porrect,present,prickle,purple,ray,ruit,rusty,semi-circula,septum,sessile,short,simple,spaced,stage,stalk,stellae,stem,straight,tamen,throughout,time,truncat,tube,unarme,unarmed,unbranched,unit,unknow,uvenile,vary,weakly,wide,x,ympodial	5-merous,abaxial,adaxial,colour,corolla,filament,form,growth,height,history,leaf,life,na,number,ovary,position,reproduction,seed,shape,spacing,staman,surface,texture,truncate
324	wfo-0001028075	success	196	96	71	125	25	0.362	1-10,1.5-2.5,10-35,2-4.5,5-12,5-17,5-7,5-9,7-30,8-12,abaxially,acuminate,acute,adaxially,anther,apex,axillary,broadly,brownish,bud,cell,chartaceous,cm,condition,corolla,covering,dark,diameter,drying,elliptic-lanceolate,filament,flower,forked,fresh,fruit,glabrescent,glabrous,globose,green,greenish,hair-like,herb,lateral,leaf,light,membranous,minutely,mm,obtuse,odd-pinnate,ovate,ovate-elliptic,ovoid,pedicel,peduncle,pentagonal,petiole,plant,puberulent,rotate,seed,stigma,style,subtending,terminal,testal,thick,wall,white,whitish,yellow	.5,1-2,1-2.7,1-3,1.5-7,1.6-2.7,2-3,2-6,2.5-10,3-11,3-23.5,4-12,4-7,5-14,5-8,5-merou,7-13,absent,acuman,acumen,ag,along,alyx,apart,apparently,articulated,axe,base,berry,blade,borne,capitat,ciliate,connivent,cuneate,decreasing,differentiated,digestion,distal,distally,distinctively,dorsally,dot,eaf,edge,eed,end,enzyme,erec,especially,exceeding,flat,folded,geminat,generally,glabrescen,green-white,half,homostylous,honeycomb-shaped,interjected,lanceolate,larger,leaflet,lengthening,ligulate,living,lobe,long,lower,make,margin,middl,midrib,much,mucilaginous,narrow,nflorescence,oblique,often,orolla,pair,pale,perfect,petiolule,plurifoliate,pore,poricidal,purple,reflexed,removed,rounded,ruit,scattered,seudostipule,singly,size,slightly,slit,sometimes,spaced,specimen,stamen,star,stolo,straight,subcordate,tall,tamen,tem,throughout,tip,toward,tri-,tube,tuber,typically,unit,usually,vary,wet,wide,wing,x,ympodial	abaxial,adaxial,arrangement,capitate,colour,form,growth,height,history,inflorescence,length,life,na,number,ovary,perennial,position,rachi,reproduction,shape,spacing,staman,surface,texture,width
325	wfo-0001028076	success	195	96	70	125	26	0.359	.5,1-10,1-2,12-22,2-12,2-5.4,2.2-2.6,2.5-4,4-5,5-20,7-8,abaxially,adaxially,anther,apart,apex,articulated,axillary,berry,brownish,bud,cell,cm,condition,conical,corolla,covering,densely,diameter,drying,elliptic,filament,flower,forked,fresh,fruit,glabrous,green,greenish,hair-like,herb,lateral,leaf,less,light,medium,mm,odd-pinnate,ovate,ovoid,pedicel,peduncle,pentagonal,petiole,plant,proximal,pubescent,purple,ripe,rotate,seed,stigma,style,subtending,terminal,testal,thick,wall,whitish,yellow	0.4-0.5,0.5,1-1.3,1-3,1.2-2.2,1.8-2.2,110,13-14,2-3,2.2-3.7,2.5-3,2.6-3.8,4.5-7,5,5-6,5-6.5,5-merou,?,absent,acumen,acuminate,ag,alyx,apparently,attenuate,axe,base,blade,borne,capitat,chartaceous,ciliate,connivent,decreasing,digestion,distal,dorsally,eaf,edge,eed,end,enzyme,erec,especially,exceeding,flat,folded,geminat,generally,glabrou,gradually,green-white,hair,half,homostylous,honeycomb-shaped,interjected,lanceolate,larger,leaflet,lengthening,like,living,lobe,long,lower,make,margin,membranous,minute,mucilaginous,nflorescence,obtuse,orolla,pair,perfect,petiolule,plurifoliate,pore,poricidal,pubescen,rarely,ray,removed,round,ruit,secondary,semierect,sessile,seudostipule,singly,size,slightly,slit,spaced,specimen,stamen,ste,stem,stolo,straight,subequal,subsessile,symmetrical,tall,tamen,tem,thir,throughout,tip,toward,tri-,tube,tuber,typically,unit,unwinged,usually,vary,wet,white,wide,wing,x,ympodial	abaxial,adaxial,arrangement,capitate,colour,form,growth,height,history,inflorescence,length,life,na,number,ovary,perennial,position,rachi,reproduction,shape,spacing,staman,surface,texture,third,width
326	wfo-0001028080	success	187	86	63	124	23	0.337	0.2-1.5,0.25-0.5,0.5-1.5,0.5-2,0.5-3,1-1.5,1-2,1-3,2-10,2-2.5,20-30,5-merous,6-7,8-10,abaxially,adaxially,andromonoecious,anther,articulated,base,chartaceous,clavate,cm,densely,diameter,ellipsoidal,extra-axillary,filament,flattened,flower,form,fruit,glabrous,glandular,green,hair,leaf-opposed,mm,moderately,outline,ovate,ovoid,pedicel,peduncle,petiole,plant,puberulent,rachi,reniform,rugulose,shrub,simple,sparsely,stellate,stellate-pubescent,stigma,style,surface,unbranched,white,white-pubescent,x,yellow	1,1.5-2,1.5-5,2-3,2-5,2-8,2.5-3,2.5-9,3-4,30-40,4-6,5-12,5-6,absent,accrescen,acuminate,acute,adaxiall,alyx,andromonoeciou,apart,apex,armed,axe,ba,bark,berry,blade,branch,brown,brownish,calyx,capitat,connivent,cylindrical,directed,distally,eaf,eed,eglandular,entire,equal,fine,fissure,formed,free,fruiting,geminat,gradually,hermaphroditic,heteromorphic,interpetalar,lanceolate,lateral,like,linear-lanceolate,lobe,long,long-,long-stalked,longitudinal,lower,lowering,major,margin,midpoint,midvein,multangulate,narrowly,needle-like,nflorescence,opening,orolla,part,pendent,perfect,pericarp,persistent,plurifoliate,pore,porrect-stellate,prickle,projection,pubescent,ray,recurved,ruit,scandent,sessile,short-,short-stalked,short-styled,shorter,side,slit,small,sometimes,spaced,staminate,stellate-multangulate,stem,straight,strongly,subcordate,tall,tamen,tapered,thi,time,tissue,triangular,truncate,tube,unarmed,unequal,unit,vary,vein,vertical,weakly,whitish,wide,without,ympodial	abaxial,adaxial,arrangement,capitate,colour,corolla,growth,height,history,inflorescence,leaf,length,life,na,number,ovary,position,reproduction,seed,shape,spacing,staman,texture
327	wfo-0001028105	success	150	77	47	103	30	0.313	.1,.5,0.3-1.5,0.5-2,0.6-1,1-1.2,1.5-1.8,2-2.2,3.5-4,abaxially,adaxially,anther,apex,bilobed,clavate,cm,corolla,dark,elliptic,filament,filiform,flattened-reniform,glabrous,globose,green,leaf,lobed,minutely,mm,olive-green,opposite,ovary,papillose,pedicel,petiole,pitted,pubescent,reddish-brown,shrub,simple,slightly,small,stigma,style,surface,tree,white	.4,0.5,0.5-1,1-1.5,1-2.5,1.5,1.5-2,1.5-4.5,2,2-5,3-5-celled,3-6,5-7-flowered,6-7,9.5-15,acuminate,acute,anthesi,apar,apical,attenuate,axi,axil,ba,bark,base,berry,calyx,conical,deflexed,dense,dia,differing,difoliate,distinct,drying,eaf,edicel,eed,ellipsoid,erect,evenly,exserted,free,fruiting,geminat,glandular,greenish-yello,incrassate,lamina,lateral,like,lobe,lon,long,lower,main,major,margin,middle,minor,nearly,nflorescence,occasionally,older,pair,pale,papillo,planar,pore,poricidal,portion,projection,quadrate,reflexed,ruit,scar,scattered,shaped,size,spaced,sparsely,spreading,stem,straight,strongly,tall,tear-drop,tip,trichome,tub,tube,tuft,ud,uniseriate,unit,vein,widest,woody,x,yellowish,ympodial,young	5-7,abaxial,adaxial,apart,arrangement,colour,diameter,flower,form,fruit,growth,height,history,inflorescence,length,life,na,number,peduncle,perennial,plant,position,rachi,reproduction,seed,shape,spacing,staman,texture,width
328	wfo-0001028109	success	205	94	72	133	22	0.351	-20,0.4-0.8,0.4-1.5,0.45-0.65,0.8-1.5,1.5-10,1.5-5.5,2-4,2.5-3,2/3-3/4,20-60,30-150,4-5-merous,5-13,abaxial,abaxially,acuminate,acute,adaxial,anther,apart,apex,base,berry,bright,chartaceous,cm,densely,diameter,dull,elliptic,erect,evenly,filament,flattened-reniform,flower,fruit,glabrous,gray-green,green,green-brown,lateral,leaf,length,light,lobed,maturity,mauve,mm,moderately,orange-brown,pedicel,peduncle,petiole,recurved,red,red-brown,shrub,simple,small,sometimes,spherical,stellate-pubescent,style,surface,terminal,tree,way,weakly,white,yellow,young	-4,-7,.5,/3,0.05-0.15,0.05-0.2,0.1,0.1-0.2,0.3,0.5-1.2,0.5-2.5,0.6-0.8,0.7,0.8-1.6,1.5-2.5,1/8-1/4,10-25,10-30,12-40,15-100,2-15,2.3-2.9,2.5-5,3-,3-7,3.5-6,3/4,4-13,5-30,8-12,8-15,8-25,acut,almost,alyx,ame,apar,apically,apparently,articulated,bark,blade,branching,brow,c.,calyx,connivent,cuneate,curved,deltate,dimorphic,discolorous,drying,eaf,eed,elongating,entire,equal,free,fruiting,fully,geminate,gently,glabrescent,glabrou,infructescence,lobe,long,long-styled,longer,lower,margin,mature,midpoint,minor,multangulate,nflorescence,obtuse,occasionally,older,one,open,opening,orolla,oung,pair,per,perfec,pericarp,perpendicular,plurifoliat,poricidal,porrect,portion,prickl,prickle,prickly,primary,ray,reflexed,ruit,scar,secondary,sessile,slender,smooth,spaced,spreading,stalk,stalked,stellate,stem,straight,strongly,tamen,tapering,terete,tertiary,time,tip,trichome,tube,unarme,unarmed,unit,usually,vary,vein,venation,visible,wide,woody,ympodial	arrangement,colour,corolla,form,growth,height,history,inflorescence,life,na,number,ovary,plant,position,rachi,reproduction,seed,shape,spacing,staman,stigma,texture
329	wfo-0001028115	success	165	99	63	102	36	0.382	-1.1,-2.5,0.6-0.7,0.7-0.8,1.1-1.8,2-3.2,5-15,6-10,abaxially,abundant,adaxially,anther,antrorse,apex,berry,blue,calyx,campanulate,capitate,cm,diameter,ellipsoidal,elliptical,entire,evident,filament,fruiting,glabrescent,globose,herb,length,light,margin,mm,moderately,narrowly,non-glandular,ovate,pale,papery-scarious,petiole,pinnatifid,pinnatipartite,pinnatisect,prostrate,pubescent,rarely,reticulate,seed,simple,slender,small,stem,stigma,style,trans-ovoidal,trichome,tuberculate,venation,violet,width,x,yellow	-5.2,.2,.6,0.2-0.3,0.42,0.5,0.8-,1-2.4,1-3,1.3-1.8,1.4-1.7,1.7-2.2,1.8-3.5,12-13.5,2-,2.5-,3-4.5,3-5,3-6.5,4.7-,5-8.5,7-7.5,9-17,accrescent,acuminat,acute,ag,alternate,amply,annular,articulate,attenuate,basal,base,blade,coat,connectival,curved,difoliat,dorsal,eaf,eed,embryo,especially,exceeding,glabrous,glandular,growing,half,herbaceous,hig,inflated,linear,lobe,long,longer,longitudinal,longitudinally,lower,mixed,much,multi-seeded,near,nerve,oblong,one,opening,opposite,orolla,pair,papillo,pore,poricidal,portion,prolongation,ree,ridged,ruit,scarce,segment,similar,slightly,slit,smooth,sometimes,strongly,styl,subsessil,tem,time,tip,triangular,tube,unequal,unifoliate,uniseriate,unit,vary,wide,wider,winged,ympodial	abaxial,adaxial,arrangement,bark,bud,cell,center,colour,corolla,flower,form,fruit,growth,height,history,inflorescence,leaf,life,na,new,number,ovary,pedicel,peduncle,perennial,plant,position,prickle,rachi,reproduction,scar,shape,spacing,staman,surface,texture
330	wfo-0001028131	success	208	108	79	129	29	0.38	-1.2,.5,0-0.6,0.3-0.7,0.5-1.1,0.8-1,0.8-1.1,1-4,1-5,1.5-3,1.5-5,2-5,5-6.5,abaxial,adaxial,anther,apex,bark,base,calyx,cell,chartaceous,cm,cream,curved,dark,diameter,dull,erect,filament,flattened,flattened-reniform,flower,fruit,fruiting,glabrous,green,herb,lateral,leaf,length,lobed,margin,marking,mature,mauve,membranous,mm,moderately,narrow-obovate,narrow-ovate,orange,orange-brown,outline,pale,pale-brown,pedicel,peduncle,petiole,pit,prickle,purple,raised,red,scar,shiny,simple,small,smooth,sparsely,spherical,stellate-pubescent,stem,style,surface,trichome,yellow,yellow-green,young	.1,/5,0-2,0-3,0-30,0-4,0.05-0.2,0.1-0.15,0.1-0.3,0.2-1.5,0.4-0.8,0.7-1.1,1-10,1-3,1.8-2,1.8-2.2,1/4-2/3,1/5,2-2.8,2-4,2-6.5,2/3,3-6,4-6,5-8,5-merous,6-7,7-8,abaxially,absent,acuminat,alyx,apar,apart,apically,apparently,articulated,attenuate,berry,blade,branched,broad-deltate,concolorous,connivent,deltate,densely,difoliate,distance,drying,eaf,eed,elongating,epidermi,equal,extending,eye,filiform,free,geminat,glabrescent,gland,infructescence,lanceolate,lengt,like,lobe,long,longer,lower,maturity,midpoint,midvein,naked,nflorescence,oblong,obtuse,often,older,one,open,orolla,oung,pair,pale-gra,pendulous,per,perfec,pericarp,poricidal,porrect,portion,prickl,prickly,primary,ray,reduced,reflexed,rounded,ruit,sessil,sessile,shorter,side,sometimes,spaced,spreading,stellate,straight,strongly,sunk,tamen,tapering,terete,tertiary,time,tip,tube,unarme,unarmed,unit,upper,vary,vein,venation,visible,way,wide,woody,ympodial	arrangement,bud,center,colour,corolla,form,growth,height,history,inflorescence,life,na,new,number,ovary,pale-gray,perennial,plant,position,rachi,reproduction,seed,shape,spacing,staman,stigma,texture,unknown,width
331	wfo-0001028147	success	185	103	73	112	30	0.395	abaxially,acuminate,adaxially,anther,apex,articulated,base,berry,branched,break,brown,chartaceous,cm,corolla,dark,diameter,dry,entire,except,filament,flattened-reniform,flower,glabrous,globose,green,hairy,immature,internode,lateral,light,lobed,margin,mature,minutely,mm,mottled,narrowly,nearly,oblong,orange,outer,ovate,ovoid,pale,pedicel,peduncle,pentagonal,petiole,pitted,puberulent,rachi,recurved,rugose,seed,shape,simple,slender,somewhat,stellate,stem,stigma,style,surface,terminal,testal,tip,turning,vine,wall,white,yellow,yellow-green,yellowish-orange	.5,0.25,0.5,0.6,1.5–2,1.5–5.5,1.6–2.3,10–15,15–20,1–2,1–4,1–5,2–4,2–7,2–8,3-5,3.5–4.5,3.5–9,3–4,3–6,4-5,5–10,5–12,6–9,7–10,absent,acute,ag,alyx,anthesi,appearing,armed,axe,becoming,blade,broadly,bud,calyx,campanulate,cell,connivent,cuneate,deciduous,decurrent,deltate,dr.,eaf,eed,ellipsoid,elongate,elongating,equal,exserted,fifth,five,four,fruiting,herbaceous,interpetalar,lanceolate,larger,lengthening,lobe,long,long-styled,longer,lower,major,midrib,nflorescence,often,one,orange-red,orolla,paired,pericarp,plurifoliat,pore,poricidal,prickle,pulp,rarely,recurve,robust,ruit,season,seen,shallowly,short-styled,side,slightly,slit,spine,spreading,stout,straight,subcaudate,tamen,time,tissue,truncat,tube,unequal,unit,vary,vein,wide,wood,woody,x,ympodial,×	0.25-0.6,1-2,1-4,1-5,10-15,2,2-4,2-7,5-10,5-12,6-9,7-10,abaxial,arrangement,center,colour,form,fruit,growth,inflorescence,leaf,length,na,number,ovary,position,spacing,staman,texture,truncate
332	wfo-0001028148	success	157	82	53	104	29	0.338	0.25-0.5,1-15,1-3.5,1.5,12-15,2,2-7,2.5-4,20-50,3.5-9,5-7,angled,apart,apex,blue-black,branched,chartaceous,cm,dark,diameter,elliptic,flower,fruit,glaucous,globose,less,minute,mm,narrowly,orange,pedicel,peduncle,petiole,pink,plicate,purple,rachi,rhizomatous,ridge,rotate-stellate,scalloped,shrub,simple,slender,smooth,stigma,style,surface,treelet,violet,whitish,x,yellow	-6,.5-4,0.5-1.5,0.6-3.5,0.75-2,1.5-2.5,10-30,15,2-3,3.5-4,4-10,4.5-10,5,5-10,5-20,5-8,6-18,abaxially,absen,acute,adaxially,aggregate,apiculate,articulated,axe,ba,base,blade,broadly,calyx,cell,central,connivent,cylindrical,decurrent,deltate,densely,directed,distal,distall,eaf,eed,entire,especially,except,fleshy,fresh,glabrous,hair,highly,light-colored,lobe,long,lower,many-foliat,margi,margin,material,mature,midrib,moderately,nflorescence,nther,obtuse,often,orolla,ovate,part,perfect,plicae,pore,puberulence,puberulent,puberulent-pubescent,radiu,rarely,ripe,ruit,slightly,smoot,sometimes,spaced,sparse,star,stone,succulent,tal,tapered,tem,thickened,time,tip,triangular,truncat,tube,unbranched,unit,usually,vary,white,wide,winge,ympodial,young	0.5-4,abaxial,adaxial,anther,arrangement,colour,corolla,filament,form,growth,height,history,inflorescence,leaf,length,life,na,number,ovary,plant,position,reproduction,seed,shape,spacing,staman,texture,truncate,width
333	wfo-0001028161	success	124	84	46	78	38	0.371	0.1-0.25,1-1.5,2-9,3-7,4-5,along,apex,bark,branched,brown,calyx,cell,closely,corolla,dendritic,densely,denser,elliptic,fruiting,globose,green,lanceolate,leaf,margin,minutely,mm,narrowly,opposite,ovoid-reniform,pale,pedicel,petiole,pitted,pubescent,reddish-brown,scar,shape,shrub,simple,spaced,stem,surface,tapering,thin,trichome,vein	.5,0.25-0.5,0.7-1.7,1-1.3,1-2,1-2.3,1.5-4.5,1/3,2-5-flowered,2.5-3,3-4,6-9,7.5-12,9-11,abaxially,acuminate,acute,adaxially,anthesi,arising,attenuate,ba,base,berry,branch,cm,congested,consisting,deflexed,dia,differing,difoliate,distal,eaf,edicel,eed,exserted,geminat,glabrescen,incrassate,inflorescenc,later,lateral,like,lon,long,main,major,middle,minor,nflorescence,obovoid,often,older,orbicular,outline,overlappin,pair,probably,pubescence,rest,rounded,ruit,short,sinuate,size,somewhat,sparsely,strongly,tall,tan,tub,ud,unit,widest,x,ympodial,young	2-5,abaxial,adaxial,anther,arrangement,bud,center,colour,diameter,filament,flower,form,fruit,growth,height,history,inflorescence,length,life,na,new,number,ovary,overlapping,peduncle,perennial,plant,position,prickle,rachi,reproduction,seed,spacing,staman,stigma,style,texture,width
334	wfo-0001028164	success	197	105	80	117	25	0.406	-1,/4,0.4-0.8,0.5-0.8,0.5-1,0.9-1.6,1,1-1.5,1-4.5,2.5-4,2.5-4.5,3-17,4-5-merous,8-15,abaxial,abaxially,acuminate,acute,almost,anther,apex,apparently,articulated,base,berry,branched,bright,cm,curved,dark,diameter,dull,elliptic,erect,evenly,filament,filiform,flattened-reniform,flower,fruit,glabrescent,glabrous,green,lateral,leaf,length,less,lobed,maturity,mauve,membranous,midvein,mm,moderately,obtuse,orange-brown,pale,pedicel,peduncle,petiole,recurved,red,red-brown,shrub,simple,sometimes,sparsely,spherical,stellate,stellate-pubescent,straight,style,surface,terminal,tip,way,white,yellow,yellow-green,young	-14,-6,-8,0-20,0.05-0.2,0.05-1.5,0.1,0.3-0.8,0.7-1.1,0.8-1.5,1.5-2.5,1.8-2.5,1/3,1/6-1/4,12-20,2-2.5,2.8-4,3-7,3.6-4.8,4-13,4-7,4-8,6-8,8-17,alyx,ame,apar,apically,attenuate,bark,blade,c.,calyx,concolorous,connivent,deltate,densely,difoliate,drying,eaf,eed,elongating,entire,equal,eye,free,fruiting,geminat,glabrescen,glabrou,glandular,gray,hair,infructescence,lobe,long,long-acuminat,longer,lower,margin,mature,midpoint,minute,multangulate,naked,narrow-deltate,nflorescence,often,older,one,open,orolla,oung,pair,per,perfec,pericarp,poricidal,porrect,portion,primary,ray,reflexe,ruit,scar,sessile,shallowly,shorte,shorter,side,smooth,spaced,spreading,stalk,stalked,stem,tamen,tapering,terete,tertiary,time,trichome,tube,unarme,unarmed,undulate,unit,upper,variously,vary,vein,venation,visible,wide,woody,yellow-gra,ympodial	adaxial,apart,arrangement,colour,corolla,form,growth,height,history,inflorescence,life,na,number,ovary,perennial,perfect,plant,position,reproduction,seed,shape,spacing,staman,stigma,texture
335	wfo-0001028180	success	147	83	54	93	29	0.367	.05,1-1.5,1-1.8,1-3,4.5-5,5-6,7,acute,along,anther,apex,base,capitate,closely,cm,corolla,dark,darker,densely,elliptic,filament,glabrous,globose,gold,golden,green,leaf,lobed,margin,minutely,mm,nearly,opposite,ovary,ovoid-reniform,pale,papillose,pedicel,petiole,pinkish-white,pitted,pubescent,shiny,simple,spaced,stigma,style,surface,tan,tree,trichome,uniseriate,white,x	.5,/2,0.7-1,1-1.2,1.5-5,15-28,2-2.2,2-3,2.5-3,20-30-flowered,3-10,3-4,5-8,8-10,abaxially,adaxially,anthesi,attenuate,ba,bark,beginning,berry,c.,calyx,conical,cucullate,deflexed,deltate,dia,differing,difoliate,distinctly,drying,eaf,eed,elongate,erect,falcate,fleshy,four-angled,free,fruiting,geminat,glabrat,irregularly,know,larger,lateral,leathery,lobe,lon,long,lower,main,major,midrib,minor,nflorescence,obscure,older,onto,overlappin,pair,planar,pore,poricidal,portion,puberulent,ruit,scar,shaped,size,small,somewhat,sparsely,stem,straight,styl,tall,tear-drop,thick,tip,tube,ud,underside,unit,vein,way,winged,woody,yellow-gray,ympodial,young	20-30,abaxial,adaxial,arrangement,colour,diameter,flower,form,fruit,growth,height,history,inflorescence,length,life,na,number,peduncle,perennial,plant,position,rachi,reproduction,seed,shape,spacing,staman,texture,width
336	wfo-0001028182	success	150	68	41	109	27	0.273	0.5-0.6,0.8-1,0.9-1,1-1.5,2-2.5,2-6.5,3-5,anther,apart,apex,black,capitate,cm,corolla,filament,filiform,flower,glabrous,hemiepiphyte,inflorescence,internodal,leaf,lobed,minutely,mm,narrowly,opposite,ovary,ovate,papillose,pedicel,petiole,pubescent,shiny,shrub,sparsely,stigma,style,surface,white,x	.5,0-90,0.1-0.2,0.5,0.5-1,2,3,4-6,5-15-flowered,5-ribbed,6-9,along,anthesi,apiculae,apiculate,arching,axi,bark,base,bending,beneath,blade,branch,brown,calyx,ciliate,conical,cordate,deflexed,deltoid,densely,dia,dry,eaf,edicel,eed,ellipsoid,evenly,except,extreme,free,globose,gre,keeled,know,known,later,lateral,lax,less,like,lobe,long,long-acuminate,lower,main,margin,material,midrib,minute,nearly,nflorescence,obovoid,older,pair,papillo,planar,pore,poricidal,portion,present,prominent,proximal,purplish,reflexed,rib,rounded,ruit,sca,scar,shaped,simple,slender,slightly,somewhat,spaced,sparser,specimen,spindly,stem,still,strongly,tapering,tear-drop,third,time,tip,trichome,truncate,tube,ud,unifoliat,uniseriate,unit,vein,widest,ympodial,young,zig-zag	5-15,abaxial,adaxial,arrangement,colour,diameter,form,fruit,growth,height,history,length,life,na,number,peduncle,plant,position,rachi,reproduction,seed,shape,spacing,staman,texture,unifoliate,width
337	wfo-0001028183	success	237	104	78	159	26	0.329	-10,-5.3,0.2-0.3,0.2-0.5,0.5-2.5,0.7-2,0.8-1.4,0.8-3.1,1.1-1.8,1.7-2.7,2-4.2,2-5,2.8-4.2,5.2-6.2,6.6-20,7.5-23,abaxial,abaxially,adaxially,along,anther,apart,apex,axi,brown,capitate,central,cm,corolla,dark,deltoid,diameter,drying,dull,elliptic,elongated,filament,flower,fruit,glabrescent,glabrous,globose,granular-punctate,hair,half,lanceolate,leaf,mm,orangish-tan,pedicel,peduncle,petiole,pseudoterminal,pubescent,purple,rachi,reportedly,reticulate-punctate,ripe,scabrous,shrub,simple,small,soon,spherical,stellate,stigma,streak,style,sub-lenticular,surface,tree,upper,violet,white,x,yellow,yellowish	.5-3,0.1,0.1-0.2,0.1-0.4,0.1-0.9,0.2-0.4,0.5,0.6,0.7-1.2,1.2-1.4,1.3-1.4,1.3-1.7,1.4-2.8,1.5-3.4,1.6-2.3,1.9-3.7,1/3-1/2,10-15,11-30,2.2-5.7,2.5-4.1,2.6-4.4,3.2-,3.5-6.6,4.5-9,4.6-6.4,5-8,5-8.5,50-400,8-9.1,9-13,accrescent,acute,ag,alyx,anthesi,apparently,around,articulated,attenuate,axillary,bark,base,berry,blade,blunt-tipped,branch,branched,bud,calyx,cell,chartaceous,closely,cuneate,cylindrical,dendritic-multangulate,directed,distally,distantly,eaf,earl,edge,eed,entire,epidermal,especially,evident,except,exserted,farinose,few-rayed,free,fruiting,glabrescen,group,high,inserted,lackin,lateral,lengthening,lobe,lobed,lon,long,long-decurrent,longitudinal,lower,m.,main,many,margin,midrib,multangulate,narrowly,nearly,nflorescence,oblong,obovoid,older,open,orolla,ovate-lanceolate,overlapping,perfec,plurifoliate,pore,poricidal,porrect-stellat,porrect-stellate,present,prominent,pubescence,rarely,relatively,ruit,runk,sessile,short,short-,side,slit,somewhat,spaced,sparingly,sparse,splitting,stage,stalk,stamen,stem,stipitate-glandular,stout,strongly,subcampanulate,suture,tamen,tan,terete,thick,thin,thin-textured,time,tip,tomentose,touching,translucent,tube,ud,unarme,unit,usually,vary,vein,way,whitish,wide,yellowish-tomentose,ympodial,young	150-400,3.2-6.4,adaxial,arrangement,colour,form,growth,height,history,inflorescence,length,life,na,number,ovary,perennial,plant,position,reproduction,seed,shape,spacing,sparely,staman,texture,width
338	wfo-0001028226	success	185	78	53	132	25	0.286	0-0.1,0.15-0.3,0.15-0.45,1-2,3.5-4.5,5.5-8.5,9-14,9-15,adaxially,andromonoecious,anther,apex,articulated,base,chartaceous,cm,cylindrical,densely,diameter,elliptical,extra-axillary,flower,fruit,glabrous,globose,green,herbaceous,inflorescence,lavender,leaf-opposed,length,mm,obtuse,ovate,pale,pedicel,peduncle,petiole,plant,prostrate,pseudo-umbellate,resprouter,simple,solitary,sparsely,sprawling,stellate,stellate-pubescent,straight,strongly,style,unbranched,yellow	%,.5,0-1,0-2,0.1-0.3,0.2-0.3,0.25-0.4,0.25-0.5,0.3-0.7,0.3-1,0.4-0.6,0.4-0.7,0.5-1,0.5-1.2,0.6-1.3,0.7-0.9,1,1-3,1-5,1.2-2.6,1.5-3,1.5-5,1.6-2.4,10-16,10-45,13-22,15-27,18-50,2-3,2-5,2-5.5,2.5-3,2.5-9,2.7-3.2,5-8,5-merou,6-8,7-8,abaxially,absen,absent,accrescent,acicular,across,adaxiall,adult,alyx,apart,apparently,armed,axe,ba,blade,branche,brown,calyx,confined,cuneate,deeply,deltate,directed,distall,distributed,dm,eaf,eed,eglandular,finger,fruiting,functional,geminat,gland-tipped,hair,half,heterostylous,index,juic,lamina,lateral,less,lobe,lobed,lobing,lon,long,longer,lower,margin,mature,mesocarp,midpoint,midrib,midvein,minute,moderately,moist,nflorescence,oblique,onl,orolla,part,per,plurifoliate,pore,porrect,present,prickle,ray,rostrate,ruit,sessile,shallowly,short,side,somewhat,spaced,stage,stellae,tal,tamen,tem,thick,throughout,time,transparent,tube,unit,uvenile,vary,wide,x,ympodial	5-merous,abaxial,adaxial,arrangement,colour,corolla,filament,form,growth,height,history,leaf,life,na,number,ovary,position,reproduction,seed,shape,spacing,staman,stigma,surface,texture
339	wfo-0001028227	success	236	107	84	152	23	0.356	-6.2,0-250,0.2-0.3,0.2-0.4,0.7-2.1,0.8-1.4,0.9-1.4,1-4.2,1.1-3.1,1.2-2,1.3-4,2-12,3-4.9,3.7-7,4.8-7.6,6-16,6.7-15,8.5-22,abaxial,abaxially,adaxially,along,anther,apart,apex,articulated,base,branched,brown,brownish,cm,corolla,dark,deltoid,diameter,drying,elliptic,elongate,farinose,filament,fleshy,flower,fruit,glabrous,globose,granular-tomentose,gray,grayish,green,hair,leaf,many,midvein,mm,oblong-lanceolate,orangish-tan,ovate-lanceolate,pale,pedicel,peduncle,petiole,pseudoterminal,purple,quarter,rachi,reticulate-punctate,ripe,scabridulous,shrub,simple,stellate,stigma,style,sublenticular,subspherical,surface,time,tomentose,tree,upper,velutinous,violet,x,yellow	-2/3,.5-4,0.1,0.2,0.2-0.5,0.3,0.4,0.5,0.8,0.9,0.9-1.2,1,1-1.7,1-2.5,1.4,1.4-2.6,1.5-2.3,1.7-2.8,1.9,1.9-4.2,1.9-5.8,1/2,1/2-3/4,10,10-24,11-15,2-3.8,2.5-7.8,2.6-5.9,2.9-4.7,3.7-6.3,4-13,5-7.5,8.1-18,accrescent,acuminate,acute,ag,age,alyx,anthesi,apparently,appressed,around,attenuate,axillary,bark,becoming,berry,blade,blunt-tippe,blunt-tipped,branch,bud,c.,calyx,closely,cuneate,cylindrical,decurrent,dendritic-echinoid,directed,distally,eaf,early,echinoi,echinoid,edge,eed,ength,entire,exserted,free,fruiting,glabrescent,high,inserted,lacking,lanceolate,lateral,lengthening,less,lobe,lobed,lon,long,longitudinal,lower,m.,main,margin,midrib,mostly,multangulate,nflorescence,oblong,obscured,obtuse,occasionally,often,older,orbicular,orolla,ovate-orbicula,overlapping,perfec,plurifoliate,pore,poricidal,porrect-stellate,present,prominent,pubescence,pubescent,relatively,rounded,ruit,runk,sessile,side,slightly,slit,somewhat,spaced,sparsely,stalk,stamen,stem,stout,subcampanulate,sulcate,suture,tamen,thick,thicker,thin,tip,tomentu,touching,tube,ud,unarme,unit,usually,vary,vein,way,well,wide,yellowish,ympodial,young	adaxial,arrangement,colour,form,growth,height,history,inflorescence,length,life,na,number,ovary,perennial,plant,position,reproduction,seed,shape,spacing,staman,texture,width
340	wfo-0001028228	success	143	93	64	79	29	0.448	.5,0.1-1.7,1.1-1.2,1.2-1.8,1.5-2,2-8,3/4,6-7,abruptly,acute,anther,apex,area,base,brown,calyx,campanulate,closely,cm,corolla,dark,deflexed,dry,elliptic,filament,glabrous,globose,green,greenish-yellow,leaf,lobe,lobed,long,margin,material,minute,minutely,mm,narrowing,obovate,opposite,ovary,overlapping,ovoid-reniform,pale,papillose,pedicel,petiole,reticulate,rounded,shining,shrub,simple,small,spaced,stigma,style,surface,thickened,tip,tree,tube,way,white	0.75,1-1.5,1.1-2.5,1.8-3.4,10-30-flowered,2,2-5,2.1-4.2,2.8-6.5,6-8,7.5-12.5,age,anthesi,ba,bark,becoming,beginning,beneath,berry,caly,clavate,coriaceous,deltoid,dia,difoliate,distal,eaf,edicel,eed,erect,exserted,fragrant,free,fruiting,geminat,impressed,inflorescenc,lateral,lon,lower,main,major,middle,minor,nflorescence,occasionally,older,ovoid,pair,planar,pore,poricidal,portion,prominent,ruit,scar,shaped,shinin,slender,slightly,stem,straight,styl,sweetly,tall,tapering,tear-drop,terminal,thick-margined,ud,unit,usually,vein,weight,widest,woody,x,ympodial,young	10-30,abaxial,adaxial,arrangement,colour,diameter,flower,form,fruit,growth,height,history,inflorescence,length,life,na,number,peduncle,perennial,plant,position,rachi,reproduction,seed,shape,spacing,staman,texture,width
341	wfo-0001028234	success	155	71	41	114	30	0.265	/3,0.15-0.35,0.25-0.5,1-2.5,3-10,5-11,annual,anther,blade,blue-tinged,branched,broadly,brown,capitate,capitate-glandular,cm,dark,divergently,dm,erect,glabrous,hair,internodal,leaf,long,mm,ovate,petiole,pinnatifid,plump,prickly,radially,ridged,simple,spherical,stellate,taprooted,unexpanded,unicellular,uniseriate,white	/2,0.5-1.0,1.0-1.8,15-30,2.6.3.2,3.5-7,4-10,5-20-flowere,520,8-11,accrescent,acro,across,acute,along,alyx,and,anthesi,armed,around,basally,base,beneath,berry,black,caly,calyx,campanulate,cauline,central,closely,deltoid,density,developing,dia,difoliate,dissected,divided,dry,eaf,earliest,eed,enveloped,extended,few-rayed,fleshy,fully,geminat,gland,green,herb,heteromorphic,high,invested,largest,later,linear-lanceolate,lobe,lon,main,many,margin,marking,maturity,mostly,narrowly,nflorescence,occasionally,often,one,orolla,pedicel,per,persisting,prickle,purple,purplish-tinged,reduced,ruit,scattered,second,sessile,short,short-stipitate,slende,somewhat,spaced,splitting,starlike,ste,stellae,stem,stipitate,stout,strait,subulate,tamen,thrice,tightly,tigma,triangular,tub,tube,twice,tyle,ultimate,unit,vary,varying,vein,wholly,year,yello,ympodial	5-20-flowered,abaxial,arrangement,branching,colour,corolla,diameter,filament,flower,form,fruit,growth,height,history,inflorescence,length,life,na,number,ovary,plant,reproduction,seed,shape,staman,stigma,style,surface,texture,type
342	wfo-0001028250	success	256	89	62	194	27	0.242	0.3–3.9,0.5–1.0,0.5–1.3,1,1.0–1.6,1.1–1.6,1.2–6.3,2.3–2.5,2.3–5.1,2.7,5.0,5.8–6.6,95,anther,apart,apex,attachment,branched,chartaceous,cm,corolla,deltate,densely,diameter,dry,extra-axillary,filament,flattened-orbicular,flower,fruit,glabrous,globose,interpetalar,lateral,leaf,mature,mm,notched,oblong,ovate,pedicel,peduncle,petiole,point,poorly-developed,pubescent,red,shrub,simple,small,stellate,stigma,straight,style,surface,tissue,tree,white,yellow,yellow-tan,±smooth,–3	.2,.3,.4,.7,.8,0.08,0.13,0.17,0.2–0.6,0.3–0.5,0.3–0.6,0.4–0.8,0.6–0.7,0.7–0.8,0.8–1.0,0.8–1.3,0.9–1.3,1.0–2.0,1.2–1.7,1.3–1.6,1.3–2.0,1.5,1.5–3.4,1.6–1.8,1.7,1.7–2.5,1.8,1.8–2.2,1.9–2.2,1/3,1/4–3/4,12.5,1–3,2.1,2.2–2.9,2.8,3.9–12.2,4–11,4–6,4–8,5-merou,5.1–6.2,5.7–7.7,6–10,8.3–18.0,90°,abaxially,acute,adaxially,adnate,aequilateral,alyx,anthesi,apical,apically,apiculate,apparently,appearing,appressed,articulate,axe,ba,base,berry,blade,branch,broad,brochidodromous,bud,calyx,caudate,channeled,climate,clinate,congested,continuing,cuneate,curved,dentate,depression,development,difoliate,directed,disc-shape,distinct,eaf,edge,eed,egandular,either,emerging,endocarp,entir,entire,erect,evenly,exocarp,fertile,filiform,free,frui,geminate,glabrescent,glandular,glossy,growt,hair,homostylous,hooked,increasing,internode,intersepalar,juic,lanceolate,large,less,lobe,lobed,lon,long,longer,lower,major,margin,midpoint,midrib,midvein,minor,minute,moderately,nearly,new,nflorescence,oblique,occasionally,opaque,orolla,overlapping,per,pore,porrect,portion,potentially,raised,ray,restricted,rigid,rounded,row,ruit,sessile,shallow,short-stipitate,shorter,side,sinuate,sinus,smoot,sparsely,split,splitting,spread,spreading,stamen,stella,stellae,stellate-pubescent,stipe,suture,tamen,tardily,tem,thin,time,tip,toward,truncate,tube,two,typically,ud,unarmed,upper,upright,vary,vein,weakly,wide,yellow-ferruginous,ympodia,young,±equal,×,–1.6	5-merous,abaxial,adaxial,arrangement,colour,disc-shaped,form,growth,height,history,inflorescence,length,life,na,number,ovary,perennial,plant,position,rachi,reproduction,seed,shape,spacing,staman,texture,width
343	wfo-0001028263	success	156	84	58	98	26	0.372	0.25,1-3,1-4,11-23,2.6,3.4,6,8-14,9,abaxially,adaxially,apex,articulate,branched,broadly,cm,conical,corolla,cyme,darker,deep,diameter,dichasial,dichasially,distal,ebracteate,elliptical,filament,flower,green,green-white,half,herbaceous,leaf,light,medium,mm,monochasial,odd-pinnate,ovate,ovoid,pedicel,peduncle,perennial,petiole,plant,proximal,puberulent,pubescent,rotate,seed,stigma,strigose,style,throughout,violet,yellow,¼	1-2,11-13,14-44,2,2-3,2-4,3,3-6-foliat,3.5-4.2,4,4-5,5-7,5-7.5,6-8,8-1.,abaxiall,acumen,acuminate,acute,apical,apically,atenuate,base,calyx,cell,connate,cordate,covering,cuneate,dehiscent,digestion,diminishing,dorsally,eaf,edge,eed,emoval,enzyme,equal,exceeding,first,flat,folded,forked,generally,globo,gradually,hair-like,honeycomb,interjected,introrse,lateral,leaflet,living,lobe,lon,long,lower,lunat,make,maturing,mucilaginous,nflorescence,nther,oblique,often,orolla,pair,pattern,perfect,plan,poricidally,reveal,ruit,sessile,seudostipule,short,size,slit,specimen,stamen,straight,tal,tem,terminal,testal,thick,throughou,toward,truncate,tuber-bearing,two,typically,unit,vary,wall,wide,ympodial	abaxial,adaxial,anther,arrangement,colour,form,fruit,globose,growth,height,history,inflorescence,length,life,na,number,ovary,position,rachi,reproduction,shape,spacing,staman,surface,texture,width
344	wfo-0001028273	success	225	87	70	155	17	0.311	-2,.5,0,0.5-1,0.6-0.8,2.3-3,2.5-6,4-10,4-11,6-8,abaxial,adaxial,anther,apart,apex,armed,base,berry,brown,cm,conical,coriaceous,corolla,densely,diameter,elliptic,filament,flattened,flower,fruit,globose,growth,height,holly-like,inflorescence,leaf,lobed,long-styled,minutely,mm,orange,ovary,ovate,pedicel,peduncle,petiole,pitted,puberulent,pubescent,rachi,reddish,reniform,shiny,short,shrub,simple,sparsely,stellate,stigma,stout,style,styled,surface,terminal,truncate,unknown,way,white,x,½-2/3	-8,0.1,0.2,0.4,0.4-0.5,0.4-1,0.5,0.6-1,1,1-1.5,1-2,1-4,1.2,1.5-,1.5-2,2,2-3,2-6,2.5-,2.6-5,3-5,30,4,4-7,4-7-lobed,4-8.5,5-8,<,>,?,abaxially,abruptly,absent,acicular,acute,adaxially,age,alfway,along,also,anthesi,articulated,bark,basal,beneath,branched,broad-based,c.,calyx,cell,closer,color,deep,dense,discolorous,distall,eaf,eed,equalling,erect,evenly,exfoliatin,exserted,free,fruiting,glabrous,greyish,heterostylous,impressed,known,less,like,linear,lobe,lon,long,long-stalked,long-triangular,longer,lower,major,margin,markedly,midpoint,midvein,minute,mixture,mucronate,multangulate,multiseriate,new,nflorescence,nodding,occasionally,often,older,pair,papillae,per,pericarp,persisting,planar,plurifoliat,poricidal,porrect,portion,prickle,prickly,primary,pubescence,ray,rest,rim,ruit,scar,scattered,sessile,shallowly,shorter,sinuate,size,slightly,small,smaller,sometimes,spaced,sparse,splitting,spreading-campanulate,stalk,stalked,stellate-pubescent,stem,straight,tapering,terminating,testal,time,tip,together,tooth,toothed,trichome,truncat,tube,ud,unicellular,unit,urceolate,variable,vein,widely,woody,yellow,ympodial	arrangement,colour,form,history,length,life,na,number,plant,position,reproduction,seed,shape,spacing,staman,texture,width
345	wfo-0001028278	success	219	107	87	132	20	0.397	0.4-2.1,0.5-0.75,0.5-2.5,0.7-1.2,0.8-3,1,1-10,1-5,1.2-1.6,1.5,2-3,3-7,4.5-6,6-11,7-12,7-15,abaxially,acute,adaxially,andromonoecious,anther,apart,apex,articulated,base,broadly,brown,chartaceous,cm,densely,diameter,ellipsoidal,erect,extra-axillary,filament,flattened,flower,fruit,glabrous,green,grey-green,inflorescence,interpetalar,leaf,length,light,lobe,long,mid-point,midrib,mm,obtuse,ovate,pale,pedicel,peduncle,perennial,perfect,petiole,pink,pseudo-racemose,purple,rachi,red,reniform,rhizomatous,rugose,shallowly-lobed,shape,shrub,simple,somewhat,sparsely,stellate,stellate-pubescent,stigma,style,surface,thick,throughout,tissue,truncate,unbranched,weakly,white,x,yellow	%,.5,0-0.15,0-0.7,0-1,0-3,0.1-0.25,0.1-0.5,0.2-0.3,0.45-0.7,0.5-0.9,0.5-1.5,0.7-1,0.8-1.3,0.8-2,1-1.2,1-2,1-3,1-4,1-locular,1.4-1.9,1.5-2,1.5-3,11-15,17-30,2,2-4,2.2-7,2.5-3,2.5-9,2.7-2.9,3-4,3-5,4,4-,4-12,4-5,5-10,5-11,5-merou,6-8,7-10,7-8,8-10,absen,absent,accrescent,across,adult,alyx,apparen,ascending,axe,ba,bilobe,blade,calyx,connivent,cordate,cylindrical,dense,difoliate,directed,distall,eaf,eed,elliptic,entire,exceeding,exocarp,finger,fruiting,functional,geminat,gland-tipped,glandular,hair,heterostylous,incomplete,index,juicy,juvenile,lamina,lanceolate,lateral,leave,lobed,lobing,lower,margin,mature,mesocarp,midpoint,minute,nflorescence,oblique,orolla,pair,part,per,placenta,pore,porrect,present,prickle,ray,ruit,septum,shallowly,short,side,spaced,sparse,stalk,stellae,succulent,tal,tamen,tem,time,tissu,transparent,triangular,tube,unarme,unarmed,unit,upper,vary,wide,without,ympodial	abaxial,adaxial,bilobed,colour,corolla,form,growth,height,history,life,number,ovary,plant,position,reproduction,seed,spacing,staman,tall,texture
346	wfo-0001028280	success	87	71	29	58	42	0.333	.5,1-2,2-3,apex,bark,ciliate,closely,dark,elliptic,fruiting,glabrous,globose,green,lanceolate,leaf,margin,minutely,mm,narrowly,new,opposite,pedicel,petiole,scar,shrub,simple,spaced,stem,surface	0.7-1,1-2-flowered,1.5-2.7,2-2.5,6-9,7-8,acuminate,almost,anthesi,ape,arching,attenuate,axil,base,berry,branch,brow,cm,completely,decurrent,dia,eaf,eed,flattened,immature,know,known,lateral,lon,long,lower,main,middle,nflorescence,older,onto,pair,papillae,pendant,present,rounded,ruit,sessil,small,somewhat,tall,tip,ud,ultimate,unifoliat,unit,vein,widest,winged,woody,x,ympodial,young	abaxial,adaxial,anther,arrangement,brown,bud,calyx,cell,center,colour,corolla,diameter,filament,flower,form,fruit,growth,height,history,inflorescence,length,life,na,number,ovary,peduncle,perennial,plant,position,prickle,rachi,reproduction,seed,shape,spacing,staman,stigma,style,texture,trichome,unifoliate,width
347	wfo-0001028281	success	267	123	108	159	15	0.404	-0.9,-1,-10,-20,-3,-36,-45,-5,-7,0.2-0.5,0.2-0.7,0.3-1,0.5-0.6,0.5-0.7,0.5-1,0.7-2.5,0.75-1,1-1.5,1-5,1.0-1.6,1.1-1.4,1.1-2.4,1.2-1.6,1.7-2.5,10-30,2-4,2-6.5,2.1-3.0,20-30,3-16,3-5,3-8.5,6,7-30,abaxial,acuminate,acute,adaxial,anther,apex,articulation,broadly,calyx,capitate,cell,cm,column,conical,corolla,dark,deep,developed,diameter,distal,doubly,elongate,filament,flower,form,fruit,fruiting,globose,golden,green,half,imparipinnate,inflorescence,interrupted,lateral,leaf,leaflet,lobe,long,margin,mm,obovate,once-branched,ovary,pair,paler,pedicel,peduncle,petiolule,present,primary,pseudostipule,pubescent,regularly,rotate,serrate,shrub,small,smooth,staminal,stem,stigma,style,surface,terminal,three,transparent,trichome,type,uniseriate,vine,wall,well,yellow	+,-8,.2,.4,.5,0.05-0.4,0.1-0.15,0.15-0.2,0.2-0.3,0.3-0.5,0.5-,0.5-1.1,0.5-1.2,0.7-,0.7-1.2,0.8-1,1,1-,1-3,1.2-1.5,1.4-4,1.5-2,1.5-6,10-18,2-13,2-4-celled,2-locular,2.5-,3-foliate,5-8-celled,6-15,abaxially,absent,almost,alternate,anthesi,apical,appearance,appendage,appressed,arising,autogamous,axi,base,basiscopically,bent,berr,blade,bract,bracteate,branching,brown,composed,covering,darker,decreasing,decurrent,densely,dry,eaf,edicel,eed,eglandular,either,elliptic,elongate-triangular,enclosing,entire,exerted,exserted,extended,fragile,free,generally,giving,glabrous,gland,glandular,gree,hair-like,hal,halfway,head,included,interjected,internode,large,largest,less,like,lon,longest,lower,material,medial,midvein,minute,mixture,multi-celled,multi-cellular,multicellular,narrowly,nflorescence,node,oblique,occasionally,opposite,orbicular,other,outgrowth,ovate,pale,patent,petiole,point,population,portion,primarily,probably,proximal,rachi,rest,ruit,secondary,serrat,sessile,set,shorter,silky,size,smaller,sometimes,sparsely,sparser,sprawling,sterile,stiff,straight,stripe,strongly,subopposite,tem,tertiary,testa,thick,thin,tip,toward,tube,ud,unicellular,unit,usually,vein,weak,weak-walled,wide,winged,ympodial	1-2,2.5-6-15,arrangement,bud,colour,growth,height,length,number,plant,seed,shape,texture,thicknes,width
348	wfo-0001028294	success	222	80	58	164	22	0.261	0-1,0.5-2,0.8-1.2,1,1.5-3.5,1.5-7,1.9-7,4.5-6,5-12,8-10,8-18,acuminate,acute,andromonoecious,anther,apex,broadly,chartaceous,cm,densely,diameter,extra-axillary,flower,fruit,glabrous,globose,green,grey-green,inflorescence,leaf,length,lilac,lobed,mm,ovate,pale,pedicel,peduncle,perennial,petiole,plant,rachi,shallowly,simple,sparsely,stellate,stellate-pubescent,stigma,straight,style,surface,unbranched,vine,weakly,white,yellow,yellowish,yellowish-green	%,0-0.2,0-0.4,0-10,0-6,0.1-0.15,0.2-0.3,0.25-0.4,0.25-0.5,0.3-0.4,0.3-0.5,0.5-0.6,0.5-1,0.7-1.2,0.7-1.5,0.8-1,1-2,1-2.5,1-3.5,1-6,1.3-1.5,1.7-2.4,11-15,11-22,17-25,18-22,18-40,2-2.5,2-3,2-3.5,2-5,2-foliate,2-locular,2.5-7,30-40,4-6,4-8,5-13,5-8,5-merou,50-100,50-140,6-8,7-10,7-8,9-13,9-15,abaxially,absent,accrescent,across,adaxiall,adaxially,adult,alyx,anvil-shape,apart,armed,articulated,ascending,axe,ba,base,blade,branch,branche,broad-based,brown,calyx,capitat,connivent,cordate,cross-section,cuneate,curved,cylindrical,decimetre,deltate,directed,distall,distally,distributed,dm,eaf,eed,eglandular,elliptic,entire,erect,exocarp,finger,fruiting,functional,geminat,gland-tipped,grey,hair,half,heterostylous,juicy,juvenile,lamina,lanceolate,lateral,less,lobe,long,longer,loosely,lower,margin,markedly,mature,mesocarp,mid-point,midpoint,midvein,minute,moist,nflorescence,oblique,obtuse,orolla,pair,part,per,placenta,pore,porrect,presen,present,prickle,ray,repand,ruit,rusty,scattered,scrambling,semi-circular,sessile,short,slightly,spaced,stalk,stalked,stellae,tal,tamen,tem,thick,thicker,throughout,time,toward,tube,unarme,unarmed,unit,upper,vary,vein,wide,x,ympodial	abaxial,adaxial,arrangement,capitate,colour,corolla,filament,form,growth,height,history,life,na,number,ovary,position,reproduction,seed,shape,spacing,staman,texture
349	wfo-0001028298	success	188	84	64	124	20	0.34	.5,0.5-1,0.6-0.7,0.8-1.7,1-1.5,1-3,2-7,2.5-3,4-5,5-8,8-11,abaxially,absent,adaxially,anther,base,brown,cm,densely,diameter,erect,extra-axillary,filament,flower,fruit,glabrous,globose,grey-green,inflorescence,interpetalar,leaf,length,lilac,lobed,long,mm,moderately,ovate,pale,pedicel,peduncle,perennial,petiole,rachi,red,reniform,reticulate,rhizomatous,rotate-stellate,sessile,shrub,stellate-pubescent,stigma,style,surface,thick,throughout,tissue,truncate,unbranched,white,x,yellow,yellowish	%,0-0.1,0.1-0.2,0.15-0.3,0.2-0.4,0.25-0.4,0.3-0.4,0.3-0.5,0.4-0.5,0.4-0.65,0.7-1,1-2,1-4,1-locular,1.5-2,1.5-3.5,1.9-2.5,10-11,17-25,2-3,2-foliate,2.2-2.5,3-5,3-7,4-9,4.5-8,5-6,5-7,5-merou,6-8,7-12,7-8,9-10,absen,accrescent,across,acuminate,acute,adult,alyx,apart,apex,apparen,articulated,axe,ba,blade,broadly,calyx,capitat,chartaceous,connivent,contiguous,cordate,cylindrical,deltate,directed,distall,distributed,eaf,eed,eglandular,elliptic,entire,exceeding,exocarp,finger,fruiting,geminat,gland-tipped,hair,incomplete,juicy,juvenile,lamina,lanceolate,lateral,lobe,lower,margin,mature,mesocarp,midpoint,minute,nearly,nflorescence,oblique,obtuse,orolla,part,per,perfect,placenta,pore,porrect,present,prickle,probably,pseudo-umbellate,ray,ruit,septum,shallowly,short,simple,soliary,somewhat,spaced,stalk,stellae,succulent,tal,tamen,tem,time,tissu,transparent,tube,unarme,unarmed,unit,vary,wide,ympodial	abaxial,adaxial,capitate,colour,corolla,form,growth,height,history,life,number,ovary,plant,position,reproduction,seed,shape,staman,stem,texture
350	wfo-0001028317	success	204	78	57	147	21	0.279	-1.5,0.3-1,0.6-1.2,0.8-1.1,1-1.3,1-3,1.4-2,5-8,abaxially,anther,apex,branched,bright,chartaceous,cm,cream,cuneate,dark,diameter,dull,filament,flattened-reniform,flower,fruit,glabrous,green,herb,lanceolate,lateral,leaf,length,lobed,marking,maturity,mauve,mm,moderately,obtuse,orange-brown,ovate,pale,petiole,purple,red,shrub,sometimes,sparsely,spherical,stellate,stellate-pubescent,style,surface,terminal,white,yellow,yellow-green,young	-5,/5,0,0-1,0-5,0.1,0.1-0.25,0.1-0.3,0.1-0.4,0.3-0.4,0.5-3.5,0.6-0.8,0.6-1.5,0.8-2.5,1-4,1.1-1.9,1.8-2.5,1/,1/3-1/4,1/4-2/3,1/5,2-2.8,2-4,2-4.5,2.5-6.5,2.8-3.3,2/3,3-10,3-4,3-5,4-5-merous,4-6,4-8,6-10,absent,acuminat,acute,almost,alyx,apar,apart,apically,apparently,articulated,bark,base,berry,blade,broad-deltate,brow,brown,calyx,concolorous,curved,deltate,densely,difoliate,distance,drying,eaf,eed,elongating,equal,erect,extending,eye,filiform,free,fruiting,geminat,gray,hair,herbaceous,infructescence,lobe,long,longer,lower,margin,mature,midpoint,midvein,minute,naked,nflorescence,oblong,older,one,open,orolla,oung,pair,pedicel,peduncle,pendulous,per,perfec,pericarp,poricidal,porrect,portion,prickl,prickle,prickly,primary,ray,reduced,reflexed,rounded,ruit,scandent,scar,sessile,shorter,side,simple,smooth,spaced,spreading,stalk,stalked,stem,straight,subsessile,tamen,tapering,terete,tertiary,time,tip,toward,translucent,trichome,truncate,tube,unarme,unarmed,unit,upper,variously,vary,vein,venation,visible,way,wide,ympodial	abaxial,adaxial,colour,corolla,form,growth,height,history,inflorescence,life,ovary,perennial,plant,position,reproduction,seed,shape,staman,stigma,texture,unknown
351	wfo-0001028323	success	164	90	67	97	23	0.409	-2,0.2-0.5,0.2-1,0.4-1.3,0.6-1,1-1.5,1.5-2.5,2-3,3,3-6,3.5-4,7.5-9,anther,anthesi,apart,blue-green,brown,cm,conical,corolla,dark,dendritic,densely,diameter,ellipsoid,elliptic,erect,fading,filament,fleshy,flower,glabrous,growth,inflorescence,leaf-opposed,lobed,maturity,minute,minutely,mm,ovary,ovoid,pale,papillose,pedicel,peduncle,perfect,petiole,pitted,poricidal,pubescent,reddish,shiny,shrub,simple,soft,somewhat,sparsely,stigma,style,surface,tip,trichome,uniseriate,violet,white,x	0.5,0.5-1,0.8,0.9-1.2,1,1-1.2,1-2,1.1-4.5,1.5,2-9,3-5,5-6,abaxially,abscissio,absent,acute,along,apex,apparently,appressed,articulated,attenuate,ba,bark,base,berry,c.,calyx,capiatate,cell,coriaceous,cup-shaped,deltate,drying,eaf,eed,entire,free,fruiting,glabrescen,glabrescent,globose,grey,included,internodal,lanceolate,lengthening,less,like,lobe,longer,lower,main,margin,new,nflorescence,occasionally,ovate,pair,papillat,peg,pericarp,planar,plurifoliat,pore,portion,primary,proceed,remaining,revolute,rounded,ruit,scar,scattered,shoot,short,sinus,small,sometimes,soon,sparely,splitting,stem,straight,tearing,testal,thick,thin,tube,tuft,ud,unit,vein,wall,way,woody,ympodial	abaxial,arrangement,capitate,colour,form,fruit,hair,height,history,leaf,length,life,number,papillate,perennial,plant,position,reproduction,seed,shape,spacing,staman,texture
352	wfo-0001028328	success	215	103	80	135	23	0.372	-15,0-4,0.5-1,1-1.5,1-2,1-6,1-7,14,15-20,2-10,2-9,3-4,5-10,5-7,50,abaxially,adaxially,andromonoecious,anther,apart,apparently,branched,brown,chartaceous,cm,dark,densely,diameter,elliptic,elliptic-ovate,extra-axillary,filament,flattened,flower,forked,fruit,glabrous,globose,green,hair,inflorescence,juvenile,leaf,leaf-opposed,light,lighter,like,lobe,long,membanaceous,minutely,mm,moderately,nearly,outline,pedicel,peduncle,petiole,plant,rachi,reflexed,reniform,ripe,rugulose,shiny,simple,smooth,somewhat,stellate,stellate-pubescent,stem,stigma,strongly,style,subcoriaceous,surface,tree,white,x,yellow	.2,.5-2,0-0.3,0.2-0.5,1,1.5-2,16-30,2-2.5,2-3,2-4,2-4-lobed,2.5-3,20-30,20-35,4-7,5-merou,6-18,6-8,7-.,7-10,7-14,7-30,7-9,8-18,absent,abundantly,accrescent,acuminate,acute,adaxiall,ag,alyx,apex,apiculate,armed,articulated,axe,ba,base,berry,blade,broad-based,calyx,capitat,coarsely,compressed,congested,connivent,covering,cylindrical,differentiated,difoliate,directed,discolorous,distally,eaf,eed,entire,equal,except,ferruginous,flowering,free,frui,fruiting,geminat,half,heterostylous,highly,interpetalar,leave,lobed,longitudinal,lower,major,margin,midpoint,minor,multangulate,narrowly,nflorescence,oblique,obtuse,often,one,opening,orolla,paired,part,perfect,perhaps,pericarp,pore,porrect,prickle,pubescent,ray,rounded,ruit,runk,sessile,shallowly,sharp,short,short-stalked,side,slightly,slit,small,spaced,sparse,stalk,staminate,straight,subcuneate,subtending,tamen,tapered,thi,time,tip,tissue,tomentose,triangular,truncate,tube,tubevery,unarmed,unit,vary,vein,whitish,wide,ympodial,young	5-merous,abaxial,adaxial,arrangement,capitate,colour,corolla,form,growth,height,history,length,life,number,ovary,perennial,position,reproduction,seed,shape,spacing,staman,texture
353	wfo-0001028329	success	215	102	74	141	28	0.344	0.2-0.3,0.8-1.4,0.9-1.3,1-6,1.5-8,2-3,3-8,4-15,5-10,6-8,7-19,abaxially,adaxially,anther,apart,apex,articulated,asperous,base,becoming,brown,cm,conical,continued,corolla,deltoid,diameter,due,filament,finely,flower,fruit,granular-tomentose,green,growth,honeycombed,lateral,leaf,length,minutely,mm,moderately,mostly,orbicular,ovate,ovate-elliptic,pedicel,peduncle,petiole,pubescent,rachi,reniform,reticulate-punctate,ripe,shrub,simple,small,sparsely,stellate-rotate,stem,stigma,style,subglobose,suborbicular,tomentose,toward,tree,turning,velutinous,white,whitish,x,yellow,yellowish	.5-3,.75-2,.75-5.75,/10-3/10,0-100,0.8-1.1,1.0-1.4,1.1-2.5,1.3-1.8,1.3-2,1.5-2.3,1.5-2.75,1.5-3.5,10-34,12,2-4,2.2-3.9,2.6-5,2.75-4.5,3-14,3.75-7,3/4,4-5,6-11,6-9,absen,acuminate,acute,ag,angled,anthesi,apical-lateral,apparently,axe,axillary,ba,bark,berry,blade,blunt-tipped,branch,branched,bud,calyx,chartaceous,closely,cylindrical,dehiscing,dendritic-echinoi,dendritic-echinoid,dichotomously,distantly,distinct,eaf,echinoid,eed,entire,fleshy,free,glabrescen,glabrous,granular,gray,grooved,hair,high,inserted,introrse,large,lengthening,lobe,lobed,long,long-attenuate,longitudinally,lower,main,margin,midvein,multangulat,multangulate,nflorescence,obelliptic,oblong,obovate,obscured,obtuse,occasional,older,orolla,pale,perfect,plurifoliate,pore,porrect-stellate,present,pseudo-terminal,rather,receptacle,relatively,ruit,runk,sessil,sessile,several,short-,short-stalked,side,slightly,slit,sometimes,spaced,sparse,stalked,stellat,stellate,stellate-pubescent,stelliform,subcapitat,suture,swollen,tamen,testa,thick,thickened,thin,time,tomentu,touching,tube,unarme,unarmed,unit,usually,vary,vein,vestigial,way,wide,ympodial,young	0.5-3,20-100,abaxial,adaxial,arrangement,colour,form,glabrescent,height,history,inflorescence,life,na,number,ovary,perennial,plant,position,pseudoterminal,reproduction,seed,shape,spacing,staman,subcapitate,surface,texture,width
354	wfo-0001028337	success	195	89	66	129	23	0.338	.5,/3,0.3-0.5,0.4-0.8,0.7-1,1-1.8,1-2,1-3,2-4,4-5,5-merous,abaxial,abaxially,adaxial,anther,apart,apex,articulated,base,berry,branched,chartaceous,cm,dark,densely,diameter,erect,evenly,filament,flattened-reniform,flower,fruit,glabrous,glaucous,green,green-brown,inflorescence,lateral,leaf,length,lobed,long,marking,mauve,minutely,mm,moderately,narrow-oblong,orange-brown,pedicel,peduncle,petiole,pitted,rounded,shallowly,shrub,simple,smooth,spherical,stellate-pubescent,style,surface,terminal,way,white,young	-2,-2.5,-4,-6,.8,0,0.05-0.15,0.05-1,0.1-0.3,0.4-0.7,0.7-0.9,1,1.5-3,1.5-4,1.8-2,1/2,1/3-2/3,1/4-1/3,1/8-1/4,11-16,15-50,2-2.2,3-4,5-25,5-6,5-8,6-7,8-10,8-14,acut,alyx,apar,ape,apically,apparently,bark,blade,calyx,color,conical,connivent,cuneate,curved,deltate,discolorous,drying,eaf,eed,elongating,entire,equal,eye,free,fruiting,fused,gently,glabrescent,glabrou,gray,gray-brown,hair,infructescence,juvenil,juvenile,known,lobe,long-styled,longer,lower,margin,mature,midpoint,naked,nflorescence,occasionally,older,one,open,orolla,oung,pale,per,perfect,pericarp,plurifoliat,poricidal,porrect,porrect-lepidote,portion,prickle,prickly,primary,ray,reddish,reflexed,ruit,scar,sessile,shoot,short,short-styled,shorter,slender,small,spaced,sparse,staminate,stellate,stem,stout,straight,strongly,tamen,tapering,terete,time,tip,toward,trichome,tube,unarme,unarmed,unit,usually,vary,vein,visible,wide,ympodial	0-6,arrangement,colour,corolla,form,growth,height,history,life,na,number,ovary,perennial,plant,position,rachi,reproduction,seed,shape,spacing,staman,stigma,texture
355	wfo-0001028339	success	195	112	85	110	27	0.436	.5,1-2,1-5,1.1-1.4,1.2-1.5,1.7-3.2,3.5-4,5-7,8182,acuminate,acute,anther,apex,base,beneath,berry,blue,brown,calyx,capitate,closely,cm,corolla,cup-shaped,dark,decurrent,dia,dried,dry,evenly,filament,flattened,flower,glabrous,globose,growth,leaf,like,little,lobed,long,margin,minutely,mm,mustard,nearly,opposite,ovary,ovate,ovoid-reniform,papillate,papillose,pedicel,petiole,pitted,pulp,schwarz,shrub,simple,slender,slightly,small,somewhat,spaced,sparsely,specimen,stem,stigma,style,surface,tapering,texture,tip,tree,trichome,tube,uniseriate,vein,white,white-speckled,winged,woody,yellow,yellowish,young	0.05-0.1,0.8-1.2,1-1.2,1-1.5,1.5,1.5-2,10-30-flowered,10.2-18.5,2.5-5,3.4-5.5,43191,5-angled,5.8-7.9,7-11,8-10,across,almost,anthesi,appearance,appearing,appressed,attenuate,bark,becoming,broadly,bud,carinate,carpel,connate,covered,crystalline,cuneate,deflexed,densely,differing,difoliate,distinctly,eaf,edicel,eed,enclosed,epidermi,erect,exserted,fide,filiform,first,floccose,free,frui,fruiting,geminat,glabrate,grainy,greyish-brown,irregular,large-celled,later,lateral,leave,lobe,lon,long-triangular,lower,main,major,middle,minor,nee,nflorescence,oblique,obscure,occasionally,older,one,overlappin,ovoid,papery,planar,pore,poricidal,portion,proximal,red-brown,reflexed,ruit,scar,secondary,septum,shaped,shining,size,speckled,straight,strong,strongly,tall,tear-drop,tightly,tub,ud,unit,urceolate,venation,white-lenticellat,white-papillo,wide,widest,x,ympodial	10-30,abaxial,adaxial,arrangement,colour,diameter,form,fruit,height,history,inflorescence,length,life,na,number,peduncle,perennial,plant,position,rachi,reproduction,seed,shape,spacing,staman,white-papillose,width
356	wfo-0001028351	success	175	96	72	103	24	0.411	.2,.8,0,0.2,1.0–2.0,1.0–2.5,2.0–2.5,2–4,40,5.0,5.0–5.5,5–7,8–15,abaxially,acute,adaxially,along,annual,anther,anthesi,apart,apex,articulated,base,blue,brown,capitate,clavate,cm,colour,densely,diameter,filament,flattened,flower,fruit,glabrous,globose,green,hair,herb,leaf,like,long,midvein,mm,moderately,multicellular,number,opposed,ovate,pale,pedicel,peduncle,pentagonal,perennial,petiole,pitted,pubescent,shallowly,shiny,simple,stigma,style,surface,unicellular,uniseriate,unknown,velutinous,white,x,–3.0	.8–1.0,0.1,0.5,0.6,0–,1.0–,1.0–1.6,1.4–1.5,1.5–4.0,1.6–,10,2,2.0–5.0,2.1–3.5,2/3,2–2.5,3,3.4–5.0,3–4,4,5,5.5–10.5,6.5–8.5,6–12,absent,adaxiall,ag,apical,axe,ba,basal,becoming,blade,branching,calyx,cell,chartaceous,connivent,convex,cylindrical,directed,distally,eaf,eed,equal,erect,fleshy,geminat,glandular,indumentum,lamin,lanceolate,lobe,lobed,lon,longitudinal,lower,m.,margin,narrowly,nfloresence,oblong,obtuse,occasionally,opening,orolla,pair,perfect,plurifoliate,pore,present,probably,regularly,ruit,serrate,shaped,side,slender,slit,smaller,spaced,sparsely,stem,stone,straight,tal,tamen,tardily,teardrop,tem,time,truncate,tube,unbranched,unit,vary,wide,wing,winged,woody,ympodial,young,–	abaxial,adaxial,arrangement,corolla,form,growth,height,history,inflorescence,lamina,length,life,na,ovary,plant,position,rachi,reproduction,seed,shape,spacing,staman,texture,width
357	wfo-0001028353	success	177	111	87	90	24	0.492	0.2-0.4,0.5,1,1.4-2,2-3,2-4,3-5,4-7,6-8,acute,along,anther,apart,apex,becoming,beneath,bluntly,bright,campanulate,capitate,cell,centre,cm,conical,corolla,cup-shaped,dark,deep,deeply,densely,diameter,elliptic,erect,filament,flower,fracturing,glabrous,globose,green,greenish,herb,honey-comb,internodal,leaf,less,like,lobe,long,margin,midrib,minute,minutely,mm,nodding,often,ovary,ovoid,pale,papery,papillate,papillose,pedicel,peduncle,petiole,pitted,plant,plump,pubescent,purple,rhomboid,ripe,short,simple,slender,somewhat,sparsely,stigma,style,surface,tan,testal,thin,tip,truncate,vein,x,yellow	.5,/3,0.5-,0.9-1.2,1-2,1-4,1.5-2,1.5-5,2,3,7,8-10,abaxially,accrescent,age,anthesi,area,base,berry,calyx,ciliate,clasping,coarsely,cordate,curved,decreasing,decumben,difoliate,distally,dry,drying,eaf,edicel,eed,ellipsoid,emarginated,exerted,fleshy,free,frui,fruiting,geminat,gree,growing,heteromorphic,hollow,horn,horned,inserted,lengthening,lon,lower,m.,material,nflorescence,open,outline,pair,pericarp,point,pore,poricidal,portion,primary,principal,reddish,ruit,scar,scattered,sessil,sessile,shallow,size,sleeve,slightly,slit,stem,straight,strongly,toothed,toward,trichome,tube,ud,uniseriate,unit,wall,way,wrinkled,ympodial	abaxial,adaxial,arrangement,colour,form,fruit,growth,height,history,inflorescence,length,life,na,number,perennial,position,rachi,reproduction,seed,shape,spacing,staman,texture,width
358	wfo-0001028367	success	178	89	47	131	42	0.264	1.5,60,anther,apex,black,blue,branched,brown,calyx,cell,chartaceous,cm,colour,dark,diameter,filament,flattened,flower,fruit,glabrous,globose,grey-green,leaf,margin,mm,oblong,opposed,ovate,pedicel,peduncle,pentagonal,perennial,petiole,purple,shiny,shrub,simple,stigma,style,surface,texture,tomentose,unknown,white,width,x,yellow	0.2,0.2–0.4,0.4–2.3,0.5,0.5–3,0.8–0.9,1,1.0–1.8,1.2–3.0,1.3–9.0,1.4–2.0,1.5–1.7,1–,1–1.5,1–2,2.0–4.2,2.0–4.5,2.8–3.1,2–10,2–3,3.5–6.9,3–3.5,3–5,4–10,4–7,5,5–5.8,5–6,6.5–8.5,6–8,6–9,7–15,8.5–9.5,8–17,8–23,abaxially,absen,accrescent,adaxiall,adaxially,ag,anthesi,apart,apical,arising,articulated,axe,ba,basal,base,blade,concave,connivent,cuneate,cylindrical,deeply,densely,diamete,directed,eaf,eed,equal,erect,geminat,glabrescen,hair,half,lanceolate,laterally,lobe,lobed,lon,long,longer,longitudinal,lower,marking,moderately,multicellular,narrowly,nflorescence,obliquely,obtuse,opening,orolla,pair,pale,perfect,pitted,pore,poricidal,primary,probably,pubescent,regularly,rounded,ruit,secondary,shorter,side,slit,smaller,spaced,stone,straight,strongly,tal,tamen,tapering,tem,three,time,tip,toward,tube,two,unequal,unicellular,unifoliate,uniseriate,unit,usually,vary,wide,woody,ympodial,–10.0,–25,–5.0,–5.5,–7	0.2-0.4,1.3-9.0,2.8-3.1,25,3-3.5,4-10,4-7,6-8,6.5-8.5,8-17,8.5-9.5,abaxial,adaxial,arrangement,bark,bud,center,corolla,form,fruiting,growth,height,history,inflorescence,length,life,na,new,number,ovary,plant,position,prickle,rachi,reproduction,scar,seed,shape,spacing,staman,stem,trichome
359	wfo-0001028370	success	147	81	45	102	36	0.306	1.0-1.7,1/2-2/3,2-4,3-5,3-7,3.5-5.0,4-10,annual,anther,armed,blade,blue,broadly,brown,capitate,cm,coarsely,dark,deltoid,dm,eglandular,foveolate,glabrous,glandular,green,herb,internodal,lenticular,long,minutely,mm,obovoid,ovate,pentagonal,petiole,pinnatifid,prickly,purple-tinged,ridged,seed,spherical,twice,variously,violet,yellow	-0.6,/3,0.2-0.4,0.8,1.5-2.2,2-8,2.5-2.9,4-11,40-70,5-9-flowere,9-12,accrescent,acicular,acro,across,along,alyx,ample,anthesi,attenuate,ature,base,beneath,berry,branched,broad,bud,calyx,campanulate,densely,developing,dia,difoliate,distinct,divided,dry,eaf,extended,few-rayed,fully,geminat,gland,gland-tipped,hair,hardly,high,incurved,interpetalar,invested,lanceolate,lobe,lon,main,markedly,maturity,narrowly,near,nflorescence,oblong,obtuse,often,one,orolla,per,pinnatisect,plicat,prickle,rounded,ruit,scattered,sessile,short,short-stipitate,simple,slende,slightly,somewhat,sparsely,splitting,spreadingly,stellae,stem,strait,subulate,surrounding,tamen,taprooted,terete,terminal,tightly,tigma,tissue,tub,tube,tyle,ultimate,unti,usually,vary,vein,viscid,ympodial	5-9,abaxial,adaxial,apex,arrangement,colour,corolla,diameter,filament,flower,form,fruit,growth,height,history,inflorescence,leaf,length,life,na,number,ovary,pedicel,peduncle,plant,position,rachi,reproduction,shape,spacing,staman,stigma,style,surface,texture,width
360	wfo-0001028390	success	147	76	50	97	26	0.34	-10,0,0.5,0.5-1,0.5-1.5,0.5-2.5,1-2.5,1-5,1.5-2,1.5-3.5,10-15,5-7,7-8,angled,apart,chartaceous,cm,densely,diameter,elliptic,felty-pubescent,flower,forked,glabrous,globose,mm,orange,ovate,pedicel,peduncle,perfect,petiole,pseudohair,pubescent,rachi,rarely,shrub,simple,sparsely,stellate,stigma,style,subcoriaceous,truncate,unbranched,violet,white,white-pubescent,x,yellow	.5-3.3,1,1-3,1.5-5.5,2,2.5,3-4,3-5,4-11,4-5,6-many-foliat,7,9,abaxially,absen,acute,adaxiall,adaxially,aggregate,apex,apiculate,articulated,axe,base,blade,branched,calyx,cell,connivent,cuneate,curled,cylindrical,deltate,dendritically,dendritically-branched,dense,directed,distall,divided,eaf,eed,eglandular,entire,gland,hair,lanceolate,leaving,less,like,lobe,lon,long,lower,margin,midvein,mixed,moderately,mostly,narrowly,near,nflorescence,nther,obtuse,occasionally,often,orolla,peg,pore,presen,puberulent,pubescen,radiu,ripe,ruit,scar,short,slightly,small,spaced,stalked,ste,stone,subcapitat,subclavate,subcordate,tal,tem,time,tip,triangular,tube,unequally,unit,usually,vary,wide,ympodial	abaxial,adaxial,anther,arrangement,colour,corolla,form,fruit,growth,height,history,inflorescence,leaf,length,life,number,ovary,perennial,plant,reproduction,seed,shape,spacing,subcapitate,surface,texture
361	wfo-0001028399	success	273	97	63	210	34	0.231	.8,5.0,9.1,9.8,abaxially,adaxially,age,anther,apart,apex,arching,attachment,base,chartaceous,cm,corolla,densely,diameter,dry,elliptic,extra-axillary,filament,flattened-orbicular,flattened-reniform,flower,fruit,glabrous,globose,gradually,increasing,lateral,leaf,length,long,mature,mm,moderately,notched,orange,ovate,pedicel,peduncle,petiole,point,position,probably,pubescent,red,reticulate,scattered,short,shrub,simple,spaced,sparse,stellate,stigma,style,surface,toward,well,yellow-tan,young	.3,.4,.5,.5–2.4,/3,0.04,0.06,0.13,0.2–0.3,0.3–0.4,0.3–0.5,0.3–0.6,0.4–0.5,0.4–0.6,0.4–0.7,0.4–0.9,0.5–1.1,0.5–1.3,0.7–1.0,0.7–2.3,0.8–2.5,0.9–1.9,1.0–5.5,1.1–1.4,1.1–1.7,1.2–1.5,1.2–1.7,1.2–2.0,1.3–2.0,1.4–2.4,1.5–2.1,1.6–2.3,1.6–2.5,1.7–2.7,1/2–2/3,1/3–1/2,1/4–1/3,2.0–3.9,2.2–2.6,2.2–2.8,2.2–2.9,2.4–3.2,2.5–11.2,2.8–3.0,3.1–3.8,3.2–3.8,3.4–3.6,4.0–5.4,4.2,4.3,4.4,5,5-merou,5.2–17.8,5.4,5–8,5–9,6.0–6.6,7.0,7–11,8–120,absent,acute,adnate,aequilateral,alyx,anthe,anthesi,apiculate,apparently,appearing,appressed,articulate,attenuate,axe,ba,bark,basal,based,becoming,berry,blade,branch,branching,broad,broad-based,brochidodromous,brown,bud,calyx,capitat,channeled,cunate,deciduous,dehiscent,deltoid,dentate,developed,difoliate,distal,distinct,eaf,eed,either,emerging,entire,erect,exocarp,extending,fertile,filiform,flexed,free,geminat,glandular,glossy,hair,heterostylous,incurved,internodal,internode,interpetalar,intersepalar,juic,lanceolate,large,layer,lobe,lobed,lon,longer,longitudinally,lower,major,many,margin,midpoint,midrib,midvein,minor,minute,narrowly,nearly,nflorescence,oblique,oblong,orolla,per,porrect,porrect-stellate,portion,potentially,prickle,primary,raised,ray,red-orang,reddish,reflexe,restricted,ridge,rigid,rounded,row,ruit,secondary,sessile,shorter,side,sinuate,sinus,slit,sloughing,somewhat,soon,splitting,spread,spreading,stamen,stellae,stellate-pubescent,stem,stipe,stipitate,straight,tamen,tem,thin,time,tip,tissue,translucent,transparent,triangular,truncate,tube,two,ud,unarmed,upper,various,vary,vein,weakly,wide,yellow-ferruginous,ympodia,±90°,±equal,×	0.5-1.3,0.7-2.3,1.0-5.5,1.1-1.4,1.2-1.7,1.2-2.0,1.5-2.1,1.6-2.5,2.2-2.9,5-merous,8-120,abaxial,adaxial,arrangement,capitate,colour,form,growth,height,history,inflorescence,life,na,number,ovary,plant,rachi,reproduction,seed,shape,spacing,staman,texture,width
362	wfo-0001028405	success	149	69	48	101	21	0.322	0.4-0.5,1-9,1.5-6.5,10-11,2,2-3,3-4,4-6,8-15,articulate,branched,cm,conical,corolla,cyme,diameter,dichasial,dichasially,distal,ebracteate,elliptic-lanceolate,flower,forked,green,green-white,half,herbaceous,lanceolate,leaf,mm,monochasial,mucilaginous,odd-pinnate,ovoid,pedicel,peduncle,perennial,petiole,plant,proximal,puberulent,seed,stellate,stigma,style,throughout,yellow,¼	0.5-3,1-4,1.3-8,2-2.5,2-4,3-20,3-6-foliat,3.5-10,3.5-6.5,4-11.5,6-7,7-14.5,9-15,abaxially,absen,acumen,acute,adaxially,apex,apical,apically,apiculate,attenuate,base,calyx,cell,connate,covering,decurrent,dehiscent,digestion,diminishing,dorsally,eaf,edge,eed,elliptic,emoval,enzyme,exceeding,filament,flat,folded,generally,globo,gradually,hair-like,honeycomb,interjected,introrse,lateral,leaflet,living,lobe,lon,long,lower,lunat,make,maturing,nflorescence,nther,oblique,oblong,often,orolla,ovate-elliptic,pair,pattern,perfect,plan,poricidally,rachi,reveal,ruit,seudostipule,short,short-acuminate,short-petiolate,size,slit,specimen,stamen,straight,subsessile,tal,tem,terminal,testal,thick,throughou,toward,tuber-bearing,typically,unit,vary,wall,whit,wide,without,ympodial	anther,arrangement,color,form,fruit,globose,growth,height,history,inflorescence,length,life,ovary,position,reproduction,shape,spacing,stem,surface,texture,white
363	wfo-0001028424	success	253	103	81	172	22	0.32	-3,-9,0-0.5,0-1,0.5,0.7-2,1,2-3,3,3-12,4-12,5-15,5.5-10,abaxially,adaxially,anther,apart,apex,base,broadly,cm,deeply,deltoid-orbicular,densely,diameter,extra-axillary,felty,filament,flexuous,flower,fruit,glabrous,globose,hair,inflorescence,leaf-opposed,length,lenticular,less,light,like,minutely,mm,narrower,occasionally,orange,outline,ovate,pedicel,peduncle,pentagonal-stellate,perennial,persistently,petiole,pitted,prickle,pubescent,rachi,sessile,simple,slender,somewhat,spreading-hirsute,stellate,stellate-puberulent,stellate-pubescent,stem,stigma,stout,style,suffrutescent,surface,tan,thin-textured,truncate,unbranched,weakly,white,white-pubescent,x,yellow	-0.8,-1.2,-28,0.1-0.2,0.15-0.4,0.2-0.35,0.2-0.7,0.3-0.6,0.3-0.7,1-3,1-7,1.5-2.5,1.8-3,1/3-1/2,10-16,12,12-19,2,2-2.5,2-4,2-foliate,3-16,3-5,3-6,3-7,3-8,4-5,4-6,4-7,5-10,5-22,5-8,8-15,8-25,accrescent,acicular,acute,acute-,adaxiall,almost,along,and/or,articulated,ascending,attenuate,axe,ba,blade,branched,broad-based,broader,calyx,campanulate,capitat,capitate-glandular,cauline,closely,coarsely,commonly,connivent,conspicuously,convex,covering,curved,cylindrical,deltoid,dense,dentate,depressed-deltoid,diffusely,directed,distal,distally,distributed,divergently,diverging,eaf,eed,elongate,elongate-lanceolate,entire,equaling,exceeding,female-sterile,fruiting,geminat,gland-tipped,glandular,inserted,interlobal,larger,lateral,laterall,lobe,long,longer,lower,major,margin,midpoint,midrib,mixture,mostly,much,multiple-stemmed,multiseriate,nflorescence,numerous,obsolete,obtuse,obtuse-,often,orolla,ovate-lanceolate,per,perfect,pore,prickly,principal,puberulent,radiu,rarely,ray,recurved,reduced,reflexe,resembling,ripe,round-tipped,ruit,scattered,section,short,short-styled,shorter,side,similar,single-,sinus,size,small,smaller,sometimes,spaced,sparsely,species,stalk,stalked,ste,stellae,strongly,subcordate,tal,tamen,tem,termination,thickened,time,tip,trichome,tube,typically,unarmed,unit,upward,usually,variable,vary,vein,wide,widely,ympodial	abaxial,adaxial,arrangement,capitate,colour,corolla,form,growth,height,leaf,na,number,ovary,plant,position,reproduction,seed,shape,spacing,staman,texture,width
364	wfo-0001028429	success	162	88	63	99	25	0.389	0.2-0.4,1-4,1.5-3,10-11,2-3,2.5-12,2.5-7.5,2.7-3.6,6-18,6-28,abaxially,adaxially,apex,branched,broadly,cm,corolla,cyme,darker,diameter,dichasial,dichasially,distal,ebracteate,elliptical,filament,flower,forked,glabrescent,glabrous,globose,green,green-white,greenish,hair,half,herbaceous,leaf,light,medium,mm,monochasial,narrowly,odd-pinnate,ovate,ovoid,pedicel,peduncle,pentagonal,perennial,petiole,plant,rotate,scattered,seed,slightly,spot,stigma,style,throughout,violet,white,yellow	0.8-1.2,0.9-2.3,1-2.5,1.5-4,10-27,10.5-21,2-1.,2-4,2-8,2.5-4,3-6,3-6-foliat,4-14,5-12,7-7,abaxiall,acumen,acuminate,acute,apical,apically,articulate,base,calyx,cell,connate,cordate,covering,cuneate,dehiscent,digestion,diminishing,dorsally,eaf,edge,eed,emoval,enzyme,especially,exceeding,flat,folded,generally,globo,gradually,hair-like,honeycomb,interjected,introrse,lateral,leaflet,living,lobe,lon,long,long-attenuate,lower,lunat,make,maturing,mucilaginous,nflorescence,nther,oblique,obovate,often,orolla,pair,pattern,perfect,petiolule,plan,poricidally,proximal,reveal,ruit,seudostipule,short,size,slit,specimen,stamen,straight,tal,tem,terminal,testal,thick,throughou,toward,tuber-bearing,typically,unit,vary,vein,wall,wide,ympodial,¼	abaxial,adaxial,anther,arrangement,colour,form,fruit,growth,height,history,inflorescence,length,life,na,number,ovary,position,rachi,reproduction,shape,spacing,staman,surface,texture,width
365	wfo-0001028436	success	150	80	55	95	25	0.367	.5,0.2-0.4,0.5-1,1-3,1.5,1.5-2,10-20,2.5-3,4,5-10,5-8,8-12,absent,anther,apex,brown,center,chartaceous,diameter,dm,dried,edge,elliptic,filament,fine,flower,fruit,glabrous,globose,leaf,linear,margin,membranaceous,mm,moderately,nearly,parallel,pedicel,peduncle,petiole,pubescent,rachi,radiating,raised,ridge,rotate,running,shallow,shrub,stigma,style,surface,unifoliate,white,x	0.5,0.8-1.5,1-2,1-2-celled,1.5-2.5,1st,2-3,2-4,2nd,5-12,5-15,7,abaxially,abundant,acute,adaxiall,adaxially,along,apically,appearance,appearing,axe,base,berry,beyond,blade,calyx,cell,ciliate,cm,connected,cordat,decurrent,deflated,dehiscent,difficult,due,eaf,eed,entire,evaluat,explosively,exserted,flat,frui,fruiting,geniculate,glabrescen,hair,interpetalar,lengt,like,linear-lancolate,lobe,long,lower,lying,much-branched,nflorescence,notch,oblong,often,older,orolla,oung,per,placenta,pointing,presence,pubescen,reaching,rhizomatous,ruit,small,sparsely,stamen,stem,structure,swollen,tal,tamen,taproot,tear,thick,tissue,triangular,tube,two-celled,unbranched,unit,vary,wid,woody,wrinkled,ympodial	abaxial,adaxial,arrangement,colour,corolla,form,growth,height,history,inflorescence,length,life,na,number,ovary,perennial,plant,position,reproduction,seed,shape,spacing,staman,texture,width
366	wfo-0001028465	success	159	80	54	105	26	0.34	0.75,1-4,11-23,2-6,2-9.3,2.4-2.8,3-5,4.5-5.5,8-10,9-19,apex,branched,broadly,cm,corolla,cyme,diameter,dichasial,dichasially,distal,ebracteate,elliptical,filament,flower,globose,green,green-white,half,herbaceous,interpetalar,leaf,medium,mm,monochasial,odd-pinnate,ovoid,pedicel,peduncle,perennial,petiole,plant,puberulent,pubescent,purple,rachi,rotate,seed,spot,stigma,strigose,style,throughout,white,yellow	1-2,1.2-2,1.5-2.9,10,10-24,2,2-3,2-4,2.5-4,3-4,3-6-foliat,3-8,3.8-7,4-1.,4-8,5-7,7-15,abaxially,acumen,acuminate,acute,adaxially,apical,apically,articulate,attenuate,base,calyx,cell,connate,covering,cuneate,decurrent,dehiscent,digestion,diminishing,dorsally,eaf,edge,eed,emoval,enzyme,equal,exceeding,first,flat,folded,forked,generally,globo,gradually,hair-like,honeycomb,interjected,introrse,lateral,leaflet,living,lobe,lon,long,lower,lunat,make,maturing,mucilaginous,nflorescence,nther,oblique,often,orolla,pair,pattern,perfect,petiolule,plan,poricidally,proximal,rarely,reveal,ruit,sessile,seudostipule,short,size,slit,specimen,stamen,straight,tal,tem,terminal,testal,thick,tissu,toward,tuber-bearing,two,typically,unit,vary,wall,wide,ympodial,¼	abaxial,adaxial,anther,arrangement,colour,form,fruit,growth,height,history,inflorescence,length,life,na,number,ovary,position,reproduction,shape,spacing,staman,stem,surface,texture,tissue,width
367	wfo-0001028468	success	255	92	67	188	25	0.263	-5.5,.3-0.4,0.2-0.3,0.4-4,0.5-3,0.5-8,0.6-1.2,0.7-2.5,1.2-1.5,16,5-9,6-9,acute,anther,apart,apex,berry,blue,brown,chartaceous,clavate,cm,corolla,dark,densely,diameter,extra-axillary,filament,flattened,flower,foveate,fruit,glabrous,green,length,light,mm,moderately,narrowly,oblique,oblong-conical,orange,orangish,pedicel,peduncle,petiole,purple,rachi,reticulate,rhombic,rotate-stellate,shrub,simple,stellate-pubescent,stigma,style,subcapitate,subelliptic,subglobose,sublenticular,subreniform,subshrub,surface,unbranched,x,yellow,yellowish	-1.3,-10,-3,-4,-7,.1-0.2,.1-0.3,.1-0.4,.2,.2-0.4,.3,.5,.5-1.5,.5-1.6,.6-1,/10-1/5,/4-1/3,0.05,0.1,0.2-0.6,0.2-1.5,0.4-1,0.5-2,0.5-3.3,0.5-3.5,0.6-2,0.8-3.5,1,1.3-2,1.5-2.2,1.5-3.1,1.6,1/3-1/2,1/5-1/2,2,2-9,2.2-3,2.5-4,2.8-4.1,2/3-3/4,20,3-4,4-6,4-9,5-21,6-10,abaxially,accrescent,acuminate,adaxially,along,appressed,ark,armed,articulated,attenuate,axe,base,becoming,beyond,blade,broad-based,broadly,bu,bud,c.,calyx,campanulate,cauline,central,commonly,compresse,compressed,connivent,d.,decreasing,density,directed,distal,distally,distantly,dry,eaf,eed,ellipsoid,equal,exserted,fruiting,geminat,glabrescent,gradually,gray,greenish,hair,half,increasing,inserted,interpetalar,introrsel,lamin,lateral,laterally,lobe,lobed,long,longer,lower,m.,main,margin,midpoint,midvein,minutely,mixed,mostly,multangulat,multangulate,nflorescence,oblong-lanceolate,obtuse,occasionally,older,orolla,ovate,overlapping,ovoid,pair,pale,papillo,per,perfect,pore,porrect-stellate,prickle,proximal,pubescence,pubescent,ray,recurved,reduced,relatively,ruit,sessile,shallowly,short,short-,short-stalked,side,similar,similarly,slightly,somewhat,spaced,sparsely,specimen,stalk,stamen,stelliform,stem,straight,subacuminate,subchartaceous,subcuneate,subsessile,tal,tamen,terete,testa,thick,thick-stalked,thicknes,time,tissue,touching,toward,triangular,tube,unarmed,unifoliate,unit,upper,usually,vary,vein,way,wide,ympodial,young	0-1.3,0.5-1.5,4-10,abaxial,adaxial,arrangement,colour,form,growth,height,history,inflorescence,leaf,life,na,number,ovary,plant,position,reproduction,seed,shape,spacing,staman,texture
368	wfo-0001028470	success	185	79	53	132	26	0.286	0.25-0.75,1-12.3,1-2,12-44,2.1-3.9,3-10,3-5,3.5-16,4-7,6-33,anther,apex,articulated,berry,chartaceous,clavate,cm,corolla,dark,deep,diameter,dot,elliptic,filament,flower,forked,fruit,glabrous,green,greenish,herb,leaf,light,medium,mm,mucilaginous,odd-pinnate,ovate,ovoid,pedicel,peduncle,pentagonal,petiole,plant,rounded,seed,stigma,style,substellate,terminal,white,whitish,yellow	0-18,0.9-2.2,0.9-2.3,1-3,1.5-2.8,1.6-3.2,11.8-21,2-10,2-5,2-7,2-8,3.2-5.5,3.5-7,4-6,5-merou,5.5-11.6,abaxially,acumen,acute,adaxiall,adaxially,ag,alyx,apart,apparently,asymmetric,attenuate,axe,axillary,base,basiscopic,blade,brownish,bud,capitat,cell,condition,connivent,covering,decreasing,digestion,distal,dorsally,drying,eaf,edge,eed,end,enzyme,erec,exceeding,flat,folded,fresh,geminat,generally,glabrescent,glabrou,green-white,hair,hair-like,hal,half,high,homostylous,honeycomb-shaped,interjected,lanceolate,lateral,leaflet,lengthening,living,lobe,long,lower,make,mottled,nflorescence,one,orbicular,orolla,pair,perfect,petiolulate,placed,plurifoliate,pore,poricidal,pubescent,purple,removed,ripe,ruit,scarce,sessile,seudostipule,short,side,size,slit,sometimes,spaced,specimen,stamen,stolo,straight,subequal,subglabrou,subtending,tall,tamen,tem,testal,thick,throughout,tip,tissue,toward,tri-,tube,tuber,typically,unit,unwinged,usually,vary,wall,wet,wide,wing,x,ympodial	abaxial,adaxial,arrangement,capitate,colour,form,growth,height,hermaphroditic,history,inflorescence,length,life,na,number,ovary,perennial,position,rachi,reproduction,shape,spacing,staman,surface,texture,width
369	wfo-0001028476	success	246	95	73	173	22	0.297	-1,-6,0.2-0.5,0.4-0.6,0.4-1.5,0.5,0.8-1.2,0.8-1.6,1,1-4,1.8-2.5,5-15,8-30,abaxially,acuminate,acute,anther,apex,bifurcate,branched,bright,brown,capitate,cell,cm,conical,corolla,dark,diameter,elliptic,filament,flower,fruit,globose,green,hair-like,herb,imparipinnate,inflorescence,interrupted,lateral,leaf,less,minutely,mm,narrowly,obovate,outgrowth,ovary,pale,pedicel,peduncle,perennial,petiole,pubescent,purple,rachi,regularly,simple,sparsely,stellate,stigma,stripe,style,surface,testa,trichome,uniformly,uniseriate,usually,wall,weak-walled,yellow	-16,-20,-8,.05-0.1,.5,0-,0-0.5,0.1-0.15,0.1-0.4,0.15-0.2,0.15-0.4,0.2-0.3,0.2-0.6,0.25-0.4,0.25-0.5,0.3-0.4,0.3-0.5,0.3-0.7,0.3-1.2,0.4-0.5,0.5-0.6,0.5-1.7,0.7-2.5,1-1.2,1-1.4,1-1.5,1-2,1-2-celled,1-6,1-celled,1.1-1.5,1.1-1.6,1.2-2.5,12-30,2,2-6,2-foliate,2-locular,2.4-3,3-12,3-7,3-foliate,3.5-13,4-celled,6-,7-10,absent,abundant,acroscopically,age,almost,along,also,alternate,anthesi,ape,apical,appearance,appendage,articulated,axi,basal,base,basiscopically,becoming,bifurcation,bract,bracteate,calyx,column,curved,decurrent,deeply,diamete,distal,eaf,ebracteate,edicel,eed,elongate,entire,especially,exserted,first,fortaleza,fruiting,give,glabrescent,glandular,gradually,gree,hal,half,head,hyaline,incurved,interjected,internode,irregularly,lanceolate,largest,leaflet,like,lobe,lobed,lon,long,lower,main,margin,maturity,midvein,minute,mixed,nflorescence,node,numerous,oblique,occasionally,often,pair,petiolule,population,present,primary,prominent,pseudostipule,puberulent,pubescence,rarely,recurve,reflexed,rest,rounded,ruit,río,scattered,secondary,sessile,set,short,silky,sinus,slightly,smaller,sprawling,spreading,staminal,stem,sterile,stiff,straight,subopposite,tall,tem,terminal,tertiary,thick,tip,toward,truncate,tube,ud,unicellular,unit,unpaired,vein,white,wid,wide,winged,woody,ympodial	6-30,abaxial,adaxial,arrangement,colour,form,growth,height,history,length,life,na,number,plant,position,reproduction,seed,shape,spacing,staman,texture,width
370	wfo-0001028478	success	267	102	70	197	32	0.262	.2,.8,0.0,2,3.4,abaxially,adaxially,anther,apart,apex,attachment,base,bilobed,cm,corolla,deeply,densely,developed,diameter,dry,elliptic,filament,flattened-orbicular,flower,fruit,glabrous,globose,interpetalar,lanceolate,leaf,length,long,mature,mm,moderately,nearly,notched,obtuse,orange-red,ovate,pedicel,peduncle,petiole,pitted,point,poorly,pubescent,scattered,shallowly,shoot,short,shrub,simple,slightly,spaced,sparsely,stellate,stigma,straight,style,sub-coriaceous,suborbicular,surface,terminal,tissue,toward,well,white,yellow,yellow-tan	.0,.04,.3,.5,.9,0.1,0.2,0.2–0.4,0.3–0.4,0.3–0.5,0.4,0.4–0.5,0.5–0.6,0.5–0.8,0.5–0.9,0.6–1.3,0.9–1.1,1.0–1.3,1.0–1.5,1.1–1.6,1.3–1.6,1.4–2.3,1.4–4.4,1.5–2.4,1.5–4,1.8–2.0,1/2–1/3,2.0–11.0,2.1–2.3,2.2–4.0,2.3,2.5,3.3–4.9,3–6,4,4.6,4.6–7.0,4.8,4–6,4–7,5-merou,5.5–6.6,7,7.7–9.2,acuminate,adjacent,adnate,aequilateral,ag,alyx,anthesi,apical,apparently,appearing,appresse,around,articulate,attenuate,axe,ba,bark,based,berry,blade,borne,broad,broad-based,broadly,brochidodromous,brown,bud,calyx,capitat,channeled,clinate,connivent,deciduous,deflexed,deltate,development,difoliate,directed,distal,distally,distinct,distinctly,eaf,edge,eed,either,emerging,endocarp,entire,erect,exocarp,extending,fertile,filiform,flexed,free,geminat,glandular,glossy,gradually,hair,hort,increasing,incurved,individually,internode,intersepalar,juic,lateral,layer,lobe,lobed,lon,longer,lower,margin,markedly,midpoint,midrib,midvein,minute,nflorescence,oblique,oblong,occasionally,opaque,orolla,per,perforated,pore,porrect,porrect-stellate,portion,potentially,presen,prickle,probably,raised,ray,reddish,retrorse,rigid,rounded,row,ruit,seen,sessile,side,sigmoid,sinuate,sinus,sloughing,smoot,somewhat,soon,spatulate,splitting,spread,stamen,stellae,stellate-pubescent,stem,stipe,stipitate,strongly,sub-cordate,suture,tamen,tem,thin,time,tip,transparent,triangular,truncate,tube,two,typically,ud,unarmed,unbranched,various,vary,vein,wide,yellow-ferruginou,ympodia,young,±45°,±90°,±equal,×,–10	1.0-1.5,1.1-1.6,1.3-1.6,1.4-2.3,2.0-11.0,3-6,4.6-7.0,7.7-9.2,abaxial,adaxial,arrangement,capitate,colour,form,growth,height,history,inflorescence,life,number,ovary,perennial,plant,position,rachi,reproduction,seed,shape,spacing,staman,texture,unknown
371	wfo-0001028481	success	194	118	100	94	18	0.515	.1,.5,0.15,0.6-1,0°,1-3,1-4,1.5,1.8-2.5,3-4,3-6,8,acuminate,acute,almost,along,anther,apex,apically,attenuate,bark,base,branch,branched,brown,chartaceous,clavate,cm,colour,conical,corolla,cuneate,cupular,deltoid,dendritic,dendritic-pubescent,diameter,distributed,drying,elliptic,entire,evenly,flaking,glabrous,green,leaf,length,less,liana,like,lobe,lobed,long,long-acuminate,longitudinally,main,margin,midvein,mm,narrowly,oblong,occasional,often,orange-brown,pair,pedicel,peduncle,petiole,primary,pubescent,ray,reddish,ridged,scar,shortly,shrub,side,size,slender,small,smoothly,sparsely,stem,stigma,stump,style,surface,terminal,tertiary,thickly,trichome,unarmed,unknown,vein,venation,visible,white,x,yellowish,young	.3,0-2,0.1-0.2,0.5-1,1-1.4,1-2,1.5-2,1/2-2/3,2-3,2.5-3,3,3-3.5,3-4.5,5.5-7.5,abaxially,absent,adaxially,age,alyx,anthesi,apar,apparently,articulated,canaliculate,clearly,close,deeply,delineated,density,different,dilated,discolorous,divided,domatia,dorsifixed,dry,eaf,eed,ellipsoi,equal,erect,except,extending,extent,eye,faint,filament,flat,flexuous,flower,free,increasing,know,known,lamina,lengthening,linear,lon,longer,lower,m.,mostly,naked,nflorescence,nther,oblique,orolla,ovate,perfec,plurifoliat,pore,poricidal,portion,protruding,rachi,raised,ribbed,ruit,see,simple,sinus,smoot,spreading,tearing,tip,together,toward,tube,ud,uneven,unit,vary,wide,ympodial	angle,apart,arrangement,branching,bud,calyx,ellipsoid,form,growth,inflorescence,number,ovary,shape,smooth,spacing,texture,thicknes,ye
372	wfo-0001028482	success	224	135	108	116	27	0.482	.1,/3,0.5-1,0.5-5,00,1-11,1-2,1-4,1.1-5,10,2-3,2-celled,3-4,4-5,6-50,abaxially,acuminate,acute,angled,anther,anthesi,apex,bark,base,becoming,bilobed,bright,brownish,bud,calyx,campanulate,capitate,closely,cm,coriaceous,corolla,creamy,cymose,densely,diameter,distinct,dry,ellipsoid,elliptic,emarginate,entire,exfoliating,filament,flattened-reniform,fleshy,flower,fresh,fruit,fruiting,glabrous,glandular,globose,green,growth,hard,heterostylous,internodal,leaf-opposed,lobed,margin,material,maturity,minute,minutely,mm,new,nodding,obovate,ovary,pale,pedicel,peduncle,pentamerous,petiole,pitted,pubescent,reddish,revolute,row,scar,simple,spaced,sparsely,stem,stigma,style,subglobose,subpyramidal,surface,tan,transparent,tree,trichome,tuft,two,uniseriate,way,white,x,yellow,yellowish,young,µm	.5,0,0.2,0.5,0.7-1.1,1-1.5,1.2-1.6,1.5-2,1.5-3,3-12,5-25,7-14,adaxially,age,alternate,apiculae,ascending,asymmetric,basal,berr,berry,bifid,bifurcate,branched,broadly,brochiodromous,channeled,chartaceous,circinate,constriction,corky,corrugated,cucullate,curved,deciduous,deflexed,deltate,diffusely,difoliate,discolorous,distally,drying,eaf,eed,embryo,enlarged,exerted,expanding,free,geminat,glabrou,golden,grayish,halfway,impressed,incrassate,individual,investing,irregular,keeled,lengthening,less,lobe,long,lower,markedly,materia,midrib,midvein,nflorescence,occasionally,olive,overlappin,pair,papillat,per,pericarp,petal,pore,poricidal,portion,primary,ruit,scandent,shaped,shiny,short,size,slightly,slit,small,sometimes,somewhat,soon,stout,straight,subcoriaceous,tear-drop,tightly,tiny,tip,transversely,truncate,tub,tube,tuberculate,twice,ud,unifoliate,unit,usually,vegetative,vein,venation,woody,ympodial	abaxial,adaxial,arrangement,cell,center,colour,form,height,history,inflorescence,leaf,length,life,na,number,perennial,plant,position,prickle,rachi,reproduction,seed,shape,spacing,staman,texture,width
373	wfo-0001028487	success	195	107	82	113	25	0.421	0.3-0.7,0.9-3,1-2,10-4.3,10-41,15-28,2.5-3.5,3-10,3-19,3-5,5-6,abaxially,acuminate,acute,adaxially,anther,apex,axillary,berry,brownish,bud,cell,central,clavate,cm,condition,coriaceous,corolla,covering,dark,deep,diameter,drying,elliptic,filament,flower,forked,fresh,fruit,glabrescent,glabrous,green,green-white,greenish,hair,hair-like,herb,lateral,leaf,light,make,medium,mm,mucilaginous,odd-pinnate,ovate,ovoid,pedicel,peduncle,pentagonal,petiole,plant,purple,ripe,scabrous,scarce,seed,short,star,stigma,style,substellate,subtending,terminal,testal,thick,throughout,wall,wet,white,whitish,yellow	0-9,0.4-1.5,1-3,1-3.2,1.1-1.5,1.4-1.7,1.7-7,2-4,2-4.8,2-6,3-4,3.4-7.8,4-7,4.6-13.6,5-merou,7.8-16.4,acumen,adaxiall,ag,along,alyx,apart,apparently,arranged,articulated,asymmetric,attenuate,axe,base,basiscopic,bead,blade,capitat,connivent,considerably,decreasing,digestion,distal,dorsally,eaf,edge,eed,enzyme,erec,exceeding,flat,folded,geminat,generally,glabrou,hal,half,high,homostylous,honeycomb-shaped,interjected,lanceolate,leaflet,lengthening,like,living,lobe,long,lower,moniliform,multiple,narrow,necklace,nflorescence,orbicular,orolla,pair,perfect,petiolulate,plurifoliate,pore,poricidal,removed,rounded,ruit,second,sessile,seudostipule,side,size,slit,smaller,sometimes,spaced,specimen,stamen,stolon,straight,subequal,subglabrou,tall,tamen,tem,tip,tissue,toward,tri-,tube,tuber,typically,unit,unwinged,usually,vary,wide,wing,x,ympodial	abaxial,adaxial,arrangement,capitate,colour,form,growth,height,history,inflorescence,length,life,na,number,ovary,perennial,position,rachi,reproduction,shape,spacing,staman,surface,texture,width
374	wfo-0001028489	success	224	102	76	148	26	0.339	-10,-2.5,/4,0-3,0.3-0.5,0.3-1,0.3-1.2,0.5-1.1,0.5-1.5,1-3,1-6,1.5-4,1/3,2-6,3.5-6,5-merous,abaxially,anther,apex,articulated,base,berry,cell,chartaceous,cm,cream,dark,densely,diameter,dull,elliptic,erect,filament,flattened-reniform,flower,fruit,glabrous,green,lateral,leaf,length,lobed,marking,maturity,mauve,membranous,mm,moderately,orange,orange-brown,outline,ovate,pale,pedicel,peduncle,petiole,purple,raised,red-brown,shiny,shrub,simple,smooth,sometimes,sparsely,spherical,stellate-pubescent,style,surface,upper,way,weakly,white,yellow,yellow-green,young	-0.6,-4,-5,-6,0-10,0-15,0-20,0-50,0.1,0.1-0.6,0.2,0.2-,0.2-0.4,0.2-0.5,0.2-0.6,0.2-0.7,0.3-0.7,0.4-0.8,0.5-0.8,0.5-1,0.6-1.2,0.7-3,1-4,1-7,1.5-3,1.8-2.2,1.8-4,1.8-5.5,1/3-1/2,1/4-1/2,2-3,2-4,2.1-3,3-7,4-10,4-13,4-8,5-25,5-8,7.5,acicular,acute,alyx,apar,apart,apically,apparently,ba,bark,beyond,blade,branched,broad-deltate,calyx,caudat,concolorous,connivent,cordate,cuneate,curved,deltate,difoliate,distance,drying,eaf,eed,elongating,equal,extending,eye,free,fruiting,geminat,gray,hair,herbaceous,infructescence,less,lobe,lon,long,longer,lower,margin,mature,midpoint,midvein,minute,naked,nflorescence,obtuse,occasionally,often,older,one,open,orange-green,orolla,oung,pair,pendulous,per,perfec,pericarp,perpendicular,poricidal,porrect,portion,prickle,prickly,primary,protruding,ray,rounded,ruit,scar,sessile,side,slender,spaced,spreading,stalk,stellate,stem,straight,subsessile,tamen,tapering,terete,tertiary,time,tip,toward,trichome,truncate,tube,unarme,unarmed,unit,vary,vein,venation,visible,white-gra,wide,woody,yellow-orange,ympodial	abaxial,adaxial,arrangement,colour,corolla,form,growth,height,history,inflorescence,life,na,number,ovary,perennial,plant,position,rachi,reproduction,seed,shape,spacing,staman,stigma,texture,width
375	wfo-0001028492	success	130	80	49	81	31	0.377	0.2-2,0.5-1,1-2.5,1-4,1-5,1.5-2.5,1.5-6,2-2.5,3,5-15,5-8,6-11,acute,angled,apart,apex,chartaceous,cm,colored,dark,diameter,elliptic-ovate,forked,fruit,glabrous,globose,herb,mm,pedicel,peduncle,petiole,pubescent,purple,rachi,rarely,reticulate,ripe,shrub,simple,spaced,stellate,stigma,style,unbranched,unevenly,unknown,white-punctate,whitish,x	-5-foliat,1.5-3,1.75-3.5,15-20,2-3,2-4,2-5,2.5-9,3-6,4,5-25-flower,6-12,8-15,abaxially,absen,adaxially,aggregate,apiculate,articulated,axe,axi,base,blade,calyx,cell,ciliolate,color,connivent,containing,crystal,cylindrical,deltate,directed,distall,eaf,eed,entire,except,glabrou,hair,irregularly,leaving,lobe,long,lower,margin,narrowly,nflorescence,nther,obtuse,orolla,pore,punctate,radiu,rounded,ruit,san,sand-punctate,scar,somewhat,sparse,splitting,stone,subcordate,subcoriaceous,succulent,tal,tem,time,tip,triangular,triangular-ovate,truncat,tube,unit,vary,veiny,white,wide,x1-3,ympodial	5-25,abaxial,adaxial,anther,arrangement,colour,corolla,filament,flower,form,growth,height,history,inflorescence,leaf,length,life,na,number,ovary,perennial,plant,position,reproduction,seed,shape,spacing,staman,surface,texture,truncate
376	wfo-0001028501	success	195	103	79	116	24	0.405	0-3.2,0.3-0.7,1-2,1.8-10.7,13-41,2.8-18,2.8-4.9,3-10,3-5,4-8,8-34,abaxially,adaxially,anther,apex,axillary,brownish,bud,cell,clavate,cm,condition,coriaceous,corolla,covering,dark,diameter,drying,elliptic,filament,flower,forked,fresh,fruit,glabrescent,glabrous,green,green-white,greenish,hair,hair-like,herb,lateral,leaf,light,make,medium,mm,mucilaginous,odd-pinnate,ovate,ovoid,pedicel,peduncle,petiole,plant,pyriform,rachi,ripe,rotate,scarce,seed,short,simple,sometimes,spot,stigma,style,subtending,terminal,testal,thick,throughout,usually,wall,wet,white,whitish,yellow	0-3,0-4,0.3-3.3,0.6-5.8,0.8-1.6,0.8-1.7,1,1-3,1-8,2-4,2-5,3-7,3.1-10.4,3.1-12,4.8-18,5-merou,6.6-21.1,8-10,acumen,acuminate,acute,adaxiall,ag,along,alyx,apart,apparently,arranged,articulated,attenuate,axe,base,bead,berry,blade,broadly,capitat,connivent,considerably,decreasing,decurrent,digestion,distal,dorsally,eaf,edge,eed,enzyme,erec,exceeding,flat,folded,geminat,generally,glabrou,hal,half,high,homostylous,honeycomb-shaped,interjected,lanceolate,larger,leaflet,lengthening,like,linear,living,lobe,long,lower,moniliform,mottled,multiple,narrow,narrowly,necklace,nflorescence,onto,orbicular,orolla,pair,perfect,plurifoliate,pore,poricidal,present,purple,removed,ruit,sessile,seudostipule,size,slit,spaced,specimen,stamen,stolon,straight,subglabrou,tall,tamen,tem,tip,toward,tri-,tube,tuber,typically,unit,unwinged,vary,wide,wing,x,ympodial	abaxial,adaxial,arrangement,capitate,colour,form,growth,height,history,inflorescence,length,life,na,number,ovary,perennial,position,reproduction,shape,spacing,staman,surface,texture,width
377	wfo-0001028502	success	158	78	51	107	27	0.323	0.5-1,1-2,1.5-2,1.5-2.5,1.6-2.4,2-7,2-8,3.5-4,5-15,abaxial,abaxially,adaxially,anther,apex,beige,clavate,cm,corolla,densely,elliptic,filament,flattened-reniform,fleshy,flower,glabrous,globose,inflorescence,later,lateral,leaf,lobed,minutely,mm,ovary,papillose,pedicel,petiole,pitted,pubescent,reddish-brown,seed,shining,shrub,small,stigma,style,surface,terminal,tree,white,woody	.5,/2,1.5-3,1.5-6,2-2.5,2-4,2-5,3.5-15,5-6,6-8,?,acute,age,along,anthesi,apar,ba,bark,base,blade,body,branch,branched,brown,calyx,campanulate,cazalet,christmas-tree-like,closely,cone,congested,constricted,dark,deltate,dendritic,denser,dia,eaf,edicel,eed,erect,exserted,fawn,fide,flat,free,fruiting,glabrat,heteromorphic,impressed,included,incrassate,inflorescenc,lengthening,light,like,lobe,lon,long,long-styled,lower,main,margin,matted,middle,narrower,nflorescence,obovate,often,older,packed,pair,papillo,planar,plurifoliat,pore,poricidal,portion,prominent,rest,ruit,scar,scattered,short-styled,slit,spaced,stem,structure,tall,thick,time,tip,tree-like,trichome,tub,tube,ud,unclear,unevenly,vein,warty,way,wide,widest,within,ympodia,young	4-6,adaxial,apart,arrangement,colour,diameter,form,fruit,growth,height,history,length,life,na,number,peduncle,perennial,plant,plurifoliate,position,rachi,reproduction,shape,spacing,staman,texture,width
378	wfo-0001028505	success	168	66	40	128	26	0.238	.3,.5,0.8-1,0.8-1.5,1-3,anther,apex,bright,cm,corolla,filament,gently,glabrous,globose,green,leaf,lobed,minutely,mm,narrowly,opposite,ovary,ovate,ovoid-reniform,papillose,pedicel,petiole,pitted,plant,pubescent,seed,shape,shrub,simple,stigma,style,surface,tan,tapering,white	.01,.1,/3,0.25-0.5,1,1.2-2.5,1/3,10-14-flowered,10-15,2,2.5-4.5,3-5,3.5-5,7-8,acuminate,acute,anthesi,aspect,ba,barely,bark,basal,base,beneath,berry,black,blade,body,branch,broadly,bud,calyx,characteristic,conical,darker,deciduous,decurrent,deflexed,delicate,deltoid,dia,differentiated,differing,difoliate,distance,distinct,dried,dry,drying,eaf,edicel,eed,elliptic,erect,expanded,exserted,exsertion,f,flattened,free,fruiting,geminat,greatly,grey,incrassate,lateral,live,lobe,lon,long,lower,m.,main,major,margin,materia,material,member,minor,minute,nflorescence,obovoid,obvious,older,overlapping,pair,pale,pore,poricidal,portion,prominent,proximal,purple,reflexed,rounded,ruit,scar,shaped,short,size,slightly,somewhat,soon,specimen,stem,straight,strongly,tall,tear-drop,tip,touching,trichome,truncate,tube,ud,unicellular,uniseriate,unit,usually,vein,way,whit,widest,woody,x,yellowish,ympodial,young	10-14,abaxial,adaxial,arrangement,colour,diameter,flower,form,fruit,growth,height,history,inflorescence,length,life,na,number,peduncle,perennial,position,rachi,reproduction,spacing,staman,texture,width
379	wfo-0001028513	success	240	107	85	155	22	0.354	-17,.3-0.5,0.1-0.15,0.5-0.6,0.5-2,1-2.5,1-4,15-40,2-4,2-5,3-4,30,5-10,8-11,8-15,8-16,abaxially,adaxially,anther,apart,apex,articulated,base,bristly,broadly,brown,close,cm,commonly,densely,diameter,ellipsoidal,extra-axillary,filament,flexible,flower,fruit,glabrous,globose,inflorescence,lavender,leaf,length,lenticular,less,light,mm,often,orange,outline,ovate,pair,pedicel,peduncle,perennial,petiole,pitted,prickly,pubescent,purple,rachi,reaching,rigid,ripe,scabrous,silvery-gray,simple,small,soft,somewhat,sparsely,stellate,stellate-pubescent,stigma,style,surface,texture,thin-textured,tree,trichome,unbranched,variable,white,x,yellow	-0.7,-0.8,-5,-6,.1-1.3,.2,/3,0-0.4,0.1-0.4,0.2-0.8,0.3-0.5,1,1-2,1-3,1.5-5,1/5-1/3,2,2-4.5,2-6,2-foliate,2.75-3.25,20-35,25-45,3-4.5,3.5-4,4-6,4-8,4-locular,4.5-6,5-6,5-9,7-11,8-25,9-11,accrescent,acute,acute-,acute-tipped,adaxiall,along,apiculate,appearing,appressed,approaching,approximately,armed,attenuate,axe,ba,berr,blade,broad,broad-based,bud,calyx,campanulate,capitat,cauline,closely,coarsely,compresse,connivent,cylindrical,deciduous,deltoid,dentate,depressed-deltoid,directed,distal,distall,doubling,eaf,eed,enclosing,entire,erect,exceeding,female-sterile,fruiting,geminat,hair,horizontal,inserted,interlobal,large,larger,lateral,laterally,lignescent,linear-lanceolate,lobe,long,lower,major,many,margin,mature,midpoint,minute,near,nflorescence,numerous,obtuse,obtuse-,one,oriented,orolla,ovate-lanceolate,partially,per,pericarp,persisting,plane,pore,present,prickl,prickle,principal,radiu,rarely,ray,recurved,round-tipped,rounded,ruit,rust-colored,scattered,sessile,short,short-stalked,side,sinus,siz,smaller,spaced,stalk,stellae,subcordate,tal,tamen,tem,termination,time,tooth-like,truncate,tube,unarmed,underdeveloped,unit,usually,vary,vein,weakly,wide,ympodial	abaxial,adaxial,arrangement,capitate,colour,corolla,form,growth,height,history,life,na,number,ovary,plant,position,reproduction,seed,shape,spacing,staman,width
380	wfo-0001028524	success	236	87	62	174	25	0.263	0.3-0.8,0.5-3.5,0.6-1.4,1.5-1.6,2-6,3-15,3-4.3,4-6,4-8,8-13,9-14,acuminate,acute,anther,apex,branched,brown,chartaceous,cm,conical,corolla,cream,dark,deltoid,diameter,filament,flower,fruit,glabrescent,granular-tomentose,green,greenish,growth,honeycombed,lanceolate,leaf,length,mm,orbicular,ovate,pale,pedicel,peduncle,petiole,probably,rachi,reniform,reticulate-punctate,simple,slightly,small,stellate,stigma,style,subcoriaceous,subglobose,suborbicular,tomentose,tree,yellow,yellowish,yellowish-green	-2.7,-3,.5-1,/10-3/10,0-150,0.3,1-5,1.1-1.2,1.2-1.3,1.5-3,1.8-2.5,1/3-2/3,10-20,11,2-3.8,2.5-3.4,2.5-3.8,2.5-4,2.8-3.5,3-10,3.3-4,3.4-3.6,4.3-6,6-7,6-9,7-10,7-11,abaxially,accrescent,adaxially,ag,along,anthesi,apart,apical-lateral,apparently,articulated,ascending,axe,axillary,ba,bark,base,becoming,berry,blade,blunt-tipped,branch,bud,calyx,capitat,closely,continued,dehiscing,densely,distal,dm,due,eaf,echinoi,echinoid,eed,elliptic,entire,exserted,extend,ferrugineous,few-,few-rayed,first,fleshy,free,fruiting,glabrescen,glabrous,gray,hair,half,high,indument,inserted,interpetalar,introrse,lacking,lanceolat,large,late,later,lateral,lobe,lobed,long,longitudinal,lower,m.,main,many-rayed,margin,matted,midvei,midvein,mixed,multangulate,nearly,nflorescence,oblong,obscured,obtuse,often,older,orolla,ovate-lanceolate,overlapping,partly,perfect,persistent,plurifoliate,pore,porrect-stellate,present,prominent,pseudo-terminal,pubescent,rather,ray,relatively,ripe,rounded,ruit,runk,scabridulous,sessile,short,short-stalked,side,slit,somewhat,spaced,sparingly,sparsely,stalked,stamen,stelliform,stem,stout-stalked,strongly,sulcate,suture,tamen,terete,testa,thick,thick-stalked,thin,thin-stalked,time,tissue,tomentu,touching,translucent,tube,unarme,unarmed,unit,usually,vary,vein,velutinous,warty,way,wide,x,ympodial,young	30-150,abaxial,adaxial,arrangement,capitate,colour,form,height,history,inflorescence,life,na,number,ovary,perennial,plant,position,pseudoterminally,reproduction,seed,shape,spacing,staman,surface,texture
381	wfo-0001028525	success	257	114	96	161	18	0.374	.25,0.2-0.3,0.5,0.5-1.5,0.5-2.5,1.1-1.7,10,10-13,1mm,2,2-2.5,3,3-5,3-7,4-5,6,almost,anther,apex,apically,apparently,bark,base,black,branch,branching,brown,capitate,chartaceous,clavate,cm,conical,corolla,dark,dendritic,dendritic-pubescent,developed,diameter,dilated,drying,elongated,flattened,flexuous,flower,form,fruit,glabrescent,glabrous,green-brown,grey,inside,lateral,leaf,less,liana,light,lobed,longitudinally,lumpy,main,mature,mauve,membranous,mm,multicellular-dendritic,obscuring,orange-brown,outside,ovate,partly,pedicel,peduncle,petiole,puberulous,pubescent,pyriform,red-brown,ridged,scattered,shrub,simple,slender,sparsely,spheroidal,stem,stigma,style,surface,terete,terminal,thin,trichome,unarmed,whitish,x,young	.4,0.2-0.6,0°,1-1.5,1-2,1-2.5,1-4,1.2-1.6,1.5,1.5-3,1/3-3/4,2-3,2.5-5,4,4-15,4-7,7,7-13,7.5,accrescent,acuminate,acute,age,along,alternate,alyx,anthesi,apar,apart,apice,around,articulated,attenuate,axil,becoming,berry,brachyblast,branched,broadly,calyx,centre,clearly,clum,clustered,cordate,cup,curved,deeply,delineated,deltoid,densely,density,detaching,developing,discolorous,divided,domatia-like,dorsal,dorsifixed,eaf,eed,ellipsoi,entire,equal,erect,eye,fertilisation,fewer,filament,fine,flat,flexible,formed,forming,free,frequently,frui,fruiting,increasing,known,lamina,laterally,leave,lengthening,like,linear,lobe,long,longer,loop,loose,lower,m.,margin,midvein,minute,much,naked,narrowly,nflorescence,nther,obconical,oblong,often,one,orolla,overlapping,ovoid,pair,pendulous,perfec,pericarp,plurifoliat,pore,poricidal,portion,primary,prominent,protruding,rachi,ray,rounded,ruit,scar,sessile,side,sinus,size,slightly,small,smaller,smoot,smooth,sometimes,somewhat,soon,spreading,stripe,structure,stump,tangling,tearing,tertiary,thick,tip,toward,truncate,tube,ud,uneven,unit,vary,vein,venation,visible,weakly,well-developed,white,wide,wider,ympodial	abaxial,adaxial,arrangement,colour,frequent,growth,inflorescence,length,na,ovary,perfect,position,seed,shape,spacing,texture,width,ye
382	wfo-0001028528	success	155	82	58	97	24	0.374	0.9-1.2,2-4,2.5-3,3/4,4-6,6-10,8-9,abaxial,adaxial,anther,apex,base,bi-lobed,blackish,branch,cm,corolla,decurrent,dendritic,densely,diameter,elliptic,filament,flattened,flower,fork,glabrous,globose,growth,later,leaf,lobed,minutely,mm,narrowly,obovate,outline,ovary,pedicel,pericarp,petiole,pitted,pubescent,pyramidal,reddish-brown,round,shiny,shrub,stem,stigma,strongly,style,surface,terminal,thin,trichome,violet,way	.5,1-2,1.1-1.2,1.5,1.8-2,2-3,3.5-4,3.5-6,4-5,6-7,?,absent,acuminate,acute,adaxially,age,along,anthesi,apical,attenuate,ba,bark,basal,becoming,berry,branching,calyx,conical,coriaceous,denser,dichasia,eaf,edicel,eed,erect,ew,except,exserted,free,fruiting,glabrat,glandular,immature,impressed,inserted,leave,like,lobe,long,lower,m.,margin,midvein,minute,mucronate,nflorescence,nodding,occasionally,older,pair,papillo,per,petal,planar,plurifoliate,pore,poricidal,portion,prominent,revolute,ruit,scar,secondary,short,sleeve,slit-like,somewhat,sparsely,stamen,ste,tall,tapering,time,tip,triangular,tub,tube,ud,unit,vein,white,wide,winged,woody,x,ympodial,young	2,4.5,arrangement,colour,form,fruit,height,history,inflorescence,length,life,na,number,peduncle,plant,position,rachi,reproduction,seed,shape,spacing,staman,texture,width
383	wfo-0001028529	success	164	81	56	108	25	0.341	0.1,0.5-2,0.8-1.3,1,1-1.2,1-1.5,2.5-3,5-6,anther,apart,apex,bluish,brown,capitate,cast,cm,corolla,filament,flower,furcate,glabrous,globose,green,internodal,lanceolate,leaf,less,lobed,metallic,minutely,mm,narrowly,nearly,oblanceolate,occasionally,opposite,ovary,ovoid-reniform,papillose,pedicel,petiole,pitted,shape,shrub,simple,smooth,somewhat,stigma,style,subshrub,surface,tapering,white,winged,x,yellowish	.2,0.5,0.8-3,0.8-3.2,1.5,2/3,3-40-flowered,3-5,6-9,7-8,8-14,across,acuminate,acute,age,anthesi,apiculate,attenuate,bark,base,becoming,beginning,beneath,berry,bud,calyx,close,cork,course,dark,decurrent,deflexe,deltoid,dia,distal,eaf,edicel,eed,ellipsoi,elliptic,erect,evenly,exfoliating,exserted,free,fruiting,growing,heterostylous,hrub,hyaline,immature,indistinct,inflorescenc,lateral,lenticellat,linear,lobe,lon,long,lower,main,major,middle,minor,minute,much,nflorescence,older,one,pair,paler,papillae,papillo,planar,pore,poricidal,portion,present,prominent,range,reflexed,river,ruit,scar,scattered,shaped,short,size,slender,slightly,small,soon,spaced,species,stem,straight,tall,tear-drop,tip,tube,ud,umbonate,variable,vein,way,widest,woody,young	3-40,abaxial,adaxial,colour,diameter,form,fruit,growth,height,history,inflorescence,length,life,na,number,peduncle,plant,position,rachi,reproduction,seed,spacing,staman,texture,width
384	wfo-0001028532	success	186	90	65	121	25	0.349	0.2-1,1-2,1-3,1.3-8.7,15-36,17-42,2.2-4.2,3-10,3-5,4-7,5.5-15,abaxially,adaxially,anther,apex,brownish,cell,chartaceous,clavate,cm,condition,corolla,covering,dark,deep,diameter,drying,filament,flower,forked,fresh,fruit,glabrous,globose,green,greenish,hair-like,herb,lateral,leaf,medium,mm,odd-pinnate,ovate,ovate-lanceolate,ovoid,pedicel,peduncle,pentagonal,petiole,plant,purple,rotate,seed,sometimes,spot,stigma,style,terminal,testal,thick,wall,white,whitish,yellow	0-19,1-1.6,1-1.7,1-5,1.4-1.6,2-3,2-6,2-8,3-7,3.3-4.4,3.9-5,5-9,5-merou,6.5-9.2,7.5-15.2,abaxiall,acumen,acuminate,acute,ag,along,alyx,apart,apparently,arranged,articulated,asymmetric,attenuate,axe,axillary,base,basiscopic,bead,berry,blade,bud,capitat,connivent,decreasing,digestion,distal,dorsally,eaf,edge,eed,enzyme,erec,exceeding,flat,folded,geminat,generally,glabrou,green-white,half,homostylous,honeycomb-shaped,interjected,lanceolate,larger,leaflet,lengthening,like,linear,living,lobe,long,lower,make,middl,moniliform,mottled,mucilaginous,multiple,necklace,nflorescence,orbicular,orolla,pair,perfect,petiolulate,plurifoliate,pore,poricidal,removed,ripe,rounded,ruit,second,sessile,seudostipule,side,size,slightly,slit,spaced,specimen,stamen,stolon,straight,subequal,subtending,symmetric,tall,tamen,tem,throughout,tip,tissue,toward,tri-,tube,tuber,typically,unit,unwinged,usually,vary,wet,x,ympodial	abaxial,adaxial,arrangement,capitate,colour,form,growth,height,history,inflorescence,length,life,na,number,ovary,perennial,position,rachi,reproduction,shape,spacing,staman,surface,texture,width
385	wfo-0001028546	success	239	88	68	171	20	0.285	0-1,0.5-0.75,0.5-2,1-2,1-3.5,1-7,1.1-2.2,1.5-1.75,1.5-2,2-3.5,4-13,4.5-6,7-24,7.5-10,acuminate,acute,andromonoecious,anther,apex,capitate,chartaceous,cm,cylindrical,diameter,ellipsoidal,erect,extra-axillary,filament,finely,flattened,flower,fruit,glabrous,globose,inflorescence,leaf,length,mm,moderately,pale,pedicel,peduncle,pendent,perennial,petiole,plant,pseudo-racemose,purple,rachi,red,reticulate,rhizomatous,rotate,shrub,simple,slightly,sparsely,stellate,stellate-pubescent,stigma,style,surface,tan,unbranched,weakly,white,x,yellow	%,0-0.1,0-0.5,0-18,0-9,0.15-0.25,0.3-0.5,0.3-1,0.4-0.5,0.5-1,0.5-1.3,0.5-1.5,0.6-2,0.8-1.4,1-3,1-4,1-locular,1.1-1.8,1.5-6,10-14,10-22,100-150,11-12,120-400,16-24,2-,2-4,2-9,2.3-2.7,2.5-3,2.6-3.4,26-38,3-,3-11,3-4,3-5,3-7,3.5-19,3.5-7.5,4-8,4-9,5-10,5-55,5-8,5-merou,6-10,8-15,8-40,9-16,9.5-19,9.5-24,abaxially,absen,absent,accrescent,acicular,across,adaxially,adult,also,alyx,ample,apart,apparen,articulated,attenuate,axe,ba,base,bilobe,blade,branch,branche,brown,calyx,connivent,cuneate,deeply,directed,distall,distally,distributed,dm,eaf,eed,eglandular,elliptical,exocarp,finger,foliate,fruiting,functional,geminat,gland-tipped,green,hair,half,heterostylous,incomplete,index,interpetalar,juicy,juvenile,lamina,lanceolate,lateral,less,lobe,lobed,lobing,long,longer,lower,main,margin,markedly,mature,mesocarp,mid-point,midpoint,midvein,minute,nflorescence,oblique,obtuse,often,orolla,ovate,pair,part,per,pinkish,placenta,pore,porrect,present,prickle,ray,ruit,septum,sessile,shallowly,short,side,somewhat,spaced,stalk,stellae,straight,succulent,tal,tamen,tem,thick,thicker,thicknes,throughout,time,tissu,tissue,triangular,tube,unarme,unarmed,unit,upper,usually,vary,vein,wide,ympodial	5-merous,abaxial,adaxial,bilobed,color,corolla,form,growth,height,history,life,number,ovary,position,reproduction,seed,shape,spacing,staman,texture
386	wfo-0001028547	success	224	91	68	156	23	0.304	.2,.5,.8,/5,1-2.5,1.7-2,2-6,3-5,5-merous,abaxial,abaxially,absent,acute,adaxial,anther,apart,apex,articulated,base,berry,branched,bright,cell,cm,densely,diameter,dull,erect,filament,flattened-reniform,flower,fruit,glabrous,inflorescence,lateral,leaf,length,lobed,long-acuminate,maturity,mauve,mm,moderately,orange,orange-brown,outline,ovate,pedicel,peduncle,petiole,pit,purple,raised,red,shrub,simple,small,smooth,somewhat,spherical,stellate,stellate-pubescent,style,surface,terminal,way,yellow,yellow-green	-1/2,-13,-3,-6,.7,/2,0,0-1,0-10,0-15,0-2,0-30,0-5,0.05-0.15,0.1-0.2,0.15,0.2-0.35,0.3-0.4,0.5-,0.7-1,0.8-1,1-2,1-4,1-5,1.2-1.4,1.5-2.5,1/3,1/5-1/4,10-12,2-1.5,2-2.5,2-4,2.5-2.8,2.8-3.2,3.5-4.5,4-5,4-6,6-8,7-10,7-9,alyx,apar,ape,apically,apparently,appearing,bark,blade,branching,bulbous,calyx,chartaceous,conical,connivent,cream,cuneate,curved,dark,deltate,discolorous,distance,drying,eaf,eed,elongate,elongating,entire,equal,extending,faint,flattened,free,fruiting,gently,glabrescent,glabrou,gray-brow,green,infructescence,lobe,lon,long,long-styled,longer,lower,margin,marking,mature,midpoint,midvein,narrow-deltate,nflorescence,oblong,occasionally,often,older,one,open,orolla,oung,pair,pale,pendulous,per,perfect,pericarp,plurifoliat,poricidal,porrect,portion,prickl,prickle,prickly,primary,ray,reddish,reflexed,rounded,ruit,scandent,scar,sessile,shallowly,short-styled,side,slender,sometimes,spaced,spreading,stalk,stalked,staminate,stem,straight,subsessile,tamen,tapering,terete,tertiary,thin-acuminat,time,tip,trichome,truncate,tube,unit,usually,vary,vein,venation,villous,wide,woody,yellow-orange,ympodial,young	arrangement,colour,corolla,form,growth,height,history,life,na,number,ovary,perennial,plant,position,rachi,reproduction,seed,shape,spacing,staman,stigma,texture,width
387	wfo-0001028548	success	266	100	66	200	34	0.248	.4,.7,.8,.9,0,3.1,4.9,anther,apart,apex,area,attachment,base,brown,calyx,central,chartaceous,cm,corolla,densely,developed,diameter,distal,dry,filament,flattened-orbicular,flower,fruit,glabrous,globose,gradually,growth,lanceolate,lateral,leaf,length,long,margin,mm,nearly,notched,ovate,pedicel,peduncle,petiole,pitted,point,poorly,portion,probably,pubescent,scarcely,short,shrub,simple,smooth,stellate,stigma,straight,style,surface,swelling,unknown,white,yellow,×	.2,.6,.8–2.4,/3,0.06,0.3–0.8,0.4,0.4–0.5,0.4–0.6,0.4–0.7,0.6,0.7–0.8,0.7–1.7,0.8–1.2,0.8–1.9,0.8–2.0,0.8–2.9,0.9–1.2,1.0–4.1,1.1–1.2,1.1–1.4,1.1–1.5,1.3–1.6,1.4–2.3,1.6–2.7,1.7–2.1,1/3,1/3–1/2,2.0,2.2–2.8,2.3,2.4–2.7,2.8,3.1–3.8,3.6–8.1,3.7–4.0,3.8–4.6,4,4–8,5-merou,5.5–6.6,5.6,6.4–19.8,6–10,6–9,90°,abaxially,absent,acuminate,acute,adaxially,adnate,aequilateral,ag,alyx,anthesi,apical,apiculate,apparently,appearing,arching,around,articulate,attenuate,axe,ba,bark,berry,blade,branch,branching,broad,brochidodromous,bud,capitat,channeled,clinate,color,congested,cuneate,deciduous,deltoid,dentate,development,difolate,directed,distinct,eaf,edge,eed,either,elliptic,emerging,endocarp,entire,erect,exocarp,extending,extra-axillary,fertile,filiform,flexed,free,geminat,glandular,glossy,hair,heterostylous,increasing,incurved,intact,internode,interpetalar,intersepalar,juic,juvenile,large,layer,less,lobe,lobed,lon,longer,lower,major,many,mature,midpoint,midrib,midvein,minor,minute,moderately,nflorescence,oblique,oblong,occasionally,opaque,orolla,per,pore,porrect,porrect-stellate,potentially,pubescenc,raised,ray,reddish,reflexe,remaining,rigid,rounded,row,seen,sessile,short-stipitate,shorter,shortly,side,sinus,sloughing,smoot,somewhat,soon,sparsely,splitting,spread,spreading,stamen,stellae,stellate-pubescent,stem,stipe,suture,tamen,tem,thin,time,tip,tissue,transparent,truncate,tube,two,ud,unarmed,unbranched,upper,various,vary,vein,wave,weakly,wide,yellow-ferruginous,ympodia,young,±90°,±equal,±glabrous	0.7-0.8,0.8-1.9,0.8-2.9,0.9-1.2,1.0-4.1,1.1-1.2,1.1-1.5,1/3-1/2,2.2-2.8,5-merous,abaxial,adaxial,arrangement,capitate,colour,form,height,history,inflorescence,life,na,number,ovary,perennial,plant,position,rachi,reproduction,seed,shape,spacing,staman,texture,width
388	wfo-0001028551	success	243	106	83	160	23	0.342	.0,.5,.8,0,0.7–2.3,0.8–1.4,1.0,1.1–1.4,1.4–2.0,1.6–1.7,1/3,2,2.0–3.5,2.0–3.7,2.5,4.2–5.9,4.5–7.0,9.0,abaxially,acuminate,anther,apex,armed,attachment,attenuate,base,broad-based,calyx,chartaceous,cm,corolla,dark,deltate,densely,diameter,dry,elliptic,extra-axillary,filament,flattened-suborbicular,flower,fruit,glabrous,glandular,globose,green,hair,immature,internode,lanceolate,lateral,leaf,long,markedly,maturing,minute,mm,narrowly,nearly,notched,pedicel,petiole,point,prickle,pubescent,red,scattered,shiny,shrub,simple,slender,stellate,stigma,style,subcoriaceous,tan,tree,triangular,upper,white,yellow,±globose,×	.06,.1,.3–0.5,.6,0.4–0.5,0.5–0.6,0.7–1.0,1.0–1.5,1.0–1.6,1.1,1.1–2.2,1.3,1.5–1.8,1.5–1.9,1.7,1.7–2.6,1.8–2.5,2.0–2.6,2.2–3.4,2.2–5.2,2.2–7.5,2.3–3.4,2.75–4.0,3/4,4–6-merou,5–11,7.5–10.5,8.0–11.4,8.0–12.0,8.5–20.5,adaxially,adnate,aequilateral,almost,alveolate,alyx,anthesi,apart,apical,apiculate,apparently,appearing,area,articulated,axe,ba,becoming,berry,blade,branch,brochidodromous,bud,capitat,caudate,central,channeled,closely,conical,connivent,continuing,cuneate,dehiscence,dentate,development,difoliate,distally,distinctly,dorsally,eaf,eed,either,endocarp,enlargement,entir,entire,equal,exocarp,fertile,filiform,forking,free,frui,geminat,glabrou,gradually,homostylous,inclined,increasing,interpetalar,juic,lacking,large,lilac,line,lobe,lobed,lon,longer,lower,major,margin,mature,midrib,midvein,minor,nflorescence,numerous,oblique,oblong,occasionally,orolla,outline,poorly-developed,pore,porrect,portion,potentially,prominent,pseudo-peduncle,ripe,row,ruit,side,sinus,smooth,somewhat,spaced,split,splitting,spread,stamen,stellae,stellate-pubescent,straight,suture,tamen,tem,thin,time,tip,tissue,toward,tube,two,typically,ud,unarme,unarmed,unbranched,vary,vein,violet,wavy,weakly,wide,yellow-ferruginou,ympodia,young,±appressed,–4.8	abaxial,adaxial,armature,arrangement,capitate,colour,form,growth,height,inflorescence,length,number,ovary,peduncle,plant,position,seed,shape,staman,stem,surface,texture,yellow-ferruginous
389	wfo-0001028558	success	224	77	61	163	16	0.272	0.4-1.5,0.5-2,1-1.3,1-9,1.5-2.3,1/3-1/2,1/4,2.4-3,3-8,4.2-7,5-merous,6-7.5,abaxially,almost,andromonoecious,anther,base,berry,branched,cm,cream,dark,densely,diameter,dull,entire,filament,flattened-reniform,flower,fruit,glabrous,green,herb,leaf,length,lobed,long,long-styled,margin,marking,maturity,mauve,mm,often,orange-brown,ovate,pale,petiole,plant,short-styled,shrub,sparsely,spherical,stellate,stellate-pubescent,style,surface,upper,way,yellow,young	-2,-5,.5,/6,0-10,0-30,0-4,0-5,0.1,0.1-0.3,0.1-0.4,0.15-0.5,0.2,0.5-0.9,0.6,0.8-1.5,00-200,1,1-3,1-4,1.3-1.8,1.5-2.5,1.5-3,1.5-6,1.8-2.3,1/3,1/4-1/3,15-60,2-5,2.2-2.8,2.5-3.5,2.5-5,3-,3-50,3-9,3/,4,4-15,4.5-8,5-10,5-60,5-7,6-10,6-20,6-22,6-9,7-10,8-12,acute,adaxially,alyx,ame,apar,apart,apex,apically,apparently,articulated,bark,blade,broad-deltate,c.,calyx,chartaceous,clearly,concolorous,conical,connivent,cordate,curved,deltate,discolorous,distal,distance,drying,eaf,eed,elongated,elongating,equal,erect,extending,flattened,free,fruiting,gently,glabrescent,gra,hermaphrodite,heterostylous,infructescence,lateral,least,lobe,longer,lower,lowermost,mature,midpoint,midvein,moderately,multangulate,narrow-deltate,nflorescence,obtu,older,one,open,orolla,oung,pair,pedicel,peduncle,pendent,pendulous,per,pericarp,plurifoliat,poricidal,porrect,portion,prickl,prickle,prickly,primary,ray,reflexed,rounded,ruit,scar,sessile,side,simple,smooth,spaced,spreading,stalk,stalked,staminat,stem,stout,straight,tamen,tapering,terete,terminal,tertiary,time,tip,trichome,tube,unarmed,unit,variously,vary,vein,venation,visible,weakly,wide,woody,yellowish,ympodial	/,abaxial,colour,corolla,form,growth,height,inflorescence,na,ovary,reproduction,seed,shape,staman,stigma,texture
390	wfo-0001028571	success	230	119	70	160	49	0.304	0.4,2,2.5,abaxially,absent,accrescent,acute,anther,apex,base,broadly,brown,calyx,cell,cm,dark,diameter,elongated,entire,erect,extra-axillary,filament,finely,flattened,flower,fruit,fruiting,glandular-puberulent,globose,highly,length,light,lobe,lobed,margin,minutely,mm,nearly,ovate,pair,pale,pedicel,peduncle,perhaps,petiole,prickle,pubescent,rachi,rounded,shallow,shrub,similar,simple,somewhat,sparsely,spreading,stellate,stem,stigma,straight,style,surface,terete,thin-textured,tip,unbranched,undulate,white,x,yellow	'',.1,.2,.5,/3,0.2–0.4,0.3–0.4,0.3–0.6,0.4–0.8,0.5–1,0.6–0.8,0.6–1.4,0.75–4,0.9–1.7,0–,1,1.1-1.4,1.5–2.4,1.7–2.6,1/2,1/3,10–21,11–12,12,13–25,18,1–1.4,1–1.5,1–2,1–5,2-foliate,2.5–15,2–10,2–3.4,3,3.4–3.7,3.5–16,3–13,3–5-celled,3–7.5,3–8,4-rayed,40–80,4–10,4–15,5,5.2–9.2,5–15,5–8,62,7–16,8–12,8–14,8–15,9,=,``,acicular,adaxially,almost,also,apical,average,axe,ba,bacca,blade,capitat,compressed,contiguou,cordate,cover,curved,cylindrical,dense,densely,differing,dilated,dimorphic,directed,distall,divided,eaf,eed,enlarged,especially,exclusively,extreme,fertile,fewer,free,geminat,geminate,glabrou,gland,gland-tipped,glaziou,hair,half,hyaline,interlocking,lanceolate,larger,linear,long,longer,longest,lower,lutea,marginal,matura,maturing,merely,minute,multangulate,n,narrowly,near,nflorescence,one,orolla,p,per,pore,proportion,pubescence,ray,recurved,ruit,scattered,sessile,size,slender,small,smaller,stellae,stipitate,stout,summit,surrounded,tal,tamen,tem,time,tomentose,triangular,tube,unarmed,unit,usually,variable,vary,varying,vestigial,visible,wide,wing,ympodial,–1.6,–19	0.3-0.6,0.75-4,0.9-1.7,1-1.4,1-2,1-5,1.7-2.6,10-21,11-12,13-25,19,3-8,4-15,5.2-9.2,8-15,abaxial,adaxial,arrangement,bark,bud,capitate,center,colour,contiguous,corolla,form,glabrous,growth,height,history,inflorescence,leaf,life,na,new,number,ovary,perennial,plant,position,reproduction,scar,seed,shape,spacing,staman,texture,trichome,width
391	wfo-0001028583	success	294	117	92	202	25	0.313	.0,.5,.9,0,0.6–0.9,0.8–1.2,1.0–1.2,1.0–2.1,1.1–7.7,1.4–1.9,1.4–4.7,1.5–3.1,1.8–2.3,1/3–1/2,2.6,5.2,6.5–16.0,7.0–1.4,abaxially,adaxially,anther,apart,apex,base,bent,calyx,capitate,central,chartaceous,cm,congested,corolla,deeply,densely,developed,diameter,distal,dry,evenly,extra-axillary,filament,flattened-reniform,flower,fruit,glabrous,globose,gradually,green,increasing,interpetalar,lateral,leaf,lightly,long,margin,mature,mm,moderately,oblong,orange,ovate,pedicel,peduncle,petiole,pitted,poorly,portion,pubescence,pubescent,purple,red,red-brown,scattered,short,shrub,simple,somewhat,spaced,stellate,stigma,straight,style,subcoriaceous,surface,tissue,toward,vein,well,white,yellow,±90°,×	.2,.6,0.01,0.06,0.08,0.13,0.2–0.6,0.3–0.6,0.4,0.4–0.6,0.6,0.6–1.0,0.6–1.3,0.6–2.2,0.8–1.4,0.8–1.5,0.9–1.3,0.9–1.5,1.2–1.9,1.4,1.4–1.5,1.5–2.4,1.9–2.6,1.9–3.2,1/2,1/3,2.0,2.2–3.1,2.3,2.3–6.8,2.5–2.9,2.6–3.7,2.6–4.8,2/3,3.1–4.0,3.2–6.2,3.5–3.8,4,4.3,4–8,5-merou,5.1–15.4,5.2–6.3,5.7,5–9,6.3,6.9–9.2,6–8,absent,acute,adnate,aequilateral,ag,alyx,anthesi,ape,apical,apparently,appearing,appressed,around,articulate,attenuate,axe,ba,bark,basal,based,berry,blade,borne,branch,branching,broad,brown,bud,channeled,craspedodromous,cuneate,deciduous,deltate,deltoid,dentate,difoliate,directed,distinct,eaf,edge,eed,either,emerging,endocarp,erect,exocarp,extending,ferruginous,fertile,filiform,flexed,free,geminate,glandular,glossy,gree,hair,heterostylous,immature,immediately,incurved,individually,intact,internode,intersepalar,juic,lanceolate,large,layer,lobe,lobed,lon,longer,lower,major,many,midpoint,midrib,midvein,minor,minute,narrowly,nearly,nflorescence,oblique,occasionally,opaque,orolla,per,perforated,pore,porrect,porrect-stellate,potentially,present,prickle,primary,raised,ray,red-orang,reddish,reflexed,remaining,restricted,ridge,rigid,rounded,row,ruit,secondary,semicraspedodromous,sessile,several,shorter,shot,side,sinuate,sinus,slightly,sloughing,sparsely,splitting,spread,spreading,stamen,stellae,stellate-pubescent,stem,stipe,stipitate,subacute,suture,tamen,tardily,tem,thin,time,tip,transparent,triangular,truncate,tube,two,ud,unarmed,unbranched,upper,vary,wide,yellow-ferruginous,ympodia,young,±equal,±erect	5-merous,abaxial,adaxial,arrangement,colour,form,growth,height,history,inflorescence,length,life,na,number,ovary,plant,position,rachi,reproduction,seed,shape,spacing,staman,texture,width
392	wfo-0001028587	success	178	78	53	125	25	0.298	.4,.5,0.3-1,0.8-1.8,1-1.3,1-4,6-8,8-10,acuminate,acute,anther,apex,base,brown,closely,cm,corolla,densely,filament,flower,fruit,geminate,glabrous,globose,green,greenish-white,leaf,length,lobed,minutely,mm,nearly,obovate,opposite,ovary,ovate,ovoid-reniform,papillose,pedicel,petiole,pitted,pubescent,pubesent,seed,shrub,slender,spaced,sparsely,stigma,style,subumbellate,surface,white	.75,0,0.3,0.5,0.5-1,0.7-1.2,0.8-1.6,0.8-2.9,1-1.5,1-2,1.3-5.1,1/4,2-5,2.1-6.9,2.5,3-8,6.5-17.7,8-10-flowered,abruptly,accrescent,across,anthesi,bark,baseflower,becoming,berry,ca,calyx,chartaceou,coat,cracking,cup,deflexed,degree,dia,different,difoliate,distal,drying,eaf,edicel,eed,ellipsoid,erect,forming,free,fruiting,geminat,impressed,keeled,lamina,lateral,layer,like,lobe,lon,long,long-styled,lower,main,major,middle,midrib,minor,minute,narrowing,nflorescence,obe,obovoid,occasionally,often,older,open,outer,overlappin,pair,paler,papillo,peeling,per,persistent,pore,poricidal,portion,puberulent,pubescence,reflexed,ruit,scar,scattered,short,simple,slightly,slit-like,stem,stiff,straight,straw-colored,tall,terminal,thickened,thin,tip,transversel,triangular,trichome,tube,two,type,ud,umbonate,unicellular,uniseriate,unit,upon,upper,usually,variable,vein,wide,widest,woody,x,ympodial,young	abaxial,adaxial,arrangement,colour,diameter,form,growth,height,history,inflorescence,life,na,number,overlapping,peduncle,perennial,plant,position,rachi,reproduction,shape,spacing,staman,texture,width
393	wfo-0001028594	success	142	99	69	73	30	0.486	0.3-1.0,0.8-1.8,1-1.2,1.5-9,12,12-14,2,3-4,3-6,abaxially,acute,anther,apex,axillary,becoming,black,bottle-shaped,calyx,cell,cm,conical,corolla,densely,diameter,drying,ellipsoid,elliptic,filament,flattened-reniform,flower,fruit,fruiting,glabrous,globose,green,herb,immature,inflorescence,leaf,length,margin,maturity,minutely,mm,orange-brown,ovary,ovate,pedicel,pendent,petiole,planar,pubescent,purple,reddish,reflexed,rounded,scar,simple,slightly,smooth,somewhat,sparsely,stigma,style,surface,trichome,uniseriate,violet,x	.5,0-100,1-1.3,1-1.5,1-2,1-3,3-9,5-6,6-20,6-7,acuminate,adaxially,along,anthesi,axil,base,bearing,berry,capitat,climbing,denser,eaf,edicel,eed,epidermal,especially,exserted,floo,forest,free,glabrat,hair-like,inflorescenc,lax,like,lobe,lon,long,lower,minute,nflorescence,noddin,obtuse,often,open,pair,papillate,per,portion,primary,projection,quit,rectangular,regular,rest,ruit,scattered,side,soft,spreading,strait,strongly,tem,time,tip,trailing,tub,tube,ud,unifoliat,unit,vein,ympodial	abaxial,adaxial,arrangement,bark,bud,capitate,center,colour,form,growth,height,history,life,na,new,number,peduncle,perennial,plant,position,prickle,rachi,reproduction,seed,shape,spacing,staman,stem,texture,width
394	wfo-0001028660	success	204	81	55	149	26	0.27	0.5-2.8,0.5-5.5,0.9-2.5,1-10,1-2,1.5-2.8,2-9,3-30,3-9,4-6,7-10,abaxially,adaxially,anther,apex,blue,clavate,cm,corolla,diameter,elliptic,entirely,filament,flower,forked,fruit,glabrous,globose,green,greenish,herb,linear,minutely,mm,narrowly,odd-pinnate,ovoid,pedicel,peduncle,pentagonal,petiole,plant,puberulent,pubescent,purple,rotate,seed,stigma,style,substellate,terminal,tinged,white,whitish,yellow	0-5,0.1-0.3,0.2-1.1,0.3-1.1,0.7-4.2,0.8-1,1.5-4,1.5-7.6,2-11,2-5,2-6,20,3-5,3-7,3.8-13,5-8,5-merou,6,absent,acumen,acute,ag,along,alyx,apart,apparently,articulated,attenuate,axe,axillary,base,berry,blade,borne,broadly,brownish,bud,capitat,cell,chartaceous,ciliate,condition,connivent,covering,decumbent,decurrent,densely,digestion,distal,dorsally,dot,drying,eaf,edge,eed,end,enzyme,erec,especially,exceeding,except,flat,folded,fresh,geminat,generally,glabrou,greatly,green-white,hair,hair-like,half,homostylous,honeycomb-shaped,interjected,lanceolate,lateral,leaflet,lengthening,less,like,living,lobe,long,lower,make,margin,membranous,middl,midrib,mucilaginous,nflorescence,oblique,obtuse,often,orbicular,orolla,ovate,pair,perfect,petiolulate,petiolule,plurifoliate,pore,poricidal,proximal,rarely,reduced,removed,ripe,ruit,scabrous,scattered,sessile,seudostipule,short,singly,size,slit,spaced,sparsely,specimen,stamen,ste,stem,stolo,straight,subequal,subtending,sunny,tall,tamen,tem,testal,thick,throughout,tip,tri-,tube,tuber,typically,unit,unwinged,usually,vary,wall,wet,x,ympodial	abaxial,adaxial,arrangement,capitate,colour,form,growth,height,history,inflorescence,leaf,length,life,na,number,ovary,perennial,position,rachi,reproduction,shape,spacing,staman,surface,texture,width
395	wfo-0001028666	success	159	79	52	107	27	0.327	0-2,0.3-0.6,0.4-0.8,1-2,3-4.5,4-5,5-11,7-9,absent,adaxially,anther,apex,chartaceous,cm,cordate,densely,diameter,ellipsoidal,extra-axillary,flower,fruit,glabrous,gland-tipped,grey-green,hair,inflorescence,lanceolate,lavender,length,mm,moderately,obtuse,ovate,pale,pedicel,peduncle,perennial,petiole,purple,red,scattered,short,shrub,simple,stellate,stellate-pubescent,stigma,style,unbranched,white,yellow,yellowish	%,0-0.1,0.05-0.1,0.1-0.15,0.2-0.25,0.2-0.3,0.25-0.4,0.3-0.45,0.7-0.8,0.8-2,1,1-1.5,1-locular,11-19,2.2-2.3,2.5-5,2.5-7,2.6-4.2,3-4,3-6,4-5-merou,4-5.5,7-11,7-8,abaxially,absen,accrescent,across,acute,adaxiall,alyx,apart,apparen,articulated,axe,ba,base,blade,brown,calyx,capitat,connivent,cylindrical,directed,distall,distributed,eaf,eed,eglandular,elliptic,entire,erect,exceeding,exocarp,finger,fruiting,incomplete,juicy,lamina,lateral,lobe,long,lower,margin,mature,mesocarp,midpoint,minute,nflorescence,oblique,orolla,part,per,perfect,placenta,pore,porrect,prickle,pseudo-umbellate,pubescent,ray,rhizomatous,ruit,septum,sessile,solitary,somewhat,spaced,stalk,stellae,succulent,tal,tamen,tem,thick,throughout,time,transparent,tube,unarme,unarmed,unit,unknow,vary,wide,x,ympodial	abaxial,adaxial,arrangement,capitate,colour,corolla,filament,form,growth,height,history,leaf,life,na,number,ovary,plant,position,rachi,reproduction,seed,shape,spacing,staman,surface,texture,width
396	wfo-0001028667	success	129	75	47	82	28	0.364	-2.6,0.4-0.7,0.7-4,1-1.5,1-6,1.3-2,5-20,acute,apex,axillary,branched,cm,completely,corolla,diameter,dry,elliptic,flattened,flower,glabrous,growth,inflorescence,irregularly,leaf,minutely,narrowly,pale,pedicel,peduncle,petiole,pitted,reniform,shiny,shoot,short,simple,slender,spaced,straw-colored,surface,terminal,twice,vine,white,woody,wrinkling,yellow	.5,1-2-1.5,1-4.5,3,3-11,5,5-merou,8-10,aid,alyx,anthesi,apar,appearing,ark,around,articulated,base,berry,branch,calyx,cell,climbin,climbing,clustered,conical,coriaceous,creamy,curling,deciduous,discolorous,eaf,eed,ellipsoid,entire,exfoliatin,exfoliating,exserted,fide,fragrant,fruiting,like,lobe,long,lower,margin,mentz,midrib,mm,new,nflorescence,occasionally,older,orolla,other,outer,papilla,papillat,pendan,per,perfect,plurifoliat,primary,revolute,scar,sleeve,slightly,small,soon,stem,strongly,support,tem,tip,triangular,tube,twining,ud,unit,vein,visible,x,ympodial	abaxial,adaxial,anther,arrangement,colour,filament,form,fruit,height,history,length,life,na,number,ovary,perennial,plant,position,rachi,reproduction,seed,shape,spacing,staman,stigma,style,texture,width
397	wfo-0001028672	success	207	97	75	132	22	0.362	.5,/4,0-13,0.5-0.7,0.5-1,0.7-3,0.8-1,1-2,1.8-2.5,1/4,2.5-3.5,abaxially,acute,almost,andromonoecious,anther,apart,apex,articulated,base,berry,black,branched,broad,cm,connivent,cream,dark,diameter,erect,filament,flattened-reniform,flower,fruit,glabrescent,glabrous,green,lateral,leaf,length,lobed,long,long-styled,lower,marking,maturity,mauve,mm,moderately,orange-brown,ovate,pale,pedicel,peduncle,petiole,plant,poricidal,rotate,rounded,shrub,simple,sparsely,spherical,stellate-pubescent,straight,style,surface,tapering,terminal,tip,upper,way,yellow,yellow-green,young	-6,-merous,0,0-15,0-150,0-5,0.2,0.2-0.4,0.2-0.7,0.3-1,0.5-1.2,0.5-5,1,1-3,1.3-8,1.5-2.2,1.5-3,1.8-2.2,1/,1/4-1/3,2-10,2-20,2-3,2-30,2.4-2.8,2.5-12,3-5,3-8,4-6,4-8,5,5-10,5-8,6-12,9-15,acut,adaxially,alyx,ame,apar,apically,apparently,bark,blade,broad-deltate,brow,c.,calyx,chartaceous,concolorous,deltate,difoliate,discolorous,distal,distance,drying,eaf,eed,elongated,elongating,equal,extending,flattened,free,fruiting,geminat,gray,hair,hermaphrodite,heterostylous,infructescence,lobe,longer,lowermost,margin,mature,midpoint,midvein,minute,nflorescence,obtuse,older,one,open,orolla,oung,pair,pendulous,per,pericarp,porrect,portion,prickl,prickle,prickly,primary,ray,reflexed,ruit,scar,sessile,short-styled,side,smooth,sometimes,spaced,spreading,stalk,stalked,staminat,stem,tamen,terete,tertiary,time,translucent,trichome,truncate,tube,unarmed,unit,usually,variously,vary,vein,venation,visible,weakly,wide,woody,yellow-orange,ympodial	1/2,abaxial,adaxial,arrangement,colour,corolla,form,growth,height,history,inflorescence,life,ovary,perennial,position,reproduction,seed,shape,spacing,staman,stigma,texture
398	wfo-0001028674	success	196	82	61	135	21	0.311	0.1,0.7-1,1-2,1-3,1.5-3,10-15,10-30,2-2.5,2-5.5,3-11,5-7,acuminate,acute,adaxial,anther,apex,apiculate,branching,cm,corolla,cream,diameter,elliptic,filament,flattened,flower,fruit,globose,green,greenish,growth,leaf,leaf-opposed,lenticular,lobed,maturing,mm,ochraceous,ovary,pedicel,peduncle,petiole,plant,reniform,rusty,shrub,simple,stellate-pubescent,stigma,style,subcapitate,subglobose,surface,terete,variegated,white,whitish,woody,x,yellow,yellowish	-1,0.2-0.25,0.2-0.3,0.5-0.7,0.5-0.8,0.7-1.0,1-1.5,1/3,1/4,2-3,2.5-3,3-10,3-3.5,3-4-lobed,4-4.2,4-5,5-6,8-10,abaxially,adaxially,angulate,armed,articulate,attenuate,bark,basal,base,berry,blade,branched,brow,brown,c.,caly,calyx,campanulate,chartaceous,confined,conical,coriaceous,curved,dark,densely,directed,distal,distally,eaf,eed,eglandular,entire,erec,erect,especially,exserted,face,fewer,free,fruiting,glabrescent,glabrous,glandular,glandular-puberulent,glandular-pubescent,heterostylous,hirsute,juvenile,larger,lateral,laterally,leave,lengthening,like,linear-lanceolate,lobe,long-styled,lower,margin,midpoint,minute,much,mucilaginous,new,nflorescence,older,one,partially,perfect,pericarp,plurifoliat,pore,poricidal,porrect,portion,prickle,prickly,pubescent,raise,ray,recurved,reddish,reduced,reticulate,rounded,ruit,scar,scattered,sessile,shallowly,short-styled,similar,slightly,sparsely,staminate,stellate,stellate-tomentose,stem,straight,subsessile,tapering,testa,thick,time,tip,tomentose,triangular-lanceolate,trichome,tube,ud,unarmed,unicellular,unit,upper,way,ympodial,young	abaxial,arrangement,colour,form,height,history,inflorescence,length,life,na,number,pellate,perennial,position,rachi,reproduction,seed,shape,spacing,staman,texture
399	wfo-0001028680	success	236	94	68	168	26	0.288	.0,.5,.8,0.3–2.1,0.9–1.0,1,1–2,2.1–3.0,3.8–4.6,abaxially,adaxially,anther,apex,appearing,attachment,cm,coriaceous,corolla,diameter,dry,elliptic,extra-axillary,fast,filament,flattened-orbicular,flattened-reniform,flower,fruit,glabrous,globose,growth,hair,lanceolate,lateral,mature,mm,notched,occasionally,ovate,pedicel,petiole,pitted,point,porrect,pubescent,rachi,scattered,sessile,shoot,short,shrub,simple,sparsely,stellae,stellate,stigma,style,surface,terminal,toward,white,yellow,yellow-tan,young,±absent,×,–1.75,–3	.2,.3,0.2–0.3,0.4,0.5–0.8,0.5–2.3,0.9,0.9–1.2,1.1,1.1–6.5,1.2,1.2–2.2,1.4–1.8,1.6–2.5,1.7–2.1,1.7–2.2,1.9–2.4,1/2,1/3,1/4–1/3,2.2–2.5,2.2–3.0,2–3,3.2–3.5,4.3–5.9,4–5,4–5-merou,5.2–7.2,6–8,?,acuminate,adnate,aequilateral,ag,alyx,anthesi,apical,apiculate,apparently,appresse,around,articulate,attenuate,ba,bark,base,based,berry,blade,borne,broad,brochidodromous,brown,calyx,capitat,channeled,connivent,deltoid,dentate,developed,development,directed,distal,distally,distinct,eaf,edge,eed,either,emerging,endocarp,entire,exocarp,extending,fertile,filiform,flexed,free,glandular,glossy,gradually,homostylous,hort,increasing,individually,intact,internode,interpetalar,intersepalar,isolated,juic,layer,limp,lobe,lon,long,longer,lower,many,margin,markedly,middle,midpoint,midrib,midvein,minute,nearly,nflorescence,obtuse,opaque,orolla,per,perforated,plurifoliate,poorly,pore,portion,potentially,presen,prickle,raised,ray,reddish,remaining,retrorse,revolute,rounded,ruit,see,shorter,shortly,side,sinuate,sinus,slightly,sloughing,sometimes,splitting,spread,stamen,stem,straight,sub-cordate,suture,tamen,tem,thin,time,tip,tissue,transparent,truncate,tube,typically,ud,unarmed,unbranched,vary,vein,weakly,wide,yellow-ferruginou,ympodia,±90°,±equal,±glabrous,±straight,–6	abaxial,adaxial,arrangement,capitate,colour,form,height,history,inflorescence,leaf,length,life,na,number,ovary,peduncle,perennial,plant,position,reproduction,seed,shape,spacing,staman,texture,width
400	wfo-0001028688	success	137	78	49	88	29	0.358	.5,0.4-1,0.5,0.5-1,0.5-1.5,0.9-1,1-5,1.1-1.2,2-3,5-6,anther,apex,area,base,calyx,cm,corolla,dia,filament,furcate,glabrous,lanceolate,leaf,lobed,mm,near,nearly,opposite,ovary,overtopping,papillose,pedicel,petiole,pilose,pore,poricidal,pubescent,shaped,shoot,shrub,slender,stigma,style,tapering,tear-drop,tip,tube,white,wide	0.5-0.75,1-1.5,1-1.8,1-3,1.4-2.8,2.2-4.8,5-11,across,acuminate,acute,along,anthesi,apar,bark,beneath,bi-cellular,branch,clavate,curl-tipped,deciduous,decreasing,deflexed,deltoid,densely,densest,differing,difoliate,eaf,edicel,eed,elliptic,exfoliatin,exserted,free,geminat,globose,golden,interpetalar,irregularly,know,known,like,lobe,lon,long,lower,major,markedly,membraneous,middle,minor,minutely,nflorescence,occasionally,often,older,paler,planar,portion,proximal,reddish-brown,ruit,scar,shiny,sinus,size,slightly,soon,spaced,sparsely,stem,straight,styl,tall,terminal,thickened,thin,trichome,tub,ud,uniseriate,unit,usually,vein,widest,x,ympodial,young	abaxial,adaxial,apart,arrangement,colour,diameter,flower,form,fruit,growth,height,history,inflorescence,length,life,na,number,peduncle,plant,position,rachi,reproduction,seed,shape,spacing,staman,surface,texture,width
401	wfo-0001028690	success	191	76	53	138	23	0.277	0.3-2.5,0.8-2,1-7,4-7,8-9,9-13,adaxially,andromonoecious,anther,broad-based,chartaceous,cm,densely,diameter,erect,extra-axillary,flower,fruit,glabrous,globose,green,grey-green,inflorescence,lanceolate,leaf,length,lobed,longer,mm,moderately,ovate,pale,perennial,petiole,plant,prickle,pseudo-racemose,pseudo-umbellate,purple,rhizomatous,shallowly,shrub,sparsely,stellate-pubescent,stigma,straight,style,surface,time,unbranched,white,wide,yellow	%,.3,0-0.1,0-0.2,0-0.5,0-5,0-7,0.05-0.1,0.1-0.2,0.15-0.25,0.2-0.6,0.25-0.4,0.3-0.5,0.3-0.7,0.4-0.6,0.5-0.8,0.5-1,0.5-6,0.8-1,1-2,1-5,1.3-6.5,1.5-1.7,2-3,2-7,2-locular,2.1-4.5,2.3-2.8,3-4.5,30-50,4-10,4-5.5.5,4-9,4.5-16.5,5-6,5-merou,5.5-6,6-8,7-10,7-30,7-8,9.5-14,abaxially,absen,absent,accrescent,across,acute,adaxiall,adult,alyx,apart,apex,articulated,ascending,attenuate,axe,ba,base,blade,branch,branche,calyx,capitat,connivent,cross-section,cuneate,cylindrical,directed,distall,distributed,dm,eaf,eed,eglandular,entire,exocarp,finger,fruiting,functional,geminat,gland-tipped,hair,half,heterostylous,juicy,juvenile,lamina,lateral,less,linea,lobe,long,lower,margin,mature,mesocarp,mid-point,midpoint,minute,moist,nflorescence,oblique,obtuse,orolla,pair,part,pedicel,peduncle,per,placenta,pore,porrect,present,ray,ruit,sessile,short,simple,somewhat,spaced,stalk,stellae,stellate,tal,tamen,tem,thick,throughout,tube,unarme,unarmed,unit,upper,vary,weakly,x,ympodial	4-5.5,5-merous,abaxial,adaxial,capitate,colour,corolla,filament,form,growth,height,history,life,linear,ovary,position,reproduction,seed,shape,staman,stem,texture,width
402	wfo-0001028696	success	224	86	51	173	35	0.228	.5,abaxially,acicular,adaxially,along,anther,apart,apex,armed,blue,cm,density,diameter,filament,finely,flower,fruit,glabrous,globose,hirsute,lavender,length,lenticular,long,mm,ovate,pedicel,peduncle,petiole,pilose,pitted,plump,prickle,principal,reniform,rotate-pentagonal,shiny,shrub,simple,spreading,stellate,stigma,style,subterminal,surface,tan,varying,vein,woolly,yellow,×	0.8–,1.5–4,12–20,15–17,15–30,1–2,1–4,1–6,2.4,2.5,2.8–3.5,2–2.3,2–5,2–7,3.5–5.5,3–5,3–6.5,4–5,4–7,5,5-merou,5–15,6–13,6–8,7–8,7–9,8–13,8–20,9–10,9–12,accrescent,acuminate,adaxiall,alyx,ample,anthesi,apparently,articulated,ascending,asymmetric,attenuate,axe,ba,base,bifi,blade,borne,branch,branched,bristle,bristle-like,bristly,broadly,calyx,chartaceous,coarsely,color,connivent,cordate,deltoid,densely,developed,difoliate,directed,distally,diverse,drie,eaf,eed,elongate,entire,erect,fruiting,geminat,glabrou,gland,gland-tipped,glandular,hair,homostylous,intergrading,intermixed,internode,interpetalar,known,lamina,larger,lateral,like,linear-caudate,linear-lanceolate,lobe,lobed,lon,long-stipitate,longitudinally,lower,margin,mature,middle,midpoint,midvein,midzone,moderately,narrowly,near,nflorescence,numerous,oblong,obtuse,occasionally,often,one,orange,orolla,overtopped,ovoid,per,perfect,pericarp,pore,prickly,prominent,pubescence,pubescent,ray,reflexed,repand,resembling,ruit,scattered,sessile,several-celled,short,short-,shorter,side,sinuate,slender,slightly,small,smaller,sometimes,somewhat,soon,spaced,sparser,splitting,stalked,stellae,stellate-hirsute,stellate-pilose,stellate-pubescent,stem,tall,tamen,tem,tippe,tipped,tissue,toothed,trichome,truncate,tube,ud,ultimate,vary,weakly,well,wide,widely,ympodia,young	1-6,1.5-4,12-20,15-30,2-2.3,3.5-5.5,5-15,7-8,9-10,abaxial,adaxial,arrangement,bifid,colour,corolla,form,growth,height,history,inflorescence,leaf,life,na,number,ovary,plant,position,rachi,reproduction,seed,shape,spacing,staman,texture,width
403	wfo-0001028698	success	166	94	69	97	25	0.416	0.3-0.75,1-4,1-9.8,1.9-4,13-25,2-10,3-17,5-6,8-10,apex,articulate,branched,broadly,cell,cm,conical,corolla,covering,cyme,dark,diameter,dichasial,dichasially,distal,dot,ebracteate,ellipsoid,elliptical,filament,flower,green,green-white,hair-like,half,herbaceous,lateral,leaf,light,medium,mm,monochasial,odd-pinnate,ovate,ovoid,pedicel,peduncle,pentagonal,perennial,petiole,plant,proximal,puberulent,pubescent,rachi,raised,rotate,seed,smooth,stigma,strigose,style,testal,thick,throughout,violet,wall,white,yellow,¼	0-1.,1-2,1.8-5,2-3,2-4,3-5,3-6-foliat,3.5,4-14,5-15,5-8,6,6-13,6-27,9-35,abaxiall,abaxially,acumen,acuminate,acute,adaxially,apical,apically,base,calyx,commonly,connate,cuneate,darker,decurrent,dehiscent,digestion,diminishing,dorsally,eaf,edge,eed,emoval,enzyme,equal,exceeding,first,flat,folded,forked,generally,globo,gradually,honeycomb,interjected,introrse,leaflet,living,lobe,lon,long,long-attenuate,lower,lunat,make,maturing,minute,mucilaginous,nflorescence,nther,oblique,often,orolla,pair,pattern,perfect,petiolule,plan,poricidally,rarely,reveal,ruit,sessile,seudostipule,short,size,slit,specimen,stamen,straight,tal,tem,terminal,toward,tuber-bearing,two,typically,unit,usually,vary,wide,ympodial	abaxial,adaxial,anther,arrangement,colour,form,fruit,globose,growth,height,history,inflorescence,length,life,na,number,ovary,position,reproduction,shape,spacing,staman,surface,texture,width
404	wfo-0001028716	success	145	64	35	110	29	0.241	0.5,0.6-1.9,0.75,1-2,2.5-8,7-8,8-9,anther,apart,apex,cm,corolla,filament,filiform,fruit,glabrous,glandular,leaf,less,lobed,minutely,mm,opposite,ovary,ovate,papillose,pedicel,petiole,shape,shrub,simple,style,truncate,white,x	.2,.5,1.9-5.5,10-40-flowered,11-16.4,2-4,2.2-7.9,3.6-8.8,5-6,9-10,across,acuminate,anisophyllou,anthesi,appearing,asymmetric,ba,bark,base,becoming,beginning,beneath,bi-cellular,branched,brown,calyx,cuneate,dark,decurrent,deflexed,dia,differing,difoliate,eaf,edicel,eed,ellipsoid,elliptic,evenly,except,fertilization,fifth,free,geminate,hirsute,inflorescenc,intermediate,know,known,lateral,lengthening,lenticellat,like,lobe,lon,long,long-triangular,lower,main,major,markedly,middle,minor,much,nearly,nflorescence,node,often,older,one,orbicular,pair,pointed,pore,poricidal,portion,prominent,proximal,puberulent,pubescent,raised,reflexed,remaining,rounded,ruit,scar,shaped,size,slightly,spaced,sparsely,stem,stigm,straight,strongly,tall,tear-drop,tip,triangular,trichome,tube,two,ud,uniseriate,unit,vein,widening,widest,ympodial,young	10-40,abaxial,adaxial,arrangement,colour,diameter,flower,form,growth,height,history,inflorescence,length,life,na,number,peduncle,perennial,plant,position,rachi,reproduction,seed,spacing,staman,stigma,surface,texture,width
405	wfo-0001028723	success	211	81	62	149	19	0.294	-1.5,0-0.5,0.8-1,1,1-1.8,1-2.2,1-2.5,10-16,2-2.7,3.5-4,4-5,5,abaxial,acute,almost,anther,apex,apically,base,brachyblast,branch,capitate,clustered,cm,conical,corolla,dark,dendritic,diameter,dilated,drying,elliptic,filament,flower,glabrous,green,leaf,length,less,liana,lobed,membranous,middle,mm,obovate,occasional,orange-brown,pedicel,peduncle,petiole,rachi,shrub,simple,small,stigma,style,surface,terminal,trichome,unarmed,wrinkled,x	.3,.5,0.2,0.8-2,0°,1-1.5,1/3-1/2,1/5-1/3,10-15,2-2.5,2-4,2.5,3-4,4,5-6,5-7,abaxially,adaxially,age,alternate,alyx,another,anthesi,apar,apice,apparently,articulated,bark,becoming,branched,branching,broadly,brown,calyx,clearly,common,concolorous,curved,decurrent,delineated,deltoid,densely,density,developed,divided,domatia,dorsifixed,eaf,eed,ellipsoi,entire,equal,except,ey,faint,fine,flat,flexuous,formed,free,frequent,gradual,increasing,inner,junction,know,known,lengthening,like,lobe,long,long-attenuate,longitudinally,lower,m.,main,margin,midvein,minutely,mostly,much,multiply,naked,narrowly,nflorescence,nther,obconical,oblong,obtuse,one,orolla,outer,ovate,overlapping,pair,pale,papillo,perfec,plurifoliat,poorly,pore,poricidal,portion,primary,prominent,protruding,pubescent,raised,ray,region,regular,ridged,ruit,scar,separated,short,side,sinus,slender,smaller,smooth,sparsely,spreading,stem,stump,surrounding,tearing,tertiary,tip,tissu,toward,transition,tube,tuft,ud,uneven,unevenly,unit,vary,vein,venation,visible,white,wide,widely,yellow,ympodial,young,youngest	adaxial,arrangement,colour,form,fruit,growth,height,inflorescence,na,number,ovary,plant,position,reproduction,seed,shape,spacing,staman,texture
406	wfo-0001028725	success	197	107	83	114	24	0.421	-10,0.1-0.2,0.6-1,1.5-1.7,1.5-2,1.5-4,10-12,2.5-3,2.5-8,3-6,4-5,5-10,7-8,adaxially,anther,apex,base,berry,brown,chartaceous,clavate-truncate,closely,cm,cordate,corolla,curved,densely,depressed,diameter,elliptic-ovate,filament,finely,flattened,flower,glabrous,gland-tipped,glandular,glandular-pubescent,glandular-tomentose,globose,green,growth,inflorescence,internodal,leaf,leathery,lobed,long-styled,minutely,mm,moderately,nearly,ovary,ovate,pedicel,peduncle,persistently,petiole,reniform,reticulate,rusty,rusty-tomentose,short-styled,shrub,simple,size,slender,slightly,stellate,stigma,style,surface,terminal,tomentose,trichome,undulate,unevenly,varying,velutinous,violet,viscid,x,yellowish	.1,0.2-0.5,0.3-0.4,1-1.5,1-2,1.2-1.5,1/4,2,3-4,3-plurifoliat,4-12,4-6-celled,4-locular,7,abaxially,acicular,acute,anthesi,armed,articulated,bark,basal,bud,calyx,clearly,connate,denser,discolorous,distal,eaf,eed,eglandular,elongate,enlarged,entire,exserted,free,fruiting,glabrescent,glandular-villose,greatly,greyish,heterostylous,inconspicuous,lanceolate-subulate,lengthening,like,linear-lanceolate,lobe,long,longer,lower,margin,midpoint,midrib,minute,mixed,multicellular,new,nflorescence,oblique,obverse,older,papillo,perfect,pericarp,pore,poricidal,porrect,portion,prickle,prickly,pubescence,pubescent,ray,recurved,reduced,reflexe,reflexed,repand-angular,rest,rounded,ruit,rusty-brown,scar,sessile,short-talked,similar,slit,small,somewhat,space,sparsely,stalked,staminate,stellate-tomentose,stem,straight,strongly,tall,tapering,terete,testa,tip,tube,turbinate,ud,unarmed,unit,upper,vein,whit,yellow,ympodial	abaxial,adaxial,arrangement,colour,form,fruit,height,history,length,life,na,number,papillose,plant,position,rachi,reproduction,seed,shape,spaced,spacing,staman,texture,width
407	wfo-0001028736	success	180	91	68	112	23	0.378	0.5,0.5-1.5,1,1-2,1-3,10-15,3.5-5,4-6,5-10,5-15,abaxially,absent,acute,anther,apex,base,brown,chartaceous,cm,created,cylindrical,dark,diameter,extra-axillary,filament,flower,fruit,glabrous,globose,green,immature,leaf,length,light,lobed,many,mature,mm,moderately,mottled,nearly,netlike,obtuse,orange,pedicel,peduncle,petiole,pit,pubescent,rachi,raised,red,reniform,rhombic,ridge,shrub,simple,small,sparsely,stellate,stigma,style,surface,unbranched,white,x,yellow,yellow-white	0.2-0.4,0.5-1,0.5-1mm,0.5-2,1-1.5,1.5,1.5-3,1/6,2-4,2-5,2-7,3-5,3-6,3-8,4-12,4-9,40-70,5-merou,6-13x3-8,6-8,accrescent,adaxiall,adaxially,alyx,apar,apical,apparently,armed,attenuate,axe,berry,beyond,blade,calyx,connivent,contiguous,cordate,cut,decurrent,densely,difoliate,directed,discolorous,eaf,eed,either,exserted,filiform,flattened,frui,fruiting,geminate,glabrou,glandular,gree,hair,introsel,less,like,lobe,long,lower,m.,major,midpoint,midrib,midvein,multicellular,multiseriate,narrowly,nflorescence,occasional,occasionally,onto,orolla,pair,per,perfect,pore,porrect-stellate,prickle,purple,ray,recurved,roselike,ruit,scanden,side,sinus,slightly,spaced,stalk,stamen,ste,stem,tamen,tapering,tem,thin-skinned,triangular,tube,unarmed,unequa,unicellular,uniseriate,unit,unlobed,vary,vein,way,wide,ympodial	abaxial,adaxial,apart,arrangement,colour,corolla,form,growth,height,history,inflorescence,life,na,number,ovary,plant,position,reproduction,seed,shape,spacing,staman,texture
408	wfo-0001028737	success	151	75	50	101	25	0.331	0.2-0.5,1-4,1-6,1.5-3.5,12-14,16-30,2.8-3.5,4-10,6,apex,articulate,branched,cm,corolla,cyme,diameter,dichasial,dichasially,distal,ebracteate,elliptic-lanceolate,filament,flower,glandular,globose,green,green-white,half,herbaceous,lanceolate,leaf,mm,monochasial,mucilaginous,odd-pinnate,ovoid,pedicel,peduncle,perennial,petiole,plant,proximal,rachi,seed,stellate,stigma,style,throughout,yellow,¼	0.7-2,1,1-2.5,10,2-3,2-5,3-4,3-5,3-6-foliat,4-6.5,4-9,5-6,7-15,abaxially,absen,acumen,acuminate,acute,adaxially,apical,apically,apiculate,attenuate,base,calyx,caudate,cell,connate,covering,decurrent,dehiscent,digestion,diminishing,dorsally,eaf,edge,eed,emoval,enzyme,exceeding,flat,folded,forked,generally,glabrescent,globo,gradually,hair-like,honeycomb,interjected,introrse,larger,lateral,leaflet,living,lobe,lon,long,lower,make,maturing,nflorescence,nther,oblique,oblong,often,orolla,pair,pattern,perfect,pinnatifi,plan,poricidally,reveal,ruit,second,sessile,seudostipule,short,size,slit,specimen,stamen,straight,strongly,tal,tem,terminal,testal,thick,throughou,toward,tuber-bearing,typically,unit,vary,wall,whit,wide,without,ympodial	abaxial,adaxial,anther,arrangement,colour,form,fruit,growth,height,history,inflorescence,length,life,na,number,ovary,position,reproduction,shape,spacing,staman,surface,texture,white,width
409	wfo-0001028773	success	169	70	47	122	23	0.278	0-0.2,0.15-0.3,0.9-2.8,1-2,3-4.5,4-7,5-6.5,6-11,adaxially,anther,apex,broadly,cm,densely,diameter,erect,extra-axillary,flower,fruit,glabrous,globose,green,greenish-white,inflorescence,leaf,length,lilac,mm,obtuse,ovate,pale,pedicel,peduncle,perennial,petiole,red,rhizomatous,rotate,rotate-stellate,shrub,simple,stellate-pubescent,style,surface,unbranched,white,yellow	%,.7,0-1,0.1-0.2,0.15-0.25,0.15-0.35,0.3-0.4,0.3-0.5,0.3-0.6,0.4-0.5,0.5-0.58,0.8-0.9,1-3,1-4.3,1-locular,1.4-2,10-16,2,2-5,2-6,2-foliate,2.2-2.8,3-5,3.3-3.8,30-55,4-6.5,4.5-5.5,5-merou,7-8,7-9,abaxially,absen,absent,accrescent,across,adaxiall,adult,alyx,apart,apparen,articulated,axe,ba,base,blade,brown,calyx,chartaceous,cordate,directed,distall,distributed,eaf,eed,eglandular,elliptic,entire,exceeding,exocarp,finger,fruiting,geminate,gland-tipped,glandular,grey,hair,homostylous,incomplete,juicy,juvenile,lamina,lateral,lobe,lobed,long,lower,margin,mature,mesocarp,midpoint,minute,nflorescence,oblique,onl,orolla,pair,part,per,perfect,placenta,pore,porrect,prickle,probably,pseudo-racemose,ray,ruit,rusty,septum,sessile,shallowly,short,solitary,spaced,stellae,succulent,tal,tamen,tem,thick,throughout,time,tube,unarme,unarmed,unit,upper,vary,wide,without,x,ympodial	abaxial,adaxial,arrangement,colour,corolla,filament,form,growth,height,history,life,na,number,ovary,plant,position,reproduction,seed,shape,spacing,staman,stigma,texture
410	wfo-0001028774	success	141	63	36	105	27	0.255	1.4-1.8,1/2-2/3,10-20,2.5-3.5,2.5-4.0,4-8,8-12,anther,blade,bright,broadly,calyx,chocolate-brown,cm,dm,dry,elongate,erect,foveolate,glabrous,lenticular,linear-lanceolate,long,minutely,mm,ovate,pentagonal-stellate,perennial,petiole,smooth,spherical,spreading,stellate-pubescent,surface,tube,yellow	0.4-0.7,0.5-0.8,12-20-rayed,2.7-3.3,3-5,3-7,3-8,30-60,5-9,6-10-flowere,9-12,accrescent,acro,almost,along,alyx,annually,anthesi,appearance,arcuate,armed,base,beneath,berry,broad,campanulate,closely,deeply,density,developing,dia,difoliate,distinctive,divided,eaf,eed,emerging,extended,externally,fine,fully,geminat,giving,grayish-green,hair,herb,herbage,hetermorphic,internodal,invested,irregular,least,lengt,lobe,lon,lowermost,margin,maturity,merely,midvein,nflorescence,numerous,often,orolla,otherwise,per,pinnatifid,prickle,prickly,rounded,ruit,scattered,separated,short,short-stipitate,slende,somewhat,spaced,splitting,stellate,stellate-woolly,stem,stout,straight,strait-yellow,surrounding,tall,tamen,thick,tightly,tigma,tub,tyle,unarmed,undulate,unexpande,unit,vary,varying,velvety-farinaceous,vestiture,weakly,woody,ympodial,zygomorphic	6-10,abaxial,colour,corolla,diameter,filament,flower,form,fruit,growth,height,history,inflorescence,leaf,length,life,number,ovary,plant,reproduction,seed,shape,staman,stigma,style,texture,unexpanded
411	wfo-0001028777	success	205	90	68	137	22	0.332	-10,.5,0-2,0.4-0.8,0.5-1.3,0.7-1.2,1,1-3,1.5-3,1.5-4,1.8-2.5,3/4-4/5,4-5-merous,4.5-8,abaxially,anther,apex,base,berry,chartaceous,cm,concolorous,dark,diameter,discolorous,drying,filament,flattened-reniform,flower,fruit,glabrescent,glabrous,green,green-brown,inflorescence,leaf,length,less,lobed,long,marking,maturity,mauve,mm,moderately,obovate,orange,orange-brown,ovate,pale,pedicel,peduncle,petiole,shoot,short,shrub,small,sometimes,spherical,stellate-pubescent,style,surface,terminal,tree,way,white,yellow-green,young	-12,-2.5,-3,-4,.8,.9,0-30,0.1-0.2,0.1-0.3,0.2,0.6-1,0.7-1.3,0.8-1,0.8-2.2,1-2,1-2.5,1.5,1/4,1/4-1/2,2-,2.5,2.5-3,2.5-5,3,3.5-5,6-10,7-11,8,8-15,acuminat,acute,alyx,ame,apar,ape,apically,articulated,attenuate,bark,blade,branched,briefly,c.,calyx,connivent,curved,deciduou,deltate,eaf,eed,elongating,entire,equal,erect,faint,free,fruiting,glabrescen,infructescence,lengt,lobe,long-styled,longer,lower,margin,mature,midpoint,minute,multangulate,narrow-deltate,nflorescence,occasionally,older,one,open,orolla,oung,pair,per,perfect,pericarp,plurifoliat,poricidal,porrect,portion,present,primary,ray,recurved,red-brown,reflexe,reflexed,retuse,rounded,ruit,scar,sessile,short-styled,shorte,shorter,simple,smooth,somewhat,soon,spaced,sparsely,spreading,stalk,stalked,staminate,stellate,stem,stout,strongly,tamen,tapering,terete,tertiary,time,tip,trichome,truncate,tube,unarme,unarmed,unit,usually,variously,vary,vein,venation,visible,whole,wide,wider,woody,ympodial	abaxial,adaxial,apart,colour,corolla,form,growth,height,history,life,na,number,ovary,perennial,plant,reproduction,seed,shape,spacing,staman,stigma,texture
412	wfo-0001028788	success	189	80	58	131	22	0.307	0.4-1.3,0.6-1.2,0.7-1.8,0.8-1.1,2-3,2-5,2.5-3.5,3-10,4.5-6.5,8-10,andromonoecious,anther,black,brown,cm,cylindrical,dark,densely,diameter,distally,erect,extra-axillary,flower,fruit,globose,green,grey,grey-green,inflorescence,lanceolate,length,lilac,long,markedly,mm,ovate,pale,pedicel,peduncle,perennial,petiole,plant,pseudo-racemose,purple,rhizomatous,rusty,shrub,stellate,stellate-pubescent,straight,streak,style,thick,thicker,unbranched,yellow,yellowish,yellowish-green	%,0-0.3,0-0.4,0-10,0-3.5,0.05-0.1,0.1-0.4,0.15-0.4,0.2-0.4,0.3-0.5,0.5-1,0.7-1.3,0.7-1.4,0.8-1.5,0.8=2.5,1,1-1.5,1-10,1-2,1.1-2.3,1.4-1.6,10-14,10-20,2.3-3.6,2.5-4.5,2.5-8.5,4-locular,5-15,5-merou,6-10,6-14,6-8,7-10,7-9,8-11,abaxially,absen,absent,acicular,across,acute,adaxiall,adaxially,alyx,anvil-shape,apart,apex,articulated,ascending,attenuate,axe,ba,base,blade,broad-based,calyx,chartaceous,cordate,cross-section,decimetr,directed,distall,distributed,dult,eaf,eed,eglandular,entire,exocarp,finger,fruiting,functional,gland-tipped,hair,half,heterostylous,hig,juicy,lamina,lateral,less,lobe,longer,lower,margin,mature,mesocarp,mid-point,midpoint,minute,moist,multiradiate,nflorescence,oblique,obtuse,onl,orolla,part,per,placenta,pore,porrect,present,prickle,ray,rostrate,ruit,sessile,short,simple,spaced,stage,stalk,stalked,stellae,stem,tamen,throughout,time,tube,unarme,unarmed,unit,unknow,uvenile,vary,weakly,white,wide,x,ympodial	abaxial,adaxial,colour,corolla,filament,form,growth,height,history,leaf,life,na,number,ovary,position,reproduction,seed,shape,staman,stigma,surface,texture
413	wfo-0001028791	success	257	87	66	191	21	0.257	+,0.05-0.2,0.4-0.65,0.8-1.3,1-1.5,1.8-3.3,10,100,2-7,20-to,4-5+,5-15,9-30,anther,apex,articulated,branched,broadly,brown,capitate,cm,conical,corolla,dark,densely,diameter,dichotomously,elliptic,filament,flower,fruit,glabrous,globose,green,hair-like,imparipinnate,interrupted,leaf,liana,many,middle,near,obovate,occasionally,outgrowth,ovary,pale,paler,pedicel,peduncle,petiole,plant,pubescent,rachi,seed,slightly,sparsely,stellate,stigma,style,surface,time,vine,white,woody,yellow	-0.6,-1.5,-9,.5,0-6,0.05,0.2-0.3,0.2-0.4,0.2-0.8,0.25-0.3,0.3-0.4,0.3-0.5,0.3-0.6,0.3-0.8,0.4-0.5,0.4-0.6,0.4-1.1,0.45-0.55,0.5,0.6-0.8,0.6-0.9,0.7-1.5,0.8-1,1-2,1-2-celled,1-3,1-3-celled,1-celled,1.5-,1.5-2,1.6-4.5,1.7-2.1,2-3,2-3.5,2-7-celled,2-locular,2.5-4.5,2.8-3.0,3-,3-4,4-11.5,4-15,4-celled,5-,5-10,5-22,5-plurifoliate,50-80,8-10-celled,9-35,abaxially,absen,absent,abundant,acuminate,acute,adaxially,addition,ag,along,anthesi,apical,appearance,appendage,articulation,basal,base,basiscopically,beneath,berr,border,breaking,bullate,calyx,cell,clambering,colo.,column,consistently,darker,deciduous,deltate,densest,developed,eaf,ebracteate,edicel,eed,eglandular,elongating,enlarged,entire,even,exserted,extended,free,fruiting,give,glabrescent,glandular,gree,grow,growing,half,halfway,head,interjected,internode,lamina,large,lateral,leaflet,leaving,less,like,lobe,lon,long,lower,margin,midvein,minutely,mixture,mm,much,multicellular,nflorescence,oblique,often,pair,papillate,per,petiolule,poorly,present,primary,protuberance,pseudostipule,pubescence,reflexed,rest,rough,round,ruit,sandpapery,scandent,secondary,sessile,short,shorter,silky,simple,single,small,smaller,sometimes,somewhat,sparse,spreading,stamen,staminal,stem,sterile,stiff,straight,tal,tem,terminal,tertiary,testa,thick,thickened,tip,touch,transparent,trichome,truncate,tube,ud,unicellular,uniseriate,unit,upper,usually,vegetation,vein,wall,wide,winged,ympodial,–1-2-celled	abaxial,adaxial,arrangement,colour,form,growth,height,history,inflorescence,length,life,na,number,perennial,position,reproduction,shape,spacing,staman,texture,width
414	wfo-0001028798	success	214	83	58	156	25	0.271	0-1,0.2-0.4,0.5-2,0.9-1.2,1-4.5,1-6,1.1-2,1.5-1.8,10,2-7,3-5,3.3-5.6,5-8,7-8,anther,apart,apex,chartaceous,cm,conical,corolla,diameter,dm,filament,flower,fruit,granular,green,greenish,growth,lanceolate,leaf,length,mm,oblanceolate,oblong,orbicular,pale,pedicel,peduncle,petiole,probably,pseudo-terminal,rachi,ripe,rotate-stellate,rough,short,shrub,simple,stigma,style,subcoriaceous,subglobose,tomentose,x,yellow,yellowish	.5-5,0-60,1-3,1/2-2/3,1/20,15-19,2-3,2-3.75,2-6,2.4-4.4,2.5-3.5,2.6-4,2/3,3-4,3.8-4.2,4-5.4,5.25-7.5,6-10,6-8,8-18,8.5-13,abaxially,accrescent,acuminate,acute,adaxially,ag,anthesi,apical-lateral,apparently,articulated,attenuate,axe,axillary,ba,base,becoming,berry,blade,blunt-tipped,boat-shaped,branch,branched,bud,calyx,capitat,continued,curved,cylindrical,decurrent,dehiscing,densely,distal,downward,due,eaf,echinoi,echinoid,eed,entire,exserted,extend,fleshy,free,fruiting,glabrous,granular-tomentose,hair,hal,high,included,inserted,introrse,irregularly,lacking,large,lateral,less,lined,lobe,lobed,long,longitudinal,lower,m.,main,many,margin,midvein,minutely,mixed,multangulat,multangulate,nearly,nflorescence,oblanceolat,obovate,obscured,obtuse,often,orolla,oung,ovate-lanceolate,overlapping,perfect,persistent,persistently,plurifoliate,pore,porrect-stellate,present,prominent,pubescent,quite,rather,ray,rough-granular,ruit,semi-ovate,sessile,short-stalked,side,slightly,slit,small,somewhat,spaced,sparingly,splitting,stalked,stamen,stellate-pubescent,stem,strongly,subcampanulate,sulcate,suture,tamen,thick,time,tip,tomentu,tomentum,toward,translucent,tube,unarme,unarmed,unit,unknow,vary,vein,velutinous,way,wide,ympodial	10-60,abaxial,adaxial,arrangement,capitate,colour,form,height,history,inflorescence,life,number,ovary,perennial,plant,position,reproduction,seed,shape,spacing,staman,surface,texture,unknown,width
415	wfo-0001028803	success	204	107	90	114	17	0.441	.5,0.5,10,12–14,14–20,1–1.5,1–2,1–3,1–3.5,2–10,2–3,4–10,4–7,5,5-merous,5–8,8–12,8–14,abaxial,actinomorphic,acute,adaxial,andromonoecious,anther,apart,apex,appearing,attenuate,base,berry,branch,branched,brown,chartaceous,cm,curved,cylindrical,densely,diameter,due,erect,field,filament,flower,fruit,functionally,glabrous,globose,green,hair,herbarium,hermaphroditic,leaf,length,liana,light,like,lobed,long,main,male,midvein,mm,moderately,nearly,ovate,pedicel,peduncle,petiole,plant,pubescent,purple,rachi,reniform,scandent,sheet,shrub,slightly,small,sparsely,stellate-pubescent,stem,stigma,style,surface,tree,violet,yellow,zygomorphic,×	0.5–1,0.5–3,1,1–1.2,2,2–3.5,2–4,3–10,3–4,3–6,6–10,75-120,8-12,absent,ag,alyx,anthesi,apical,apparently,armed,articulated,asymmetrical,axe,ba,bearing,becoming,blade,bud,calyx,connivent,cordate,cupular,curve,curving,darker,developed,difoliate,distal,downward,eaf,early,eed,elongated,em,end,entire,exceeding,extra-axillary,flowering,fruiting,geminate,glabrou,glandular,held,infructescenc,lacking,late,lobe,longitudinal,margin,midpoint,midrib,multiseriate,narrowly,nflorescence,obtuse,occasional,often,older,opening,orolla,ower,pair,per,pinnate,pore,prickle,proximally,ray,recurved,rounded,ruit,secondary,side,simple,slit,spaced,splitting,spreading,stalk,ste,stellate,surfac,tamen,tan,tapering,tomentose,triangula,triangular,typically,unarmed,unequa,unit,upright,upward,usually,vary,vein,venation,weakly,white,wid,ympodial,young	1–20,colour,corolla,form,growth,height,inflorescence,na,number,ovary,reproduction,seed,shape,spacing,staman,texture,wide
416	wfo-0001028815	success	196	105	80	116	25	0.408	0.4-0.8,1-10,1-2,10-15,2-4,22-35,3-4,3-5,5-6,6-8,7-16,abaxially,acute,adaxially,along,anther,apex,axillary,broadly,brownish,bud,cell,cm,condition,corolla,covering,dark,diameter,drying,elliptic,especially,filament,flower,forked,fresh,fruit,glabrous,globose,green,greenish,hair-like,herb,lateral,lilac-purple,make,medium,midrib,minutely,mm,mucilaginous,obtuse,odd-pinnate,ovate,ovoid,pedicel,peduncle,petiole,plant,puberulent,pubescent,purple,rachi,red-purple,ripe,rotate,rugose,seed,sparsely,stem,stigma,style,subtending,terminal,testal,thick,tinged,wall,wet,whitish,yellow	0.5-1,1-3.5,1-4,1-5,14-28,2-4.5,2-9,2.5-6.5,3-7,4-10,5-7,5-merou,6-10,acumen,ag,alyx,apart,apparently,articulated,articulation,auriculate,axe,base,basiscopic,berry,blade,capitat,chartaceous,ciliate,connivent,cuneate,decreasing,decurrent,developing,digestion,distal,distinct,dorsally,eaf,edge,eed,elliptic-lanceolate,enzyme,exceeding,flat,folded,geminat,generally,glabrou,green-white,hair,hal,half,high,homostylous,honeycomb-shaped,indistinct,interjected,lanceolate,leaflet,lengthening,like,living,lobe,long,lower,margin,membranous,narrowly,nflorescence,onto,orolla,pair,papillose,perfect,petiolulate,plurifoliate,pointed,pore,poricidal,purpl,removed,rounded,ruit,semi-erec,semi-rosette,sessile,seudostipule,short,side,size,slightly,slit,spaced,specimen,splotched,stamen,ste,straight,tall,tamen,tem,terminated,throughout,tip,tri-,triangular-lanceolate,tube,unit,unwinged,usually,vary,winged,x,ympodial,young	abaxial,adaxial,arrangement,capitate,colour,form,growth,height,history,inflorescence,leaf,length,life,na,number,ovary,perennial,position,reproduction,shape,spacing,staman,surface,texture,width
417	wfo-0001028876	success	127	70	45	82	25	0.354	.5,0.4-1,0.5-2,1.5-2,2-2.3,3-5,4-5,5-6,abaxial,anther,apex,capitate,closely,cm,corolla,dendritic,densely,elliptic,filament,flower,glabrous,internodal,leaf,lobed,mm,opposite,ovary,papillose,pedicel,petiole,pubescent,shining,shrub,simple,slender,small,spaced,sparsely,stigma,style,subshrub,surface,trichome,white,x	/4,1-2,1.5-3,3-8,4-8,abaxially,acute,adaxially,along,anthesi,attenuate,bark,base,branched,brown,calyx,conical,dark,dia,difoliate,drying,eaf,edicel,eed,ellipsoid,free,geminat,glabrat,golden,hroughout,included,inflorescenc,know,known,lamina,lateral,leave,like,lobe,long,long-triangular,lower,main,middle,midrib,minutely,nflorescence,nodding,occasionally,older,overlappin,pair,papillae,papillo,planar,pore,poricidal,portion,reddish,rest,rounded,ruti,sagittate,scar,shaped,speciman,stem,straight,tall,tear-drop,tip,tub,tube,type,ud,uniseriate,unit,vein,way,widest,ympodial,young	adaxial,arrangement,colour,diameter,form,fruit,growth,height,history,inflorescence,length,life,na,number,peduncle,plant,position,rachi,reproduction,seed,shape,spacing,staman,texture,width
418	wfo-0001028883	success	207	107	70	137	37	0.338	1,2,4,50,6,absent,anther,apex,articulated,base,berry,calyx,capitate,cell,chartaceous,cm,concolorous,coriaceous,cyme,dark,deltate,diameter,drying,dull,elliptic,entire,filament,flower,fruit,glabrescent,glabrous,globose,green,greenish,growth,herb,lateral,leaf,length,light,margin,membranaceous,mm,narrowly,new,normally,pedicel,peduncle,petiole,pubescent,rachi,rarely,reniform,ripe,seed,simple,slightly,stellate,stem,stigma,style,subopposite,surface,trichome,unbranched,undulate,uniseriate,white,whitish,yellow	0.3–0.6,0.4–1.2,0.5–2,0.6,1.5–7,1–2,1–6,2–3,2–5,3–5,4–6,5,5-merou,6–10,6–12,abaxially,accrescent,acuminate,acute,adaxiall,adaxially,almost,along,alyx,antrorse,antrorsely,apar,arched,ark,ascending,attenuate,axi,becoming,blade,branch,brochidodromous,brow,capitat,ciliate,circular,common,completely,connivent,curved,cylindrical,decurrent,densely,differing,directed,eaf,eed,elliptic-ovate,emarginate,equal,erect,exfoliating,eye,flattened,frui,geminate,geniculat,glabrou,glandular,head,hilum,hollow,impressed,introrsely,less,like,lobe,long,longitudinal,lower,lying,midrib,minor,moderately,multicellular,naked,nflorescence,notably,oblong,obtuse,often,older,onto,opening,orolla,ovate-lanceolate,parallel,pendan,per,perfect,plurifoliate,pore,poricidal,present,primarily,prominent,pubescence,region,rounded,ruit,secondary,sessile,shap,shiny,shrub,similar,single,single-celled,size,slit,small,sometimes,spaced,sparse,sparsely,spreading,stalk,straight,subapical,subsessile,swollen,tall,tamen,tem,unit,vary,vein,venation,visible,wide,woody,ympodial,×	1-2,1-6,2-5,3-5,4-6,5-merous,6-10,6-12,abaxial,adaxial,apart,arrangement,bark,bud,center,colour,corolla,form,fruiting,height,history,inflorescence,life,na,number,ovary,perennial,plant,position,prickle,reproduction,scar,shape,spacing,staman,texture,width
419	wfo-0001028885	success	214	105	83	131	22	0.388	0.5-5,0.7-2,1-1.2,1-2,1.5-3.5,10-20,2.3-2.5,2/3,3-5,3.5-4.5,7-8,9-11,abaxial,adaxial,adaxially,along,anther,apart,apex,base,berry,black,branched,capitate,cm,collapsing,corolla,densely,diameter,elliptic,erect,filament,flower,furcate,glabrous,globose,golden,groove,growth,height,inflorescence,irregularly,lamina,lanceolate,lateral,leaf,like,lobed,long,midvein,mm,narrowly,nodding,occasionally,pedicel,peduncle,petiole,plant,pubescent,purple,rhachi,ripe,scandent,scattered,shrub,simple,slender,spaced,sparsely,stellate,stigma,style,surface,terminal,time,trichome,uniseriate,usually,vine,way,weak,woody,¾	-1,.5,0.3-0.5,0.5-1,1-1.5,1-3,1.5-1.7,2,2-,2-2.5,2.5-3.5,3.5-8.5,4-5,5-merou,7-9,9-12,?,acute,ag,alyx,anthesi,apiculate,apparently,archin,ark,articulated,attenuate,basal,blackish,branch,broadly,brown,calyx,cell,connivent,cup-shaped,dark,dark-pigmented,decurrent,deltate,dendriti,distal,dried,drying,eaf,eed,ellipsoid,entire,exserted,extending,fleshy,free,fruiting,glabrescent,glabrou,glandular,gradually,groupe,ilament,immature,inserted,known,leaving,lengthening,less,live,lobe,loosely,lower,margin,material,minute,minutely,mostly,multicellular,narrowing,new,nflorescence,noddin,often,older,orolla,pair,papillo,part,peg,perfect,pericarp,pigmentation,plurifoliat,pore,poricidal,portion,primary,quarter,recorded,reddish,retaining,revolute,ruit,scar,shin,shiny,short,sleeve,slightly,slit,small,smaller,sometimes,spheroidal,spreading,stem,strongly,tangled,tem,thin,third,tip,tube,twinin,ud,unit,upper,vary,vein,wall,weak-walled,wide,winged,ympodial	5-merous,abaxially,arrangement,colour,form,fruit,grouped,history,length,life,na,number,ovary,position,rachi,reproduction,seed,shape,spacing,staman,texture,width
420	wfo-0001028888	success	207	99	73	134	26	0.353	0-3.5,0.15-0.5,1-10,1-2,10-25,2.3-7,2.5-3.3,4-25,5-10,5-7,8-11,abaxially,adaxially,anther,apart,apex,articulated,axillary,broadly,brownish,bud,cell,clavate,cm,condition,corolla,covering,diameter,drying,elliptic,filament,flower,forked,fresh,fruit,glabrous,globose,green,greenish,hair-like,herb,lateral,middle,minutely,mm,odd-pinnate,ovate,ovoid,pedicel,peduncle,pentagonal,petiole,plant,puberulent,pubescent,ripe,seed,sparsely,stem,stigma,streak,style,subglabrous,substellate,subtending,terminal,testal,thick,violet,wall,white,whitish,yellow	0-5,0-7,1,1-1.5,1-3,1.5-4,12.5-25,2-5,2-6,2.3-5,3-4,3-5,3.6-12.5,3.8-8.3,4-7,5-merou,6-11,8-13.5,acumen,acuminate,acute,ag,along,alyx,apiculate,apparently,axe,base,berry,blade,capitat,center,central,chartaceous,ciliate,connivent,covered,cuneate,digestion,distal,dorsally,dot,eaf,edge,eed,end,enzyme,erec,especially,exceeding,except,flat,folded,geminat,generally,glabrou,glaucous,greatly,green-white,hair,hal,half,homostylous,honeycomb-shaped,interjected,lanceolate,leaflet,lengthening,less,like,living,lobe,long,low,lower,make,margin,membranous,midrib,mottled,mucilaginous,nflorescence,oblique,often,one,orbicular,orolla,pair,perfect,petiolulate,petiolule,placed,plurifoliate,pore,poricidal,proximal,purple,reduced,removed,rounded,ruit,scattered,sessile,seudostipule,short,size,slightly,slit,sometimes,spaced,specimen,stamen,ste,stolo,straight,subequal,tall,tamen,tem,throughout,tip,tri-,truncate,tube,tuber,typically,unit,unwinged,usually,vary,wet,wing,x,ympodial	abaxial,adaxial,arrangement,capitate,colour,form,growth,height,history,inflorescence,leaf,length,life,na,number,ovary,perennial,position,rachi,reproduction,shape,spacing,staman,surface,texture,width
421	wfo-0001028905	success	210	94	67	143	27	0.319	-5,1,1-3,1.5-3,10,3-4,3-5,4,5-15,6-9,acuminate,anther,apex,axil,bilobed,blunt,bluntly,broadly,brown,capitate,cm,concentrically,conical,corolla,cyme,deep,deeply,distinctly,except,filament,flower,fork,form,glabrous,glandular,green,hair,later,leaf,line,minute,mm,obovoid,orange-yellow,ovary,ovate,ovoid,paling,pedicel,peduncle,petiole,pinnatisect,plant,purple-blue,reddish,reticulate,rotate,rugose,scorpioid,shortly,shrub,stem,stigma,style,succulent,surface,yellow	-20,-3.5,-4,-9,1-,1.5,1.5-2,10-15,10-20,15-30,2,2-2.5,2-3,2.5-3,200-300,38/1-38/2,40-60,5,5-,7,acuman,acumen,adult,age,almost,also,appearing,appressed,aspect,aster,base,becoming,berry,broad,bud,calyx,cell,close,completely,continued,covering,cuneate,developed,dia,distance,eaf,eed,ellipsoid,emarginate,enlarged,entire,equal,even,exceeding,exerted,facetted,firming,first,floral,forked,free,frui,fruiting,general,glabrescent,growing,herbarium,inadequate,interacuminal,intermediate,lanceolate,lasting,lengthening,less,lobe,lobed,lobing,lon,long,lower,main,margin,may,midrib,mucronate,narrowly,nflorescence,oblong,occur,often,pair,papillo,pedicellate,plurifoliat,pore,poricidal,purpli,range,rarely,reaching,readily,rh,rhachi,ripe,rounded,ruit,ruiting,scarious,seedling,several,shed,short,show,showy,simple,sinus,size,slende,slit,smaller,soft-wooded,soon,sparse,specimen,spreading,stone,straggly,suffused,tall,tip,tissue,tub,tube,ud,unit,usually,variable,violet,well,x,year,ympodial,young	abaxial,adaxial,arrangement,colour,diameter,fruit,growth,height,history,inflorescence,length,life,na,number,papillose,perennial,plurifoliate,position,rachi,reproduction,seed,shape,slender,spacing,staman,texture,width
422	wfo-0001028916	success	212	89	67	145	22	0.316	0.2-0.4,0.5-3.2,1-2,1-4.6,1-7,1.5-3,2-12,2-5,3.5-4.5,5-10,5-7.5,7-18,adaxially,andromonoecious,anther,apex,chartaceous,cm,densely,depressed-globose,diameter,ellipsoidal,elliptical,extra-axillary,filament,flower,fruit,glabrous,globose,green,grey,hair,herbaceous,inflorescence,later,length,light,lilac,marbled,minutely,mm,obtuse,ovate,pale,pedicel,peduncle,petiole,pitted,plant,prostrate,purple,rachi,resprouter,rotate,rotate-pentagonal,simple,sparsely,sprawling,stellate,stellate-pubescent,stigma,style,surface,unbranched,weakly,white,yellow	%,-8,0-0.4,0-0.5,0-2,0.05-0.1,0.2-0.3,0.25-0.3,0.25-0.35,0.3-0.4,0.4-0.8,0.4-1.3,0.5-3,0.5-3.5,0.5-5,0.9-1.1,1-1.5,1-3,1-4,1.5-2.5,1.8-2.2,10-16,14-21,15-25,2.5-5,3-4,3-5,35-50,35-55,4-,4-8,5-12,5-35,5-9,5-merou,6-20,7-10,7-8,8-10,8-9,abaxially,absen,absent,abundant,accrescent,acicular,across,adaxiall,adult,alyx,apart,armed,articulated,axe,ba,base,blade,branche,broad-based,broadly,brown,calyx,connivent,cuneate,cut,cylindrical,decimetre,deeply,deflexed,deltate,directed,distall,distributed,eaf,eed,eglandular,finger,fruiting,functional,gland-tipped,half,heterostylous,index,interpetalar,lamina,lateral,less,lobe,lobed,lobing,lon,long,longer,loosely,lower,margin,mature,mesocarp,midpoint,midvein,minute,moderately,nflorescence,notably,oblique,oblong-attenuate,orolla,part,per,pore,porrect,presen,present,prickle,ray,ruit,sessile,shallowly,short,side,somewhat,spaced,stage,stellae,straight,succulen,tal,tamen,tem,thick,throughout,time,tissue,triangular,truncat,tube,unit,unknow,uvenile,vary,vein,wide,winged,x,ympodial	abaxial,adaxial,arrangement,colour,corolla,form,growth,height,history,leaf,life,na,number,ovary,position,reproduction,seed,shape,spacing,staman,texture,truncate
423	wfo-0001028920	success	152	95	67	85	28	0.441	.5,0.2-1,0.5-1,0.8-1.1,1-1.2,1-3,3-15-flowered,3-3.5,6-6.5,abaxially,acuminate,acute,adaxially,anther,apex,arachnoid-pubescent,area,base,brown,closely,cm,congested,corolla,dark,decurrent,deflexed,densely,difoliate,elliptic,filament,flower,glabrous,globose,green,leaf,lightly,lobed,long-styled,minutely,mm,nearly,obovate,occasionally,opposite,ovary,ovoid-reniform,papillose,pedicel,petiole,pitted,pubescent,shape,short-styled,shrub,simple,small,spaced,sparsely,stigma,style,surface,tapering,tip,tree,unifoliate,white,winged	.25,1-1.5,1-2.4,1.5-2,2-2.5,2-7,3-4,5-9,6-15,anthesi,arachnoid,attenuate,axil,ba,bark,berry,broadly,brownish,calyx,conical,cucullate,deltate,dendritic,dense,dia,differing,eaf,edicel,eed,ellipsoid,erect,exserted,felty,fleshy,free,fruiting,geminat,glabrate,gray-brow,later,lateral,lobe,lon,long,lower,main,major,middle,minor,nflorescence,obovoid,older,overlappin,pair,planar,pore,poricidal,portion,present,pubescence,ruit,scar,shaped,size,somewhat,soon,stem,strongly,styl,tall,tear-drop,thick,trichome,tub,tube,tuft,ud,uniseriate,unit,vein,widest,woody,x,ympodial,young	abaxial,adaxial,arrangement,colour,diameter,form,fruit,geminate,growth,height,history,inflorescence,length,life,na,number,overlapping,peduncle,perennial,plant,position,rachi,reproduction,seed,spacing,staman,texture,width
424	wfo-0001028929	success	210	96	74	136	22	0.352	.5,.7,.9,/5,0-3,0.4-0.8,0.5-2,0.7-2,2-3,2-4,2-9,5-6,5-merous,abaxial,abaxially,acute,adaxial,anther,apart,apex,apparently,articulated,base,berry,cell,chartaceous,cm,concolorous,densely,diameter,discolorous,drying,dull,elliptic,erect,filament,flattened-reniform,flower,fruit,glabrous,inflorescence,lateral,leaf,length,lobed,long,maturity,minutely,mm,obovate,obtuse,orange-brown,outline,pedicel,peduncle,petiole,pit,raised,red,red-green,reticulate,shrub,simple,small,smooth,sometimes,spherical,stellate-pubescent,style,surface,way,white,yellow,yellow-green	-2,-2/3,0,0-1,0-10,0-20,0.1,0.15-0.3,0.2-0.3,0.2-0.4,0.2-0.8,0.3-0.6,0.5-1.5,0.7-1,0.8-1,1,1-1.1,1-3,1.5-2.4,1/2,1/4-1/3,2-6,2.2-2.3,2.5-4,2.7-3,2/3-3/4,3-20,3-4,4-6,5-25,5-7.5,6-8,7-9,8-10,acicular,alyx,apar,ape,apically,bark,blade,branched,calyx,connivent,cuneate,curved,difoliate,distance,eaf,eed,elongating,equal,extending,foliaceous,free,fruiting,geminat,gently,glabrescent,glabrou,gra,hair,infructescence,lobe,lon,long-styled,longer,lower,margin,mature,midpoint,midvein,minute,narrow-deltate,narrow-ovate,nflorescence,oblong,obtu,occasionally,older,one,open,orolla,oung,pair,pale,patch,pendulous,per,perfect,pericarp,perpendicular,poricidal,porrect,portion,prickl,prickle,prickly,primary,ray,red-brown,rounded,ruit,scar,sessile,short-styled,side,slender,spaced,spreading,stalk,stalked,staminate,stellate,stem,straight,subsessile,tamen,tapering,terete,tertiary,time,tip,trichome,tube,unarmed,unit,usually,variously,vary,vein,venation,visible,wide,woody,ympodial	arrangement,colour,corolla,form,growth,height,history,life,na,number,ovary,perennial,plant,position,rachi,reproduction,seed,shape,spacing,staman,stigma,texture
425	wfo-0001028934	success	177	87	65	112	22	0.367	0.5-0.75,0.5-1,0.5-1.5,0.5-2,1-2,1-3,1.5-2.5,10-30,2-3,5-10,5-15,5-6,6-9,abaxially,adaxially,anther,apex,brown,chartaceous,cm,created,dark,densely,diameter,extra-axillary,filament,flower,fruit,glabrous,globose,green,immature,leaf,light,lobed,many,mature,mm,moderately,nearly,netlike,orange,ovate,pedicel,peduncle,petiole,pit,pubescent,rachi,raised,recurved,red,reniform,ridge,small,stellate,stigma,style,surface,unbranched,vine,white,wide,x,yellow	0.5,1,1-.,1.5,1.5-2,15-25,2-2.5,2-4,3-5,3-6,3-7,5-8,5-merou,6-7,8-14,absent,accrescent,acute,adaxiall,alyx,apar,apical,apparently,armed,asymmetrical,attenuate,axe,base,berry,beyond,blade,bud,calyx,connivent,cordate,cylindrical,difoliate,directed,discolorous,distally,eaf,eed,either,em,expanded,exserted,filiform,flattened,frui,fruiting,geminate,glabrou,gree,hair,introrsel,lanceolate,leathery,like,lobe,long,lower,m.,major,margin,midpoint,midrib,midvein,multicellular,multiseriate,narrowly,nflorescence,obscure,obtuse,often,orolla,pair,per,perfect,pirckle,pore,porrect-stellate,prickle,ray,reflexed,roselike,ruit,secondary,side,simple,skinned,slightly,spaced,spreading,stalk,stamen,ste,stem,tamen,tan,tapering,thin,triangular,tube,unarmed,unequa,unicellular,unit,unlobed,vary,vein,x1-3,ympodial	1-4,abaxial,adaxial,apart,colour,corolla,form,growth,height,inflorescence,length,na,number,ovary,plant,position,reproduction,seed,shape,spacing,staman,texture
426	wfo-0001028944	success	212	95	71	141	24	0.335	0.5-1,0.8-5,1-1.5,1-2,1-3,1-4,1-5,1.5-7,10-20,2.5-4,20-50,5-10,6-15,6-8,abaxially,adaxially,anther,apart,apex,articulated,base,branched,bright,brown,chartaceous,cm,dark,densely,diameter,elliptic,extra-axillary,filament,flower,forked,fruit,glabrescent,glabrous,globose,green,growth,leaf,light,mature,mm,nearly,outline,ovate,pedicel,peduncle,petiole,pubescent,purple,rachi,reniform,ripe,rotate-stellate,shrub,simple,small,smooth,stellate,stellate-pubescent,stigma,style,surface,tree,unbranched,white,x,yellow,young	.5-2.5,0.5-0.75,0.5-1.5,0.75-1.25,0.8-1.5,1-3-lobed,2-15,2-2.5,2-3,2.5-10,3-4,4-5,4-6,4-8,5-25,5-merou,6-7,7-17,8-10,8-13,abundant,accrescent,acute,ag,alyx,apparently,armed,axe,ba,berry,blade,broad,broad-based,brownish,calyx,capitat,coarsely,connivent,cordate,covering,cuneate,curved,cylindrical,deltate,denser,difoliate,directed,discolorous,distally,divided,eaf,eed,entire,equal,erect,especially,ferruginous,flattened,free,frui,fruiting,geminate,glabrou,hair,halfway,highly,homostylous,interpetalar,lanceolate,like,linear-acuminate,lobe,long,long-stalked,longitudinal,lower,main,major,margin,membanaceous,midpoint,midrib,moderately,mucilaginou,multangulate,narrowly,nflorescence,numerous,oblique,obtuse,occasionally,often,opening,orolla,part,perfect,pericarp,pore,porrect-stellate,prickle,ray,recurved,rounded,ruit,sessile,shallowly,short-,short-stalked,shorter,side,slightly,slit,sometimes,spaced,sparse,sparsely,stalk,stem,straight,strongly,subtending,tal,tamen,tapered,tem,thin,time,tip,tissue,toward,triangular,tube,unarmed,unit,vary,vein,white-pubescent,whitish,wide,yellowish,ympodial	abaxial,adaxial,arrangement,capitate,colour,corolla,form,height,history,inflorescence,length,life,na,number,ovary,plant,position,reproduction,seed,shape,spacing,staman,texture,width
427	wfo-0001028963	success	197	90	72	125	18	0.365	/2,0-0.4,0-2,0.3-0.6,0.3-1,0.45-0.6,0.6-1,0.9-1.5,1-4,2-4,3.5-4.2,4-10,5-merous,abaxially,anther,apex,articulated,base,berry,bright,cell,cm,connivent,densely,diameter,dull,erect,evenly,filament,flattened-reniform,flower,glabrous,gray-green,green,herb,inflorescence,lanceolate,leaf,length,lobed,maturity,mauve,mm,moderately,narrow-elliptic,narrowly,orange,outline,pale,pedicel,peduncle,petiole,pit,poricidal,purple,raised,red,shrub,small,smooth,spherical,stellate-pubescent,style,surface,tapering,tip,unarmed,unbranched,way,winged,yellow-orange,young	.5,0.1,0.1-0.2,0.1-0.25,0.15-0.3,0.3-0.7,0.3-1.5,0.6-0.9,0.8-1.8,1.5-2,1/,1/4-1/3,1/5,1/6,2-2.3,2-3,2-5,2-9,2.4-2.8,3-4.5,4-8,5-25,6-10,7-8,acute,alyx,apar,ape,apically,apparently,attenuate,bark,becoming,blade,broad-deltate,brown,calyx,chartaceous,concolorous,curved,cuspidat,deltate,difoliate,discolorous,drying,eaf,eed,elongating,entire,equal,eye,free,frui,fruiting,geminat,glabrescent,gra,herbaceous,infructescence,lateral,less,light,lobe,long,long-styled,longer,lower,margin,mature,midpoint,naked,narrow-cuneate,nflorescence,obtuse,occasionally,older,one,open,orolla,oung,pair,pendulous,per,perfect,pericarp,porrect,portion,primary,ray,ruit,scar,sessile,short-styled,shorter,simple,slender,slightly,spaced,spreading,stalk,stalked,staminate,stellate,stem,straight,subsessile,tamen,terete,terminal,tertiary,time,trichome,tube,unarme,unit,upper,usually,variously,vary,vein,venation,visible,wide,woody,ympodial	abaxial,adaxial,apart,colour,corolla,form,fruit,growth,height,number,ovary,plant,reproduction,seed,shape,spacing,staman,texture
428	wfo-0001028971	success	225	99	77	148	22	0.342	.1-0.2,0.1-0.4,0.25-0.6,0.25-1.25,0.3-0.6,0.4-0.9,1-2,1.5-2.2,10-15,2.5-3.5,3-14,4-9,5-10,6-16,6-8.5,abaxially,adaxially,anther,apart,apex,appearance,articulated,base,branched,broadly,cm,densely,diameter,erect,essentially,extra-axillary,farinaceous,felty-pubescent,filament,flower,form,fruit,glabrous,globose,hair,inflorescence,leaf,length,lenticular,minutely,mixture,mm,orange,outline,ovate,pedicel,peduncle,perennial,petiole,pitted,pubescent,rachi,reniform-ovate,sericeous,sessile,short-stalked,simple,spreading-hirsute,spreadingly,stellae,stellate,stellate-pubescent,stigma,stipitate,style,surface,tan,thin-textured,trichome,white,x,yellow	-0.8,-1.4,0.1-0.5,0.2-0.5,0.4-1.5,0.8-2.5,05-2.5,1-5,1.5-4,1.75-2.5,1/5-1/2,15-30,2-5,2-foliate,2.2-3.5,2.5-4.5,2.5-5,20-35,3-5,3-6,4-5,5-15,5-8,6-9,7-16,acute,acute-,adaxiall,along,also,appearing,armed,ascending,attenuate,axe,ba,bearing,becoming,blade,broad-based,calyx,campanulate,capitat,cauline,close,coarsely,compressed,connivent,cylindrical,delicate,deltoid,dentate,directed,distal,distall,eaf,eed,elongate,elongate-deltoid,entire,felty,female-sterile,frequently,geminat,grading,growt,inserted,interlobal,invested,lanceolate,largest,later,lateral,laterally,least,lignescent,like,linear-lanceolate,lobe,lon,long,longer,longest,lower,major,manifestly,margin,maturit,midpoint,midrib,minute,much,multiseriate,narrowly,nflorescence,numerous,obtuse,occasionally,often,one,orolla,other,ovate-apiculate,ovate-lanceolate,pair,per,persistent,pore,prickle,prickly,principal,ray,reduced,ripe,round-tipped,ruit,scattered,short,shorter,side,similar,sinus,smaller,sometimes,spaced,sparse,stalk,ste,stem,tal,tamen,tem,termination,time,tooth-like,truncate,tube,unbranched,underdeveloped,unit,usually,variable,variously,vary,vein,well-developed,wide,ympodial	abaxial,adaxial,arrangement,capitate,colour,corolla,growth,height,history,life,na,number,ovary,plant,position,reproduction,seed,shape,spacing,staman,texture,width
429	wfo-0001028975	success	163	76	49	114	27	0.301	.5,1-3,1-5,1.2-1.5,3-3.5,6-6.5,8-9,acute,anther,apart,apex,area,broad,brown,cm,corolla,dark,densely,elliptic,filament,fruit,glabrous,globose,golden,green,leaf,length,lobed,minutely,mm,once-furcate,opposite,ovary,ovoid-reniform,pedicel,petiole,pitted,pubescent,shiny,shrub,simple,small,sparsely,stigma,style,surface,tapering,tree,white	.2,0.1-1,0.5-1,1,1.5-1.8,1.5-2,2.2-6,3-10-flowered,3-6.5,5-ribbed,5.5-10,7.5-15,?,acuminate,along,anthesi,appearing,bark,base,beneath,berry,calyx,closely,conical,conically,corky,cup-shaped,decurrent,deflexed,denser,dia,differing,difoliate,eaf,edicel,eed,entire,epidermi,equal,erect,exserted,extension,free,fruiting,geminat,hyaline,immature,large-celled,late,lateral,like,lobe,lon,long,lower,main,mainly,major,margin,member,mere,middle,minor,narrowly,nearly,nflorescence,obscured,occasionally,older,one,pair,papillo,pore,poricidal,portion,prominent,pubescenc,raised,reddi,reflexed,remaining,rib,ruit,scar,shaped,short,sinus,size,slender,slightly,somewhat,spaced,stem,straight,strongly,tall,tear-drop,tip,triangular,trichome,tub,tube,ud,uniseriate,unit,upper,varying,vein,wide,widest,woody,x,ympodial,young	3-10,9,abaxial,adaxial,arrangement,colour,diameter,flower,form,growth,height,history,inflorescence,life,na,number,peduncle,plant,position,rachi,reproduction,seed,shape,spacing,staman,texture,width
430	wfo-0001028980	success	168	101	70	98	31	0.417	.5,0.5-1.5,1.2-1.8,1.5-1.8,1.5-2,1.5-6,4-5,5-6,6,acute,anther,apart,apex,bark,black,calyx,capitate,cm,coarsely,corky,corolla,elliptic,expanded,filament,flattened-reniform,fleshy,fruiting,furcate,glabrous,globose,green,lamina,leaf,margin,minutely,mm,opposite,ovary,ovate,ovoid,paler,pedicel,peduncle,petiole,pitted,planar,pubescent,reddish,reflexed,scar,seed,shining,shrub,simple,slightly,small,sparsely,stem,stigma,style,surface,tall,thick,tree,trichome,uniseriate,white,woody,x,yellowish	.1,.75,/3,1-1.2,1.2-3,2.5,2.5-5,20-25-flowered,3-4,3/4,5-8,6-8,7-12,acuminate,along,anthesi,axil,basal,base,beginning,beneath,berry,broadly,clearly,conical,cucullate,deflexed,deltoid,densely,dia,differentiated,differing,difoliate,dry,drying,eaf,edicel,eed,exserted,extending,f,free,frui,geminat,glabrate,glandular,impressed,incrassate,inflorescenc,lateral,lenticellat,like,lobe,lobed,lon,long,lower,m.,main,major,material,member,middle,minor,nflorescence,occasionally,older,one,pair,pale,papillose,pit,pore,poricidal,portion,prominent,ruit,scarious,shaped,sharply,size,soon,speciman,strongly,tapering,tear-drop,ti,tip,tube,type,ud,unit,usually,vein,way,widest,ympodial,young	20-25,abaxial,adaxial,arrangement,bud,cell,center,colour,diameter,flower,form,fruit,growth,height,history,inflorescence,length,life,na,new,number,plant,position,prickle,rachi,reproduction,shape,spacing,staman,texture,width
431	wfo-0001028982	success	213	106	84	129	22	0.394	.5,0-0.2,0.3-0.6,0.4-1.1,1-1.5,1-2,1.5-2,13-18,3-4.5,4-,4-6,5-9,8-18,abaxially,absent,acicular,adaxially,angled,anther,articulated,base,chartaceous,cm,connivent,contiguous,cylindrical,diameter,erect,extra-axillary,filament,flower,fruit,glabrous,gland-tipped,globose,green,hair,homostylous,inflorescence,interpetalar,lanceolate,leaf,length,lilac,lobe,longer,loosely,mm,moderately,narrowly,nearly,pale,pedicel,peduncle,perennial,petiole,prickle,pseudo-umbellate,rachi,red,reniform,rhizomatous,rugose,scattered,shape,short,shrub,simple,solitary,sparsely,stellate,stellate-pubescent,stigma,straight,style,surface,tan,time,tissue,truncate,unbranched,wide,x,yellow	%,.3,0-2.5,0-3,0.2-0.3,0.2-0.4,0.25-0.5,0.3-0.7,0.3-0.8,0.3-2,0.35-0.5,0.4-0.65,0.5-0.6,0.5-1,0.5-1.3,0.8-1.5,0.8-2.5,1,1-3,1-locular,1.5-2.5,1.5-3,1.5-4.5,1.6-2.3,14-24,15-30,2-6,2.5-4.5,35-50,4-5,4-7,4.5-7.5,5-6,5-merou,6-8,8-16,9-16,absen,accrescent,across,acute,adult,alyx,apart,apex,apparen,armed,attemuate,axe,ba,basal,blade,branch,branche,calyx,capitat,confined,cuneate,decimetre,deeply,directed,distall,distributed,dm,eaf,eed,eglandular,entire,exocarp,finger,fruiting,geminat,half,hastate,hig,incomplete,juicy,juvenile,lamina,lateral,less,linear-hastate,lobed,long,lower,margin,mature,mesocarp,mid-point,midpoint,midrib,midvein,minute,nflorescence,oblique,obtuse,orolla,overall,pair,part,per,perfect,placenta,pore,porrect,present,ray,ruit,septum,sessile,shallowly,spaced,sparse,stellae,succulent,tamen,tem,thick,throughout,tissu,transparent,triangular,tube,unarme,unarmed,unit,upper,vary,ympodial	5-merous,abaxial,adaxial,axillary,capitate,colour,corolla,form,growth,height,history,life,ovary,plant,position,reproduction,seed,spacing,staman,stem,texture,width
432	wfo-0001028984	success	180	117	89	91	28	0.494	-14,-6,-65,0.5-,1,1-,1-6,1-9,1.2-4,1.5,10-20,15-35,2-,2-2.5,2-3,2-4,20-40,3-10,3-26,4-30,4-5,4-6,abaxially,adaxially,age,apart,apex,apical,articulated,base,campanulate,chartaceous,cm,concave,densely,diameter,dilated,distally,eglandular,ellipsoid-fusiform,especially,flower,forked,fruit,glabrous,gland,glandular-puberulent,greenish,leaving,long,margin,minutely,mm,moderately,obconical,ovate,pale,papillose,pedicel,pedicellar,peduncle,petiole,pilose,puberulent,puberulent-pubescent,pubescent-pilose,purple,rachi,rarely,remnant,shrub,simple,small,spaced,sparsely,stigma,strongly,style,subcoriaceous,tomentose,toward,tree,turning,two,unbranched,unknown,violet,x,yellow	-2,-2.5,-3,-9,1-1.7,1-2,1-2.5,12-20,2,2-16,3-28,3-6,4-6.3,4-7,4-foliat,5,5-10,7-14,8-15,abruptly,absen,acuminate,acute,adpressed,aggregate,almost,also,ape,axe,basal,blade,broad,broadly,calyx,cell,color,connective,cordate,directed,eaf,eed,entire,equalling,exceeding,fleshy,globose,hair,lanceolate,laterally,lobe,lon,longer,lower,narrowed,near,nflorescence,nther,obtuse,often,orolla,ovoid,perfect,pilo,pore,possibly,presence,present,pubescent-pilo,radiu,ripe,ruit,shorter,slightly,stamen,stone,swelling,tal,tem,thecae,time,tip,tomento,triangular,truncate,tube,ud,unit,unknow,vary,wide,ympodial	abaxial,adaxial,anther,arrangement,colour,corolla,filament,form,growth,height,history,inflorescence,leaf,length,life,na,number,ovary,plant,position,reproduction,seed,shape,spacing,staman,surface,texture,width
433	wfo-0001028997	success	136	91	63	73	28	0.463	.5,0.5-0.7,0.5-1.5,0.8-1.1,1-1.2,1-1.5,20-50-flowered,3-4,4-10,5-6,abaxially,adaxially,anther,apex,appearing,area,base,branched,broadened,cm,corolla,difoliate,dry,drying,elliptic-obovate,filament,filiform,flattened-reniform,glabrous,globose,golden,green,height,leaf,lobed,many,matte,minutely,mm,mustard,nearly,opposite,ovary,pale,papillose,pedicel,pericarp,petiole,pitted,shiny,shrub,stigma,style,surface,tan,terminal,thick,time,trifoliate,unknown,white,x,yellow	0.5-1,2-2.5,2-3.5,3.3.5,4-4.5,4-angled,6-10,6-7,acute,anthesi,apar,attenuate,ba,bark,berry,calyx,conical,coriaceous,cucullate,deflexed,dia,eaf,edicel,eed,elliptic,erect,exserted,fragrant,free,fruiting,geminat,glabrou,greenish-brow,incrassate,later,lateral,lobe,lon,long,lower,main,margin,merely,middle,nflorescence,older,pair,partially,pore,poricidal,portion,quadrate,revolute,ruit,scar,shaped,spaced,specimen,stem,strongly,styl,tear-drop,thickened,tip,tub,tube,ud,unevenly,vein,widest,woody,ympodia,young	abaxial,adaxial,apart,arrangement,colour,diameter,flower,form,fruit,growth,history,inflorescence,length,life,na,number,peduncle,plant,position,rachi,reproduction,seed,shape,spacing,staman,sympodia,texture,width
434	wfo-0001029003	success	207	94	69	138	25	0.333	0.5,1-10,1-2,1.2-2.5,11-32,13-36,2.5-10,3,4-8,5-10.5,5-12.5,7-9,abaxially,adaxially,anther,apex,blue-violet,brownish,cell,chartaceous,cm,condition,conical,corolla,covering,diameter,drying,elliptic,filament,flower,forked,fresh,fruit,glabrous,green,greenish,hair-like,herb,lanceolate,lateral,leaf,light,medium,membranous,mm,odd-pinnate,ovoid,pale,pedicel,peduncle,pentagonal,petiole,plant,pubescent,purple,ripe,rotate,seed,sparsely,stigma,style,subcapitate,terminal,testal,thick,violet,wall,whitish,yellow	0-6,0.3-0.5,0.4-3,1,1-2.5,1-3,1-5,1.2-1.9,1.5-2.3,12.2-30,2-6,2.5-7.5,3-20,3-5,3.5-7.5,5,5-merou,7-15.5,9-14,absent,acumen,acuminate,ag,alyx,apart,apparently,articulated,attenuate,axe,axillary,base,berry,blade,bud,capitat,ciliate,connivent,decreasing,digestion,distal,dorsally,eaf,edge,eed,elongated,end,enzyme,equal,erec,especially,exceeding,flat,folded,fourth,geminat,generally,glabrou,gradually,green-white,hair,hal,half,highly,homostylous,honeycomb-shaped,interjected,larger,leaflet,lengthening,like,living,lobe,long,lower,make,margin,middle,minute,mottled,mucilaginous,nflorescence,obtuse,one,orbicular,orolla,ovate,pair,perfect,petiolule,pigmentation,placed,plurifoliate,pore,poricidal,prostrate,proximal,rarely,ray,removed,rounded,ruit,secondary,sessile,seudostipule,size,slightly,slit,sometimes,spaced,specimen,stamen,ste,stem,stolo,straight,subequal,subglabrous,subtending,symmetrical,tall,tamen,tem,throughout,tip,toward,tri-,tube,tuber,typically,unit,usually,vary,wet,white,wide,wing,x,ympodial	abaxial,adaxial,arrangement,capitate,colour,form,growth,height,history,inflorescence,length,life,na,number,ovary,perennial,position,rachi,reproduction,shape,spacing,staman,surface,texture,width
435	wfo-0001029006	success	217	129	102	115	27	0.47	-+,0.2,0.4-2.5,0.5-4,1,1-1.5,1.8-2.2,2-3,2-6,3.5-4,5,50,7-8,<,abaxially,acuminate,acute,adaxial,along,anther,anthesi,apex,area,axil,base,berry,bilobed,blackish,branched,c.,cell,chartaceous,cm,corolla,dense,diameter,elliptic,extending,filament,filiform,flattened,flower,glabrous,globose,groove,growth,inflorescence,irregularly,lamina,later,lateral,lobed,long,many,membranous,midrib,minutely,mm,narrowly,nodding,occasionally,pale,papillate,pedicel,peduncle,pentagonal,petiole,pitted,puberulent,pubescent,purple,reniform,ripe,rotate-stellate,shiny,simple,somewhat,spaced,sparsely,spreading,stigma,style,surface,tan,terminal,testal,thin,time,tiny,tip,trichome,tuft,uniseriate,usually,variously,vein,vine,violet,way,white,woody,x	.5,0.5,0.5-2,1-4,1-5,1.2-1.5,1/3,10,10-20,2.5,4-6,5-6,5-merou,7-9,>,adaxiall,ag,age,alyx,apar,ark,articulated,asymmetrical,axi,basal,beyond,black,bright,broadest,calyx,clavat,conical,connivent,deeply,deltate,depending,drying,eaf,eed,ellipsoid,elongate,entire,exserted,free,fruiting,green,growing,ilament,inflated,intramarginal,irregular,keeled,leaving,lengthening,lobe,loosely,lower,margin,markedly,minute,nearly,new,nflorescence,oblique,obvious,often,older,one,orolla,pair,part,peg,pendan,per,perfect,pericarp,pinnatifid,planar,plurifoliat,pore,poricidal,portion,primary,puberulen,purplish,reaching,reddish,ruit,sagittate,scar,size,sleeve,slit,small,smaller,sometimes,stem,strong,strongly,sunligh,tem,truncate,tube,twinin,twining,ud,unit,upper,variable,vary,widest,within,ympodial,young,zig-zag	5-merous,abaxial,adaxially,apart,arrangement,clavate,colour,form,fruit,height,history,leaf,length,life,na,number,ovary,plant,position,rachi,reproduction,seed,shape,spacing,staman,texture,width
436	wfo-0001029021	success	161	92	69	92	23	0.429	0.5-1,0.8-1,1-1.5,1-2,1.1-1.3,1.5-3,1.8-2,2,3/4,5.5-6,8-10,abaxial,abaxially,acute,adaxial,anther,apex,apical,basal,base,bi-lobed,black,broadly,cm,corolla,darker,decurrent,dendritic,densely,diameter,elliptic,filament,flattened,flower,fruit,glabrous,globose,growth,leaf,lenticular,lobed,long,loosely,minutely,mm,outline,ovary,ovate,pedicel,pericarp,petiole,pitted,pubescent,purple,reddish-brown,shiny,shrub,stem,stigma,style,surface,tapering,terminal,thin,tiny,trichome,violet,way,winged	0.8-1.2,0.8-2.1,1-3.4,1-4,1.5-2,2-2.5,3,3-6,3.5,absent,adaxially,age,along,anthesi,appearing,axi,ba,bark,becoming,berry,blade,branching,calyx,caudate,conical,coriaceous,deciduous,deflexed,denser,eaf,edicel,eed,ew,exserted,fleshy,free,fruiting,glabrate,grey-brown,im.,impressed,inserted,lamina,later,lateral,lax,lobe,long-triangular,loose,lower,m.,margin,monochasia,nflorescence,nodding,older,overtopping,pair,papillo,per,planar,plurifoliate,pore,poricidal,portion,prominently,raised,revolute,ruit,scar,scattered,secondary,shoot,simple,sleeve,slit-like,sparsely,stamen,ste,strongly,time,tip,tub,tube,ud,unit,vein,wide,woody,x,ympodial,young	arrangement,colour,form,height,history,inflorescence,length,life,na,number,papillose,peduncle,perennial,plant,position,rachi,reproduction,seed,shape,spacing,staman,texture,width
437	wfo-0001029031	success	213	110	87	126	23	0.408	-11.4,-12.3,-8,.5-1.2,0-5,0.1-0.5,0.5-1.5,0.5-4,0.6-1.2,1-1.5,1-5,1-9.4,2-3,2.5-5.5,20-150,3-10,5-17,abaxially,acuminate,adaxially,angle,anther,apart,apex,becoming,black,bluish,brown,capitate,chartaceous,cm,corolla,densely,diameter,elliptic,elliptic-ovate,erect,filament,flattened,flower,fruit,glabrescent,glabrous,globose,green,held,immature,lateral,leaf,leaf-opposed,length,light,mm,obtuse,occasionally,orange,outline,pedicel,peduncle,peltate-stellate,petiole,possibly,pseudoterminal,pubescent,rachi,rarely,reniform,ripening,rugulose,shrub,silvery,simple,small,sparsely,stellate,stellate-pubescent,stigma,strongly,style,suborbicular,surface,tree,white,whitish,x,yellow,yellowish	-3.6,.1-0.3,0.5,0.7-1.1,1-2,1-2.5,1-2.6,1-3,1.3-3.3,1.5-2.8,1.5-3.5,1.8-2.7,1.8-4,1/3,10,13.5,2-10.7,2-3.3,2-5,2.5-5.6,4-5-,4-7.5,6-12,6-21,absent,accrescent,acute,adaxiall,ag,apexacute,apparently,around,articulated,axe,ba,base,berry,bilobe,blade,branched,calyx,center,connivent,covering,cuneate,curved,cylindrical,deltate,denser,directed,distally,eaf,edge,eed,eglandula,eglandular,entire,equal,farinose,fleshy,forked,frui,fruiting,fused,geminate,hair,impressed,inserted,lanceolate,large,least,like,lobe,long,longitudinal,lower,major,many-foliate,margin,midpoint,midvein,nearly,nflorescence,oblong,opening,orolla,paired,peltate,perfect,pore,porrect-stellate,prominent,pubescen,pubescence,ray,rounded,ruit,sessile,short,short-stalked,side,slightly,slit,smaller,sometimes,somewhat,spaced,ste,stem,straight,subtending,tall,tamen,tem,time,tip,trichome,tube,unarme,unbranched,unit,usually,vary,vein,wide,ympodial	abaxial,adaxial,arrangement,bilobed,colour,form,growth,height,history,inflorescence,life,na,number,ovary,plant,position,reproduction,seed,shape,spacing,staman,texture,width
438	wfo-0001029047	success	168	82	54	114	28	0.321	.5,0.5-2,0.7-1,0.7-3,1-4,1.25,3-5,4-5,6-7,anther,apex,base,beneath,broadly,brown,campanulate,cm,corolla,elliptic,filament,filiform,flower,glabrous,globose,green,herbarium,leaf,lobed,minutely,mm,mustard,nearly,opposite,ovary,ovate,ovoid-reniform,papillose,pedicel,petiole,pitted,pubescent,shape,shrub,simple,slender,somewhat,specimen,stigma,style,surface,tapering,white,x,yellow	'',.25,0-2,0.05-0.5,0.1-0.5,0.1-0.75,0.3-1.9,0.5-1,1,1-1.2,10-11,2.1-2.6,2.5,3.6-8.5,5-20-flowered,5-9,8365,9.5-19.6,``,across,acuminate,acute,amd,anisophyllou,anthesi,arching,aspec,ba,back,bark,bearing,beginning,berry,branch,bud,calyx,deflexed,deltoid,dia,differing,difoliate,distinctly,eaf,edicel,eed,evenly,flattened,free,fruiting,geminate,giving,glabrou,herb,impressed,inflorescenc,kruckoff,lateral,lenticellate,like,lobe,lon,long,lower,main,major,margin,markedly,middle,midrib,minor,much-branched,nflorescence,occasionally,older,orbicular,pale,part,pically,pore,poricidal,portion,principal,prominent,reddish-brown,reflexed,rounded,ruit,scar,shaped,shining,shorter,smaller,smooth,soft,spaced,sparsely,stem,strongly,styl,tall,tear-drop,thread-like,time,tip,trichome,tube,ud,uniseriate,unit,vein,widest,woody,ympodial,young	5-20,abaxial,adaxial,apart,arrangement,colour,diameter,form,fruit,growth,height,history,inflorescence,length,life,na,number,peduncle,perennial,plant,position,rachi,reproduction,seed,spacing,staman,texture,width
439	wfo-0001029048	success	162	96	62	100	34	0.383	.01,.5,0.5,0.5-1.7,1,1-2,1-8,1.5-2,11,3-4,3-7,5-8,anther,apex,bicellular,bright,calyx,cm,corolla,elliptic,filament,filiform,flower,fruiting,glabrous,globose,golden,green,greenish-white,greenish-yellow,hanging,leaf,less,lobed,long,margin,minutely,mm,opposite,ovary,ovoid-reniform,pale,papillose,pedicel,petiole,pitted,puberulent,scar,shrub,slightly,small-capitate,stem,stigma,style,surface,tan,thread-like,trichome,uni-,unifoliate,winged,x	.2,/3,0.5-1,0.8-1,14,2,25,26,3.5-4,4-6,8-10,9-15,acuminate,angle,another,anthesi,apar,apparent,arching,attenuate,basal,base,bearing,becoming,beneath,berry,blade,branch,broadly,conical,decurrent,dia,eaf,edicel,eed,elongated,except,expanded,f,free,geminate,glabrate,greatly,greenish-yello,hispidulous,incrassate,lateral,like,live,lobe,lower,main,matte,middle,midrib,minute,much,nflorescence,node,non-reproductive,obovoid,obtuse,older,one,pair,papillo,parallel,planar,pore,poricidal,portion,reflexed,right,ripe,rounded,ruit,shaped,sharply,slender,somewhat,spaced,specimen,straight,tall,tapering,tear-drop,time,tip,translucent,tube,ud,unevenly,unit,vein,way,widely,widest,ympodial,young,zig-zag	abaxial,adaxial,apart,arrangement,bark,bud,cell,center,colour,diameter,form,fruit,growth,height,history,inflorescence,length,life,na,new,number,peduncle,perennial,plant,position,prickle,rachi,reproduction,seed,shape,spacing,staman,texture,width
440	wfo-0001029053	success	275	122	99	176	23	0.36	0.7–1.2,0.7–1.3,0.7–1.7,1.1–1.3,1.4–2.0,1.5,1/2–2/3,1/3,2.0–2.8,2.4–2.8,2.4–5.1,21,3.5,4.9,5.4–7.1,6.6,6.8–15.2,8.0–14.5,8.5–15.8,across,along,anther,apart,attachment,base,becoming,bent,blade,calyx,cm,congested,corolla,densely,diameter,distal,distally,dry,emerging,extra-axillary,filament,flattened-oval,flower,fruit,glabrous,glandular,glandular-pubescent,globose,gradually,hair,increasing,internode,interpetalar,lanceolate,lateral,length,long,main,mature,minute,mm,moderately,notched,oblong,orange,ovate,overlapping,pedicel,peduncle,petiole,point,porrect,probably,pubescence,red,sessile,short,short-stipitate,shrub,simple,smooth,sometimes,spaced,stellae,stellate,stellate-pubescent,stigma,straight,style,subopposite,surface,tissue,upper,vein,well,well-developed,white,yellow,yellow-tan,young	.04,.3,.7,.9,0.1,0.2,0.2–0.6,0.3–0.4,0.3–0.7,0.4–0.8,0.5–0.6,0.5–1.1,0.6–1.3,0.7–1.0,0.7–1.1,0.7–3.4,0.8–1.0,0.8–1.2,1.0–1.6,1.3–2.0,1.5–2.5,1.5–2.7,1.6–9.2,1.7–1.8,1/3–1/2,2.0–2.3,2.1–2.4,2.1–3.8,2.5,3.5–7.2,4.5–6.2,5-merou,5–8,6–12,7.1–9.7,7–8,8,90°,abaxially,accrescent,acuminate,acute,adaxially,adnate,aequilateral,ag,alyx,anthesi,apex,apical,apiculate,apparently,appearing,appressed,around,articulate,attenuate,axe,ba,bark,basal,beneath,berry,borne,branch,broad,brochidodromous,bud,capitat,caudate,channeled,clinate,coat,criss-cros,deciduous,deltoid,dentate,development,difoliate,directed,distinct,eaf,edge,eed,either,endocarp,entire,erect,exocarp,extending,fertile,filiform,free,geminat,glossy,heterostylous,individually,intact,intersepalar,juic,lacking,layer,less,lobe,lon,longer,lower,many,margin,markedly,midpoint,midrib,midvein,much,nearly,nflorescence,oblique,opaque,ove,pattern,per,perforated,pore,portion,potentially,pubescent,raised,ray,remaining,revealing,rigid,rounded,row,ruit,seen,semisucculent,shorter,side,sinus,slightly,sloughing,smoot,soon,sparsely,splitting,spread,spreading,stamen,stem,stipe,suture,tamen,tem,thin,time,tip,transparent,truncate,tube,twice-branched,two,ud,unarmed,unbranched,unit,various,vary,weakly,wide,yellow-ferruginous,ympodial,±90°,±equal,±glabrous,×,–10	5-merous,arrangement,capitate,colour,form,growth,height,history,inflorescence,leaf,life,na,number,ovary,perennial,plant,position,reproduction,seed,shape,spacing,staman,texture
441	wfo-0001029055	success	169	95	68	101	27	0.402	0.4-1.5,1-4,1-5,1.8-3.5,14-50,4-6,5-24,5.5-9,8-9,apex,articulate,branched,cell,cm,corolla,covered,covering,cyme,dark,densely,diameter,dichasial,dichasially,distal,ebracteate,elliptical,filament,flower,gland,green,green-white,hair-like,half,herbaceous,lateral,leaf,longitudional,mm,monochasial,odd-pinnate,outline,ovate,ovoid,pedicel,peduncle,pentagonal,perennial,petiole,pilose,plant,proximal,pubescent,purple,rotate,seed,short-stalked,sometimes,stigma,stripe,style,testal,thick,throughout,triangular,type,wall,yellow,¼	1-2.6,1.6-3.5,1.7-2.2,2-1.,2-3,2-4,2.2-3,2.5-8,3,3-10,3-6,3-6-foliat,4-10,4-7,6-14,9-22,abaxially,acumen,acuminate,acute,adaxially,apical,apically,attenuate,base,calyx,connate,cordate,cuneate,decurrent,dehiscent,digestion,diminishing,dorsally,eaf,edge,eed,elliptcal,emoval,enzyme,exceeding,first,flat,folded,forked,generally,globo,hair,honeycomb,interjected,introrse,leaflet,living,lobe,lon,long,long-attenuate,longer,lower,lunat,make,maturing,mucilaginous,near,nflorescence,nther,oblique,often,orolla,pair,pattern,perfect,plan,poricidally,rarely,reveal,ruit,second,sessile,seudostipule,short,short-petiolate,size,slit,specimen,spreading,stamen,straight,tal,tem,terminal,time,toward,tuber-bearing,typically,unit,vary,whit,wide,widest,ympodial	abaxial,adaxial,anther,arrangement,colour,form,fruit,globose,growth,height,history,inflorescence,length,life,na,number,ovary,position,rachi,reproduction,shape,spacing,staman,surface,texture,white,width
442	wfo-0001029056	success	140	71	34	106	37	0.243	.2,.5,1/3-1/2,3-5-lobed,3-5-rayed,3-6,7-10,annual,anther,blade,broadly,capitate,cm,densely,dm,externally,glabrous,glandular,hair,herb,length,long,mm,ovate,petiole,pinnately,scattered,sessile,simple,stellate,stellate-pubescent,surface,uniseriate,white	-5,0,0.3-0.5,0.7-1.0,4,5-9,6-10,6-8-flowere,across,acute,along,also,alyx,ample,anthesi,attenuate,basally,base,black,branched,calyx,campanulate,cauline,central,coarsely,consisting,dentate,developing,dia,difoliate,divided,eaf,eed,elongated,erect,externall,flanking,geminat,gland,green,intermixed,internod,invested,irregularly,know,known,lacking,large,linear-lanceolate,lobe,lon,lower,major,marking,midpoint,much,nflorescence,numerous,obtuse,occasional,often,one,orolla,present,prickle,prickly,purplish,ray,reduced,ruit,separated,sharply,short-stipitate,shorte,side,slende,slender,somewhat,sparse,spreading,starlike,stellae,stem,strait,strongly,subulate,swollen,tall,tamen,taprooted,terete,terminally,tightly,tigma,tip,tub,tube,tyle,unit,upturned,vary,vein,vestiture,villous,yellow,ympodial	3-5,6-8-flowered,abaxial,adaxial,apex,arrangement,colour,corolla,diameter,filament,flower,form,fruit,growth,height,history,inflorescence,internoda,leaf,life,na,number,ovary,pedicel,peduncle,plant,position,rachi,reproduction,seed,shape,spacing,staman,stigma,style,texture,width
443	wfo-0001029059	success	199	96	68	131	28	0.342	.5,1-3,1-4,1-6,1.2-3,1.3-1.7,1.5-2.8,3.5-6,7-9,along,anther,apex,base,calyx,clavate,cm,corolla,deep,dirty,elliptic,extremely,filament,flattened-reniform,glabrous,globose,inflorescence,leaf,lobed,long,minute,minutely,mm,nearly,occasionally,opposite,orange,orangish-yellow,ovary,pair,pale,papillose,pedicel,petiole,pitted,pubescence,purplish,ripe,shape,shrub,simple,slender,small,stigma,style,surface,tapering,tinge,tree,trichome,tube,underside,uniseriate,variable,vein,waxy,white,yellowish-green,yellowish-tan	0.1-0.5,0.1-1,0.2,0.2-0.5,0.5,0.5-1,1-1.2,1-1.5,1.5-2,10-19,2.5,3-3.5,3-6.5,3.5-8,4-10.5,5,5-15-flowered,6-10,acute,anisophyllou,anthesi,apar,ape,apiculae,apiculate,arising,bark,beneath,berry,bout,branched,bud,closely,coiba,connivent,cordate,covered,cuneate,de,deflexed,deltoid,dense,densely,dia,differing,difoliate,eaf,edicel,eed,ellipsoid,expanded,exserted,extending,foetid,free,fruiting,geminate,glabrate,greatly,hispidulous,impressed,incrassate,interpetalar,isla,lamina,lateral,lobe,lon,longest,lower,main,major,margin,member,membranous,middle,minor,narrowly,nflorescence,oblique,often,older,one,orbiculate,paler,panama,papillo,partially,planar,pointed,population,pore,poricidal,portion,prominent,pubescent,reddish-gre,rest,rounded,ruit,scar,shallowly,shaped,sinus,size,somewhat,soon,spaced,sparse,specimen,stem,straight,tall,tear-drop,terminal,thickened,ti,tightly,tip,triangular,ud,unicellular,unit,usually,wide,widest,woody,x,yellowish,ympodial,young	5-15,abaxial,adaxial,apart,arrangement,colour,diameter,flower,form,fruit,growth,height,history,length,life,na,number,peduncle,perennial,plant,position,rachi,reproduction,seed,spacing,staman,texture,width
444	wfo-0001029065	success	202	93	77	125	16	0.381	0.5-1.5,0.5-4,1,1-2.5,1-6,10-20,2,2-3,2-4,3-7,4-8,5-15,7-10,abaxial,abaxially,absent,acute,adaxial,andromonoecious,anther,apex,base,brown,chartaceous,cm,contiguous,cylindrical,dark,densely,diameter,filament,flower,fruit,functionally,glabrous,globose,green,green-brown,hermaphroditic,immature,leaf,light,lobed,male,many,mature,mm,moderately,nearly,netlike,orange,ovary,ovate,pedicel,peduncle,petiole,pit,plant,pubescent,rachi,raised,red,reniform,ridge,separated,small,spaced,sparsely,stigma,style,surface,unbranched,vine,white,woody,x,yellow	0.2-0.4,0.5,0.5-1,0.5-1mm,1-2,1-3,1-5,1.,1.5-2,1.5-2.5,1.5-3,1/3,2-15,2-2.5,2-5,2-ranke,3-6,30-60,4-7,5,5-10,5-7,8,8-12,8-20,accrescent,adaxiall,adaxially,alyx,apar,apical,armed,asymmetrical,attenuate,axe,berry,beyond,blade,calyx,charteacous,connivent,cordate,cut,difoliate,directed,discolorous,eaf,eed,either,em,exserted,extra-axillary,flattened,frui,fruiting,geminate,generally,glabrou,glandular,gree,hair,heteromorphic,introsel,leathery,less,like,lobe,long,long-styeld,lower,m.,major,margin,merou,midpoint,midrib,midvein,multicellular,multiseriate,narrowly,nflorescence,obtuse,often,older,orolla,pair,per,pore,porrect-stellate,prickle,ray,recurved,roselike,ruit,sessile,short-styled,side,simple,sinus,slightly,stalk,stamen,staminate,stellate,stem,straight,strongly,tamen,tapering,triangular,tube,unarmed,unequa,unicellular,uniseriate,unit,unlobed,usually,vary,vein,way,wide,ympodial,young,¼	10,apart,colour,corolla,form,growth,height,inflorescence,length,number,reproduction,seed,shape,spacing,staman,texture
445	wfo-0001029072	success	235	82	65	170	17	0.277	0.4-0.9,0.5-2,0.8-1.5,1-1.2,1-1.5,1-25,1.5-2.6,2-7,2-8,2.5-3.5,3-8,4.2-6.5,5-10,5-7,abaxial,acute,adaxial,andromonoecious,anther,apart,apex,branched,bright,chartaceous,cm,cream,dark,densely,diameter,dirty,dull,filament,flattened-reniform,flower,fruit,glabrous,green,green-brown,herb,leaf,length,lobed,long-styled,margin,marking,mature,mm,orange-brown,ovate,pale,pedicel,peduncle,petiole,plant,rounded,short-styled,shrub,spherical,stellate,stellate-pubescent,style,surface,whitish,yellow,young	-1/2,-15,-2.5,.5,/6,0,0-2,0-20,0-4,0-8,0.1-0.4,0.2-0.3,0.2-0.4,0.3,0.5-3,0.7,0.8,00-200,1,1-3,1.5-2.5,1.5-3.2,1/3,1/4-1/2,1/4-1/3,12-19,2-10,2-5,2.2-2.5,2.2-3.2,2.5-3.8,2.5-4.5,20-50,3-10,3-20,3-5,3-50,3.5-6,3/,4-,4-10,4.5-9,5-50,5-9,5-merous,7-10,7-15,8-20,8-27,abaxially,adaxially,alyx,ame,angled,apar,apically,apparently,articulated,bark,base,berry,blade,broad-deltate,broadly,c.,calyx,clearly,conical,connivent,cordate,cuneate,curved,deltate,discolorous,distal,distance,drying,eaf,eed,elongated,elongating,equal,erect,extending,flattened,free,fruiting,gently,gra,hermaphrodite,heterostylous,infructescence,lateral,least,lobe,long,longer,longitudinal,lower,lowermost,maturity,mauve,midpoint,midvein,moderately,multangulate,narrow-deltate,nflorescence,obtu,older,one,open,orolla,oung,pair,pendent,pendulous,per,pericarp,plurifoliat,poricidal,porrect,portion,prickl,prickle,prickly,primary,raised,ray,reflexed,ridge,ruit,scar,sessile,side,simple,smooth,sometimes,spaced,sparsely,spreading,stalk,stalked,staminat,stem,stout,straight,strongly,tamen,tapering,terminal,tertiary,time,tip,trichome,tube,unarmed,unit,upper,variously,vary,vein,venation,visible,way,weakly,white,wide,woody,ympodial	/,colour,corolla,form,growth,height,inflorescence,na,number,ovary,reproduction,seed,shape,spacing,staman,stigma,texture
446	wfo-0001029073	success	211	127	102	109	25	0.483	.5,0.3-1,0.5-1,0.6-2,1-1.5,1-3,1.5-2,10-16,2,2-3,2-4,4-5,5-merous,8-14,acute,adaxially,anther,apart,apex,bark,beneath,berry,broad-based,brown,calyx,cell,cm,conical,corolla,curved,dark,darker,dense,densely,diameter,elliptic,entire,filament,flattened,flower,fruiting,glabrous,globose,growth,hooked,inflorescence,internodal,interpetalar,lanceolate,leaf,length,lobed,long,margin,maturity,minutely,mm,narrowly,new,occasionally,orange,pale,paler,papillose,pedicel,peduncle,petiole,porrect,prickle,prickly,pubescent,purple,reniform,reticulate,scar,sessile,shallowly,shiny,short-stalked,shrub,simple,sinuate,somewhat,sparsely,stellate,stem,stigma,straight,strongly,style,surface,tan,tapering,thin,tip,tissue,trichome,truncate,unarmed,unequally,x,yellowish	.7,0.5,0.6-0.7,1-1.2,1-2.5,1.1-1.5,1.2-1.6,10-15,2/3,3.5-9,4-6,5-6,5-8,6-9,7-10,abaxially,acuminate,along,another,anthesi,armed,articulated,away,awn-like,ba,basal,base,chartaceous,cream,difoliate,dimorphic,discolorous,drying,eaf,eed,enlarged,equal,erect,except,exserted,four,free,frui,geminat,golden,gre,lamina,lengthening,like,linear,lobe,long-styled,lower,midpoint,midvein,mixture,multangulate,nflorescence,nodding,oblique,older,one,opposite,pair,per,perfect,pericarp,planar,plurifoliate,pore,poricidal,portion,primary,pubescence,ray,rectangular,ruit,short,shorter,slightly,slit,sometimes,spaced,splitting,styled,testal,three,ti,triangular,tube,two,ud,underside,unequal,unisexual,unit,upper,upward,vein,visible,wall,way,whitish,wide,woody,yellow,ympodial,zygomorphic,½	abaxial,adaxial,arrangement,bud,center,colour,form,fruit,grey,height,history,life,na,number,ovary,plant,position,rachi,reproduction,seed,shape,spacing,staman,texture,width
447	wfo-0001029074	success	174	90	68	106	22	0.391	.1,0.2-1,0.3-0.8,0.5-1,0.5-1.2,0.7-0.8,1,1-2,1.4-1.8,1.5-2,11,3-6,3.5-5,abaxially,adaxially,anther,apart,apparently,base,berry,black,capitate,cm,conical,corolla,densely,diameter,filament,flattened,flower,glabrous,globose,green,growth,herb,immature,internodal,leaf,lobed,minutely,mm,opposite,ovary,ovate,pedicel,peduncle,petiole,pitted,pubescent,pulp,purplish,reniform,ripening,simple,sparsely,stellate,stellate-pubescent,stigma,style,subshrub,surface,thin,uniformly,watery,way,white,x,¾	.5,0,0.3-0.4,0.7-0.95,1-,1-1.2,1-1.5,1.5-4,2-2.3,2-4,2-5,2-7,3-,5-6,5-7,absent,acute,age,almost,along,anthesi,apex,appearing,articulation,bark,basa,broadly,calyx,cuneate,deflexed,denser,eaf,eed,ellipsoid,entire,exerted,expanding,free,frui,fruiting,glabrescen,grey,lacking,lengthening,less,lignescent,like,lobe,longest,lower,margin,markedly,midpoint,midvein,mixture,new,nflorescence,obscuring,often,older,pair,pale,papillat,per,perfect,pericarp,petal,planar,plurifoliat,pore,poricidal,portion,primary,prominent,ray,reflexed,rounded,ruit,sagittate,scar,scattered,sessile,slit,small,somewhat,stalk,stalked,stem,strongly,swollen,tip,triangular,trichome,truncate,tub,tube,ud,underside,uniseriate,unit,usually,vein,woody,yellow,yellowish,ympodial	abaxial,adaxial,arrangement,colour,form,fruit,height,history,inflorescence,length,life,na,number,plant,position,rachi,reproduction,seed,shape,spacing,staman,texture
448	wfo-0001029075	success	217	113	89	128	24	0.41	0.8-1.5,1-10,1-2,10-20,2-5,2.5-3,30-60,4-10,4.5-6.5,5-10,8-9,abaxially,adaxially,along,anther,apex,axillary,brownish,bud,canescent,cell,ciliate,cm,condition,corolla,covering,dark,densely,diameter,dot,drying,elliptic-lanceolate,especially,filament,flecked,flower,forked,fresh,fruit,glabrescent,glabrous,glandular-puberulent,gray-green,green,green-white,greenish,hair-like,herb,lanceolate,lateral,leaf,make,margin,midrib,minutely,mm,mucilaginous,narrowly,odd-pinnate,ovoid,pedicel,peduncle,pentagonal,petiole,plant,puberulent,pubescent,rachi,seed,short,small,stem,stigma,style,substellate,subtending,terminal,testal,thick,throughout,tip,wall,wet,white,whitish,whitish-gray,yellow,yellow-green,yellowish-white	.3,.5,0-3,0-8,0.5-0.8,0.8-1.2,1-2.5,1-3,2-4,2.7-4.2,4-14,4-5,4-7,5-8,5-8.5,5-merou,6-12,7-17,7-9,abruptly,acumen,ag,alyx,apart,apparently,articulated,attenuate-acuminate,atypically,axe,base,berry,blade,broadly,brown,clavifor,connivent,cuneate,decreasing,decurrent,digestion,distal,dorsally,eaf,edge,eed,end,enzyme,erect,erect-ascendin,etota,exceeding,flat,folded,geminat,generally,glabrou,glandular-pilose,gradually,greatly,hair,half,homostylous,honeycomb-shaped,interjected,larger,leaflet,lengthening,light,like,living,lobe,long,long-spatulate,lower,middl,narrowed,nflorescence,orbicular,orne,orolla,ovate,pair,perfect,petal,petiolulate,petiolule,plurifoliate,pointed,pore,poricidal,purple,removed,rounded,ruit,sec,sessile,seudostipule,singly,size,slightly,slit,sometimes,spaced,specimen,stamen,ste,stolo,straight,subequal,subobtuse,subquadrate,tall,tamen,tem,toward,tri-,tube,tuber,typically,unit,unwinged,upper,usually,vary,wide,woody,x,ympodial	abaxial,adaxial,arrangement,claviform,colour,form,growth,height,history,inflorescence,length,life,na,number,ovary,perennial,position,reproduction,shape,spacing,staman,surface,texture,width
449	wfo-0001029084	success	192	80	55	137	25	0.286	.5,1-10,1-2,10-50,2-3.5,3.5-7.5,4-17,4-7,4.5-6.5,7-9,8-23,abaxially,acuminate,adaxially,anther,apex,articulated,chartaceous,cm,conical,corolla,diameter,filament,flower,forked,fruit,glabrous,green,greenish,herb,leaf,light,lilac,minutely,mm,mucilaginous,odd-pinnate,ovate-lanceolate,ovoid,pedicel,peduncle,petiole,plant,puberulent,pubescent,purple,rotate,seed,sparsely,stigma,style,subglabrous,terminal,whitish,yellow	0.8-2,0.8-2.1,1-3,1-4,1.1-2.2,1.5-2.5,2-4,2-5,3-6,3.5-8,4.5-10,5,5-7,5-merou,6-13,absent,acumen,ag,along,alyx,apart,apparently,arranged,axe,axillary,base,bead,berry,blade,brownish,bud,capitat,cell,ciliate,condition,connivent,covering,darker,decreasing,digestion,distal,dorsally,drying,eaf,edge,eed,enzyme,especially,exceeding,flat,folded,fresh,geminat,generally,glabrou,gradually,green-white,hair-like,half,homostylous,honeycomb-shaped,interjected,interpetalar,lanceolate,larger,lateral,leaflet,lengthening,like,living,lobe,lon,long,lower,make,margin,middle,midrib,minute,moniliform,mottled,multiple,narrow,necklace,nflorescence,obtuse,orolla,pair,perfect,petiolule,pilose,plurifoliate,pore,poricidal,proximal,ray,removed,ripe,ruit,secondary,semierec,seudostipule,size,slit,spaced,specimen,stamen,stolon,subequal,subglabrou,subsessile,subtending,symmetrical,tall,tamen,tem,testal,thick,thir,throughout,tip,tissue,toward,tri-,tube,tuber,typically,unit,unwinged,usually,vary,wall,wet,wide,wing,x,ympodial	abaxial,adaxial,arrangement,capitate,colour,form,growth,height,history,inflorescence,length,life,na,number,ovary,perennial,position,rachi,reproduction,shape,spacing,staman,surface,texture,width
450	wfo-0001029087	success	226	85	63	163	22	0.279	0-0.5,0-14,0.1-2,0.3-0.8,0.5-0.75,0.5-2.3,0.7-2.2,1-1.5,1.5-1.75,11-20,2-3,3-8,3.5-5.5,8-12,andromonoecious,anther,chartaceous,cm,dark,densely,diameter,extra-axillary,filament,finely,flattened,flower,fruit,glabrous,globose,green,grey-green,herbaceous,inflorescence,lanceolate,leaf,length,mm,moderately,ovate,pale,pedicel,peduncle,petiole,plant,pseudo-racemose,purple,rachi,resprouter,reticulate,rhizomatous,rotate,rotate-stellate,simple,stellate-pubescent,stigma,streak,style,surface,weakly,white,x,yellow,yellowish	%,.05,.5,0-0.1,0-2,0-6,0-7,0.2-0.6,0.25-0.4,0.3-0.4,0.3-0.45,0.3-0.5,0.35-0.45,0.5-1,0.7-0.9,0.9-1.7,0.9-8,1-3,1-3.5,1-4,1-6,1.3-1.6,1.4-1.7,10-30,16-20,2-,2-7,2-locular,2.5-4,2.7-2.9,3,3-5,3-7,3-foliate,4.5-8,4.5-8.5,5-15,5-merou,6-7,6-8,6.5-13,7-10.5,7-8,7-9,8-20,8-30,8-9,9-15,abaxially,absen,absent,accrescent,acicular,across,acute,adaxially,adult,alyx,ample,anvil-shape,apart,apex,articulated,attenuate,axe,ba,base,blade,branchlet,broadly,calyx,capitat,connivent,cross-section,cylindrical,deeply,deltate,directed,distall,distributed,dm,eaf,eed,eglandular,entire,erect,exocarp,finger,fruiting,functional,geminat,gland-tipped,grey,hair,half,heterostylous,interpetalar,juicy,juvenile,lamina,lateral,less,lobe,lobed,long,longer,lower,margin,mature,mesocarp,mid-point,midpoint,midvein,minute,moist,narrowly,nflorescence,oblique,obtuse,orolla,pair,part,pendent,per,placenta,pore,porrect,present,prickle,proximal,ray,ruit,rusty,sessile,shallowly,short,slightly,spaced,sparsely,stalk,stalked,stellae,stellate,straight,tal,tamen,tem,thick,throughout,time,tissu,tissue,transparent,triangular,tube,unarme,unarmed,unbranched,unit,upper,vary,wide,ympodial	5-merous,abaxial,adaxial,arrangement,capitate,colour,corolla,form,growth,height,history,life,number,ovary,perennial,position,reproduction,seed,shape,spacing,staman,texture
451	wfo-0001029088	success	149	92	65	84	27	0.436	.3,0.1,0.9–1.5,1.3–4.5,15–25,1–1.6,25–30,2–2.5,2–3,3–16,4–8,5,5-merous,<,acuminate,anther,apex,bronze-brown,capitate,climbing,cm,diameter,extra-axillary,filament,flower,fruit,glabrous,greenish-brown,hair,herbaceous,immature,leaf,lenticular,light,mature,membranous,minutely,mm,near,obtuse,ovoid-rhomboid,papillose,pedicel,peduncle,petiole,pubescent,purplish,rachi,reddish-brown,rounded,rugose,shortly,simple,slender,somewhat,sparsely,stellate,stigma,style,surface,terrestrial,unbranched,vine,white,x	.2,0.6–3.2,1.5–2,1.5–3,1–1.2,1–1.5,1–3,2-lobe,2.5–20,2.5–4.2,3.5–7,3.5–8,5–8,6-10,abaxially,accrescent,acute,adaxially,alyx,apar,apicall,axe,base,berry,blade,c.,calyx,ciliate,cordate,cylindrical,densely,eaf,eed,emarginate,entire,flattened,flavor,fleshy,fragrant,fruiting,glabrou,groun,half,heavy,juicy,lanceolate,lobe,long,lower,m.,margin,moderately,narrowly,nflorescence,nternode,orolla,palmate,perfec,plurifoliat,primary,revolute,ruit,sand-punctate,scent,slightly,spaced,stout,straight,strongly,swee,sweet,tamen,tem,tip,truncate,truncate-acuminat,tube,unit,vary,vein,venation,wider,ympodial,–7	2-lobed,abaxial,adaxial,apart,colour,corolla,form,ground,growth,height,history,inflorescence,length,life,na,number,ovary,perfect,plant,position,reproduction,seed,shape,spacing,staman,texture,width
452	wfo-0001029089	success	177	102	68	109	34	0.384	.5,/4,0.1-0.25,0.8-1,1-1.5,1.5-2,1.5-6,4.5-5,5-9,6-7,anther,apart,apex,bark,base,bilobed,bud,calyx,caniculate,cm,corolla,dark,densely,drying,elliptic,filament,flattened-reniform,fruiting,furcate,glabrous,globose,green,leaf,lobed,margin,minutely,mm,occasionally,opposite,otherwise,ovary,papillose,pedicel,petiole,pitted,pubescent,purplish,reddish-grey,resinous,scar,shiny,shrub,simple,small,smooth,somewhat,stem,stigma,style,surface,tan,tapering,tip,tree,trichome,way,white,x	.75,0.5-0.6,0.5-1,0.8-1.2,1,1/2,10-25,2.5-3.5,5-10,5-20-flowered,5-6,8-9,abrupt,acute,along,anthesi,apiculate,axil,ba,beginning,beneath,berry,branched,campanulate,closely,completely,covered,covering,cracking,decurrent,deflexed,dia,differing,difoliate,eaf,edicel,eed,either,enclosed,entire,erect,expand,exserted,free,geminat,glabrou,golden,impressed,incrassate,inflorescenc,lamina,later,lateral,like,lobe,lon,long,lower,main,major,material,member,middle,minor,nflorescence,obovoid,older,one,overlapping,pair,papillo,part,peeling,persistent,pinkish,planar,pore,poricidal,portion,primary,prominent,resinou,rounded,rounded-deltoid,ruit,secretion,shaped,size,slightly,spaced,still,straight,tall,tear-drop,tub,tube,ud,underside,uniseriate,unit,usually,varnish,varnished,vein,widening,widest,woody,ympodial,young	5-20,abaxial,adaxial,alternate,arrangement,cell,center,colour,diameter,flower,form,fruit,growth,height,history,inflorescence,length,life,na,new,number,peduncle,perennial,plant,position,prickle,rachi,reproduction,seed,shape,spacing,staman,texture,width
453	wfo-0001029091	success	212	96	70	142	26	0.33	-4,-4.5,1-2,1.5-,10,2-3,2.5-,3-4,4,7-8,acuminate,acute,anther,apex,axil,broadly,buff,campanulate,capitate,cm,colour,corolla,cyme,discoidal,elliptic,filament,flower,flushed,fork,glandular,globular,grey,intense,irregular,irregularly,larger,lavender,leaf,light,minutely,mm,obovate,ochre-yellow,ovate,overlain,ovoid,pale,pattern,pedicel,peduncle,pentagonal,petiole,pubescent,rachi,reddish-purple,reticulate-concentric,ridge,ridged,shrub,simple,slender,slightly,speckled,stellate-rotate,stem,stigma,style,surface,transverse,violet-purple	-1,-15,0.3-,0.5-0.8,0.5-1,1,1-10,1.5-2,10-20,10-toothed,15-40,170-210,2-12,2-2.5,20-30,3,3-,3-11-lobed,46/1,5,5-7,635/1,age,appearing,aromatic,articulated,articulation,aspect,ba,base,becoming,berry,blunt,bluntly,brownish,calyx,cell,clonal,close,common,conspicuous,cuneate,cut,dark,deeply,develop,developed,dia,downward,eed,effect,ellipsoid,emarginated,erect,exceeding,exerted,flattened,floral,forked,fresh,fruiting,general,giving,globose,gree,growing,hair,half,interacuminal,juvenile,lacking,lasting,later,lateral,lavende,lengthening,line,linear,linear-lanceolate,lobe,long,long-triangular,lower,may,mid-vein,mineral,narrowly,nflorescence,oblong,obscure,occasionally,ower,pedicellate,petiol,petiolate,plurifoliat,point,pore,poricidal,raised,readily,relatively,rh,ripe,rounded,ruit,scarcely,separate,several,shallowly,shed,shortly,sigmoid,sinus,slit,soft,soft-wooded,soon,sparsely,stone,straggly,subulate,succulent,swollen,tall,tip,tissue,toward,triangular,tub,ud,unit,upper,usually,violet,well,winged,without,woody,x,year,ympodial	abaxial,adaxial,arrangement,diameter,form,fruit,green,growth,height,history,inflorescence,length,life,na,number,ovary,perennial,plant,position,reproduction,seed,shape,spacing,staman,texture,width
454	wfo-0001029101	success	233	85	69	164	16	0.296	.5,/3,0-2,0.4-1.5,1-1.5,1-3,1-8,1.3-2,2.5-6,4-12,5-7,abaxial,abaxially,adaxial,andromonoecious,anther,apex,apparently,articulated,base,berry,cell,chartaceous,cm,cream,dark,diameter,dull,elliptic,erect,filament,flattened-reniform,flower,fruit,glabrescent,glabrous,green,lateral,leaf,length,lobed,margin,marking,maturity,mauve,mm,obtuse,orange-brown,outline,pale,pedicel,peduncle,petiole,pit,plant,raised,rounded,shrub,small,smooth,sparsely,spherical,stellate,stellate-pubescent,style,surface,way,yellow,young	-15,-3,/4,0-100,0-20,0-5,0-8,0.1,0.1-0.4,0.1-0.5,0.1-0.7,0.1-1,0.2,0.5-1,0.7-,0.8-3.5,00-200,1,1-4,1.3-2.6,1.4-2.2,1.5-2,1.5-2.5,1.7,1.8-3,1/5-1/4,10-14,10-20,2-,2-20,2-6,2.5-3.5,2.8-3.3,2/3-3/4,3-,3-10,3-4,3-7,30-100,4-7,5-,5-20,5-6,5-8,5-9,5-merous,5.5-8,6-8,7-13,8-15,acute,almost,always,alyx,apar,apart,apically,bark,blade,branched,broad-deltate,brown-green,calyx,concolorous,connivent,cuneate,darker,deltate,discolorous,distal,distance,drying,eaf,eed,elongating,equal,extending,flattened,free,fruiting,green-brow,hermaphrodite,heterostylous,infructescence,lengt,like,lobe,lon,long,long-styled,longer,lower,lowermost,mature,midpoint,midvein,moderately,multangulate,narrow-deltate,nflorescence,oblong,obovate,often,older,one,open,orolla,oung,ovate,pair,pendulous,per,pericarp,plurifoliat,poricidal,porrect,portion,present,prickl,prickle,prickly,primary,rarely,ray,reduced,reflexed,rounde,ruit,scar,secondary,sessile,short-styled,side,simple,sometimes,spaced,spreading,stalk,stalked,staminat,stem,straight,suborbicular,tamen,tapering,terete,tertiary,thick,time,tip,trichome,tube,unit,variously,vary,vein,venation,visible,well-developed,wide,woody,yellow-green,yellow-orange,ympodial	colour,corolla,form,growth,height,inflorescence,na,number,ovary,reproduction,seed,shape,spacing,staman,stigma,texture
455	wfo-0001029106	success	200	95	71	129	24	0.355	.5,/3,0.2-1,0.25-0.7,0.5-0.9,2-6,2-8,3-4,5-14,5-merous,abaxially,anther,apart,apex,apparently,articulated,base,berry,cell,cm,concolorous,densely,diameter,discolorous,drying,elliptic,erect,filament,flattened-reniform,flower,fruit,glabrescent,glabrous,lateral,leaf,length,lobed,long,maturity,mauve,membranous,mm,orange,orbicular,outline,ovate,pale,pedicel,peduncle,petiole,pit,raised,red,rounded,scandent,shiny,shrub,simple,small,smooth,sometimes,sparsely,spherical,stellate-pubescent,style,surface,way,weakly,white,yellow-orange,yellowish-green	-6,.1,0,0-0.3,0-10,0-2,0-20,0-5,0-6,0.1,0.2-0.4,0.5,0.5-0.8,0.5-1,0.5-2.5,0.9-1.2,1-1.6,1-2,1-5,1.5-1.8,1.5-2,1.5-3.5,1/4,1/5-1/4,2-3.5,2-4,2-5.5,2.2-3,2/,3-25,3-3.5,4-6,4-8,5-8,6-8,acuminat,acute,alyx,ame,apar,apically,appearing,bark,blade,branched,c.,calyx,cuneate,curved,deltate,distance,eaf,eed,elongating,equal,extending,eye,flattened,free,fruiting,gently,infructescence,light,lobe,lon,longer,lower,margin,mature,midpoint,midvein,naked,nflorescence,obtuse,older,one,open,orange-brow,orange-brown,orolla,oung,pair,pendulous,per,perfec,pericarp,plurifoliat,poricidal,porrect,portion,prickl,prickle,prickly,primary,ray,reflexed,scar,sessile,shallow,shorter,side,size,slender,spaced,spreading,stalk,stalked,stellate,stem,straight,subentire,tamen,tapering,terete,tertiary,time,tip,trichome,tube,uit,unit,variously,vary,vein,venation,visible,wide,woody,ympodial	abaxial,adaxial,arrangement,colour,corolla,form,growth,height,history,inflorescence,life,na,number,ovary,plant,position,rachi,reproduction,seed,shape,spacing,staman,stigma,texture
456	wfo-0001029112	success	190	76	51	139	25	0.268	1-10,1-2,10-17,10-21,2-3.5,2.5-4.5,2.6-3,2.7-5.7,20,3.5-4.5,3.5-7,acuminate,anther,apex,articulated,cm,conical,corolla,densely,diameter,elliptic-lanceolate,filament,flower,forked,fruit,glabrous,green,greenish,herb,leaf,light,mm,mucilaginous,odd-pinnate,ovate,ovoid,pale,pedicel,peduncle,petiole,plant,pubescent,rotate,seed,slightly,stigma,style,terminal,violet,whitish,yellow	0-2,0.5,0.9-1.7,1-3,1-4,1.4-2.5,1.5-1.8,1.5-2,2.7-3.5,2.7-4.2,3-4,3-5,3-6,3-7,5,5-8,5-merou,6.5-5.5,9.5-13,abaxially,acumen,adaxially,ag,along,alyx,apart,apparently,arranged,axe,axillary,base,bead,berry,blade,brownish,bud,capitat,cell,chartaceous,ciliate,condition,connivent,covering,decreasing,digestion,distal,dorsally,drying,eaf,edge,eed,enzyme,equal,especially,exceeding,flat,folded,fresh,geminat,generally,glabrou,gradually,green-white,hair,hair-like,half,homostylous,honeycomb-shaped,interjected,lanceolate,larger,lateral,leaflet,lengthening,like,living,lobe,long,lower,make,margin,middle,minute,moniliform,mottled,multiple,narrow,necklace,nflorescence,obtuse,orolla,pair,perfect,petiolule,plurifoliate,pore,poricidal,present,pubescen,purple,ray,removed,ripe,ruit,secondary,semierec,seudostipule,size,slit,spaced,specimen,stamen,ste,stolon,subequal,subtending,symmetrical,tall,tamen,tem,testal,thick,thir,throughout,tip,toward,tri-,tube,tuber,typically,unit,usually,vary,wall,wet,wide,wing,x,ympodial	abaxial,adaxial,arrangement,capitate,colour,form,growth,height,history,inflorescence,length,life,na,number,ovary,perennial,position,rachi,reproduction,shape,spacing,staman,surface,texture,width
457	wfo-0001029120	success	168	77	47	121	30	0.28	0.1-0.5,0.7-1,1.1-1.5,1.1-2,3-3.5,6-8,anther,apart,apex,base,beneath,cm,corolla,filament,glabrous,golden,hirsute,internodal,leaf,lobed,minutely,mm,narrowly,nearly,opposite,ovary,ovate,pale,paler,pedicel,peduncle,petiole,pubescent,rest,shrub,simple,sparsely,stigma,style,surface,trichome,unifoliate,uniseriate,vein,white,yellow,yellow-green	.05,.5,.75,/2,0.5-1.5,1-1.5,2.5-3.5,2.6-7,5-10-flowered,5-8,6.5-16.5,8511,abrupt,acuminate,acute,anthesi,bark,basal,beginning,black,bud,bullate,calyx,cell,dark,decurrent,deflexed,densely,dia,difoliate,dry,drying,eaf,edicel,eed,epidermi,erose,especially,evenly,f,fide,fleshy,free,geminat,globose,greenish-brown,inflorescenc,infloresence,know,known,lanceolate,large,larger,later,lateral,lehmann,like,lobe,lon,long,long-triangular,lower,main,margin,middle,midrib,minor,narrow,narrower,nflorescence,occasionally,often,older,outer,pair,papillose,peduncl,petaloid,point,pore,poricidal,portion,present,prominently,proximal,raised,reproductive,ruit,scar,scattered,shaped,slender,slightly,spaced,specimen,speckle,stem,straight,sympodial,tall,tapering,tear-drop,terminal,thickened,tip,tub,tube,ud,unbranched,unit,upper,urceolate,venation,way,white-papillo,wide,widening,widest,x,ympodial,young	5-10,abaxial,adaxial,arrangement,colour,decument,diameter,flower,form,fruit,growth,height,history,inflorescence,length,life,na,number,perennial,plant,position,rachi,reproduction,seed,shape,spacing,staman,texture,white-papillose,width
458	wfo-0001029121	success	161	86	60	101	26	0.373	0.2-2,1-4,1-5,15-30,2-3,2-3-celled,3.8-11,4-5.5,5-8,8-16,apex,blue,branched,cell,cm,conical,corolla,covering,cyme,deep,diameter,dichasial,dichasially,distal,ebracteate,elliptical,filament,flower,glabrous,green,green-white,hair,hair-like,half,herbaceous,lateral,leaf,medium,mm,monochasial,narrowly,odd-pinnate,ovate,ovoid,pedicel,peduncle,perennial,petiole,plant,purple,rotate,scattered,seed,short,stigma,style,testal,thick,wall,yellow	-6,0,0-2,1.1-3.9,1.2-2.5,1.2-3.3,10,2-,2-10,2-13,3-5,3-6-foliat,3.6-9,4-10,4.5-10.0,5-20,9-33,abaxiall,abaxially,acumen,acuminate,acute,adaxially,apical,apically,articulate,attenuate,base,calyx,commonly,connate,cuneate,dehiscent,digestion,diminishing,dorsally,eaf,edge,eed,emoval,enzyme,exceeding,flat,folded,forked,generally,globo,gradually,honeycomb,interjected,introrse,leaflet,living,lobe,lon,long,lower,lunat,make,maturing,mucilaginous,nflorescence,nther,oblique,obtuse,often,orolla,pair,pattern,perfect,petiolule,plan,poricidally,proximal,rarely,reveal,rounded,ruit,sessile,seudostipule,short-attenuate,size,slit,specimen,stamen,straight,subequal,tal,tem,terminal,throughou,throughout,tip,toward,tuber-bearing,typically,unit,vary,wide,ympodial,¼	abaxial,adaxial,anther,arrangement,colour,form,fruit,globose,growth,height,history,inflorescence,length,life,na,number,ovary,position,rachi,reproduction,shape,spacing,staman,surface,texture,width
459	wfo-0001029125	success	197	100	69	128	31	0.35	1,5-merous,6,abaxial,abaxially,adaxial,anther,anthesi,apex,appressed,base,berry,black,brownish,central,closely,cm,concave-reniform,corolla,densely,diameter,filament,flower,fruit,glabrous,globose,green,herb,internodal,lateral,leaf,live,maturity,maximum,minutely,mm,orange,ovary,ovate-lanceolate,pale,papillate,pedicel,peduncle,petiole,plant,pubescent,purple,purplish,ripe,seed,shiny,simple,small,spaced,sparsely,spreading,star,stellate,stigma,straight,style,subshrub,surface,trichome,turning,uniseriate,white,woody,yellow	.0–3.5,.1,.1–1.4,.2,.4,.5–2.0,.6,0.5,0.5–0.6,0.5–1.0,0.8–0.9,0.9,1.0–1.2,1.0–1.5,1.0–4.0,1.5–2.0,1.5–3.0,1.7-,1.8–3.5,1–2-celled,2.5–12.0,2/3,20–100,2–3-celled,2–4,3.0–3.4,3.5–4,35–45,3–5,3–5-celled,4–8,5–6,6–7,acuminate,acute,adaxially,age,along,apar,apparently,arising,articulated,attenuate,ba,beyond,branching,calyx,cell,cone,conical,cuneate,delicate,deltate,difoliate,eaf,eed,ellipsoid,end,entire,especially,exerted,free,fruiting,geminat,growt,hilum,later,lengthening,like,lobe,lobed,lon,long,lower,margin,narrower,nearly,nflorescence,oblique,occasionally,often,one,outline,pair,pentagonal,per,perfect,place,pore,poricidal,portion,positioned,primary,purple-tinged,reflexe,reflexed,ridged,ruit,scar,scattered,shorter,single,slightly,slit,stem,stemmed,stone,strongly,sub-lateral,tall,tem,terete,testal,tinged,tip,toward,traingular,tube,ud,unequal,unit,usually,vein,whitewith,wide,ympodial,young,¼	0.5-0.6,0.5-1.0,1-2-celled,1.0-1.2,1.0-1.5,1.5-3.0,1.7-3.4,20-100,3-5,3.5-4,5-6,apart,arrangement,colour,form,growth,height,history,inflorescence,length,life,na,number,position,rachi,reproduction,shape,spacing,staman,texture,width
460	wfo-0001029138	success	170	72	48	122	24	0.282	0.15-0.3,2.4-5.5,20-30,3-4,3.5-4.5,3.5-6.7,4-6,6-6.5,7-10,adaxially,anther,articulated,base,broadly,brown,chartaceous,cm,cylindrical,densely,diameter,extra-axillary,flower,fruit,glabrous,green,grey-green,inflorescence,length,mm,oblate,ovate,pedicel,peduncle,perennial,petiole,prostrate,pseudo-racemose,purple,rhizomatous,rotate,shrub,sparsely,stellate-pubescent,straight,style,unknown,yellow,yellowish	%,0,0-0.1,0-0.6,0-1.5,0-5,0.25-0.5,0.5-0.9,0.6-0.7,0.6-0.8,0.6-1.1,0.8-1.5,0.9-1.2,1-1.5,1-1.8,1-2,1-2.5,1-5,1.6-2.1,1.7-4,2-foliate,2-locular,2.5-3.5,20-100,3-8,3-80,5-8,5-merou,6-10,6-8,65-115,7-8,abaxially,absen,absent,accrescent,acicular,acute,adaxiall,alyx,apart,apex,apparently,armed,axe,ba,blade,broad-based,calyx,cuneate,d.,deltate,directed,distall,distally,distributed,dult,eaf,eed,eglandular,enclosing,entire,finger,fruiting,functional,geminat,glabrou,gland-tipped,hair,juic,lamina,lateral,lobe,lon,long,longer,lower,margin,markedly,mature,mesocarp,mid-point,midpoint,midvein,minute,moist,nflorescence,oblique,obtuse,orolla,part,per,pore,porrect,present,prickle,ray,ruit,rusty,short,simple,spaced,stage,stalk,stellae,stem,tal,tamen,thick,thicker,thicknes,throughout,time,tube,unbranched,unit,unknow,uvenile,vary,wide,x,ympodial	abaxial,adaxial,colour,corolla,filament,form,growth,height,history,leaf,life,na,number,ovary,plant,position,reproduction,seed,shape,spacing,staman,stigma,surface,texture
461	wfo-0001029150	success	177	105	81	96	24	0.458	0.3,0.3–0.5,0.8-1,0.8–1,0.8–1.5,1.2–1.5,1.5–2.2,15,1–11,1–5,1–6,2.5–3,2–10,3-5,3–10,5-merous,9–12,acute,adaxially,anther,apex,base,branched,canopy,climbing,cm,color,conical,diameter,ellipsoidal,elliptical,entire,extra-axillary,filament,flower,fruit,glabrous,leaf,light,margin,membranaceous,midvein,minutely,mm,moderately,nearly,oblique,opposed,ovate,pedicel,peduncle,petiole,pinnate,pubescent,rachi,rarely,rounded,rugose,sand-punctate,simple,slender,sparsely,stellate,stem,stigma,strong,style,surface,tan,teardrop-shaped,tree,trichome,truncate,understory,vegetation,venation,vine,white,wiry,woody,x	.5,0.3-0.5,0.5–1.1,0.8–3.5,1.5,1.5–2,1–1.5,1–2,2.5–5,2.5–8,2–2.5,2–3,3–4,3–50,6,7–8,8-shaped,abaxially,accrescent,across,adaxiall,alyx,apar,apicall,apically,apiculate,attenuate,axe,berry,blade,c.,calyx,capitat,ciliate,cros,cylindrical,delicate,distant,dried,eaf,eed,enlarged,except,flattened,fleshy,flush,fruiting,glabrou,inconspicuous,lamina,lanceolate,larger,living,lobe,lon,long,lower,m.,material,mor,nflorescence,nternode,older,orolla,pair,pale,perfec,pinkish-white,plurifoliat,pointed,reaching,rounded-deltoid,ruit,scar,secondary,section,shortly,side,slightly,small,somewhat,spaced,specimen,tamen,tem,thick,thickened,time,tip,translucent,tube,unit,vary,vein,wide,ympodial	abaxial,apart,arrangement,capitate,corolla,form,growth,height,history,inflorescence,internode,length,life,na,ovary,perfect,plant,position,reproduction,seed,shape,spacing,staman,texture
462	wfo-0001029151	success	197	90	68	129	22	0.345	-10,0.2-0.6,0.25-0.5,1-1.5,1-2,1-5,10-15,15-20,2-15,2-2.5,2-3,3.5-5,4.5-5,5-10,8-10,8-15,abaxially,acute,adaxial,adaxially,annual,anther,apart,apex,brown,cm,dark,densely,diameter,elliptic,entire,filament,flattened,flower,forked,fruit,glabrous,globose,green,leaf,leaf-opposed,margin,minutely,mm,narrowly,oblong,ovate,pedicel,peduncle,petiole,pubescent,purple,rachi,rarely,reniform,reticulate,silvery,sprawling,stellate,stigma,style,surface,truncate,unbranched,undulate,white,x,yellow	0-0.5,0.1-0.3,0.5-1,1-2.5,1-6,1.5-2,1.5-3,1.5-6,2-4,2-6,2-8,4-10,5,5-7,5-8,6-10,7-10,7-9,8,abundantly,accrescent,acicular,acro,acumen,apparently,armed,articulated,axe,ba,base,blade,calyx,capitat,chartaceous,close,completely,cone,connivent,covered,covering,curved,cylindrical,deflexed,developed,difoliate,directed,discolorous,distall,downward,eaf,eed,eglandular,equal,frui,fruiting,geminat,hair,held,herb,high,interpetalar,juic,juvenile,larger,lateral,like,lobe,lon,long,loosely,lower,main,markedly,mesocarp,midpoint,midrib,minute,moderately,moist,multangulate,nearly,nflorescence,oblique,obtuse,orolla,outside,pale,perfect,pore,porrect,prickle,prickly,probably,ray,rounded,ruit,scarcely,shallow,shorter,side,simple,small,spaced,sparse,sparsely,sparser,spiny,stalk,stellate-pubescent,stem,straight,subcordate,tamen,tem,time,tissu,tissue,triangular,tube,unarmed,unit,usually,vary,vein,vigorous,whitish,wide,yellowish,ympodial	abaxial,capitate,colour,corolla,form,growth,height,history,inflorescence,length,life,na,number,ovary,plant,position,seed,shape,spacing,staman,texture,width
463	wfo-0001029152	success	197	87	62	135	25	0.315	0.5-1,0.9-1.3,1-4,1.1-1.3,2-5,2.5-3,anther,apex,area,base,broadened,brown,calyx,closely,cm,corolla,dark,elliptic,filament,floccose,flower,fruit,glabrous,globose,green,inflorescence,leaf,lightly,lobed,minutely,mm,nearly,obovate,often,opposite,ovary,overlapping,ovoid-reniform,pale,papillose,pedicel,petiole,pitted,plane,plant,red,shape,shrub,simple,single,slender,small,spaced,stigma,style,surface,tapering,tip,tree,tube,white,winged	.1,.5,0.25-0.5,0.75-1,0.8-1,1,1-1.5,1-2,1-3,1.5-1.7,1.5-2,2-2.5,2-3,2-4,3-5,3-8-flowered,4-6,6-8,61-25,8.5-16,acuminate,acute,anthesi,appearanc,appearing,appressed,attenuate,ba,bark,beginning,beneath,berry,blade,branch,broadly,bud,citronella,completely,conical,corky,cuneate,deciduous,decurrent,deep,deflexed,deltoid,densely,dia,differing,difoliate,distal,dry,eaf,edicel,eed,ellipsoi,enclosing,erect,et,exsertion,fide,flattened,fragrance,free,fruiting,geminat,giving,greyish-red,held,hyaline,inflorescenc,keeled,large-lenticellate,late,lateral,live,lobe,lon,long,long-styled,longer,lower,main,major,margin,material,middle,midrib,minor,nflorescence,older,one,pair,per,planar,pore,poricidal,portion,prominent,prominently,quite,red-floccose,reddish,reddish-floccose,reflexed,reminiscent,rounded,ruit,scar,shaped,shiny,short-styled,size,slightly,somewhat,soon,stem,straight,styl,tall,tear-drop,terminal,third,tillett,trichome,ud,unit,usually,vein,weak,widest,woody,x,ympodial,young	1.5-6,3-8,abaxial,adaxial,arrangement,colour,diameter,form,growth,height,history,length,life,na,number,peduncle,perennial,position,rachi,reproduction,seed,spacing,staman,texture,width
464	wfo-0001029156	success	65	54	39	26	15	0.6	0.5,1.5-2,10-12,4-6,6,6-8,<,almost,bark,berry,center,cm,completely,diameter,exfoliating,flattened,fruiting,glabrous,golden,growth,liana,markedly,minutely,mm,multiseriate,new,pale,pedicel,per,pitted,reniform,seed,shiny,stem,surface,tan,trichome,vine,woody	-3,1,2,apex,apparently,cell,deeply,eed,epiphytic,fide,lateral,long,margin,minute,nee,noddin,occasionally,older,rectangular,rib-like,shreddy,sinuate,testal,thickening,wall,wide	2-3,colour,form,height,history,length,life,na,nodding,number,plant,reproduction,shape,texture,width
465	wfo-0001029156	success	65	54	37	28	17	0.569	0.5,1.5-2,10-12,<,almost,berry,center,cm,completely,deeply,diameter,exfoliating,flattened,fruiting,glabrous,growth,liana,minutely,mm,multiseriate,new,pale,pedicel,per,pitted,reniform,rib-like,seed,shiny,sinuate,stem,surface,tan,thickening,trichome,vine,woody	-3,1,2,4-6,6-8,apex,apparently,ark,cell,eed,em,epiphytic,fide,golden,lateral,lon,margin,markedly,minute,nee,noddin,occasionally,older,rectangular,shreddy,testal,wall,x	2-3,6,bark,colour,form,height,history,length,life,na,nodding,number,perennial,plant,reproduction,shape,texture
466	wfo-0001029160	success	150	82	59	91	23	0.393	/2,0.7,1.3-1.8,2-7,3-8,6-8,6.5-8.6,accrescent,across,annual,anther,beneath,berry,blade,broadly,brown,calyx,capitate,cm,dark,dm,dry,eglandular,enveloped,erect,few-rayed,fully,glabrous,gland,hair,including,internodal,long,maturity,mm,mostly,ovate,ovoid,petiole,pinnatifid,plump,prickly,radially,ridged,scattered,sessile,short-stipitate,sometimes,spherical,splitting,stellae,stellate,strait,thrice,tightly,twice,vestiture,wholly,yellow	0.35-0.50,0.5,1.11.4,1.3-1.6,1.8-2.2,20-40,3.0-3.5,4-8,4.5-6.0,5-13,5.6-7.5,6-10-flowered,acicular,acro,acute,adjacent,also,alyx,among,anthesi,appearance,armed,base,branched,bristly,campanulate,deep,deltoi,developing,dia,difoliate,divergently,divided,eaf,eed,exceeding,extende,finer,geminat,giving,herb,heteromorphic,hilum,incurved,invested,less,linear-lanceolate,lobe,lon,lowermost,main,many,much,much-dissected,narrowly,nflorescence,notch,occasionally,often,one,orolla,pair,prickle,purple,ruit,shorter,shortest,size,slende,somewhat,spreading,stem,stout,straigh,sunken,tall,tamen,terminally,three,tigma,tinged,tub,tube,tyle,ultimate,unit,uppermost,vary,vein,whitish-tinged,ympodial	arrangement,colour,corolla,diameter,extended,filament,form,fruit,growth,height,inflorescence,leaf,length,ovary,plant,reproduction,seed,shape,staman,stigma,style,surface,texture
467	wfo-0001029163	success	149	77	50	99	27	0.336	-25,0.3-2.5,0.5-1,10-,2,2-18,2-6,2.5-3,20-30,3-14,4-20,5-12,5-8,7-9,abaxial,apex,chartaceous,cm,diameter,elliptic,elliptic-ovate,flower,fruit,glabrous,globose,herb,lenticular,mm,pedicel,peduncle,perennial,petiole,pseudohair,puberulent,puberulent-pubescent,purple,rachi,shrub,simple,stellate,stigma,style,subcoriaceous,surface,unbranched,unknown,white,whitish,x,yellow	-4,-9,1,1-2,1.5-2,1.5-2.5,1.5-3,13-18,2-3,2-7,3-4,3-5,4-5-foliat,4-6,4.5-23,9-15,abaxially,absen,acuminate,acute,adaxiall,adaxially,aggregate,apart,articulated,axe,band,base,blade,calyx,cell,color,connivent,cuneate,cylindrical,decurrent,deltate,densely,denser,directed,distall,distally,eaf,eed,eglandular,entire,free,glandular,hair,lanceolate,leaving,like,lobe,lon,long,lower,margin,moderately,narrowed,narrowly,nearly,nflorescence,nther,obtuse,orolla,papillose,pedicellar,pore,projection,puberulent-pubescen,pubescence,radiu,remnant,ripe,roughened,ruit,scale-like,slightly,small,sometimes,spaced,sparsely,stalked,stem,stone,subapical,tal,tem,thickened,time,tip,triangular,truncat,tube,unit,vary,vein,wide,ympodial	adaxial,anther,arrangement,colour,corolla,filament,form,growth,height,history,inflorescence,leaf,length,life,na,number,ovary,plant,position,reproduction,seed,shape,spacing,staman,texture,truncate,width
468	wfo-0001029171	success	137	79	50	87	29	0.365	-,-10,-15,0.5,1-3,1-4.5,1-5,1.5-2,10-25,2-3,3.5-6.5,4-10,5-8,7-9,angled,apart,apex,branched,chartaceous,cm,diameter,elliptic,flower,forked,fruit,glabrous,globose,mm,orange,ovate-elliptic,pedicel,peduncle,petiole,pubescent,purple,rachi,rarely,red,rugose,shrub,simple,smooth,sometimes,stellate,stigma,style,unbranched,white,x,yellow	1.5-7.5,10-35,11-20,3-4,3.5-18,4-5,5-6,6-,8-17,abaxially,abruptly,absen,acuminate,acute,adaxially,aggregate,also,and/or,articulated,axe,ba,base,blade,calyx,cell,connivent,cuneate,cylindrical,decurrent,deltate,dendritically,dense,densely,directed,distall,eaf,eed,eglandular,entire,except,gland,glandula,glandular,hair,lanceolate,like,lobe,long,lower,many-foliat,margin,midrib,moderately,narrowed,narrowly,near,nearly,nflorescence,nther,obtuse,often,orolla,perfect,pore,puberulent,radiu,ripe,ruit,shoot,short-stalked,slightly,spaced,sparsely,ste,stone,tal,tem,time,tip,triangular,truncat,tube,unit,usually,vary,wide,ympodial	abaxial,adaxial,anther,arrangement,colour,corolla,filament,form,growth,height,history,inflorescence,leaf,length,life,na,number,ovary,plant,position,reproduction,seed,shape,spacing,staman,surface,texture,truncate,width
469	wfo-0001029215	success	49	61	13	36	48	0.265	0.3-0.5,0.5-2.5,1,brown,calyx,cell,cm,diameter,fruit,herb,obovate,pubescent,surface	-1.8-2.3,.2,0.5-0.7,2.3-2.9,appearance,border,coarse,eed,elongating,entire,fide,give,hair-like,lateral,lobe,long,markedly,mm,narrowly,outgrowth,round,shrub,silky,small,smelling,spreadin,strong,tall,testa,thick,wall,weigend,wide,winged,woody,xyledecor	0.2,abaxial,adaxial,anther,apex,arrangement,bark,bud,center,colour,corolla,filament,flower,form,fruiting,growth,height,history,inflorescence,leaf,length,life,margin,na,new,number,ovary,pedicel,peduncle,perennial,petiole,plant,position,prickle,rachi,reproduction,scar,seed,shape,spacing,spreading,staman,stem,stigma,style,texture,trichome,width
470	wfo-0001029216	success	243	85	62	181	23	0.255	0.4-0.5,0.5,0.6-1,1-1.2,1-2,1.2-6,10,3,4,annual,anther,apex,articulated,biennial,bright,brown,capitate,cm,conical,corolla,deep,diameter,distal,elliptic,filament,fruit,glabrescent,globose,green,hair-like,herb,imparipinnate,inflorescence,interrupted,lanceolate,length,less,long,minute,mm,narrowly,obovate,orange,outgrowth,ovary,ovate,pale,pedicel,peduncle,pentagonal,perennial,petiole,plant,pubescent,red,shape,simple,sparsely,stigma,style,surface,yellow	+,-0.5,-10,-5,.5,.8-1,0.1-0.3,0.1-0.5,0.1-0.6,0.1-0.8,0.2-0.25,0.2-0.3,0.2-0.4,0.2-0.8,0.3-0.4,0.3-0.5,0.3-2,0.4,0.5-0.8,0.5-1.5,0.5-2,0.6-0.8,0.8-2.5,1-3,1-4,1-6,1.5-2.3,1.5-2.5,1.5-3,1/,10-,10-14,2,2-4.5,2-locular,2.5-3.3,20-35,3-,3-4,3-5,3-7,3-foliate,5,5-15-flower,6-10,7-10,<,absen,absent,accrescent,acroscopically,acute,adpressed,allogamous,always,and/or,angeld,anthesi,apical,appearance,appendage,articulation,attenuate,axi,basal,base,basiscopically,becoming,branch,calyx,cell,cente,column,composed,cone,cordate,crenate,cultivar,decurrent,deeply,dentate,eaf,edicel,eed,entire,erect,exserted,extending,facultatively,fasciated,fruited,fruiting,giving,gland-tipped,glandular,gree,half,halfway,included,initially,interjected,internode,large,larger,later,lateral,leaflet,like,linear,lobe,lobulate,lon,longer,lower,mainly,margin,maturity,minutely,mixture,multicellular,multilocular,near,nflorescence,numerous,oblique,often,one,pair,particularly,petiolule,population,present,primary,procumbent,pseudostipule,rarely,reflexe,ruit,scen,secondary,sessile,shaggy,shaped,short,silky,sometimes,somewhat,sparse,spreading,staminal,stem,sterile,straight,strong,strongly,tangled,tem,terminal,tertiary,testa,thick,thickening,tip,total,toward,trichome,truncate,tube,ud,unicellular,uniseriate,unit,usually,variety,varying,villous,viny,wall,wide,winged,ympodial	1/3,5-15,abaxial,adaxial,arrangement,colour,flower,form,growth,height,history,leaf,life,na,number,position,rachi,reproduction,seed,spacing,staman,texture,width
471	wfo-0001029226	success	206	100	76	130	24	0.369	1-1.5,1-3,10-40+,2-6,2-9,2.5-10,3-3.5,5-7,7-11,8-13,anther,apart,apex,base,berry,black,blue,branched,bright,capitate,cm,cordate,corolla,dark,densely,diameter,filament,flattened,flower,glabrous,globose,growth,herbaceous,irregularly,lateral,lavender,leaf,lobed,lyrate,many,minutely,mm,open,pale,pedicel,peduncle,perfect,petiole,pinnatifid,pitted,pubescent,red,reniform,seed,shiny,short-glandular,shrub,simple,slender,spaced,spreading,stellate,stigma,style,surface,tan,terminal,time,translucent,uniformly,vine,way,white,woody,yellowish,¾	-7,-9,.5,.75,0-1,0.5,0.5-5,1-2,1-celled,2,2-3,3-6,30,4,4-6,5-merou,>,acuminate,acute,ag,alyx,anthesi,apparently,ark,articulated,ba,basal,breaking,calyx,cell,completely,congested,conical,connivent,decurrent,deltate,distall,divided,dry,eaf,eed,ellipsoid,elongate,enation,entire,exserted,flexuous,free,fruiting,glabrescent,gland,glandular,green,hairy,ilament,juice,lengthening,like,lobe,long,longer,loosely,lower,margin,material,mature,membranous,mere,minute,new,nflorescence,occasionally,often,older,one,orolla,overtopping,pair,papillat,papillate,papillo,per,pinnate,plurifoliat,pore,poricidal,portion,primary,reflexed,remainin,rim,ripe,ruit,sagittate,scar,scarlet,shorter,sleeve,slit,small,sometimes,sparsely,spot,sprawling,spreadin,staining,stem,strongly,tangled,tem,testal,thin,third,tip,trichome,truncate,tube,twinin,ud,uniseriate,unit,usually,vary,vein,wall,weak,wide,widest,winged,ympodial	abaxial,adaxial,arrangement,colour,form,fruit,height,history,inflorescence,length,life,na,number,ovary,papillose,plant,position,rachi,reproduction,shape,spacing,staman,texture,width
472	wfo-0001029234	success	204	79	57	147	22	0.279	0-2,0.1-0.5,0.3-0.9,0.5-1,0.5-2,0.9-2.1,1-1.5,1-10,3-5,3-8,5.5-7,9-24,anther,apex,articulated,base,capitate,chartaceous,cm,cuneate,diameter,erect,filament,flattened,flower,fruit,glabrous,globose,green,inflorescence,lanceolate,leaf-opposed,length,mm,narrowly,pale,pedicel,peduncle,perennial,petiole,pseudo-racemose,pubescent,purple,rachi,red,rhizomatous,rotate-stellate,rugose,shrub,sparsely,stellate,stigma,style,surface,unbranched,x,yellow	%,0-0.1,0-1,0-2.5,0-3,0-4,0-6,0.15-0.3,0.2-0.3,0.4-0.5,0.4-0.7,0.5-1.5,0.5-5,0.6-0.8,0.8-1.1,1-4,1-locular,1.1-1.5,1.5-2,1.5-2.5,11-23,18-24,2-2.5,2-3,2-6,20-,3-3.7,3-7,4-,4-7.5,4-8,4.7-7,5-9.5,5-merou,7-10,7-11,abaxially,absen,absent,accrescent,acicular,across,acute,adaxiall,adaxially,adult,alyx,apart,apparen,attenuate,axe,ba,bilobe,blade,branche,brown,calyx,confined,connivent,cylindrical,dense,directed,distall,distally,dm,eaf,eed,eglandular,entire,exocarp,few-,finger,fruiting,geminat,gland-tipped,glandular-puberulent,hair,half,incomplete,juicy,lamina,lateral,less,lobe,long,longer,loosely,lower,margin,markedly,mature,mesocarp,mid-point,midpoint,midrib,midvein,minute,moderately,nflorescence,oblique,orolla,ovate,part,per,perfect,placenta,plurifoliate,pore,porrect,present,prickle,ray,ruit,seeded,septum,sessile,short,simple,spaced,sparse,stage,stalk,stellae,stellate-pubescent,straight,succulent,tal,tamen,tem,thick,thicker,thicknes,throughout,time,tip,toward,triangular,tube,unarme,unarmed,unit,unknow,uvenile,vary,white,wide,ympodial	abaxial,adaxial,bilobed,colour,corolla,form,growth,height,history,leaf,life,number,ovary,plant,position,reproduction,seed,shape,spacing,staman,texture,unknown
473	wfo-0001029236	success	159	76	49	110	27	0.308	0.2-1,0.45-0.5,1-1.5,1-2,1.4-1.7,2-5,abaxially,adaxial,anther,apex,apically,cm,corolla,densely,diameter,elliptic,filament,flattened,fleshy,flower,fruit,glabrous,globose,growth,leaf,lenticular,lobed,minutely,mm,narrowly,obscurely,ovary,pale,pedicel,pericarp,petiole,pitted,pointed,pubescent,purplish-black,reddish-brown,shrub,slightly,stigma,style,surface,terminal,thin,violet	.5,0.2-0.7,0.5,0.5-1.5,0.9-2.3,1/2,2-4,3,6-9,absent,age,anthesi,apical,apparently,appearing,axi,ba,bark,basal,base,becoming,berry,bi-lobe,branch,branching,branchlet,broadly,calyx,compact,completely,conical,coriaceous,cupulate,decurrent,deflexed,deltate,dendritic,dichasial,eaf,edicel,eed,erect,ew,except,exserted,free,fruiting,grey-brown,inserted,later,lateral,less,lobe,long,lower,m.,many,margin,middle,midvein,near,nflorescence,nodding,obscure,occasionally,older,overtopping,packe,per,persistent,plurifoliate,pore,poricidal,portion,prominent,purplish,revolute,ruit,scar,scattered,secondary,shiny,shoot,short,simple,sleeve,slit-like,sparsely,stamen,stem,strongly,tall,tapering,time,tip,trichome,trongly,tub,tube,ud,unit,usually,venation,way,wide,winged,woody,x,ympodial,young	1,2,6,abaxial,arrangement,bi-lobed,colour,form,height,history,inflorescence,length,life,na,number,peduncle,perennial,plant,position,rachi,reproduction,seed,shape,spacing,staman,texture,width
474	wfo-0001029244	success	233	91	71	162	20	0.305	0-0.5,0-2,0-2.5,1-1.5,1-4,1.4-6,2-3,4-5.5,4.7-5,5-7,6-12,7-30,acuminate,acute,andromonoecious,anther,apex,articulated,base,chartaceous,cm,contiguous,cylindrical,densely,diameter,elliptic,erect,especially,extra-axillary,filament,flower,fruit,globose,green,inflorescence,leaf,length,lilac,margin,minutely,mm,moderately,nearly,obovate,occasionally,orange,ovate,pale,pedicel,peduncle,perennial,petiole,plant,purple,rachi,red,reniform,rhizomatous,rugose,shrub,sparsely,stellate,stellate-pubescent,stigma,style,surface,thick,toward,unbranched,weakly,yellow	%,0-0.2,0-0.3,0-1,0-16,0-55,0-80,0-9,0.15-0.25,0.2-0.25,0.2-0.3,0.2-0.5,0.25-0.4,0.4-0.7,0.5-2,0.8-5,1-2,1.1-1.8,1.5-2.5,1.8-3.5,10-18,100-150,12-25,2-12,2-4,2-foliate,2-locular,2.1-3.2,2.5-3.6,22-31,3-10,3-5,3-7,3-7.5,3-8,4-7,5-10,5-merou,6-8,6-9,7-10,7-12,7-9,8-10,9-16,9-25,90-200,abaxially,absen,absent,accrescent,acicular,across,adaxiall,adaxially,adult,alyx,anvil-shape,apart,apiculate,axe,ba,blade,branch,branche,brown,calyx,capitat,confined,connivent,cross-section,cuneate,decimetre,deltate,directed,distall,distally,distributed,dm,eaf,eed,eglandular,entire,exocarp,finger,flattened,fruiting,functional,geminat,gland-tipped,hair,half,hetereostylous,juicy,juvenile,lamina,lanceolate,lateral,less,lobe,lobed,long,longer,loosely,lower,markedly,mature,mesocarp,mid-point,midpoint,midrib,midvein,minute,moist,narrowly,nflorescence,oblique,obtuse,orolla,pair,part,per,placenta,pore,porrect,present,prickle,ray,rostrate,ruit,rusty,scarcely,sessile,shallowly,short,side,simple,sometimes,spaced,stalked,stellae,straight,summit,tal,tamen,tem,thicker,throughout,time,tip,transparent,triangular,tube,unarme,unarmed,unit,upper,vary,vein,wide,x,ympodial	5-merous,abaxial,adaxial,capitate,colour,corolla,form,growth,height,history,life,number,ovary,position,reproduction,seed,shape,spacing,staman,texture
475	wfo-0001029246	success	209	77	53	156	24	0.254	-1.5,0.1-0.4,0.3-0.8,0.7-1.3,0.7-2,0.8-1.1,1-4,1.5-2.3,1.5-2.5,2,3-5,3.5-5,5-merous,abaxial,adaxial,anther,apex,chartaceous,cm,diameter,dull,elliptic,filament,flattened-reniform,flower,fruit,lateral,leaf,length,less,lobed,mauve,mm,moderately,orange-brown,orange-red,pale,pedicel,peduncle,petiole,recurved,shrub,simple,smooth,sparsely,spherical,stellate,stellate-pubescent,style,surface,unbranched,white,yellow	-1,-4,/5,0,0-15,0-5,0.1-0.3,0.15-0.3,0.2-1.5,0.3-0.5,0.5,0.5-1.5,0.7-1.5,0.8-3,0.9-1.3,1-1.5,1-1.8,1-10,1-3,1-5,1-8,1.2-2,1.5-6,1.7-6,1.8-3,1/10-1/5,1/3,2-3,2-3.5,2-5,2.5-3.2,2.8-4,2/3,2/3-3/,3-20,4-6,5-,5-20,6-10,6-8,7-12,8-16,abaxially,acuminat,acuminate,acute,almost,alyx,apar,apart,apically,apparently,articulated,bark,base,berry,blade,broad-deltate,c.,calyx,concolorous,connivent,cuneate,curved,deltate,densely,discolorous,distance,drying,eaf,eed,elongating,entire,equal,erect,extending,eye,flattened,free,fruiting,glabrescent,glabrous,infructescence,lobe,lon,long,longer,lower,margin,mature,maturity,midpoint,midvein,naked,narrow-deltate,narrow-ovate,nflorescence,oblong,obtuse,older,one,open,orange-brow,orolla,oung,pair,pendulous,per,perfec,pericarp,plurifoliat,poricidal,porrect,portion,prickl,prickle,prickly,primary,procumbent,pubescent,purple,ray,rounded,ruit,scar,sessile,side,sometimes,spaced,spreading,stem,stout,straight,strongly,tamen,tapering,terete,tertiary,time,tip,trichome,tube,unarmed,unit,upper,usually,vary,vein,venation,visible,way,wide,woody,yellow-orange,ympodial,¼	arrangement,colour,corolla,form,growth,height,history,inflorescence,life,na,number,ovary,perennial,plant,position,rachi,reproduction,seed,shape,spacing,staman,stigma,texture,width
476	wfo-0001029263	success	211	88	67	144	21	0.318	0-2.5,0-5,0.3-1,1,1-10,2-3,2-4,3-5,3.5-5,4-7,5-merous,almost,andromonoecious,anther,apex,berry,black,cell,chartaceous,cm,corolla,cream,cultivar,dark,deep,diameter,dull,elliptic,erect,evenly,filament,flattened-reniform,flower,fruit,glabrous,green,herb,leaf,length,marking,maturity,mauve,mm,obtuse,orange,orange-brown,outline,pale,pedicel,peduncle,petiole,pit,plant,purple,raised,red-brown,rotate,small,smooth,spherical,style,surface,unbranched,usually,white,yellow,young	-2,0-100,0.5-1,0.5-1.5,0.6-1.5,1-4,1-7,1.2-2.5,1/2,1/3-2/3,1/3-3/4,1/4-1/3,1/6,10-20,10-35,12-35,2.2-3.2,2.8-3.8,30-60,4-10,4-6,5-10,5-8,6-20,6-30,7-10,acute,alyx,apar,apically,apparently,articulated,attenuate,ba,bark,base,becoming,blade,broad,broad-deltate,calyx,concolorous,connivent,cuneate,curved,decurren,deltate,difoliate,distal,distance,drying,eaf,eed,elongating,entire,equal,extending,extensive,foliaceou,free,fruiting,fully,geminat,glabrescent,glandular,hair,hermaphrodite,heterostylous,infructescence,lateral,less,lobe,lobed,lobing,long,long-acuminat,long-styled,longer,lower,lowermost,margin,mature,midvein,minute,near,nflorescence,often,older,one,onl,open,opening,orolla,oung,ovoi,pair,part,pendulous,per,pericarp,poricidal,portion,primary,reddi,reflexed,rounded,ruit,scar,secondary,short-styled,side,simple,sometimes,spaced,sparsely,spreading,staminat,stellate-pubescent,stem,stout,straight,tamen,tapering,tearing,terete,tertiary,time,tip,trichome,tube,ud,unarme,unarmed,unit,upper,vary,vein,venation,visible,way,wide,wider,woody,ympodial	abaxial,adaxial,apart,colour,form,growth,height,history,inflorescence,life,na,number,ovary,perennial,reproduction,seed,shape,spacing,staman,stigma,texture
477	wfo-0001029286	success	224	115	98	126	17	0.438	0.8,1-1.5,1-2,1.5-2,1.5-4,1.5-8,1/8,2.5-3,4-6,4.5-7,5-6,6-9,7-10,abaxial,abaxially,adaxially,almost,anther,anthesi,apart,apex,apically,bark,base,branch,branched,branching,broadly,brown,capitate,chartaceous,clustered,cm,conical,corolla,dendritic,diameter,dilated,domatia,drying,faint,filament,flat,flexuous,formed,glabrescent,glabrous,green,grey,inside,leaf,length,less,liana,light,lilac,lobed,long,mauve,membranous,midvein,minutely,mm,multicellular,obconical,oblong,obovate,outside,pair,pedicel,peduncle,petiole,primary,prominent,rachi,raised,scar,slender,smooth,sometimes,sparsely,stem,stigma,stump,style,surface,terete,terminal,tertiary,tip,trichome,tube,unarmed,vein,venation,widely,x,yellowish	.4,.5,0-0.5,0.1,0.15-0.4,0.4-1.2,0.6-1.2,0°,15-50,2-3,3-4,4-5,4.5,5,6-8,abscising,acute,age,along,altered,alyx,another,apar,apice,apiculate,apparently,arising,around,articulated,articulation,attenuate,axil,becoming,canaliculate,clearly,closer,concave,concolorous,crenulate,curved,cuspidate,delineated,deltoid,density,distributed,eaf,eed,entire,equal,except,extending,fertilization,flower,forming,free,fresh,globo,hair,increasing,inflorescenc,isolated,junction,know,known,lamina,lengthening,lobe,lower,m.,main,margi,margin,mas,meeting,middle,much,narrowly,nflorescence,nther,occasional,often,one,orolla,ovate,papillo,perfec,plurifoliat,pore,poricidal,portion,protruding,rarely,regular,rounded,ruit,separated,shallowly,side,simple,smaller,somewhat,soon,specimen,spreading,stretchy,tangled,tearing,textur,thick,thickened,thinner,time,tissue,together,toward,translucent,translucent-violet,tuft,ud,uneven,unit,vary,visible,wide,ympodial,young	adaxial,arrangement,bud,calyx,colour,form,globose,growth,inflorescence,na,ovary,papillose,position,shape,spacing,texture,true
478	wfo-0001029289	success	292	102	84	208	18	0.288	0.4-1.1,0.4-2,1-2,1-4,1.5-5,100,15-45,2.5,2.5-4,25,5-20,6-12,8,acuminate,acute,adaxial,almost,anther,apex,apically,base,berry,black,branch,brown,capitate,clavate,cm,conical,corolla,deeply,dendritic,development,diameter,dilated,distributed,drying,erect,evenly,filament,finely,flattened,flower,glabrescent,glabrous,green,honeycomb,inside,leaf,length,liana,lobed,maturity,mm,oblong,obovate,orange,outside,pale,pattern,pedicel,peduncle,petiole,pitted,puberulous,pubescent,rachi,reddish,reniform,seed,shape,sometimes,spheroidal,stigma,straight,sturdy,style,surface,terminal,trichome,undulate,violet,white,yellow	.05,.2,.5,0-2,0.15-0.25,0.2-1.5,0.4-1,0.5,0.5-0.7,0.5-1,0.5-1.2,1-1.2,1-2.5,1.2,1.5-2,1.5-4,1/6-1/3,12,15,1mm,2-3,3,3-7,4-9,4.5,5-12,60-90°,abaxially,accrescent,adaxially,age,along,always,alyx,anthesi,apar,apice,apparently,appendage,arachnoid,arising,aristate,around,articulated,articulation,attenuate,bark,becoming,boundary,branched,branching,broadly,calyx,canaliculate,chartaceous,clear,clearly,close,collapsing,complex-dendritic,complexity,concolorous,covering,crenulate,cuneate,cupular,curved,cuspidate,delineated,deltoid,dense,detaching,developing,discolorous,domatia,dorsally,eaf,eed,ellipsoi,elongated,entire,equal,eye,faint,fertilisation,flexuous,forming,found,free,fruiting,globose,hair,half,hard,indumentum,inner,irregular,lamina,leave,lengthening,less,light-coloured,line,linear,lobe,long,longitudinally,loop,lower,m.,main,margi,margin,may,middle,midvein,minute,minutely,mixture,multicellular,naked,narrowly,nflorescence,nther,obconical,often,one,orolla,outer,outline,pair,papillae,papillo,papillose,pendulous,perfec,pericarp,pili,pit,plurifoliat,point,pointed,pore,poricidal,portion,primary,prominent,pronounced,protruding,raised,rarely,reveal,ridged,rising,rounded,ruit,scar,see,shallow,shallowly,shiny,short,side,simple,sinus,size,slightly,smooth,somewhat,soon,sparse,sparsely,spreading,stem,strongly,stump,sunken,tearing,terete,tertiary,thick,thickened,thin,thin-coriaceous,time,tip,together,toward,truncate,tube,tuft,ud,unarmed,unicellular,unit,usually,variable,various,vary,vein,venation,visible,wide,widely,x,yellowish,ympodial,young	abaxial,apart,arrangement,colour,form,fruit,growth,height,inflorescence,na,number,ovary,plant,position,reproduction,spacing,staman,texture
479	wfo-0001029295	success	191	100	80	111	20	0.419	0.5,0.7-1,1,1-1.5,2,2-3,2/3,3/4,5-6,<,abaxial,along,anther,anthesi,apex,articulated,base,berry,capitate,closely,cm,continuous,corolla,diameter,drying,elliptic,fide,filament,flower,fruit,glabrous,globose,green,height,herb,internodal,known,lateral,leaf,length,lobed,membranous,midrib,minute,minutely,mm,nodding,ovary,ovoid,pale,papillate,pedicel,peduncle,petiole,pitted,purple,red,reniform,rhomboidal,ripe,scattered,short,shrub,simple,small,spaced,stigma,style,surface,tan,thin,tissue,top,trichome,uniseriate,urban,way,wing,x,yellowish	-5,-9,.5,0,1.2-3.5,2-4,2.5-3.5,2.5-6,4-4.5,4-5-celled,4-6,4-merous,6-8,?,acuminate,acute,apparently,appearing,attenuate,bark,become,calyx,cell,crystal,cup-shaped,dark,deciduous,defined,defoliate,dense,distal,eaf,eed,ellipsoid,elongate,entire,erect,essentially,exserted,free,fruiting,geminat,glabrescent,glabrou,grey,half,irregular,lamina,lengthen,lobe,lobe-lik,long,lower,margin,narrowly,nflorescence,obtusely,older,opening,orientation,outline,pair,papillat,peduncl,peelin,pentagonal,per,perfect,pericarp,pointed,pore,portion,primary,prolonged,puberulent,pubescent,rim,rooting,rounded,ruit,sand,scar,seen,sessile,shallowly,sinuate,slightly,slit,soon,sparsely,splitting,sprawling,stem,strongly,testal,tip,tube,ud,unarmed,undulation,unifoliate,unit,upper,usually,vein,whitish,widest,wiry,woody,ympodial,young	adaxial,colour,form,growth,history,inflorescence,life,number,perennial,plant,position,rachi,reproduction,seed,shape,spacing,staman,texture,unknown,width
480	wfo-0001029299	success	201	106	72	129	34	0.358	0.5-1.5,1-10,1-2,10-16,10-21,2.3-3.3,3,3-4.5,3-7.5,4-16,5-15,7-8,abaxially,acuminate,acute,adaxially,anther,apex,articulated,axillary,broadly,bud,cell,clavate,cm,corolla,covering,diameter,elliptic,filament,flower,forked,fruit,glabrous,glandular,green,greenish,hair-like,herb,lateral,leaf,margin,medium,minutely,mm,moderately,multicellular,non-glandular,odd-pinnate,ovate,ovoid,pedicel,peduncle,pentagonal,petiole,plant,puberulent,pubescent,rotate,seed,stem,stigma,style,subtending,terminal,testal,thick,trichome,wall,white,whitish,yellow	0-3,0-5,1-4,1.6-5,16-28.6,2-4,3-12,3-13,3-5,3.5-7.5,4-10,5-merou,6-5-15.3,8.5-19,acumen,ag,along,alyx,apart,apparently,attenuate,axe,base,blade,borne,brownish,capitat,chartaceous,ciliate,condition,connate,cordate,cuneate,decreasing,decurrent,dense,digestion,distal,dorsally,drying,eaf,edge,eed,end,enzyme,erec,especially,exceeding,flat,folded,fresh,geminat,generally,grading,gradually,green-white,hair,half,homostylous,honeycomb-shaped,interjected,invested,lanceolate,leaflet,lengthening,like,living,lobe,long,lower,make,membranous,middl,midrib,mottled,mucilaginous,nflorescence,oblique,orbicular,orolla,pair,perfect,petiolulate,petiolule,plurifoliate,pore,poricidal,pubescence,purple,removed,rounded,ruit,sessile,seudostipule,shallowly,short,singly,size,slightly,slit,spaced,specimen,spreading,stamen,ste,stolo,straight,subsessile,tall,tamen,tem,throughout,tip,tissue,toward,tri-,truncate,tube,tuber,typically,unit,unknow,usually,vary,wet,wide,wing,x,ympodial	abaxial,adaxial,arrangement,bark,calyx,capitate,center,colour,form,fruiting,growth,height,history,inflorescence,length,life,middle,na,new,number,ovary,perennial,position,prickle,rachi,reproduction,scar,shape,spacing,staman,surface,texture,unknown,width
481	wfo-0001029308	success	221	89	67	154	22	0.303	0.2-1.5,1-5,1.5-4,19-30,2-5,2-6,2.5-3,3.5-4.5,4-15,6-18,7-8,acuminate,acute,adaxially,andromonoecious,anther,apex,chartaceous,cm,densely,diameter,elliptical,erect,extra-axillary,flattened,flower,fruit,furrowed,glabrous,globose,green,inflorescence,leaf,length,lilac,margin,minutely,mm,moderately,ovate,pale,pedicel,peduncle,perennial,petiole,plant,purple,rachi,reticulate,rhizomatous,rotate-stellate,seed,shrub,simple,sparsely,stellate,stellate-pubescent,stigma,style,surface,thickened,toward,unbranched,weakly,yellow,yellowish,yellowish-green	%,0-10,0-25,0-4.5,0.05-0.3,0.2-0.3,0.25-0.3,0.25-0.35,0.25-0.4,0.25-1,0.4-0.7,1,1-4,1.2-2.5,1.5-2.5,1.5-2.7,1.5-3,1.5-5.5,168,1981,2-foliate,2-locular,2.2-2.7,2.7-3.1,20-40,3-4,3-6,30-50,4-5,4-6,4-8,4.3-15,4.5-6,5-merou,6-11,6-8,7-10,8-19,9-18,9.5-28,abaxially,absen,absent,acicular,across,adaxiall,adult,alyx,anvil-shape,apart,articulated,axe,ba,base,blade,branch,branche,broad-based,broadly,brown,calyx,capitat,confined,connivent,counted,cross-section,cuneate,cylindrical,decimetre,deltate,directed,distall,distributed,dm,eaf,eed,eglandular,elliptic,entire,exocarp,finger,fruiting,functional,geminat,gland-tipped,hair,half,heterostylous,interpetalar,juicy,juvenile,lamina,lanceolate,lateral,less,lobe,lobed,long,longer,loosely,lower,margi,mature,mesocarp,mid-point,midpoint,midrib,midvein,minute,moist,nearly,nflorescence,oblique,one,orolla,pair,part,per,placenta,pore,porrect,present,prickle,ray,ruit,rusty,sessile,shallowly,short,side,spaced,stalked,star,stellae,straight,tal,tamen,tem,thick,throughout,time,tissue,triangular,tube,unarme,unarmed,unit,upper,vary,vein,wide,x,ymon,ympodial	5-merous,abaxial,adaxial,arrangement,capitate,colour,corolla,filament,form,growth,height,history,life,na,number,ovary,position,reproduction,shape,spacing,staman,texture
482	wfo-0001029310	success	216	77	54	162	23	0.25	.5,0.6-1.1,1-1.5,1-4,1.2-1.5,1.8-3,2-3.5,2-4,3-4,4-10,5-12,5-6,5-merous,acute,andromonoecious,anther,apart,apex,berry,branched,cm,deltate,diameter,dull,elliptic,filament,flattened-reniform,flower,fruit,glabrescent,herb,leaf,length,lobed,long,long-styled,mauve,membranous,mm,orange-green,pedicel,peduncle,petiole,pinnatifid,plant,short-styled,shrub,smooth,spherical,spreading,stellate,style,surface,yellow	-16,-25,.1,.6,/4,/6,0-20,0-5,0.1-0.2,0.2-0.3,0.2-0.8,0.5,0.5-3,00,1,1-2,1/,10,10-13,10-15,10-20,15-20,2.5-6,2/3-3/4,20-40,20-60,200-500,3-5,3.5,4-8,45-60,5,5-10,5-20,5-30,5-7,5-8,6-8,7-12,7-13,8,abaxially,accrescent,alyx,ame,apar,apically,apparently,articulated,bark,base,beyond,blade,brown,c.,calyx,concolorous,conical,connivent,cordate,dark,difoliate,distal,distance,drying,eaf,eed,elongating,enclosing,equal,erect,extending,filifor,free,fruiting,geminat,gently,glabrous,gray,hair,hermaphrodite,heterostylous,inflated,infructescence,lateral,lobe,lobing,lon,longer,lower,lowermost,margin,mature,maturity,midpoint,midvein,minute,moderately,narrow-deltate,nflorescence,older,one,open,ornately,orolla,oung,pair,pendent,pendulous,per,pericarp,perpendicular,poricidal,porrect,portion,prickl,prickle,prickly,primary,ray,recurved,red-brow,retrorse,ruit,scar,secondary,sessile,shorter,side,simple,sometimes,spaced,sparsely,stalk,stalked,staminat,stellate-pubescent,stem,stout,straight,strongly,tamen,tapering,terete,tertiary,time,tip,tissue,toward,trichome,truncate,tube,unit,variously,vary,vein,venation,visible,way,wide,woody,ympodial	/,abaxial,adaxial,arrangement,colour,corolla,form,growth,height,history,inflorescence,life,na,number,ovary,perennial,reproduction,seed,shape,spacing,staman,stigma,texture
483	wfo-0001029317	success	151	86	58	93	28	0.384	.5,0.5,0.8-1,1,1-1.5,2-3,7-8,8-9,anther,apex,area,base,ca,calyx,channeled,closely,cm,corolla,densely,filament,glabrous,inflorescence,leaf,like,lobed,long,minutely,mm,narrowly,nearly,opposite,ovary,ovate,overlapping,paler,papillose,pedicel,petiole,probably,pubescent,rachi,rest,shrub,simple,slender,slightly,spaced,sparsely,stigma,style,tapering,thickened,tip,trichome,tube,uniseriate,white,x	0.25,0.5-0.75,0.5-1,1.5-3.5,10-16,10-30-flowered,11-14,2.5-5,6-8,6.5-11,acuminate,along,anthesi,apar,attenuate,barely,beneath,broadly,brow,bud,cup-like,deciduou,deflexed,deltoid,denser,dia,differing,difoliate,dry,eaf,edicel,eed,ellipsoi,epidermi,erect,exserted,extreme,free,frui,fruiting,geminate,glabrate,globose,grayish,immature,known,lateral,lobe,lon,lower,main,major,margin,middle,minor,nflorescence,occasionally,often,older,one,otherwise,ovoid,pair,pore,poricidal,portion,prominent,proximal,raised,reflexed,remaining,rounded,ruit,scar,shaped,size,soft,soon,specimen,stem,straight,styl,tall,tear-drop,tuft,ud,unit,vein,visible,widest,yellowish,ympodial,young	10-30,abaxial,adaxial,arrangement,colour,diameter,flower,form,fruit,growth,height,history,length,life,na,number,peduncle,perennial,plant,position,reproduction,seed,shape,spacing,staman,surface,texture,width
484	wfo-0001029332	success	197	71	55	142	16	0.279	0-0.5,0.5-1,1-4,1.3-1.5,1.5-2,2,2-2.5,2-4,2.8-3.7,2/3-3/4,3-4,4-10,8.5-9.5,abaxial,abaxially,adaxial,andromonoecious,anther,articulated,base,berry,chartaceous,cm,densely,diameter,erect,filament,flattened-reniform,flower,fruit,glabrescent,glabrous,leaf,length,lobed,margin,maturity,mauve,mm,orange-brown,ovate,pedicel,peduncle,petiole,plant,scandent,shrub,spherical,stellate-pubescent,style,surface,unbranched,way,weakly,yellow	-5,.5,/3,0,0-100,0-2,0-20,0-4,0-5,0.1,0.1-0.2,0.15-0.2,0.15-0.25,0.8-1,1-1.5,1-2,1-3,1/2,1/3,1/4,1/4-1/3,10-30,2.5-3.5,2/,3-6,3.5-5,4-15,5-6,5-8,5-merous,6-8,alyx,apar,apart,apex,apically,apparently,bark,becoming,blade,broad-deltate,calyx,concolorous,conical,connivent,cordate,curved,difoliate,distal,distance,drying,eaf,eed,elongating,equal,extending,flattened,free,fruiting,geminat,gland,globular,grayi,herbaceous,hermaphrodite,heterostylous,infructescence,lateral,less,lobe,long,long-acuminat,long-styled,longer,lower,lowermost,mature,midpoint,midvein,moderately,narrow-deltate,nflorescence,often,older,one,open,orolla,oung,pair,pale,pendulous,per,pericarp,poricidal,porrect,portion,prickl,prickle,prickly,primary,pubescent,ray,reduced,rounded,ruit,scar,sessile,short-styled,shorter,side,simple,slender,smooth,spaced,spreading,stalk,stalked,staminat,stellate,stem,subsessile,tamen,tapering,terete,terminal,tertiary,time,tip,trichome,tube,unit,upper,variously,vary,vein,venation,visible,wide,woody,yellow-green,yellow-orange,ympodial	colour,corolla,form,growth,height,inflorescence,na,number,ovary,reproduction,seed,shape,spacing,staman,stigma,texture
485	wfo-0001029333	success	155	75	48	107	27	0.31	.25,0.7-1,1-1.2,1-1.5,1-15,1-7,2-2.5,5-6,abaxial,anther,apex,clavate,cm,corolla,dendritic,dendritic-pubescent,densely,elliptic-obovate,filament,flattened-reniform,flower,glabrous,globose,green,leaf,lobed,long-styled,minutely,mm,obovate,opposite,ovary,pale,pedicel,petiole,pitted,pubescent,reddish-brown,shape,shining,short-styled,shrub,simple,spaced,stigma,style,surface,trichome	.5,/4,0.5,0.5-1,1-2,1-3,1.5-2,1.5-2.5,1.5-3,10-15-flowered,100,17-26,3-7,3-7.5,8-15,9-13,abaxially,acuminate,acute,adaxially,along,anisophyllou,anthesi,auriculate,ba,bark,base,beige,beneath,berry,broadly,calyx,conical,contracted,deflexed,denser,dia,differing,difoliate,dry,eaf,edicel,eed,erect,exserted,free,fresh,fruiting,geminate,golden,heteromorphic,incrassate,inflorescenc,lateral,like,lobe,lon,long,lower,main,major,margin,minor,nflorescence,occasionally,older,orbicular,overlappin,pair,paler,papillo,planar,pore,poricidal,portion,present,pubescence,rest,rounded,ruit,scar,sessile,shaped,size,slender,small,somewhat,sparsely,stem,strongly,tall,tear-drop,time,tip,tree,triangular,truncate,tube,type,ud,unit,vein,way,wide,woody,ympodial,young	10-15,adaxial,arrangement,colour,diameter,form,fruit,growth,height,history,inflorescence,length,life,na,number,papillose,peduncle,perennial,plant,position,rachi,reproduction,seed,spacing,staman,texture,width
486	wfo-0001029334	success	211	94	68	143	26	0.322	0.15-0.3,1-10,1-2,1.3-4.5,1.5-6,1.8-2.9,2-8,4-5.5,5-10,8-30,9-12,abaxially,adaxially,almost,anther,apex,brownish,cell,chartaceous,clavate,cm,condition,corolla,covering,diameter,drying,filament,flower,forked,fresh,fruit,glabrous,globose,green,greenish,hair-like,herb,lateral,membranous,minutely,mm,obtuse,odd-pinnate,orbicular,ovate,ovoid,pedicel,peduncle,petiole,plant,puberulent,pubescent,pure,ripe,rounded,seed,stellate,stigma,style,terminal,testal,thick,tinged,violet,wall,white,whitish,yellow	.2,0-4,1,1-3,1-6,1.5-3.9,2,2-2.5,2-4,2-5,2.5-3,3-5,3-7,3.2-5.8,3.3-6.5,4-8.5,5-merou,7.5-15.5,absent,acumen,acute,ag,along,alyx,among,apart,apparently,articulated,attenuate,axe,axillary,base,berry,blade,borne,broadly,bud,capitat,ciliate,connivent,cordate,cuneate,decreasing,decurrent,densely,digestion,distal,dorsally,eaf,edge,eed,elliptic,end,enzyme,erect,especially,exceeding,except,flat,folded,geminat,generally,glabrou,gradually,grassland,greatly,green-white,hair,half,homostylous,honeycomb-shaped,interjected,lanceolate,leaflet,lengthening,like,living,lobe,long,low-growin,lower,make,margin,middl,midrib,mucilaginous,narrowly,nflorescence,oblique,often,orolla,pair,perfect,petiolulate,petiolule,plurifoliate,pore,poricidal,proximal,rarely,reduced,removed,ruit,semi-rosette,sessile,seudostipule,shady,short,singly,situation,size,slightly,slit,spaced,specimen,stamen,ste,stem,stolo,straight,subequal,subsessile,subtending,sunny,tall,tamen,tem,throughout,tip,toward,tri-,tube,tuber,typically,unit,unwinged,usually,vary,wet,wide,woodland,x,ympodial	abaxial,adaxial,arrangement,capitate,colour,form,growth,height,history,inflorescence,leaf,length,life,na,number,ovary,perennial,position,rachi,reproduction,shape,spacing,staman,surface,texture,width
487	wfo-0001029340	success	286	82	55	231	27	0.192	1-2,2,5-merous,abaxial,absent,acute,adaxial,anther,apex,bluish,bright,brown,capitate,cm,conical,curved,depressed-spherical,diameter,filament,flattened-reniform,flower,foveolate,fruit,glabrous,glandular-puberulent,green,heterostylous,lateral,leaf,minutely,mm,orange-yellow,pale,pedicel,peduncle,petiole,pilose,purple,shiny,shrub,simple,soft,soft-pilose,spherical,spreading,spreading-pilose,stellate,stigma,style,suborbicular,surface,tough,unbranched,yellow,yellowish	'',-celled,.05,.2,.2–1.6,0,0.15–0.6,0.2–0.5,0.4,0.5,0.5–2,0.5–2.5,0.8–3.2,0–,1,1.2–2.0,1.2–2.2,1.4–1.8,1.5-3,1/2,1/4,10,100,13–15,1–,1–1.2,1–2,1–2-celled,2.5,20,2–10,2–2.2,2–3,2–3.2,2–5-celled,2–8,3,3.5–5.5,3–3.5,3–5-celled,3–5.3,3–6-celled,3–7,4,4–4.5,4–8,5,5°,5–12,8–12.5,8–17,9–20,>,``,abaxially,abruptly,acicular,age,almost,alyx,angle,anthesi,apical,apicall,armed,around,articulated,ba,basal,base,becoming,berry,bilobed,blade,branched,broad-based,calyx,coarse,column,compressed,concentrated,connivent,cordate,curving,cylindrical,darker,densely,developin,difoliate,directed,duller,eaf,eed,elongate,embedded,equal,evenly,exceeding,exceptionally,expanded,expanding,extending,falling,fertile,free,frui,fruiting,geminat,geminate,gland,gland-tipped,glandular,grading,gradually,greater,greenish,hair,held,hyaline,infructescence,irregularly,lanceolate,larger,largest,less,light,like,linea,lobe,lobed,lon,long,long-styled,lower,lowermost,main,major,many,margin,mature,maturity,mesocarp,midpoint,midrib,minute,mixture,mostly,much,narrowed,narrowly,near,nearly,nflorescence,nipple,occasionally,often,one,orange,orolla,oung,ovoid,pair,papillat,per,pericarp,perpendicular,pore,poricidal,portion,prickle,prickly,pulp,rarely,ray,recurved,reflexed,ruit,secondary,senescent,sessile,sharp,short,short-styled,shorter,shrivelling,similar,single,size,slightly,small,smaller,smooth,somewhat,soon,sparsely,spongy,ste,stem,stipitate,stipitate-glandular,stout,straight,strongly,tall,tamen,tapering,terete,thin,thin-textured,tinged,tip,tooth,triangular,trichome,tube,twice,two,unarme,unarmed,uniseriate,unit,usually,variously,vary,vein,viciously,way,white,whole,wide,ympodial	0.5-2,1-1.2,12,2-10,5-12,8-12.5,arrangement,colour,corolla,form,growth,height,history,inflorescence,length,life,na,number,ovary,perennial,plant,position,reproduction,seed,shape,staman,texture
488	wfo-0001029344	success	147	87	61	86	26	0.415	.5,0.4-1,0.5-1,0.5-1.5,1,1-5,1.5,1.5-3,1.5-4,10-20,4-6,5-15,absent,anther,apex,brown,center,chartaceous,cm,diameter,dm,drying,edge,elliptic,elliptic-ovoid,filament,fine,flower,fruit,glabrous,globose,herb,immature,long,margin,maturing,membranaceous,mm,moderately,nearly,parallel,pedicel,peduncle,petiole,pubescent,rachi,radiating,raised,rhizomatous,ridge,rotate,running,semitransparent,shallow,sparsely,stigma,style,surface,white,x,yellow	0.5-3,1-2,1-3,1-6,10-35,2-3,2-3-celled,2-4,2-7,3-10,5-12,abaxially,abundant,acute,adaxiall,adaxially,along,axe,base,berry,beyond,blade,calyx,ciliate,connected,cordate,decurrent,dehiscing,densely,denser,difoliate,eaf,eed,emarginat,entire,equal,explosively,exserted,flat,frui,geminat,hair,held,interpetalar,lacking,linear-lanceolate,lobe,lower,lying,maturit,mesocarp,nflorescence,notch,oblong,obtuse,obvious,often,one-,orolla,per,placenta,pressure,pubescen,rounded,ruit,short,slightly,sometimes,stamen,straight,swollen,tal,tamen,tem,tissue,triangular,tube,two-celled,unbranched,unit,vary,vein,watery,wid,woody,ympodial	abaxial,adaxial,arrangement,colour,corolla,form,geminate,growth,height,history,inflorescence,leaf,length,life,na,number,ovary,plant,position,reproduction,seed,shape,spacing,staman,texture,width
489	wfo-0001029363	success	152	88	59	93	29	0.388	0.2-1.1,0.5-1,1-1.2,2-6,3-7,6-7,acute,anther,apex,base,beneath,bi-lobed,calyx,capitate,closely,cm,corolla,edge,elliptic,filament,fruit,glabrous,globose,green,leaf,lobed,meeting,minutely,mm,narrowly,obtuse,occasionally,opposite,ovary,overlapping,pale,paler,papillose,pedicel,petiole,pubescent,shiny,shrub,simple,slender,small,spaced,stigma,style,surface,tapering,thickened,tree,trichome,tube,tuft,uniseriate,white,yellowish	.25,.75,/4,0-0.1,0.1-0.5,0.5,1,1.5-1.7,1.5-3.5,4-11,5-7-flowered,6-8,7-10,acuminate,anthesi,axil,ba,bark,becoming,beginning,berry,bud,coroll,cup-shaped,deep,deflexed,deltoid,densely,dia,drying,eaf,edicel,eed,erect,except,exsertion,free,fruiting,greyish,immature,inflorescenc,internodal,known,lamina,larger,later,lateral,lobe,lon,long,lower,main,margin,maroon,mature,middle,minute,much,near,nflorescence,often,older,pair,papillo,pore,poricidal,portion,prominent,reflexed,ruit,scar,slit-like,somewhat,sparse,sparsely,stem,straight,tall,terminal,tip,ud,unifoliat,unit,upon,usually,vein,way,white-papillose,wide,widest,woody,ympodial,young	5-7,abaxial,adaxial,arrangement,colour,diameter,flower,form,growth,height,history,inflorescence,length,life,na,number,peduncle,perennial,plant,position,rachi,reproduction,seed,shape,spacing,staman,texture,unifoliate,width
490	wfo-0001029364	success	153	80	53	100	27	0.346	-2,-6,0.2-0.5,1-,1-3,1-4,1-5,1.5-2,2-6,5-9,8-15,acuminate,anther,apart,apex,articulated,base,chartaceous,cm,corolla,cream,diameter,elliptic,extra-axillary,filament,flower,fruit,glabrous,globose,green,greenish,herb,membranaceous,minutely,mm,nearly,pedicel,peduncle,petiole,puberulent,rachi,shrub,simple,sparsely,spot,stellate,stigma,style,unbranched,unknown,white,x,yellow	-3,.5,1,10-27,191.,2,2-,2-foliat,3-4,4-12,4-9,5-,5-11,6-8,7-9,8-10,?,abaxially,according,acute,adaxially,aggregate,around,axe,ba,bitter,blade,blue,calyx,cell,center,color,connivent,cuneate,curled,cylindrical,darker,deep,directed,distall,distally,eaf,ed,entire,fide,finger,free,gland-tipped,glandular-puberulen,hair,immature,inserted,lobe,long,lower,major,margin,mesocarp,moderately,narrowly,nflorescence,obtuse,orolla,ovate,part,perfect,pore,presence,present,puberulen,pubescent,radiu,ripe,ruit,rusby,sagittate,shallow,short-tomentose,shorter,side,small,spaced,stone,strongly,tal,tamen,tapered,tem,thecae,tightly,time,tomento,triangular,truncat,tube,unit,vary,vein,wide,ympodial	abaxial,adaxial,arrangement,colour,form,growth,height,history,inflorescence,leaf,length,life,na,number,ovary,plant,position,reproduction,seed,shape,spacing,staman,surface,tall,texture,truncate,width
491	wfo-0001029368	success	139	71	43	96	28	0.309	0.5-2,0.9-1,1.5-1.6,1.5-3,1.5-4,2-5,2.5-4,5-6,acuminate,anther,apex,broadly,capitate,closely,cm,corolla,densely,elliptic,filament,flower,fruit,glabrous,globose,green,herb,inflorescence,internodal,leaf,minutely,mm,opposite,ovary,pedicel,petiole,puberulent,shrub,simple,somewhat,spaced,stigma,style,white,x	.2,.25,.5,0,1.5-2,11-13,16-25,?,abaxially,acute,adaxially,along,anthesi,apparently,bark,base,bearing,berry,bitter,borne,breaking,brow,calyx,coarse,conical,crumpled,cup,deflexed,dia,distal,eaf,edicel,eed,erect,exserted,few-branched,fide,flattened,free,fruiting,golden,half,indistinct,inflorescenc,known,lamina,lanceolate,lateral,leaving,like,lobe,long,lower,main,margi,margin,middle,midrib,minute,nflorescence,non-flower,obtuse,older,one,overlappin,pair,papillo,papillose,parallel,pore,poricidal,portion,reflexed,rest,ruit,scar,shaped,stem,straight,strongly,tall,tear-drop,tip,trichome,tube,ud,unifoliat,uniseriate,unit,upper,vein,widest,winged,woody,ympodial,young	0.5,abaxial,adaxial,arrangement,colour,diameter,form,growth,height,history,length,life,na,number,peduncle,perennial,plant,position,rachi,reproduction,seed,shape,spacing,staman,surface,texture,unifoliate,width
492	wfo-0001029370	success	224	94	77	147	17	0.344	-32,.3,0-35,0.5-2.2,1-2,1-4,1.5-6,1.8-2.5,1/4-1/3,3-4,3.5-8,5.5-7,6-15,abaxial,abaxially,adaxial,almost,andromonoecious,anther,apex,articulated,base,berry,branched,chartaceous,cm,cream,dark,densely,diameter,erect,filament,fine,flattened-reniform,flower,fruit,glabrous,green,greenish,herb,leaf,length,lobed,long,long-styled,marking,mature,mauve,mm,moderately,obtuse,orange-brown,ornate,ovate,pale,pattern,pedicel,peduncle,petiole,plant,red-brown,reticulate,rotate,rounded,shiny,short-styled,shrub,smooth,spherical,stellate-pubescent,style,surface,way,white,whitish,yellow,young	-20,.1,.5,/4,0-10,0-100,0-3,0.1,0.1-0.15,0.2,0.3,0.5-1,1,1-3,1.8-2.8,1/3-1/2,10-17,10-40,10-50,12-17,15-30,2-10,2-20,2-3,2-6,2.5-3.5,3.5-4,3/,4-6,4-7,4-9,5-10,5-12,5-merous,7-11,7-13,8-14,8-20,8-23,acut,alyx,ame,apar,apart,apically,apparently,bark,basal,blade,broad-deltate,c.,calyx,clearly,conical,connivent,cordate,curved,discolorous,distal,distance,drying,eaf,eed,elongate,elongating,equal,extending,fewer,flattened,free,fruiting,fully,gently,glabrescent,hermaphrodite,heterostylous,infructescence,lateral,lobe,longer,lower,lowermost,margin,maturity,midpoint,midvein,mixture,multangulate,nflorescence,often,older,one,open,opening,orange,orolla,oung,overlapping,pair,pendulous,per,pericarp,perpendicular,plurifoliat,poricidal,porrect,portion,prickl,prickle,prickly,primary,ray,ruit,scar,sessile,side,simple,slightly,sometimes,spaced,spreading,stalk,stalked,staminat,stem,stout,straight,strongly,tamen,tapering,terete,tertiary,time,tip,trichome,tube,unarmed,unit,variously,vary,vein,venation,visible,white-gra,wide,woody,ympodial	/,colour,corolla,form,growth,height,inflorescence,na,number,ovary,reproduction,seed,shape,spacing,staman,stigma,texture
493	wfo-0001029373	success	199	66	44	155	22	0.221	5-merous,abaxial,adaxial,anther,berry,clavate,cm,conical,corolla,densely,diameter,ellipsoid,flattened-reniform,flower,fruit,glabrous,green,growth,herb,internodal,lateral,leaf,minutely,mm,moderately,ovary,ovate-lanceolate,pedicel,peduncle,petiole,pitted,plant,pubescent,shallowly,shape,simple,stellate,stigma,style,surface,white,yellow,yellow-green,yellowish	.0–1.2,.2,.3,.5,.5–2.0,0.3–0.5,0.4–1.6,0.5–1.2,0.5–1.8,0.6–0.7,1.0–1.2,1.0–1.6,1.2–1.5,1.3–2.2,1.4–3.5,1.5–2.0,1.5–2.5,1.5–2.7,1.8–2.0,1.8–2.3,180°,2-celled,2.0–2.5,2.7–3.0,20–30,2–4-celled,3,3.5–4.0,30–40,3–5,4–5,4–6,5,5–6,6.8,8–9,abaxially,accrescent,acuminate,acute,adaxially,age,anthesi,apar,apex,appearanc,appressed,arising,articulated,bark,basal,base,bayonet,beyond,broadly,bud,calyx,capped,cell,cone,curved,deltate,developing,distal,eaf,eed,elongate,enclosed,enclosing,entire,exerted,filament,finger,free,fruiting,fully,geminat,glandular-tipped,globose,grey-brown,hair,half,halfway,hilum,immature,individual,laterally,lengthening,less,like,live,lobe,lobed,lon,long,lower,margin,mature,mesocarp,middle,minute,mouth,new,nflorescence,node,obtuse,older,outline,pair,papillate,pentagonal,per,perfect,plurifoliate,pore,poricidal,portion,positioned,primary,reflexed,resembling,root,rounded,ruit,scar,seen,seudostipule,short,slightly,slit,smoot,spaced,spreading,stem,still,straight,tall,tem,terete,testal,thicker-walled,tip,trailing,trichome,tub,tube,ud,uniseriate,unit,upper,vein,wide,woody,ympodial,–5	0.4-1.6,0.5-1.2,0.6-0.7,1.2-1.5,1.5-2.7,2.7-3.0,20-30,5-6,apart,colour,form,height,history,inflorescence,length,life,perennial,position,reproduction,seed,spacing,texture
494	wfo-0001029402	success	113	65	37	76	28	0.327	0.5-1,0.5-2,15-30,2,2-10,2-3,4-6,4-7,5-25,7-8,7-9,8-15,abaxial,apex,articulated,branched,chartaceous,cm,diameter,elliptic,flower,glabrous,mm,narrowly,pedicel,peduncle,petiole,rachi,shrub,simple,stellate,stigma,style,surface,unknown,violet,x	1-2.5,11-17,3-4,3-5,3-6,4-8,6-16,7-11,abaxially,acuminate,acute,adaxially,apart,axe,band,base,blade,calyx,ciliolate,color,connivent,cylindrical,deltate,denser,directed,distall,eaf,eed,fleshy,forked,free,glabrate,glabrou,hair,inrolled,lanceolate,leaving,lobe,long,lower,many-foliat,margin,moderately,narrowed,nearly,nflorescence,nther,often,orolla,papillose,pore,pubescence,pubescent,rachise,radiu,roughened,ruit,scale-like,scar,somewhat,spaced,sparsely,tal,tapered,tem,thickened,time,tip,triangular,truncat,tube,unit,unknow,vary,wide,ympodial	adaxial,anther,arrangement,colour,corolla,filament,form,fruit,growth,height,history,inflorescence,leaf,length,life,na,number,ovary,plant,position,reproduction,seed,shape,spacing,staman,texture,truncate,width
495	wfo-0001029404	success	154	106	76	78	30	0.494	-10,0.5-1,1,1-4,2,2-3,2-8,2.5-22,20-35,3-4,5-10,5-20,5-6,6-8,abaxially,acute,adaxially,anther,apart,apex,apiculate,articulated,base,branched,center,cm,cream,dark,darker,densely,diameter,eglandular,ellipsoidal,flattened,flower,fruit,glabrous,glandular,green,hair,leaving,less,light,long,longitudinal,margin,mm,moderately,mottling,orange,ovate,pedicel,pedicellar,peduncle,petiole,pink,puberulent,pubescent,purple,rachi,remnant,ripe,shrub,simple,star,stellate,stigma,style,subcoriaceous,toward,tree,unbranched,vein,white,x,yellow	-1.5,-3,-5,0-60-flower,1.5-2,15-25,2-4,2-5,2.5-3,3-5,3-8.5,4-foliat,5-24,6-9,6.5-34,8-12,absent,acuminate,aggregate,ape,auriculate,axe,basal,beyond,blade,calyx,cell,chartaceous,connective,connivent,cordate,cylindrical,deltate,directed,distally,eaf,eed,entire,exserted,fleshy,glandular-puberulen,lanceolate,lemon,lobe,lon,lower,narrowly,nflorescence,nther,obtuse,orang,orolla,ovoid,perfect,pore,presen,radiu,ruit,shorter,slightly,small,somewhat,spaced,sparsely,stone,tal,tem,thecae,time,tomento,triangular,truncat,tube,ud,unit,vary,wide,ympodial	20-60,abaxial,adaxial,arrangement,colour,corolla,filament,form,growth,height,history,inflorescence,leaf,length,life,na,number,ovary,plant,position,reproduction,seed,shape,spacing,staman,surface,texture,tomentose,truncate,width
496	wfo-0001029406	success	136	74	45	91	29	0.331	0.5-1,0.6-1,0.7-1.5,1-10,1.5-2.2,4-6,acute,anther,apex,arachnoid,arachnoid-pubescent,brown,brownish,clavate,cm,corolla,dark,elliptic,filament,glabrous,globose,green,greenish-white,leaf,lobed,minutely,mm,ovary,ovoid,ovoid-reniform,pedicel,petiole,pitted,pubescent,shiny,shrub,slightly,small,stigma,style,surface,tree,trichome,waxy,white	.5,0.3-1,1-1.5,1-2,1.5-2.5,1.5-5,2,2-11,2-3,2.5-3.5,28,3-9,30,4-18,7-12,abaxially,adaxially,along,anthesi,ba,bark,base,berry,broadly,bullate,calyx,conical,conspicuously,deciduous,deflexed,deltate,densely,dia,differing,difoliate,dry,eaf,eed,felt-like,free,fruiting,geminat,grayish-brown,grayish-green,impressed,large,lateral,lenticel,lilac,lobe,lon,long,lower,main,major,margin,matted,maturity,middle,minor,nearly,occasionally,often,older,pair,pale,papillo,papillose,planar,pointed,population,pore,poricidal,portion,ruit,shaped,size,soon,stem,tall,tear-drop,tinge,tip,tube,unit,vein,wide,widest,woody,ympodial,young	abaxial,adaxial,arrangement,colour,diameter,flower,form,fruit,geminate,growth,height,history,inflorescence,length,life,na,number,peduncle,perennial,plant,position,rachi,reproduction,seed,shape,spacing,staman,texture,width
497	wfo-0001029407	success	208	85	63	145	22	0.303	-6,.5,/3,0.4-0.7,0.5-0.7,0.5-1.5,0.5-2,1-1.4,1-4,2-4,3-4,5-merous,6-20,abaxial,abaxially,adaxial,anther,apart,apex,articulated,base,berry,bright-red,cm,dark,densely,diameter,dull,erect,filament,flattened-reniform,flower,fruit,glabrous,green-brown,lateral,leaf,length,lobed,long,maturity,mauve,mm,moderately,obtuse,orange,orange-brown,ovate,pedicel,peduncle,petiole,rounded,shrub,simple,spherical,stellate-pubescent,style,surface,unbranched,way,white,yellow,yellow-green	-10,-2,-25,-4,-7,0,0-15,0-2,0-4,0-5,0.1-0.2,0.1-0.25,0.15-0.4,0.2-0.3,0.4-1,0.6,0.6-0.9,0.7-1.2,1,1-2,1-3,1-4.5,1.5,1.8-2.5,1/3,1/3-1/2,1/5,1/8-1/5,2-3,2-5,2.5-3,3-6,3.5-4.5,4-15,4-9,4.5-6,5-7,6-13,7-8,acut,acute,almost,alyx,apar,apically,apparently,bark,blade,brow,calyx,chartaceous,connivent,cuneate,curved,deltate,difoliate,discolorous,drying,eaf,eed,elliptic,elongating,entire,equal,evenly,flattened,free,fruiting,geminat,geminate,glabrescent,gray-greenish,green,infructescence,lengt,lobe,longer,lower,margin,mature,midpoint,nflorescence,occasionally,older,one,open,orolla,oung,pair,pale,pendulous,per,perfec,pericarp,poricidal,porrect,portion,prickl,prickle,prickly,primary,pubescent,rarely,ray,recurved,reflexed,ruit,scar,sessile,shorter,side,slender,smooth,sometimes,spaced,sparsely,spreading,stalk,stalked,stellate,stem,stout,straight,straw-yellow,strongly,tamen,tapering,terete,tertiary,thick,time,tip,trichome,tube,unit,upper,vary,vein,venation,visible,weakly,wide,woody,ympodial,young	arrangement,colour,corolla,form,growth,height,history,inflorescence,life,na,number,ovary,perennial,plant,position,reproduction,seed,shape,spacing,staman,stigma,texture
498	wfo-0001029408	success	244	86	67	177	19	0.275	0.2-0.3,0.3-5,0.5-2.5,0.7-1.2,0.9-1.6,1-8,1.1-1.5,2-12,2-5,2.2-3.7,4-20,5-24,5-6.5,abaxially,adaxially,anther,apex,broadly,brown,clavate,cm,conical,corolla,deltoid,diameter,elliptic,entire,filament,flower,fruit,glabrous,globose,growth,honeycombed,lanate,leaf,length,lilac,long-attenuate,margin,mm,mostly,ovate,pale,pedicel,peduncle,perfect,petiole,plurifoliate,pseudo-terminal,purplish,rachi,rarely,reniform,reticulate-punctate,rotate-stellate,shrub,stigma,style,suborbicular,tomentose,velutinous,white,whitish,x,yellow,yellowish	-1.5,-10.5,-4.5,.2-3.5,/10,0,0-100,0.9-1.3,1.4-1.9,1.5-3,1.6-2.8,1.7-2.4,1.8-3.5,1/2,1/2-3/4,1/4,11-31,2-3.5,2-4,2.5-7,2/3,3-5,3.5-5,4-14,4-7.5,5-6,5-8,5-merou,7-12,accrescent,acuminate,acute,adaxiall,ag,alyx,anthesi,apart,apical-lateral,articulated,axe,axillary,ba,barely,bark,base,becoming,berry,blade,blunt-tipped,branch,branched,bud,calyx,capitat,chartaceous,continued,cuneate,dark,decurrent,dehiscing,dendritic-echinoi,dendritic-multangulate,densely,develope,directed,distal,distall,due,eaf,echinoi,echinoid,eed,exserted,extend,faintly,few-rayed,fleshy,free,fruiting,gray,green,hair,high,homostylous,indument,inserted,interpetalar,introrse,lacking,lanceolate,large,lateral,lobe,lobed,long,long-,long-stalked,longitudinal,lower,m.,main,many,midvein,mixed,moderately,multangulate,near,nearly,nflorescence,oblong,obscured,obtuse,often,older,orbicular,orolla,ovate-lanceolate,overlapping,part,partly,persistent,pore,porrect-stellate,present,pubescent,rather,ray,relatively,ribbed,ripe,ruit,runk,sessile,short-,short-attenuate,short-stalked,side,simple,slightly,slit,small,sometimes,spaced,stamen,stelliform,stem,subcampanulate,subovate,suture,tamen,terete,testa,thick,thick-stalked,thick-textured,thin-stalked,time,tissue,tomentu,tomentum,top,touching,toward,tree,tube,turbinate,unarme,unarmed,unit,usually,vary,vein,way,well,wide,ympodial,young	abaxial,capitate,colour,form,height,history,inflorescence,life,ovary,perennial,plant,position,reproduction,seed,shape,spacing,staman,surface,texture
499	wfo-0001029417	success	213	116	90	123	26	0.423	0.2-0.6,0.7-3,1-10,1-2,1.3-8,1.5-8,2.5-10,2.8-3.5,4-7,5-15,8-9,abaxially,adaxially,along,anther,apex,axillary,blue,broadly,brownish,bud,cell,chartaceous,clavate,cm,coarsely,condition,corolla,covering,dark,deep,diameter,drying,erect,especially,filament,flower,forked,fresh,fruit,glabrous,globose,green,greenish,hair-like,herb,lateral,make,medium,membranous,midrib,minutely,mm,moderately,mucilaginous,narrowly,non-glandular,odd-pinnate,orbicular,ovate,ovoid,pedicel,peduncle,pentagonal,petiole,pilose,plant,puberulent,pubescent,purple,rarely,ripe,rotate,seed,slightly,sometimes,stigma,style,subtending,terminal,testal,thick,tinged,trichome,typically,violet,wall,wet,whitish,yellow	.5,0-7,0.4-8,1,1-1.5,1-4,1-8,1.5-1.8,1.5-10,12,2-4,3-14,3-5,5-merou,6-11,8-15,acumen,acuminate,acute,ag,alyx,apart,apiculate,apparently,articulated,attenuate,axe,base,basiscopic,berry,blade,borne,capitat,central,ciliate,connivent,decreasing,decurrent,digestion,distal,dorsally,dot,eaf,edge,eed,end,enzyme,erec,exceeding,flat,folded,geminat,generally,glabrou,greatly,green-white,hair,hal,half,homostylous,honeycomb-shaped,interjected,lanceolate,leaflet,lengthening,like,linear,living,lobe,long,lower,lunate,margin,minute,nflorescence,often,orolla,pair,perfect,petiolulate,plurifoliate,pore,poricidal,rapidly,removed,rounded,ruit,scattered,sessile,seudostipule,short,short-petiolulate,side,singly,size,slit,spaced,specimen,stamen,star,ste,stem,stolo,straight,subequal,tall,tamen,tem,throughout,tip,tri-,tube,tuber,unit,unwinged,usually,vary,white,wide,widely,wing,x,ympodial	abaxial,adaxial,arrangement,capitate,colour,form,growth,height,history,inflorescence,leaf,length,life,na,number,ovary,perennial,position,rachi,reproduction,shape,spacing,staman,surface,texture,width
500	wfo-0001029437	success	198	106	84	114	22	0.424	-10,.5,1,1-2,1-3,1.5-2,10-12,2-3,2.5-3.5,3-5,3-7,4-5,7-10,abaxially,acicular,anther,armed,beige,berry,blue,branched,brownish,clavate-truncate,cm,corolla,cylindrical,dark-green,diameter,elliptic,elliptic-lanceolate,filament,flattened,flower,glandular,globose,golden,green,growth,inflorescence,internodal,juvenile,lamina,leaf,long-styled,maturity,mm,orange,ovary,ovate,ovate-elliptic,pedicel,peduncle,persistently,petiole,plant,prickle,pubescence,pubescent,reniform,reticulate,rusty,short-styled,shrub,similar,simple,spaced,stellate,stem,stigma,style,subcordate,subglobose,suborbicular,subscabrous,surface,tomentose,trichome,unevenly,velutinous,violet,visible,woody,x,yellow	0.5-1,1-1.5,1/3,2.5-5,3-3.5,30-50,5-9,6-8,9-13,acute,adaxially,anthesi,antrorse,apar,apex,apical,articulated,axi,bark,basal,base,brow,c.,calyx,chartaceous,compressed,cordate,coriaceous,densely,distal,eaf,eed,eglandular,enclosed,entire,erect,except,free,fruiting,glabrescent,glabrous,gland,greyish,heterostylous,hirsute,irregularly,leaving,lengthening,like,linear-oblong,lobe,lobed,lobed-angulate,long,loose,lower,margin,membranous,midpoint,minute,minutely,multangulate,multicellular,near,nearly,new,nflorescence,oblong,oblong-lanceolate,obverse,older,ovoid,packed,papillo,per,perfect,pericarp,plurifoliat,pore,poricidal,porrect,portion,prickly,recurved,rest,rotate,rounded,ruit,scar,sessile,slit,sparsely,stalked,staminate,stellate-pubescent,subscandent,subulate,tall,tapering,testa,thick,tip,triangular,tube,ud,unarmed,unicellular,unit,upper,villous,whitish,without,ympodial,¼	abaxial,adaxial,apart,arrangement,colour,form,fruit,height,history,length,life,na,number,perennial,position,rachi,reproduction,seed,shape,spacing,staman,texture
501	wfo-0001029440	success	218	89	68	150	21	0.312	0.9-1,1-1.2,2-2.5,2-4,2-6,30,4-6-forked,4-8,5-merous,8-10,abaxial,anther,apex,armed,beige,bicolorous,brown,canaliculate,clavate,cm,cyme,dark-green,deeply,diameter,ferruginous,filament,finely,flower,fruit,glabrous,glandular-pubescent,globose,lanate,leaf,leathery,length,mm,oblong-elliptic,oval-elliptic,parted,pedicel,peduncle,perennial,petiole,plant,prickle,rachi,reddish,reticulated,rugose,scabrous,shrub,slender,small,solitary,stellate,stigma,style,sub-truncate,subreniform,surface,terete,terminal,tomentose,white,within,without,yellowish	-10,0.2-0.3,0.3-1,0.5-0.6,1,1-1.5,1-2,1-2-celled,1-nerved,1.5-2,2,2-3,2.5-7,20,4-5,4-6,5-15,5-5.5,5-6,6.5-8,9-10,9-12,<,>,accrescent,acicular,across,acute,adpressed,along,alyx,anthesi,ape,apical,articulate,bark,basal,base,blade,branch,brow,caly,calyx,central,compressed,coriaceous,curved,dark,deciduous,distal,eaf,eed,elongate,enclosed,enlarged,entire,epicarp,equal,erect,exceeding,exserted,floral,free,fruiting,functional,fused,geminat,glabrescent,glandular-stellate,glandular-tipped,gynoeci,held,indument,lanceolate-attenuate,leaving,lobe,lobed,long,longer,lower,midrib,minutely,mucilaginous,nflorescence,numerous,oblong-lanceolate,obver,older,orolla,papillose,part,partially,peg,perfect,persistent,petiol,plurifoliate,pore,porrect-stellate,primary,prominent,rarely,ray,recurved,reduced,reflexed,rounded,ruit,secondary,sepal,sessile,shiny,short,similar,somewhat,sparse,sparsely,stalked,stamen,staminate,stellate-glandular,stem,stiff,straight,strigose,strongly,sub-coriaceous,sub-terete,subcampanulate,subsagittate,surfac,tall,tamen,testa,touch,tri-,triangular,trichome,tube,unarmed,unit,upright,vary,vein,velutinous,wide,ympodial,young,¼,¾	adaxial,arrangement,colour,corolla,form,growth,height,history,inflorescence,life,na,number,ovary,position,reproduction,seed,shape,spacing,staman,texture,width
502	wfo-0001029461	success	217	90	66	151	24	0.304	-1.5,-3,.5,0.6-1,1-1.6,1/4-1/2,2-2.8,4.5-7,5-merous,abaxially,almost,andromonoecious,anther,apex,base,berry,black,cell,cm,densely,diameter,dull,elliptic,erect,evenly,filament,fine,flattened-reniform,flower,fruit,glabrous,green,leaf,length,lobed,long,maturity,mauve,mm,moderately,outline,ovate,pedicel,petiole,pit,plant,raised,reddish,rounded,shiny,shrub,simple,small,smooth,sometimes,sparsely,spherical,staman,stellate-pubescent,style,surface,way,weakly,yellow,young,zygomorphic	-14,-2,-3.2,-3/4,-4,-4.5,-5,0,0.1,0.1-0.25,0.15-0.25,0.7-1,0.8,0.8-1.5,1-,1-2,1-3,1-4,1-6,1.2-1.7,1.2-1.8,1.3-2.2,1.5-,1.5-2,1/3,1/3-2/3,1/4,2-2.4,2-3,2-4,2.5-3,3-20,3-6,4-10,4-6.5,4-7,4.7-7.2,5-10,5-25,7-10,7-12,8-9,acuminat,alyx,ame,apart,apically,attenuate,bark,becoming,blade,breaking,brittle,broad-deltate,brown,c.,calyx,chartaceous,concolorous,cuneate,curved,dark,discolorous,distal,distance,drying,eaf,eed,elongating,extending,faint,fifth,flattened,four,free,fruiting,glabrescent,gra,hermaphrodite,heterostylous,infructescence,lengt,lobe,long-styled,longer,lower,lowermost,margin,mature,midpoint,midvein,oblong,obovate,obtuse,older,orange,orolla,oung,pair,pendulous,per,pericarp,plurifoliat,poricidal,porrect,portion,prickl,prickle,prickly,primary,ray,reduced,reflexed,ruit,sessile,shallow,short-styled,shorter,side,slender,slightly,spaced,spreading,stalk,stalked,staminat,stellate,stem,straight,strongly,subentire,tamen,terete,tertiary,time,tip,trichome,tube,unarme,unarmed,unequal,unit,upper,variously,vary,vein,venation,visible,wide,woody,ympodial	abaxial,adaxial,arrangement,colour,corolla,form,growth,height,history,inflorescence,life,na,number,ovary,peduncle,perennial,position,rachi,reproduction,seed,shape,spacing,stigma,texture
503	wfo-0001029462	success	166	87	59	107	28	0.355	-30,0.5-2,1-6,2-6.5,2.5-3.5,3-27,4-20,5-30,6-9,7-8,acuminate,apex,articulated,base,campanulate,chartaceous,cm,cuneate,dark,densely,diameter,ellipsoidal,elliptic,entire,flattened,flower,fruit,glabrous,green,light,longitudinal,margin,membranaceous,minutely,mm,moderately,near,occasionally,ovate,pedicel,peduncle,perfect,petiole,puberulent,pubescent-pilose,purplish,rachi,reticulate,rounded,simple,sparsely,stigma,stripe,style,tree,truncate,unbranched,white,yellow	-2,-4,-5,0.5-1,1,1-,1-2,1-3,1.5,1.5-2,1.5-3,1.5-7,10-,10-22,15-25,2-3,2.5-5.5,20-35,3,3-18,3-4,3-5,3-6,3-7,4-15,4-foliat,7-19,8-9,abaxially,abruptly,absent,acute,adaxially,aggregate,apart,ape,axe,basal,beyond,blade,broad,calyx,cell,ciliate,connective,connivent,constricted,curled,cylindrical,dentate,directed,eaf,eed,eglandular,equal,exceeding,exserted,hair,lanceolate,laterally,leaving,lobe,lon,long,lower,m.,narrowly,nflorescence,nther,obtuse,often,orolla,oval,ovoid,pedicellar,pore,pubescent,pubescent-pilo,purpl,radiu,remnant,ruit,shorter,slightly,small,smooth,somewhat,spaced,stamen,stellate-,stone,tal,tem,thecae,time,tip,tomentose,triangular,truncat,tube,ud,unit,vary,wide,without,x,ympodial	1-15,10-25,abaxial,adaxial,anther,arrangement,colour,corolla,form,growth,height,history,inflorescence,leaf,length,life,na,number,ovary,perennial,plant,reproduction,seed,shape,spacing,stellate-campanulate,surface,texture
504	wfo-0001029464	success	235	92	73	162	19	0.311	.9,0-80,0.2-0.5,1-10,2-3,2-3.5,2.5-5,3-5,4-8-merous,5.5-7.5,6-15,abaxial,acute,adaxial,andromonoecious,annual,anther,apex,black,branched,broad,chartaceous,cm,connivent,curved,diameter,ellipsoid,filament,flattened-reniform,flower,fruit,glabrescent,glaucous,globular,green,herb,lateral,leaf,length,lobed,lower,maroon,maturity,mauve,mm,moderately,mottled,oblong,orange-brown,ovate,ovoid,pedicel,peduncle,petiole,pink,plant,purple,red-brown,simple,smooth,sometimes,stellate,stellate-pubescent,straight,striped,style,surface,terminal,usually,variously,white,yellow-green,young	-2/3,-3,-30,-5,0,0-2,0.2,0.2-0.7,0.3-0.7,0.3-1,0.5,0.5-2,0.8-2,00-200,1,1-3,1-8,1.2-3,1.5-2,1/,1/4,1/4-1/2,1/4-1/3,10-15,10-23,10-40,10-50,12-50,2,2-4,2.2-2.5,2.4-4,2.5-8,2.9-3.2,3-20,3-7,3.5-5,4-7,4-8,5-17,5-8,5.5-6,7-10,8-13,8-15,9-15,abaxially,acicular,alyx,ame,apar,apart,apically,apparently,around,articulated,bark,base,berry,blade,broad-deltate,brow,brown,c.,calyx,cordate,cultivar,cup-shaped,dark,deltate,difoliate,discolorous,distal,distance,drying,eaf,eed,elongated,elongating,equal,erect,extending,free,fruiting,fully,geminat,glabrous,green-brown,hair,hermaphrodite,heterostylous,infructescence,less,lobe,long,long-acuminat,long-styled,longer,lowermost,margin,mature,midpoint,midvein,minute,narrow-deltate,nflorescence,obtuse,occasionally,often,older,one,open,opening,orolla,oung,pair,pendent,pendulous,per,pericarp,poricidal,porrect,portion,prickl,prickle,prickly,primary,ray,rounded,ruit,scar,sessile,short-styled,side,spaced,sparsely,spreading,stalk,stalked,staminat,stem,tamen,tapering,terete,tertiary,time,tip,translucent,trichome,tube,unarmed,unit,upper,vary,vein,venation,visible,way,wide,woody,yellow-orange,ympodial	1/2,arrangement,colour,corolla,form,growth,height,history,inflorescence,life,ovary,position,reproduction,seed,shape,spacing,staman,stigma,texture
505	wfo-0001029505	success	169	69	46	123	23	0.272	.1,0-0.3,0.5-1.1,1-6,4.5-5.5,5.5-7,6-18,7-12,andromonoecious,anther,apex,chartaceous,cm,densely,diameter,elliptical,extra-axillary,flower,fruit,globose,green,inflorescence,length,mm,obtuse,ovate,pale,pedicel,peduncle,perennial,petiole,plant,prostrate,pseudo-racemose,red,rotate-stellate,solitary,stellate,stellate-pubescent,stoloniferous,style,unbranched,weakly,white,yellow,yellowish	%,.05,0-10,0-3,0-3.5,0.15-0.2,0.15-0.25,0.2-0.3,0.3-0.5,0.8-1,1-1.2,1-3,1-locular,1.5-2.2,2-4,2-5,2-7,2.4-3.2,2.7-4,22-25,5-7.5,5-merou,6-8,7-20,7-8,8-10,abaxially,absen,absent,acicular,across,adaxiall,adaxially,adult,alyx,apart,articulated,axe,ba,base,blade,branche,brown,calyx,confined,cross-section,cuneateor,cylindrical,decimetre,deltate,directed,distall,eaf,eed,elliptic,elliptica,entire,exocarp,finger,fruiting,functional,glabrous,gland-tipped,hair,half,heterostylous,incomplete,juicy,lamina,lateral,less,lobe,long,longer,lower,margin,mature,mesocarp,midpoint,midrib,midvein,minute,moderately,moist,nflorescence,oblique,onl,orolla,part,per,placenta,pore,porrect,present,prickle,ray,ruit,semi-circular,septum,sessile,short,shrub,simple,spaced,sparsely,stellae,straight,tal,tamen,tem,thick,throughout,time,transparent,tube,unarme,unarmed,unit,unknow,vary,wide,x,ympodial	abaxial,adaxial,colour,corolla,filament,form,growth,height,history,leaf,life,na,number,ovary,position,reproduction,seed,shape,spacing,staman,stigma,surface,texture
506	wfo-0001029524	success	212	108	89	123	19	0.42	-5,-6,-8,0.7-0.8,1-,1-1.5,1-3,1.2-1.5,2-,2-2.5,2-4,25,3-8,4-4.5,4-6,6-7,7-9,abaxially,acicular,adaxially,anther,base,beige,berry,channelled,cm,congested,corolla,corymbose,cyme,diameter,eglandular,filament,flattened,flower,glabrous,glandular,globose,green,grey,growth,heterostylous,lanate,lobed,long,long-styled,maturity,mixture,mm,oblong,oblong-lanceolate,ovary,ovate,ovate-elliptic,ovate-lanceolate,pedicel,peduncle,petiole,plant,prickle,reniform,reticulate,rugose,rusty,short-styled,shrub,spaced,stellate,stigma,style,sub-cordate,suborbicular,subspherical,surface,tiny,tomentose,trichome,unarmed,unevenly,velvety,viscid,way,white,woody,x,yellow,yellow-green,yellowish,¾	.5,0.1-0.3,0.2-0.3,0.9-1.2,1-2,1.5-2,10,12-25,2-3,3-,3-3.5,4-7,5-15,6,9-10,acuminate,acute,adult,angulate,anthesi,apex,articulated,bark,basal,branched,brown,calyx,campanulate,cell,clavate-truncat,decumbent,densely,discolorous,distal,distall,doubling,eaf,eed,elongating,entire,erec,erect,exceeding,exserted,filamentous,flexuous,flowering,foliaceous,free,fruiting,glabrescen,glandular-hirsute,impressed,internodal,leaving,light,like,linear-oblong,lobe,long-stalked,loosely,lower,m.,margin,membranous,midpoint,minute,multicellular,new,nflorescence,numerous,oblique,obtuse,obverse,occasionally,older,one,partially,perfect,pericarp,plurifoliat,pore,poricidal,porrect,portion,prickly,pubescence,pubescent,recurved,rounded,ruit,scar,sessile,single,size,slightly,slit,somewhat,sparsely,stalked,staminate,stellate-pilose,stellate-pubescent,stem,subbsessile,subcordate,subcoriaceous,subscabrous,tall,tapering,testa,time,tip,triangular-lanceolate,tube,turbinate,ud,unit,upper,vein,venation,villous,ympodial	abaxial,clavate-truncate,colour,distally,form,fruit,height,history,inflorescence,leaf,length,life,number,perennial,reproduction,seed,shape,spacing,texture
507	wfo-0001029546	success	203	100	76	127	24	0.374	0.3-1,1-10,1-2,1-4.5,1.5-6.2,2.2-2.8,3-8,4-10,5-18,5-8,7-10,8-17,abaxially,adaxially,anther,axillary,blue,broadly,brownish,bud,cell,clavate,cm,condition,corolla,covering,densely,diameter,drying,elliptic,filament,flower,forked,fresh,fruit,glabrous,globose,green,greenish,hair,hair-like,herb,lateral,leaf,like,minutely,mm,odd-pinnate,ovate,ovoid,pedicel,peduncle,pentagonal,petiole,plant,pubescent,rachi,rarely,ripe,rotate-pentagonal,seed,simple,slightly,stem,stigma,style,subtending,terminal,testal,thick,tinged,wall,white,whitish,x,yellow	0-2,1-3.2,1-5,1.5-2,1.6-6.5,2-4,2-9,3.5-5,4.5-12.5,4.5-7,5,5-10,5-merou,6.3-19.5,8,8-19.5,absent,acumen,acuminate,acute,adaxiall,ag,alyx,apart,apex,apiculate,apparently,articulated,attenuate,axe,base,berry,blade,capitat,chartaceous,connivent,cordate,covered,curved,decreasing,decumben,decurrent,digestion,distal,dorsally,dot,eaf,edge,eed,elliptical,enzyme,erect,exceeding,flat,folded,frequently,geminat,generally,glabrou,glandular,greatly,green-white,half,homostylous,honeycomb-shaped,interjected,lanceolate,leaflet,lengthening,living,lobe,long,longer,lower,lunate,make,membranous,middl,mottle,mucilaginous,nearly,nflorescence,non-glandular,oblique,often,orbicular,pair,perfect,petiolule,plurifoliate,pore,poricidal,purple,regular,removed,ruit,sessile,seudostipule,short,size,slit,soft,sometimes,spaced,specimen,stamen,ste,straight,subequal,tall,tamen,tem,throughout,tip,tri-,trichome,truncate,tube,typically,unit,unwinged,usually,vary,wet,wide,wing,ympodial	abaxial,adaxial,arrangement,capitate,colour,form,growth,height,hermaphroditic,history,inflorescence,length,life,na,number,ovary,perennial,position,reproduction,shape,spacing,staman,surface,texture
508	wfo-0001029552	success	161	92	66	95	26	0.41	.5,0.6-1,1-1.3,1-1.5,1-3,1-5,12,2.5-3,abaxial,abruptly,acuminate,acute,anther,apex,area,base,branched,broadened,closely,cm,contracted,corolla,deflexed,densely,elliptic,filament,flattened-reniform,flower,glabrous,globose,green,incrassate,inflorescence,leaf,lobed,long-styled,margin,minutely,mm,nearly,occasionally,opposite,ovary,paler,pedicel,petiole,pitted,pubescent,shape,shining,short-styled,shrub,simple,slender,small,spaced,sparsely,stigma,style,surface,tan,tip,tree,tree-like,trichome,white	.25,0.1-0.5,0.5,1-2,1.5-2,1.5-6.5,10-20,2-2.5,2-9,5-10-flowered,5.5-8,6-9,abaxially,adaxially,along,anthesi,bark,berry,broadly,calyx,clavate,conical,decurrent,deltate,dendritic,denser,dia,differing,difoliate,drying,eaf,edicel,eed,erect,exserted,free,fruiting,geminat,greyish-brow,heteromorphic,inflorescenc,lamina,later,lateral,like,lobe,lon,long,lower,main,major,middle,minor,minute,nflorescence,older,onto,orbicular,overlappin,pair,pale,papillo,persistent,planar,pore,poricidal,portion,present,reflexed,rest,rounded,ruit,scar,scattered,shaped,size,slightly,somewhat,stem,strongly,swollen,tall,tear-drop,tub,tube,ud,unit,vein,wide,widest,woody,x,yellowish,ympodial,young	5-10,adaxial,arrangement,colour,diameter,form,fruit,growth,height,history,length,life,na,number,overlapping,papillose,peduncle,plant,position,rachi,reproduction,seed,spacing,staman,texture,width
509	wfo-0001029558	success	184	117	91	93	26	0.495	.5,0.05-0.1,0.1-0.2,0.1-0.9,0.4,0.5,1-1.1,1-1.5,1-3,1.5-2,2-4,4-merous,6-9,abaxially,anther,apex,bark,base,berry,calyx,capitate,cell,closely,cm,conical,corolla,densely,diameter,ellipsoid,entire,filament,filiform,flattened,flower,fruiting,geminate,globose,growth,inflorescence,internodal,later,leaf,like,lobed,margin,mere,minutely,mixture,mm,narrowly,nearly,new,obovate,obspathulate,ovary,overlapping,pale,pedicel,peduncle,petiole,pitted,porrect,prickle,pubescent,red,reddish,reniform,rhombic,scar,sessile,shape,shiny,short-stalked,shrub,simple,spaced,sparsely,square,stellate,stem,stigma,straight,style,surface,tan,thin,trichome,wall,white,widening,x	0.1-,0.15-0.2,0.2-,0.3-0.5,0.4-0.6,0.4-1.1,0.5-2,1,1-4,10-16,2,2-3,2.5-3.5,6-10,<,?,acute,adaxially,along,anthesi,armed,articulated,bearing,branched,deflexe,difoliate,divaricately,eaf,easily,eed,elliptic,elongate,enclosed,equal,erect,free,geminat,glabrescent,glabrous,gre,highly,hyaline,including,interlocking,larger,leave,lengthening,lobe,long,long-triangular,lower,midpoint,midvein,nflorescence,node,obtuse,occasionally,older,pair,paired,papillo,per,perfect,pericarp,planar,pore,poricidal,portion,prickly,primary,ray,rest,rhachi,rounded,ruit,shorter,sinus,size,slit,small,stalked,tapering,testal,tiny,tip,tube,ud,unit,upper,usually,vein,visible,ympodial	abaxial,adaxial,arrangement,bud,center,colour,form,fruit,grey,height,history,length,life,na,number,perennial,plant,position,rachi,reproduction,seed,spacing,staman,stelate,texture,width
510	wfo-0001029569	success	265	73	40	225	33	0.151	130,2,8.1,anther,apex,chartaceous,cm,corolla,densely,diameter,elliptic,evenly,extra-axillary,filament,flattened-reniform,flower,fruit,glabrous,globose,lateral,length,mm,orange,ovate,pedicel,peduncle,petiole,pubescent,red,reticulate,shrub,simple,stellate,stigma,straight,style,surface,white,yellow,yellow-tan	.0,.2,.3,.4,.9,/2,/3,0.03,0.05,0.1,0.2,0.2–0.5,0.3–0.5,0.4–0.6,0.5–0.8,0.6–0.8,0.6–0.9,0.7–0.9,0.8–1.0,0.9,0.9–1.3,0.9–1.4,0.9–2.0,1.0–1.3,1.3–1.8,1.4–2.4,1.5–1.7,1.6,1.6–4.5,1.7–2.3,1.8–2.5,1/2–2/3,1/3,14.6–16.5,2.0–3.2,2.3–3.0,2.3–4.4,3.2,3.2–3.8,3.4–3.7,4.0,4.5,4.9,4–6,5-merou,5.0,5.1,5.3–16.6,5.7–6.6,6.3–18.5,6.8–7.8,6–12,6–8,7.4–9.1,7–10,90°,abaxially,across,acuminate,adaxially,adnate,aequilateral,ag,along,alyx,anthesi,apart,apical,apiculate,apparently,appearing,around,articulate,attenuate,axe,ba,bark,basal,base,becoming,berry,blade,branch,branching,broad,brochidodromous,bud,calyx,capitat,channeled,clinate,cuneate,deciduous,dentate,development,difoliate,directed,distal,distally,distinct,dry,eaf,edge,eed,either,emerging,endocarp,entire,exocarp,extending,fertile,filiform,flexed,free,geminat,glandular,glossy,gradually,hair,homostylous,increasing,intact,internode,interpetalar,intersepalar,juic,lacking,lamina,layer,less,light,lobe,lon,long,longer,lower,many,margin,mature,middle,midpoint,midrib,midvein,minute,moderately,nearly,nflorescence,oblique,oblong,orolla,ove,per,perforated,pore,porrect,porrect-stellate,portion,potentially,probably,raised,ray,reduced,reflexe,remaining,restricted,rigid,rounded,row,ruit,scarcely,sessile,short,short-stipitate,shorter,side,sinuate,sinus,sloughing,smoot,spaced,sparsely,splitting,spread,spreading,stamen,stellae,stellate-pubescent,stem,stipe,stipitate,suture,tamen,tardily,tem,terete,thin,time,tip,tissue,toward,translucent,transparent,triangular,truncate,tube,two,ud,unarmed,unit,upper,various,vary,vein,weakly,well,well-developed,wide,yellow-ferruginous,ympodial,young,±90°,±equal,±glabrous,±well,×	0.9-1.3,0.9-2.0,1.0-1.3,1.5-1.7,3.2-3.8,5.7-6.6,6.3-18.5,abaxial,adaxial,arrangement,capitate,colour,form,growth,height,history,inflorescence,leaf,life,na,number,ovary,perennial,plant,position,rachi,reproduction,seed,shape,spacing,staman,texture,width
511	wfo-0001029584	success	180	108	82	98	26	0.456	1,1-2,1-6,1.5-6.5,2-3,3-10,3-5,4-15,4.5-11.5,6-7,8-15,abaxially,acuminate,acute,adaxially,anther,apex,articulated,axillary,brownish,bud,cell,clavate,cm,condition,coriaceous,corolla,covering,dark,densely,diameter,drying,elliptic,filament,flower,forked,fresh,fruit,glabrescent,glabrous,green,green-white,greenish,hair,hair-like,half,herb,lateral,leaf,light,make,middle,mm,mucilaginous,odd-pinnate,ovate,ovoid,pedicel,peduncle,pentagonal,petiole,plant,proximal,pubescent,purple,seed,short,simple,stigma,style,substellate,subtending,terminal,testal,thick,throughout,usually,wall,wet,white,whitish,yellow	0-30,1-3,16.2-33,2-4,2.4-6.3,3-7,4-14,4-5,5-merou,5.3-13.3,6.1-9.4,7-14,9.7-23.4,9.8-17,acumen,ag,alyx,apart,apparently,asymmetric,attenuate,axe,base,basiscopic,blade,borne,capitat,connivent,considerably,decreasing,dense,digestion,distal,dorsally,eaf,edge,eed,end,enzyme,erry,finer,flat,folded,geminat,generally,hal,homostylous,honeycomb-shaped,interjected,larger,leaflet,lengthening,linear,living,lobe,long,lower,margin,nflorescence,oblong-lanceolate,orbicular,orolla,pair,perfect,petiolulate,plurifoliate,pore,poricidal,present,removed,second,semi-erec,sessile,seudostipule,side,singly,size,slit,spaced,specimen,stolo,straight,tall,tamen,tem,tip,tissue,toward,tri-,tube,tuber,typically,unit,unknow,unwinged,vary,x,ympodial	abaxial,adaxial,arrangement,capitate,colour,form,growth,height,history,inflorescence,length,life,na,number,ovary,perennial,position,rachi,reproduction,shape,spacing,staman,surface,texture,unknown,width
512	wfo-0001029592	success	207	76	52	155	24	0.251	0.5-1.8,1.1-2.8,1.8-2.4,2-3-branched,2.1-4,3-6,3.5-5.5,6.5-8.5,7-10,7-25,8-10,acicular,acute,adaxially,anther,apex,black,brown,chartaceous,cm,densely,diameter,erect,extra-axillary,flower,fruit,glabrous,globose,green,inflorescence,leaf,length,long,mm,pedicel,peduncle,perennial,petiole,purple,rhizomatous,ridged,shrub,simple,stellate,stellate-pubescent,straight,style,surface,terete,unbranched,white,yellow	%,.05,.4,0,0-0.1,0-0.15,0-0.3,0-3.5,0.1-0.2,0.25-0.5,0.25-0.7,0.3-0.6,0.4-0.7,0.5-0.8,0.5-1,0.5-1.5,0.8-0.9,0.8-1.2,0.8-1.5,1-1.5,1-1.9,1-10,1-3,1-8,1-locular,1.5,1.5-3,1.8-6.5,1.8-8,14-20,18-30,2-10,2-3.5,2-foliate,240-1400,3-4,4-8,5-8,5-merou,5.5-10.5,5.5-11.5,6-8,7-17,7-9,8,8-20,abaxially,absent,across,adaxiall,adult,alyx,apart,apparen,apparently,armed,articulated,attenuate,axe,ba,base,blade,branch,branche,calyx,cordate,decimetre,deeply,deltate,depression,directed,distall,distally,distributed,dm,eaf,eed,eglandular,entire,exocarp,finger,fruiting,geminat,gland-tipped,hair,half,hemispherical,homostylous,incomplete,index,juicy,juvenile,lamina,lateral,less,lobe,lobed,lobing,longer,lower,margin,markedly,mature,mesocarp,mid-point,midpoint,midvein,minute,moderately,nflorescence,oblique,obtuse,orolla,ovate,pair,part,per,perfect,placenta,pore,porrect,presen,present,prickle,ray,ruit,septum,sessile,shallowly,short,side,spaced,sparse,sparsely,stalk,stellae,succulent,tal,tamen,tem,thick,thicker,thicknes,throughout,time,transparent,tube,unarme,unit,upper,vary,vein,wide,x,ympodial	5-merous,abaxial,adaxial,colour,corolla,filament,form,growth,height,history,life,na,number,ovary,plant,position,reproduction,seed,shape,spacing,staman,stem,stigma,texture
513	wfo-0001029593	success	181	70	46	135	24	0.254	0.5-1,0.5-5,1,1-1.5,3-4,4-6,5-10,5-15,acuminate,acute,anther,apex,axillary,brown,capitate,cm,conical,densely,diameter,elliptic,filament,filiform,flower,fruit,glabrous,globose,green,leaf,mm,obovate,ovary,ovoid-reniform,pedicel,petiole,pinnate,plant,pubescent,rachi,seed,shape,shrub,slightly,smooth,stigma,style,surface	-10,0.05,0.8-1,0.8-1.2,1-1.2,1-2,1-8,1.6-2.3,10-50,100,2,2-14,2-3,2-5,2.3,2.3-3.0,3.5-8,35-60,7-25,7.5-15,9-15,abaxially,abruptly,adaxially,age,always,anthesi,anticlinal,apically,arising,attenuate,axil,basal,base,basiscopically,bearing,berry,broadly,calyx,cateniform,cell,clavat,colony,cone,decurrent,deltate,dry,drying,eaf,edicel,eed,enlarged,entire,epidermal,exserted,extremely,free,fruiting,glabrescent,growing,half,hollow,included,irregular,lamina,large,lateral,leaflet,lobe,long,lower,markedly,minutely,much,narrowing,nflorescence,noddin,oblique,occasionally,often,once-branched,onto,open,opposite,pair,papillose,per,perfectly,petiolule,place,pointed,poricidal,portion,primary,projection,pubescen,pubescence,purple,rarely,reflecting,rest,ruit,scar,short-styled,similar,simple,single-stemmed,sinuous,small,smaller,somewhat,sparsely,tall,tem,terminal,thickening,tip,trichome,tub,tube,ud,unifoliat,uniseriate,unit,usually,variable,vein,white,white-lenticellate,wider,winged,without,woody,x,ympodial	abaxial,adaxial,arrangement,clavate,colour,corolla,form,growth,height,history,inflorescence,length,life,na,nodding,number,peduncle,perennial,position,reproduction,spacing,staman,texture,width
514	wfo-0001029601	success	187	83	57	130	26	0.305	0.2-0.8,0.5-5.8,1-2,1-3,1-53,2.3-5.9,3-10,3-5,5-41,6-10,6.8-14.5,abaxially,adaxially,anther,apex,articulated,attenuate,clavate,cm,coriaceous,corolla,dark,diameter,dot,elliptic,filament,flower,forked,fruit,glabrous,globose,green,greenish,herb,leaf,light,mm,mucilaginous,odd-pinnate,ovate,ovoid,pedicel,peduncle,pentagonal,petiole,plant,rotate,rounded,seed,small,stigma,style,terminal,wet,white,whitish,yellow	0-37,0.5-8,1-4,1.1-2.7,1.2-2.3,1.7-6.5,2,2-12,2-3,2-7,2-9,2.2-4.5,2.8-10.5,3-7,4-13.5,5-merou,6.6-22,abaxiall,acumen,acuminate,acute,ag,alyx,apart,apparently,asymmetric,axe,axillary,base,basiscopic,berry,blade,borne,brownish,bud,capitat,cell,condition,connivent,covering,decreasing,digestion,distal,dorsally,drying,eaf,edge,eed,end,enzyme,erec,exceeding,flat,folded,fresh,geminat,generally,glabrescent,glabrou,green-white,hair,hair-like,half,homostylous,honeycomb-shaped,interjected,lanceolate,larger,lateral,leaflet,lengthening,linear,living,lobe,long,lower,make,middl,middle,narrow,nflorescence,orbicular,orolla,pair,perfect,petiolulate,plurifoliate,pore,poricidal,puberulent,removed,ripe,ruit,sessile,seudostipule,short,side,singly,size,slightly,slit,spaced,specimen,stamen,stolo,straight,subequal,subglabrou,subtending,tall,tamen,tem,testal,thick,throughout,tip,tissue,toward,tri-,tube,tuber,typically,unit,unwinged,usually,vary,wall,wing,x,ympodial	abaxial,adaxial,arrangement,capitate,colour,form,growth,height,hermaphroditic,history,inflorescence,length,life,na,number,ovary,perennial,position,rachi,reproduction,shape,spacing,staman,surface,texture,width
515	wfo-0001029606	success	179	90	65	114	25	0.363	.5,/2,0.2-0.5,0.4-0.5,0.5-1,1.5-2,15,3,4.5-5,7-9,abaxially,adaxially,anther,apex,base,beneath,berry,bilobed,broadly,closely,cm,corolla,densely,diameter,elliptic,filament,flattened,flower,form,glabrous,globose,growth,inflorescence,internodal,leaf,lobed,long,long-styled,minutely,mm,multangulate,narrowly,oblong,once-branched,orbicular,pedicel,peduncle,petiole,porrect,pubescent,reddish,reniform,shiny,shrub,simple,stellate,stigma,style,surface,terminal,thin,trichome,way,white,x	0.5,1,1.5-3,1.5-3.5,1.8-2.5,2-2.5,2-3,3-9,4-5,4-6,4-8,5,5-6,7,aciculate,acuminate,acute,along,anthesi,apparently,arching,armed,articulated,bark,brown,brownish,calyx,cell,color,coriaceous,deciduous,defoliate,dense,eaf,eed,ellipsoidal,elongate,elongation,entire,equalling,erect,especially,exerted,free,fruiting,geminat,gre,herbarium,heterostylous,impressed,inshort-styled,known,lengthening,like,lobe,long-stalked,lower,m.,many,margin,marginal,midpoint,midrib,mixture,multiseriate,new,nflorescence,nodding,older,pair,papillat,per,pericarp,pore,poricidal,portion,prickle,primary,prominent,pubescence,ray,red,redder,revolute,ruit,rusty,scar,sessile,slightly,slit,sometimes,soon,space,specimen,stalk,stalked,stellate-pubescent,stem,straggling,straight,strongly,tapering,testal,tip,triangular,tube,ud,unit,urceolate,usually,vein,woody,yellowish,ympodial	abaxial,adaxial,arrangement,colour,fruit,height,history,length,life,na,number,ovary,perennial,plant,position,rachi,reproduction,seed,shape,short-styled,spaced,spacing,staman,texture,width
516	wfo-0001029619	success	188	95	74	114	21	0.394	0.25-0.75,0.5-1.5,0.5-2,1-2,1-3,1-3.5,1.5-2,10-12,2-3,3-4,3-8,4-6,5-20,6,7,abaxially,acute,adaxially,anther,apart,apex,base,brown,chartaceous,cm,dark,densely,diameter,extra-axillary,filament,flower,fruit,glabrous,globose,green,hair,immature,leaf,leaf-opposed,length,like,lobed,many,mature,mm,moderately,nearly,netlike,obtuse,orange,ovate,pedicel,peduncle,petiole,pit,pubescent,rachi,raised,reniform,ridge,scandent,separated,shrub,small,stellate,stem,stigma,style,surface,unbranched,white,whitish,x,yellow	0.5-1,1,1-.,1-1.5,1-2.5,1-5,2,2-11,2-5,25-40,5-merou,6-10,6-8,7-10,7-12,8-12,absent,accrescent,adaxiall,alyx,andromonoecy,apar,apical,apparently,appearing,armed,attenuate,axe,berry,beyond,blade,bud,calyx,clavat,connivent,contiguous,cordate,cut,cylindrical,difoliate,directed,discolorous,eaf,eed,either,elongated,em,exserted,flattedned,frui,fruiting,geminate,glabrou,gland-tipped,glandular,implying,introrsel,less,lobe,long,lower,m.,major,margin,midpoint,midrib,midvein,multicellular,multiseriate,narrowly,nflorescence,occasionally,often,orolla,pair,per,perfect,pore,porrect-stellate,prickle,ray,recurved,reduced,roselike,ruit,rusty,side,simple,sinus,slightly,spaced,sparse,sparsely,spreading,stalk,stamen,ste,tamen,tan,tapering,triangular,tube,unarmed,unequa,unicellular,unit,unlobed,usually,vary,vein,way,wide,ympodial,¼	5-merous,abaxial,adaxial,clavate,colour,corolla,form,growth,height,inflorescence,na,number,ovary,plant,position,reproduction,seed,shape,spacing,staman,texture
517	wfo-0001029621	success	165	80	51	114	29	0.309	0.5-0.75,0.5-1.5,0.7-1.1,1-1.5,1.5-2,1.5-5,3.5-4.5,7-9,anther,apex,area,becoming,brown,cm,corolla,dark,dry,filament,fleshy,fruit,glabrous,globose,green,lanceolate,later,lateral,leaf,live,lobed,material,merely,minutely,mm,oblanceolate,ovary,ovoid-reniform,pale,pedicel,pitted,plant,shrub,stigma,style,surface,tan,tapering,terminal,white,whorl-like,widened,yellowish	.1,0.5-1,0.5-1.2,0.8-1,0.8-4.5,1-2,1.5-2.5,1/3,2.5-3,2/3,3-3.5,5-20-flowered,6-20,6-8,accrescent,acute,along,anthesi,apar,appearing,appressed,attenuate,bark,base,beneath,berry,borne,branched,calyx,caudate,cluster,completely,constricted,course,cup-shaped,decurrent,deltoid,densely,dia,distal,eaf,edicel,eed,ellipsoid,elongate,enclosed,erect,exsertio,free,fruiting,geminate,glabrate,irregularly,late,like,lobe,lon,long,lower,main,many,margin,middle,nflorescence,occasionally,often,older,onto,pair,papillate,papillo,papillose,planar,plurifoliat,pore,poricidal,portion,prominent,puberulent,quite,rarely,reddish,reddish-gre,ripe,river,ruit,scar,sessile,shaped,shiny,small,somewhat,spaced,ste,stem,straight,tall,tear-drop,thick,time,tip,trichome,tube,ud,uniseriate,unit,vein,way,widest,woody,x,yellow,ympodial,young	5-20,abaxial,adaxial,apart,arrangement,colour,diameter,flower,form,growth,height,history,inflorescence,length,life,na,number,peduncle,perennial,petiole,position,rachi,reproduction,seed,shape,spacing,staman,texture,width
518	wfo-0001029622	success	182	83	57	125	26	0.313	.1,.5,/3,0.5-1,0.8-1,1.5,2.5-3,3-4,30-35,abaxially,adaxially,anther,apex,base,calyx,chartaceous,cm,corolla,diameter,elliptic,except,filament,flower,fruit,glabrous,globose,green,inflorescence,internodal,leaf,lobed,minutely,mm,narrowly,occasionally,opposite,ovate,papillose,pedicel,peduncle,petiole,rachi,shiny,shrub,simple,slender,somewhat,stellate,stigma,style,tapering,tip,tube,way,white,x,yellow	.2,0.3,0.5,0.5-0.7,0.6-0.9,1-1.2,1-1.5,1-2.7,1-4,2-11,2-4,2-5,3-5,4-6.5,40,45-50,5-6,7-11,absent,accrescent,acute,ag,alyx,anthesi,apparently,appearing,arising,attenuate,axe,axil,bark,beneath,blade,brown,bud,capitat,connivent,consisting,cylindrical,deciduous,deflexed,differing,difoliate,dimorphic,eaf,eed,elongate,entire,free,fruiting,geminate,glabrou,ilament,immature,included,interlaced,jointed,known,lamina,lateral,less,lobe,long,long-acuminate,long-triangular,longitudinal,m.,main,major,margin,mature,measured,midrib,minor,minute,nflorescence,obconic,oblong,often,older,one,onto,opening,orolla,oung,ovate-lanceolate,pair,pendent,pore,portion,present,probably,raised,reddish,reflexed,remaining,rounded,ruit,sagittate,scar,second,shaped,single,size,slende,slightly,slit,stem,straight,tal,tear-drop,thin,thus,trichome,tuft,ud,unarme,unifoliat,uniseriate,unit,vary,vein,within,ympodial,young	1,abaxial,adaxial,arrangement,capitate,colour,form,growth,height,history,length,life,na,number,ovary,perennial,plant,position,reproduction,seed,shape,spacing,staman,surface,texture,width
519	wfo-0001029625	success	168	90	60	108	30	0.357	..,0.5-1.3,1-1.5,1-2,1.2-1.6,3-,3-3.5,4-4,4-9,5,5-6,5-8,abaxial,anther,bark,calyx,cell,cm,conical,corolla,darker,diameter,elliptic,filament,flattened,flower,four,fruit,fruiting,globose,green,greenish,growth,herb,inflorescence,lobed,long,margin,mm,new,ovary,ovate-reniform,pale,papillate,pedicel,peduncle,pointed,pubescent,reddish,scar,smooth,stem,stigma,stripe,style,surface,tan,trichome,uniseriate,white	-15,.1-0.2,.5,0.5-1,0.5-2,0.5-2mm,0.8-1.4,0.8-1.8,1-3,100,2,2.5-.,3,3-3,4-10,4-5-celled,4-7-celled,5-10,6-9,8-13,9-25,along,anthesi,apical,base,beneath,branc,branch,branched,brittle,brow,capitat,cel,cucullate,deflexe,deflexed,deltate,densely,denser,distinct,dry,eaf,edicel,eed,erect,frui,glabrescent,glabrous,gland,gland-tipped,glandular,hyaline,lamina,later,lighter,like,lobe,lower,markedly,middle,midline,minute,mixed,narrowly,nearly,nflorescence,occasionally,open,outer,outline,pair,per,pericarp,planar,plurifoliat,point,primary,purplish,rarely,regularly,ruit,scattered,shrub,single,single-stemmed,sinuate,slightly,small,sparsely,striate,strongly,testa,thin,time,tinged,tip,triangular,tube,tuft,ud,unit,vein,wall,weight,without,x,ympodial,young	adaxial,apex,arrangement,brown,bud,capitate,center,colour,form,height,history,leaf,length,life,na,number,perennial,petiole,plant,plurifoliate,position,prickle,rachi,reproduction,seed,shape,spacing,staman,texture,width
520	wfo-0001029630	success	286	107	84	202	23	0.294	/6,0-5,0.5-1.5,0.5-4.5,1-3,12-17,2.5-3,3-10,3.5-5,6-8,7-10,abaxial,abaxially,acuminate,acute,along,anther,apart,apex,apparently,berry,brachyblast,branched,capitate,cell,clavate,climber,cm,corolla,dark,densely,diameter,distributed,drying,dull-yellow,elliptic,evenly,filament,flattened-reniform,flower,fruit,glabrous,glaucous,globose,green-brown,lateral,leaf,length,like,lobed,maturity,mauve,mm,orange,orange-brown,outline,ovate,pedicel,peduncle,petiole,pit,purple,rachi,raised,red-brown,rounded,shiny,side,small,smooth,sometimes,somewhat,stellate,stellate-pubescent,stem,stigma,style,suborbicular,surface,terminal,thin,yellow-brown,yellow-green,young	.1,.15,.5,.7,.8,/2,0,0-10,0-8,0.1-0.2,0.15-0.3,0.2-0.3,0.2-0.4,0.2-0.7,0.3-0.5,0.4,0.5,0.5-1,0.5-2,0.6-0.8,1,1.2-1.5,1.5-2,1.5-4,1/3,1/3-1/5,1/3-2/3,10-30,12-15,2-6,2.5,2.5-6,4-5,4-8,45-60°,5,5-20,5-9,5-merou,8,8-9,accrescent,across,adaxially,age,almost,always,alyx,apar,apically,area,armed,articulated,ascendant,attachment,bark,base,beyond,blade,branch,broadly,brown,calyx,chartaceous,clearly,coroll,cuneate,cupular,curved,delineated,deltoid,development,difoliate,discolorous,distance,divided,downward,eaf,eed,ellpsoid,elongating,entire,equal,exserted,extending,eye,fertile,finely,flat,flattened,free,fruiting,geminat,glabrescent,grey-brown,greyi,hooked,infructescence,irregula,lengthening,less,lighter,lobe,lon,long,longer,longitudinal,lower,main,margin,mature,midpoint,midvein,mostly,naked,narrow-ovate,nflorescence,oblique,often,orolla,ovoid,pair,pale,papillo,papillose,patchily,pendulous,per,perfect,pericarp,point,pore,poricidal,porrect,portion,prickle,primary,prominently,ray,recurved,reduced,reflexe,relatively,rest,robust,ruit,scar,secondary,shorter,simple,sinus,slender,slit,spaced,sparsely,species,spherical,spreading,stalk,stalked,stout,straight,strong,strongly,stump,sunk,tamen,tapering,terete,tertiary,thicker,throughout,time,tip,toward,translucent,trichome,tube,ud,undulate,unequal,unequal-deltoid,uniform,unit,usually,variously,vary,vein,venation,visibl,visible,visibly,weakly,white,white-translucent,wide,widest,woody,yellow,yellow-translucent,ympodial,×	5-merous,adaxial,arrangement,colour,form,greyish,growth,height,history,inflorescence,life,na,number,ovary,perennial,plant,position,reproduction,seed,shape,spacing,staman,texture
521	wfo-0001029632	success	202	106	80	122	26	0.396	.5,0.2,0.5–1.4,0.9,0–1.5,1.2,1.2–2.5,1.5–,1.5–2.6,11–25,2.0–11.5,2.7–3.5,3–8,4–8,5–10,abaxial,abaxially,along,anther,anthesi,apart,apex,arising,associated,black,branching,brown,clavate,cm,dark,deeply,densely,diameter,elliptic,filament,flattened,flower,fruit,glabrous,globose,green,hair,herb,leaf,like,lilac,midrib,midway,mm,ovate,pale,pedicel,peduncle,pentagonal,perennial,petiole,pitted,pubescent,purple,simple,sometimes,sparsely,stigma,style,surface,unbranched,violet,white,whitish,x,yellow,–1.4,–10,–11.5,–15,–19.0,–2.0,–4.5,–5.2,–50	.0,0.3–2.0,0.4–1.0,0.5,0.5–0.7,0.6–1.1,0.7,0.8–,0.8–1.0,0.8–1.5,0.8–2.2,1,1.0–1.5,1.0–2.0,1.0–3.5,1.0–6.0,1.1–,1.2–1.4,1.7–8.5,10–30,2,2.0–2.2,2–3,3.5–5.0,4.5–6.0,5,5.5–9.5,6–13,7.5–13,75,absent,acute,adaxiall,adaxially,ag,angular,appressed,articulated,axe,ba,base,blade,calyx,caudex,cell,chartaceous,connivent,cylindrical,decurrent,eaf,eed,elongate,equal,especially,geminat,indistinct,lamin,lobe,lobed,lon,long,longitudinal,lower,m.,margin,marking,midvein,moderately,multicellular,nflorescence,oblong,obtuse,occasionally,often,opening,orolla,pair,particularly,perfect,pore,poricidal,present,prostrate,purplish,rapidly,rarely,ruit,scandent,semi-succulent,shaped,side,slender,slit,spaced,spheroidal,stone,straight,subentire,subterranean,succulent,swollen,tall,tamen,tear-drop,tem,time,tip,tube,unicellular,unifoliate,uniseriate,unit,vary,vein,wide,wing,ympodial,–11.0,–13.5,–2.2,–4.0,–40	10-30,adaxial,arrangement,colour,corolla,form,growth,height,history,inflorescence,lamina,length,life,na,number,ovary,plant,position,rachi,reproduction,seed,shape,spacing,staman,texture,width
522	wfo-0001029645	success	160	90	63	97	27	0.394	0.2-0.5,0.3-0.5,0.5-2.5,0.5-7,1-1.5,1-4,2.5-4,3-10,3-15,3-7,3.5-4,337,750,anther,apex,base,blue,brown,chartaceous,cm,corolla,diameter,et,extra-axillary,fide,filament,flattened,flower,fruit,glabrous,globose,green,greenish,herb,kayap,line,membranaceous,minutely,mm,ovate,ovate-elliptic,pedicel,peduncle,petiole,puberulent,purple,rachi,red,rotate-stellate,rugose-verrucate,simple,smith,sparsely,stigma,style,triangular,truncate,unbranched,white,wide,x,yellow,±	-1,.5-1,1,1-2,1.3-7,1.5,1.5-2,2-3-foliat,2-4,2.5-17,4-5,4-8,5,5-8,6-12,7-12,?,abaxially,abundantly,acuminate,acute,adaxially,aggregate,along,apart,around,articulated,axe,ba,blade,calyx,cell,connivent,cuneate,cylindrical,decurrent,deltate,directed,distall,distally,eaf,eed,entire,except,finger,free,glabrou,gland-tipped,hair,immature,inserted,knapp,lobe,long,lower,major,margin,mesocarp,moderately,nearly,nflorescence,obtuse,orolla,part,perfect,pore,puberulen,radiu,rarely,ruit,sagittate,sand-punctate,short,short-tomentose,shorter,shru,side,small,spaced,stone,strongly,subcordate,tal,tamen,tapered,tem,thecae,tightly,time,tomento,truncat,tube,unit,vary,vein,veiny,ympodial	0.5-1,abaxial,adaxial,arrangement,colour,form,growth,height,history,inflorescence,leaf,length,life,na,number,ovary,plant,position,reproduction,seed,shape,shrub,spacing,staman,surface,texture,width
523	wfo-0001029646	success	141	85	59	82	26	0.418	0.1-0.6,0.7-2.2,1-4,1.5-2,10-15,4-5.5,6-8,7-15,apex,articulate,branched,cell,cm,corolla,covering,cyme,diameter,dichasial,dichasially,distal,ebracteate,elliptic,filament,finely,flower,globose,green,green-white,hair-like,half,herbaceous,lateral,leaf,mm,monochasial,narrowly,ovate,ovoid,pedicel,peduncle,perennial,petiole,plant,proximal,pubescent,seed,simple,stellate,stigma,style,testal,thick,throughout,tone,wall,white,yellow,yellow-green,¼	0.5,0.5-0.8,1.5-4.9,2-3,3-14,3-6-foliat,5-15,abaxially,acumen,acuminate,acute,adaxially,apical,apically,attenuate,base,calyx,commonly,dehiscent,digestion,dorsally,eaf,edge,eed,emoval,enzyme,epiphytic,equaling,flat,folded,forked,free,generally,globo,ground,growing,honeycomb,introrse,linear,living,lobe,lon,long,lower,make,maturing,mos,mould,mucilaginous,mucronate,nflorescence,nther,oak,often,orolla,ovat,pattern,perfect,pine,plan,poricidally,rarely,reveal,ruit,seudostipule,short,slit,specimen,stamen,straight,tall,tem,throughou,tree,tuber-bearing,typically,unit,vary,viole,wide,without,ympodial	abaxial,adaxial,anther,arrangement,colour,form,fruit,growth,height,history,inflorescence,length,life,na,number,ovary,position,rachi,reproduction,shape,spacing,staman,surface,texture,violet,width
524	wfo-0001029652	success	160	92	63	97	29	0.394	.5,0.5-4,0.75-1,0.8-1,1,1-3,1.5-2,2,2.5-3,3/4,4-4.5,abaxially,adaxially,anther,apex,base,cm,corolla,curling,deflexed,elliptic-ovate,filament,filiform,flower,glabrous,globose,golden,golden-red,green,greenish-white,hard,leaf,lobed,long,long-styled,maturity,minutely,mm,narrowly,occasionally,opposite,ovary,ovoid-reniform,pale,papillose,pedicel,petiole,pitted,pubescent,short-styled,shrub,simple,slender,stigma,style,surface,tan,tip,trichome,uniseriate,way,white,x	.25,.3,0.5-1,1-2,2-2.5,2-4,25,3.5-4,6-15,7-9,along,anthesi,apar,ape,apical,arch,arching,attenuate,ba,bark,bearing,berry,broadly,calyx,cone,conical,deciduous,deltate,denser,dia,differing,difoliate,drying,eaf,edicel,eed,evenly,exserted,free,fruiting,geminat,heteromorphic,hispid,included,joining,lamina,lateral,like,lobe,lon,long-acuminate,lower,main,major,margin,middle,midrib,minor,minute,near,nflorescence,older,pair,papillo,pericarp,pore,poricidal,portion,projection,reddish-brown,reflexed,ruit,scar,series,shaped,size,slende,slightly,soon,spaced,sparsely,stem,swollen,tall,tear-drop,thickened,time,tub,tube,ud,undulate,unit,vein,widest,within,ympodial,young	0.5,abaxial,adaxial,apart,arrangement,colour,diameter,form,fruit,growth,height,history,inflorescence,length,life,na,number,peduncle,perennial,plant,position,rachi,reproduction,seed,shape,spacing,staman,texture,width
525	wfo-0001029662	success	181	97	69	112	28	0.381	.3,.5,0.5,1,12,15,20,4-rayed,5-6,7-14,abaxially,adaxially,andromonecious,anther,apart,campanulate,chartaceous,cm,cylindrical,diameter,extra-axillary,filament,flower,fruit,glabrous,hair,herb,leaf,like,linear-tapered,lobed,margin,mm,nearly,oblong-ovoid,opposite,ovate,pedicel,peduncle,petiole,pilose,plant,prickle,pubescent,rachi,reflexed,repand,sessile,shallowly,shape,simple,slender,slightly,somewhat,sparsely,stellae,stellate,stellate-pentagonal,stem,stigma,straight,style,thickened,unbranched,unknown,vine,white,x,yellow	0.7–1,0.7–3,1.4,1.5,1.7–3.5,1–3.5,2,2-,2–3,2–3-celled,3-foliate,3.2,3.5,3.5–6,3–4,4–5,5–7.5,6-7,9–11,absent,accrescent,acicular,adaxiall,ag,apex,armed,articulated,axe,ba,base,blade,calyx,capitat,caudate,color,connivent,creeping,curve,directed,distally,eaf,eed,equal,erect,expanded,fertile,fragrant,free,fruiting,geminat,glabrou,half,ilament,immature,including,lateral,less,lightly,lobe,long,longitudinal,lower,lowest,m.,major,midpoint,minute,nflorescence,node,oblong-ovate,obtuse,offset,one,opening,orolla,per,perhaps,pore,portion,probably,ray,recurved,ripe,rooting,rounded,ruit,shorter,side,size,slit,small,spaced,striaght,subcordate,tal,tem,tip,tomentose,triangular,truncate,tube,two,unarmed,unequal,uniform,unit,vary,vein,way,wide,widely,ympodial	0.7-1,0.7-3,1.7-3.5,3-4,9-11,abaxial,arrangement,capitate,colour,corolla,curved,form,growth,height,history,inflorescence,length,life,number,ovary,perennial,position,reproduction,seed,spacing,surface,texture,width
526	wfo-0001029673	success	159	102	80	79	22	0.503	0.5-1,0.7-1.1,0.75-1,1-10,1-2,1-5,1.5-2,2-2.5,2-3,4-6,5-25,abaxial,abaxially,acute,adaxial,adaxially,anther,anthesi,apex,apical,appearing,basal,base,black,branch,broadly,clavate,cm,corolla,deep,dendritic,densely,diameter,elliptic,filament,flower,fork,fruit,glabrous,globose,greyish-yellow,growth,later,lateral,leaf,length,lenticular,minutely,mm,narrowly,occasionally,ovary,overtopping,pedicel,pericarp,petal,petiole,pitted,planar,pubescent,purple,pyramidal,reddish-brown,reflexed,shoot,shrub,slightly,small,sparsely,stigma,style,surface,tapering,terminal,thin,tree,trichome,vein,violet,winged	.5,0.8-1,1.2-3.5,1.5-1.8,10-20,2-4,2.5,3-5,3/4,5.5-15,absent,accrescent,acuminate,age,along,bark,becoming,berry,blade,branching,calyx,conical,decurrent,deflexed,deltoid,denser,dichasia,eaf,edicel,eed,ew,exserted,free,fruiting,greyish,greyish-yello,individual,inserted,lamina,like,lobe,lon,long,longer,lower,m.,monochasial,nflorescence,nodding,older,pair,papillo,plurifoliate,pore,poricidal,portion,prominent,ruit,scar,secondary,sleeve,slit-like,somewhat,stamen,stem,strongly,tall,time,tip,triangular,tub,tube,ud,unit,wide,woody,x,ympodial,young	arrangement,colour,form,height,history,inflorescence,life,na,number,papillose,peduncle,perennial,plant,position,rachi,reproduction,seed,shape,spacing,staman,texture,width
527	wfo-0001029680	success	212	99	75	137	24	0.354	0.1,0.6–1.2,1.0–1.5,1.7–7,11–16,11–25,3.0–4.2,4.5–20,4.5–7.0,4–10,50,5–11,8–32,abaxially,adaxially,annual,anther,anthesi,apart,apex,articulated,axillary,base,bipinnate,blue,branched,brown,clavate,cm,densely,diameter,filament,flattened,fleshy,flower,fruit,glabrous,globose,green,herb,leaf,length,light,mm,moderately,obovate,pale,pedicel,peduncle,pentagonal,petiole,pinnate,pitted,pubescent,purple,rarely,red,ripe,rotate,shallowly,shoot,sometimes,sparsely,stigma,style,subglabrous,surface,terminal,tripinnate,turning,violet,white,x,yellow,–12.5	.0,0.4,0.5–1.5,0.6,0.6–2.0,0.9–1.0,1,1.0,1.0–1.1,1.0–1.8,1.1–1.2,1.4–2.5,1.4–7.5,1.5,1.6–2.7,1.8–3.8,10,12,1–2,1–3,1–6,1–8,2.2–4.2,2–20,3.3–5.5,3–22,3–6,4.0–16,4.0–6.5,4–30,5,5.5–8.5,7–10,absen,acute,adaxiall,ag,along,appressed,arequipa,arranged,asymmetrically,axe,ba,becoming,beyond,blade,borne,calyx,cell,connivent,cylindrical,decreasing,decurrent,difoliate,divided,eaf,eed,entire,equal,erect,extending,flange,forming,geminat,hair,indistinct,irregularly,lobe,lon,long,longitudinal,lower,m.,margin,midrib,multicellular,narrow,nflorescence,node,oblong,obtuse,occasionally,often,opening,orolla,ovate,pair,parallel,pendant,perfect,pinnae,plurifoliate,pore,poricidal,primary,prostrate,rapidly,ruit,running,secondary,shaped,side,simple,size,spaced,specimen,split,stem,stone,straight,tacna,tal,tamen,tear-drop,tem,tertiary,time,tip,tube,unicellular,uniseriate,unit,usually,vary,wide,wing,winge,winged,woody,ympodial,–10,–19,–3,–3.2,–46,–48	abaxial,adaxial,arrangement,colour,corolla,form,growth,height,history,inflorescence,life,na,number,ovary,plant,position,rachi,reproduction,seed,shape,spacing,staman,texture,width
528	wfo-0001029685	success	288	85	66	222	19	0.229	.5,0.5-1.5,1-2,1-4,1-5,1-7,1.3-1.5,10-20,2-3,3-7,3.5-4,5.5-7,acute,anther,apex,armed,berry,branched,bright,brown,cell,clavate,cm,corolla,densely,diameter,drying,erect,filament,flattened-reniform,flower,fruit,globose,leaf,length,lobed,maturity,mauve,mm,orange,orange-brown,outline,ovate,ovoid,pedicel,peduncle,petiole,pit,rachi,raised,rarely,red-brown,shiny,shrub,simple,small,smooth,stellate,stellate-pubescent,stigma,style,surface,thin,unbranched,yellow,yellow-green	.2,.4,.8,/3,0-15,0.1,0.1-0.2,0.1-0.3,0.2,0.2-0.8,0.5,0.5-1,0.7-1.5,0.7-1.8,1-1.3,1.5,1.5-5,1.5-6,1/2-2/3,1/3,1/3-2/3,1/3-4/5,1/6-1/3,10,2-6,2.1-3,2.5-3,2.5-3.7,20,3,3-20,3-5,3-6,3.5,3.5-16,3/4-1/2,30-60°,4,4-10,4-7,4-9,4.5-6,5,5-11,5-20,5-merou,6-8,6.5-9,abaxially,accrescent,adaxially,age,almost,alyx,apar,apart,apically,apparently,articulated,axe,bark,base,beyond,black,blade,breaking,brittle,broad-deltate,calyx,chartaceous,clearly,clump,covering,cuneate,cupular,curved,dark,deep,deltate,dense,development,difoliate,discolorous,distance,divided,dorsal,downward,eaf,eed,elongating,equal,exserted,extending,faint,filiform,finely,finger-hair,flat,flattened,free,fruiting,geminat,glabrescent,glabrous,grey-brow,growing,inflated,infructescence,irregula,irregular,lateral,lengthening,less,lobe,long,long-acuminate,long-deltate,longer,longitudinal,lower,margin,mature,midpoint,midvein,minute,mixture,moderately,much,nflorescence,obconical,oblique,obovate,often,older,one,open,opening,orange-translucent,orolla,oung,ovoi,pair,papillae,papillo,partly,patch,per,perfect,pericarp,persisting,point,pore,poricidal,porrect,portion,prickle,primary,pronounced,pubescent,ray,reduced,reflexed,regular,rest,ri,ridged,robust,rounded,ruit,scar,secondary,sessile,side,sinus,slender,slightly,slit,sometimes,somewhat,spaced,sparsely,specimen,spherical,spreading,stalk,stalked,stem,stout,straight,strongly,stump,tamen,tapering,terete,terminal,tertiary,thick,throughout,time,tip,toward,translucent,trichome,truncate,tube,ud,unarmed,unit,upper,usually,variously,vary,vein,venation,visible,well-developed,wide,widest,woody,x1.5-2,ympodial,×	5-merous,abaxial,adaxial,arrangement,colour,form,growth,height,inflorescence,number,ovary,papillose,plant,reproduction,seed,shape,spacing,staman,texture
529	wfo-0001029691	success	223	78	60	163	18	0.269	0.2-0.4,0.4-0.5,1-5,1.2-1.7,1.7-2.7,11-14,2-3,2.5-8,3-4,6-10,6.5-8.5,8-14,adaxially,andromonoecious,anther,articulated,base,broadly,chartaceous,cm,densely,diameter,filament,flower,fruit,glabrous,globose,green,herbaceous,inflorescence,length,lilac,minutely,mm,orbicular,ovate,pale,pedicel,peduncle,petiole,plant,prostrate,rachi,resprouter,reticulate,rotate,shape,sparsely,sprawling,stellate,stellate-pubescent,stigma,style,surface,thick,unbranched,weakly,white,yellow,yellowish-green	%,-8,0-0.1,0-6,0.25-0.45,0.3-0.45,0.3-0.7,0.3-1.4,0.5-0.7,0.5-0.8,0.5-1,0.8-1.2,0.8-1.6,0.8-2.5,1-1.1,1-2,1-6,1-locular,1.1-2.1,1.4-2,1.5-4,1.6-2.1,10,100-400,13-18,13-20,13-25,140-320,18-23,2.5-4,3-6,3-7,3.3-3.5,36-50,4-8,40-250,5-,5-8,5-merou,5.5-9,6-8,6.5-10,abaxially,absen,absent,abundant,accrescent,acicular,across,acute,adaxiall,adult,alyx,apart,apex,armed,attenuate,axe,ba,blade,branche,brown,bursting,calyx,cone,connivent,cross-section,cuneate,curved,cylindrical,decimetre,directed,distall,eaf,eed,eglandular,elliptica,entire,equalling,exocarp,extra-axillary,finger,fruiting,functional,gland-tipped,hair,half,heterostylous,included,incomplete,index,interpetalar,juicy,lamina,lanceolate,lateral,less,lobe,lobed,lobing,lon,long,longer,lower,margin,mature,maturity,mesocarp,mid-point,midpoint,midvein,minute,moderately,moist,nflorescence,oblique,obtuse,orolla,part,per,petal,placenta,pore,porrect,presen,present,prickle,ray,readily,rounded,ruit,septum,sessile,shallowly,short,side,simple,slightly,spaced,stage,stalk,stellae,straight,summit,tal,tamen,tem,throughout,time,tip,tissue,toward,transparent,truncat,tube,unit,unknow,uvenile,vary,vein,wide,x,ympodial	abaxial,adaxial,colour,corolla,elliptical,form,growth,height,history,leaf,life,number,ovary,reproduction,seed,staman,texture,truncate
530	wfo-0001029704	success	146	81	55	91	26	0.377	0-1.5,1,1.5-2.5,1.5-3,3-5,4,7-10,acuminate,acute,anther,apex,blue,branch,broadly,brown,cm,composed,conical,corolla,dark,ellipsoid,extra-axillary,few-flowered,filament,flower,fork,glabrous,globose,green,leaf,less,minutely,mm,mottled,obovate,ovary,pedicel,peduncle,petiole,pinnatisect,pubescent,purple,reddish,reticulate,shrub,simple,single,stellate,stigma,striped,style,subdiscoidal,surface,variable,white	-17,-3,.5,0.5,1-2,1-4,1.5,10-14,1000-1200,140-185,15-25,2-2.5,2-3,2-5,3-4-celled,4-7,5,7-,9-20,acuman,along,also,anthesi,apparently,aspect,axi,base,berry,c.,calyx,cell,cunate,cuneate,cut,deeply,deflexed,dia,diam,eaf,eed,enlarged,erect,especially,exerted,flowering,fruiting,gradually,halfway,lanceolate,lengthening,lobe,lobed,long,lower,midrib,minute,moderately,nflorescence,obovoid,occasionally,one,plurifoliat,pore,poricidal,record,rounded,ruit,shoot,short,sinus,slit,sombre,sprawling,stone,stout,straight,subglobo,swollen,tip,trichome,tub,tube,twig,ud,unit,variously,vein,within,x,ympodial,young	abaxial,adaxial,arrangement,colour,diameter,form,fruit,growth,height,history,inflorescence,length,life,na,number,perennial,plant,position,reproduction,seed,shape,spacing,staman,subglobose,texture,width
531	wfo-0001029727	success	260	70	57	203	13	0.219	-3,/3,0-2,0-4,0.4-1,1-1.2,1-4,1.6-3,2-5,2.5-5.5,4.5-,5.5-7,abaxial,abaxially,adaxial,anther,apart,apparently,berry,chartaceous,clavate,climber,cm,corolla,cupular,densely,diameter,erect,finely,flattened-reniform,flower,leaf,length,lobed,margin,mauve,mm,moderately,obconical,oblong,orange-brown,ovate,pedicel,peduncle,perfect,petiole,pitted,scandent,seed,shallowly,shape,shrub,stellate-pubescent,stigma,style,subentire,surface	-1/3,-10,.5,0-15,0-20,0-30,0-40,0-5,0-8,0.1-5,0.15-0.2,0.15-0.3,0.2,0.2-0.5,0.2-2.5,0.3,0.4,0.5,0.5-1.2,0.5-3,0.7-0.9,0.7-1,1,1-,1-2,1.2-2,1.5-2.3,1.5-2.5,1.5-3,1.5-5.5,1/2-2/3,1/3-1/2,1/4,1/8-1/5,2.5,2.5-3.2,2.8-4,3-11,3-6,3-7,3/,4-7,4-merou,4-merous,4.5,5-12,5-8,5-9,6-11,7-10,acicular,acuminate,acute,age,almost,along,alternate,alyx,ame,anthesi,apar,apex,apically,articulated,bark,base,blade,branched,bristle,brown,c.,calyx,colourles,connivent,cordate,covered,curved,darker,deltate,deltoid,developing,different,dimorphic,discolorous,divided,drying,eaf,edge,eed,elongating,equal,except,extending,ferrugineous,filament,filiform,filiform-acuminat,fissure,free,geminate,glabrous,increasing,inside,lateral,lengthening,less,like,lobe,lon,long,longer,lower,m.,mature,middle,midpoint,midvein,minor,minutely,mixture,narrow-deltate,nflorescence,nther,occasional,older,one,open,orolla,oung,outside,pair,papillo,papillose,per,perfec,pit,plurifoliat,pore,poricidal,porrect,portion,prickl,prickle,prickly,primary,protruding,pubescent,raised,rarely,ray,red-brow,red-brown,reddish,reduced,regular,rounded,scar,series,sessile,short,simple,sinus,size,smooth,sometimes,spaced,spreading,stalk,stalked,stellate,stem,straight,strongly,tamen,tapering,tearing,terete,terminal,tertiary,time,tip,toward,translucent,transverse,trichome,tube,unarmed,uneven,unit,upper,variable,variously,vary,vein,venation,violet,visible,way,wide,x,yellowish,ympodial,young	colour,form,fruit,growth,height,inflorescence,na,number,ovary,plant,reproduction,spacing,texture
532	wfo-0001029728	success	238	93	58	180	35	0.244	0.5-1.5,abaxially,abundantly,acute,anther,anthesi,apex,broadly,brownish,bud,cm,cylindrical,diameter,early,extra-axillary,filament,flattened-reniform,flower,fruit,glabrous,glandular-pilose,globose,golden,green,late,leaf,length,light,mature,maturity,minutely,mm,narrowly,nearly,ovate,pedicel,peduncle,petiole,pilose,pitted,pubescent,rachi,shrub,simple,stellate,stigma,style,suborbicular,surface,tan,terete,thin-textured,triangular,unbranched,white,x,yellow,yellowish	.6,0.2,0.3,0.3–0.4,0.4–2,0.5–0.9,0.6–1.5,0.7–1.2,0.8,0.8–1.6,0.8–2.5,0–0.5,1.2–2.3,1.5–2,1.6,1.7–2.5,1/3,11,12–20,1–,1–2,1–2-celled,2,2-foliate,2.4–3.6,2.7-3.1,2.8,200-310,260,2–3,2–4,2–4-celled,3,3.4–4.5,3.5–5.5,3–18,3–5,4,4.5-5.5,4–10,4–14cm,4–15,4–6-rayed,5,6.2–8.1,7,7-10,7–12,7–14,7–15,8–10.5,9,=,absent,accrescent,acicular,adaxiall,adaxially,admixture,armed,around,ascending,auxiliary,axe,base,becoming,blade,branche,calyx,capitat,cell,column,compressed,contiguou,curled,curved,densely,differing,dimorphic,directed,distall,eaf,eed,enlarged,erect,exceeding,fallen,fertile,fewer,free,frui,fruiting,geminate,generally,glabrou,gland-tipped,glandular,grading,hair,half,horizontally,hyaline,intermixed,lanceolate,larger,least,lobe,lobed,long,longer,lower,lowermost,main,major,many,margin,midpoint,minute,mixed,much,n,nflorescence,numerous,obtuse,often,one,orolla,pair,per,plane,pore,prickle,pubescence,ray,recurved,reflexed,relatively,ruit,scarcely,scattered,sessile,shallowly,short-pilose,shorter,similar,similarly,single-stemmed,size,slender,slightly,small,smaller,sparsely,spine,spreading,stellae,stem,stout,straight,subcordate,tall,tamen,tem,terminal,tip,triangular-lanceolate,truncate,tube,undulate,unit,usually,various,vary,vein,wid,wide,withered,ympodial,–4,–5	0-0.5,0.3-0.4,0.6-1.5,1.2-2.3,1.7-2.5,12-20,2-4,4-10,6.2-8.1,7-12,abaxial,adaxial,arrangement,capitate,colour,contiguous,corolla,form,growth,height,history,inflorescence,life,na,number,ovary,perennial,plant,position,reproduction,seed,shape,spacing,staman,texture
533	wfo-0001029731	success	246	76	55	191	21	0.224	.5,0.1-0.8,1-2.5,1.5-2.5,2-6,4,4-9,7-11,8-9,acquiring,almost,along,anther,apex,apically,base,black,branch,clavate,cm,conical,corolla,diameter,dilated,distributed,elliptic,epiphyte,evenly,filament,flower,fruit,glabrous,lateral,leaf,liana,linear,lobed,long-ellipsoid,mauve,mm,obovate,pedicel,peduncle,petiole,pyriform,rachi,slender,stigma,style,surface,terminal,thick,white,woody,yellow-green	.6,0.05,0.25-0.3,1,1-1.5,1-2,1.5,1.5-3,1/3,10-20,1994,2,2-3,2.5,2.5-4.5,3,3-10,3-4,31,4-5,6,6-7,abaxially,accrescent,acuminate,acute,adaxially,age,alyx,anthesi,apar,apparently,arcy,articulated,bark,basal,basally,beak,becoming,berry,boundary,branched,branching,broadly,brown,bumpy,calyx,clearly,concolorous,connate,coriaceous,crinkled,cuneate,darker,delimited,delineated,deltoid,dense,development,different,domatia,dorsal,dorsifixed,dry,drying,dull,eaf,early,elongating,enlarge,entire,equal,erect,even,exserted,faint,filiform,fine,finely,flaring,flattened,fleshy,free,fruiting,ground,hair,iscoid,lamina,large,later,lengthening,less,like,lobe,lon,long,longitudinal,longitudinally,lower,main,margin,mature,maturity,midvein,much,narrowly,nflorescence,nther,obconical,oblong,obtuse,occasionally,often,orange-brown,orolla,pair,papillae,papillose,part,pendulous,perfec,pericarp,persisting,plurifoliat,pore,poricidal,portion,primary,prominent,protruding,raised,rakotozafy,rarely,reflexed,reported,revolute,ribbed,ridge,ridged,rounded,ruit,scar,see,several,shallowly,shorter,simple,sinus,slightly,small,smaller,smoot,sometimes,sparsely,stem,straight,stretched,stump,succulent,sunk,tearing,thickened,thinner,though,time,tip,toward,trichome,tub,tube,tuft,ud,unit,usually,vary,vein,venation,ventral,visibl,visible,well-developed,wide,widely,wing,winged,wrinkling,x,yellow,ympodial,young,’	abaxial,adaxial,arrangement,colour,form,growth,height,inflorescence,length,na,number,ovary,plant,position,reproduction,seed,shape,spacing,staman,texture,width
534	wfo-0001029741	success	137	78	50	87	28	0.365	.5,1-1.5,1-3.5,1.1-1.3,1.5-4,1.5-6,?,anther,apex,base,calyx,capitate,closely,cm,corolla,difoliate,elliptic,filament,flower,fruit,furcate,glabrous,globose,green,growth,inflorescence,leaf,lobed,minutely,mm,nearly,opposite,ovary,ovate,overlapping,papillose,pedicel,petiole,shrub,slender,spaced,stigma,style,tapering,tree,tube,unit,weak,white,x	.4,0.5-1.5,0.8-3.5,0.9-1.2,1.5,10-50-flowered,2-2.5,2.2-9,2.5-7.8,3,9.5-22.5,accrescent,acute,age,anthesi,apiculate,attenuate,becoming,berry,black,branched,ca,caly,completely,dark,deflexed,deltoid,dia,differing,divisio,dry,drying,eaf,early,edicel,eed,erect,exserted,free,fruiting,geminat,glabrou,immature,known,lateral,lenticellate,lighter,lobe,lon,long,lower,main,major,middle,minor,new,nflorescence,pair,papillo,planar,pore,poricidal,portion,produced,prominent,proximal,quite,raised,reddish-brown,ruit,scar,shaped,size,slightly,stem,straight,tall,tear-drop,tip,ud,usually,variable,vein,widest,wood,woody,ympodial	1.4,10-50,abaxial,adaxial,arrangement,colour,diameter,form,geminate,height,history,length,life,na,number,peduncle,plant,position,rachi,reproduction,seed,shape,spacing,staman,surface,sympodial,texture,width
535	wfo-0001029744	success	113	92	52	61	40	0.46	0.3-0.6,0.5-1,2-4,5-8,50,abaxially,adaxially,apart,apex,bark,branch,calyx,cm,deltate,dendritic,densely,elliptic,entire,flattened,flexuous,form,fruit,glabrous,golden,lanceolate,leaf,margin,minutely,mm,narrowly,oblanceolate,opposite,ovoid-reniform,pale,pedicel,petiole,pitted,pubescent,revolute,scar,shape,shrub,simple,single-celled,slightly,stem,surface,thin,trichome,unifoliate,uniseriate,white	1,1.5,1.5-3.2,2,7-15,8-10-flowered,8-11,acute,along,base,beginning,blunt,brow,denser,difoliate,distinct,eaf,eed,examined,extreme,fide,geminate,glabrescent,incrassate,inflorescenc,lamina,leave,lobe,long-acuminate,looping,lower,major,marginal,mature,minor,nflorescence,node,non-reproductive,oblique,occasionally,older,pair,primary,pubescence,see,similar,small,smaller,smith,sometimes,somewhat,spaced,thee,tip,ud,unicellular,unit,vein,x,ympodial,young	3,8-10,abaxial,adaxial,anther,arrangement,brown,bud,cell,center,colour,corolla,diameter,filament,flower,fruiting,growth,height,history,inflorescence,length,life,na,new,number,ovary,peduncle,perennial,plant,position,prickle,rachi,reproduction,seed,spacing,staman,stigma,style,texture,width
536	wfo-0001029746	success	179	96	74	105	22	0.413	0.3-2,0.7-1,1,1-1.3,1-1.5,2-8,3-4,3-6,8-11,acuminate,acute,anther,apart,apex,berry,blackish,brown,capitate,centre,cm,conical,corolla,dark,darker,densely,diameter,erect,filament,flattened,flower,fruit,glandular,globose,greenish,herb,inflorescence,internodal,leaf,lobe,margin,minutely,mm,nodding,orange,ovary,ovate,ovoid,pale,papillose,pedicel,peduncle,petiole,pitted,principal,pubescent,purple,rachi,red,reddish,reflexed,shallowly,simple,slender,slightly,somewhat,stigma,style,subshrub,surface,thin,tip,triangular,vein,x	.5,0.5-1,1.2-1.5,1.5,2,2-2.5,2-4,2-7,3,3-4-pluri-foliate,3-4.5,4-9,6,6-7,8-10,abaxially,adaxially,age,anthesi,base,bearing,becoming,broadly,c.,calyx,cell,ciliate,color,cordate,crenate,crowded,cup-shaped,curved,eaf,edicel,eed,ellipsoid,elliptic,enlarged,entire,exerted,fleshy,flush,free,fruiting,glabrous,gland-tipped,growing,heteromorphic,hollow,horn,irregularly,lamina,lengthening,less,lon,long,longer,longest,lower,markedly,mature,maturit,mid-length,mixed,narrowly,near,nflorescence,occasionally,pair,papillo,pericarp,plan,pore,poricidal,portion,primary,pubescen,ruit,scar,shortest,single,slit,spaced,sparse,sparsely,spreading,stem,straight,strongly,testal,third,trichome,tube,ud,uniseriate,unit,upper,upward,wall,widely,widest,woody,ympodial,–3	1.5-3,abaxial,adaxial,arrangement,colour,form,growth,height,history,length,life,na,number,plant,position,reproduction,seed,shape,spacing,staman,texture,width
537	wfo-0001029751	success	158	79	47	111	32	0.297	1.2,1.7,3,5-merous,acicular,anther,apex,capitate,clavate,cm,corolla,deltoid,diameter,enlarged,extra-axillary,fruit,geminate,glandular,globose,globose-ellipsoid,hair,leaf,length,membranaceous,mm,moderately,orbicular,outside,ovary,pedicel,peduncle,petiole,pubescent,scorpioid,shrub,simple,solitary,sometimes,sparsely,stellate,stigma,style,surface,toward,trichome,white,yellow	.5,0.6–1.6,1,1.3–2.6,1.8–4,10–11,10–19,12–14,1–2,1–3,2,2.2–2.5,2.5–5,2–3,2–4-celled,2–5,3–9,4,4.5–6,5–10,5–25-flowered,6,8–9,9–18,also,apical,armed,attenuate,base,blade,broad-based,broadly,calyx,celled,central,compressed,covered,cuneate,di-,diam,eaf,eed,eglandular,elongate,equal,geminat,glabrous,gree,immature,inner,lanceolate,lateral,linear,linear-lanceolate,little,lobe,lon,long,longer,lower,midpoint,midvein,needlelike,nflorescence,one,opening,pair,pedunculate,perfect,planar,pore,prickle,prickly,ray,recurved,ripe,ruit,sessile,shallow,short,short-stalked,shorter,size,small,smaller,somewhat,spreading,stalked,straight,subcordate,subtended,tal,tem,tooth,triangular,trifoliate,truncate,twice,unarmed,unbranched,unequal,unit,upper,usually,variegated,whitish,wide,winged,ympodial,±,×	1.8-4,10-11,2.2-2.5,3-25,3-9,8-9,abaxial,adaxial,arrangement,colour,filament,flower,form,green,growth,height,history,inflorescence,life,na,number,perennial,plant,position,rachi,reproduction,seed,shape,spacing,staman,texture,width
538	wfo-0001029758	success	261	115	100	161	15	0.383	.2,.5,0.2,0.5–0.7,0.6–0.9,0.9–1.0,0.9–1.5,1.0–3.4,1.1–1.8,1.2–1.4,1.2–1.9,1.3–1.7,1.7–2.8,10.3–14.5,2.8–4.2,5.8,7.6,7–17,7–9,acuminate,adnate,anther,apex,arcuate,attachment,attenuate,base,black,bud,calyx,capitate,chartaceous,cm,cordate,corolla,cream,curved,dark,deltoid,densely,diameter,dry,entire,erect,evenly,extra-axillary,flattened-orbicular,flattened-reniform,flower,fruit,glabrous,globose,green,internode,lateral,length,lobe,lobed,long,margin,markedly,mature,midpoint,mm,notched,obtuse,occasionally,orbicular,oval,ovate,pedicel,peduncle,petiole,point,porrect,prostrate,pubescent,purple,ray,red-brown,reticulate,rounded,shrub,simple,stellae,stellate,stellate-pubescent,stem,stigma,stipe,style,sub-coriaceous,surface,tip,tube,unarmed,white,yellow,yellow-brown,×	.3,/4,0.4–1.2,0.7–0.8,0.7–1.3,0.8–1.1,0.8–1.3,0.9–1.2,1.1–1.5,1.8,1.9–2.6,1.9–2.7,1/3,1/4–1/3,2.1–6.2,2.2–2.9,2.3–3.3,2.3–6.4,2.8–2.9,3.1–3.8,3.2–3.5,3.5–4.8,3.6,4.1–6.3,4.3–4.8,4.3–6.2,4–6,5-merou,5.7–7.8,8.0–33.1,8–11,abaxially,absent,adaxially,aequilateral,ag,alyx,anthesi,apart,apical,apparently,appearing,appresse,arching,around,articulate,axe,ba,basal,bent,berry,blade,broad,brochidodromous,bulge,channeled,cylindrical,dentate,development,directed,directly,distal,distally,distinct,eaf,edge,eed,either,emerging,endocarp,equal,exocarp,extending,fertile,filament,filiform,flexed,free,geminat,glossy,gradually,gree,heterostylous,immature,increasing,intact,interpetalar,intersepalar,juic,lanceolate,layer,least,lon,longer,lower,many,midrib,midvein,minute,moderately,nearly,nflorescence,observed,often,opaque,orolla,ove,per,perforated,persistent,petalar,pore,portion,potentially,presumably,raised,remaining,ridge,rigid,row,ruit,short,short-stipitate,shorter,side,sinus,sloughing,spaced,splitting,spread,spreading,stamen,stipitate,straight,suture,tamen,tem,tetrafoliate,thin,though,tissue,toward,transparent,trifoliate,two,ud,unbranched,unit,various,vary,vein,weakly,well,well-developed,wide,yellow-ferruginous,ympodial,young,±90°,±a,¼	5-merous,adhesion,arrangement,color,form,growth,inflorescence,leaf,number,ovary,seed,shape,size,staman,texture
539	wfo-0001029769	success	142	75	45	97	30	0.317	.5,1-3,1.5-2.5,4-5,5-8,6-17,7-8,anther,apex,base,brown,capitate,cm,corolla,dark,densely,elliptic,filament,filiform,flower,glabrous,globose,green,internodal,leaf,lobed,minutely,mm,nearly,opposite,ovary,ovoid-reniform,papillose,pedicel,petiole,pitted,pubescent,shrub,simple,smooth,sparsely,stigma,style,surface,white	.25,0.5-1.5,1-1.2,1.5-2,2.5-3,2.5-8,3.5-4,30-60-flowered,4,8-9,8.5-17,abaxially,acuminate,acute,adaxially,along,anthesi,apar,ape,archin,ba,bark,bearing,berry,branch,brochidodromu,calyx,cerro,conical,curl-tipped,cyathiform,deflexed,deltoid,dia,eaf,edicel,eed,exserted,free,fresh,fruiting,golden,hen,horizontally,inglé,lateral,less,like,lobe,lon,long,lower,main,margin,midrib,nflorescence,older,onto,pair,papillo,pore,poricidal,portion,puberulent,reflexed,ried,ruit,scar,scattered,shaped,somewhat,spaced,stem,straight,swollen,tall,tear-drop,three,time,tip,trichome,tub,tube,two,ud,unevenly,unifoliat,uniseriate,unit,vein,wide,widely,winged,woody,x,ympodial,young	30-60,abaxial,adaxial,apart,arrangement,colour,diameter,form,fruit,growth,height,history,inflorescence,length,life,na,number,peduncle,perennial,plant,position,rachi,reproduction,seed,shape,spacing,staman,texture,unifoliate,width
540	wfo-0001029771	success	196	82	62	134	20	0.316	.5,0-0.5,0.3-0.6,0.4-1.4,1-1.5,1-2,2-3,3-4,4-7,5.5-8,absent,anther,chartaceous,cm,contiguous,densely,diameter,entire,erect,extra-axillary,filament,fruit,glabrous,gland-tipped,globose,green,grey-green,hair,inflorescence,leaf,length,lilac,margin,mm,nearly,ovate,pale,pedicel,peduncle,perennial,perfect,petiole,pseudo-umbellate,purple,rachi,red,reniform,reticulate,rhizomatous,rotate,rotate-stellate,scattered,short,shrub,stellate-pubescent,stigma,style,surface,unbranched,x,yellow,yellowish	%,0-0.25,0-0.6,0-3,0-4,0-5,0.05-0.15,0.1-0.3,0.2-0.25,0.2-0.4,0.3-1,0.4-0.7,0.4-1,0.45-0.9,0.5-0.7,0.5-1.2,0.7-1.2,0.7-1.8,0.8-1.2,0.9-1,1,1-5,1-locular,1.2-2.8,1.8-3,15-35,2,2-2.3,2-3-foliate,2.5-10,2.5-7,4-,4.5-12,5-10,5-9,5-merou,6-11,7-10,7-8,abaxially,absen,accrescent,across,acute,adaxially,adult,alyx,apart,apex,apparen,articulated,axe,ba,base,blade,branch,calyx,capitat,connivent,cordate,curved,cylindrical,deltate,directed,distall,distributed,dm,eaf,eed,eglandular,elliptic,exceeding,exocarp,finger,flower,fruiting,geminate,grey,incomplete,interpetalar,juicy,juvenile,lamina,lanceolate,lateral,lobe,lon,long,lower,mature,mesocarp,mid-point,midpoint,minute,nflorescence,oblique,obtuse,orolla,part,per,placenta,pore,porrect,present,prickle,pubescent,ray,ruit,septum,simple,slightly,somewhat,spaced,stalk,stellae,straight,succulent,tal,tamen,tem,thick,throughout,time,tissu,tissue,tube,unarme,unarmed,unit,upper,vary,white,wide,ympodial	abaxial,adaxial,capitate,colour,corolla,form,growth,height,history,life,na,ovary,plant,position,reproduction,seed,shape,spacing,staman,texture
541	wfo-0001029775	success	54	51	33	21	18	0.611	0.25-1.5,0.5-4,2-6,2-8,3-4,4-5.5,6-16,alveolate,brown,cm,diameter,flattened,glabrous,globose,internode,light,margin,mm,orange,perennial,prickle,puberulent,sparsely,straight,strongly,subshrub,surface,thickened,trichome,unbranched,unifoliate,vine,yellow	absen,aggregate,base,ecuador,eed,hollow,long,recurve,ripe,robust,ruit,shin,stigma,tal,tem,tone-cell,truncat,unit,wide,x,ympodial	arrangement,color,form,fruit,growth,height,history,leaf,length,life,plant,recurved,seed,shape,stem,texture,thicknes,width
542	wfo-0001029780	success	204	79	54	150	25	0.265	1-10,1-2,15-22,15-45,2-2.8,2-3.5,2-5.5,3.5-7.3,4-6,5-7,8-12,abaxially,adaxially,anther,apex,articulated,cm,cordate,corolla,dark,densely,diameter,filament,flower,forked,fruit,glabrous,globose,green,greenish,herb,length,minutely,mm,mucilaginous,odd-pinnate,ovate,ovoid,pedicel,peduncle,petiole,plant,puberulent,pubescent,rotate,seed,stigma,streak,stripe,style,terminal,white,whitish,yellow	1-1.2,1.4-1.9,1.5-2,11-24,120-210,2-12,2-2.5,2.4-4.2,20-60,3,3-6,4.5-6,5-merou,5.5,5.5-13,50-70,600-950,?,absent,acumen,acute,ag,along,alyx,apart,apparently,attenuate,axe,axillary,base,berry,blade,borne,brownish,bud,capitat,cell,chartaceous,ciliate,condition,connivent,covering,cuneate,decumbent,digestion,distal,dorsally,drying,eaf,edge,eed,end,enzyme,erec,especially,exceeding,except,flat,folded,fresh,geminat,generally,glabrou,gland,glandular,greatly,green-white,hair,hair-like,hal,half,head,high,homostylous,honeycomb-shaped,interjected,invested,lanceolate,lateral,leaflet,lengthening,like,living,lobe,long,longer,lower,make,margin,membranous,midrib,minute,nflorescence,non-glandular,obtuse,often,orbicular,orolla,pair,pale,perfect,petiolulate,petiolule,pinkish,plurifoliate,pore,poricidal,proximal,rarely,reduced,removed,ripe,ruit,sessile,seudostipule,short,singly,size,slit,spaced,specimen,stamen,ste,stem,stolo,straight,subequal,subtending,tall,tamen,tem,testal,tetralobulate,thick,throughout,tip,tri-,trichome,truncate,tube,tuber,typically,unit,unwinged,usually,vary,wall,wet,x,ympodial	abaxial,adaxial,arrangement,capitate,colour,form,growth,height,history,inflorescence,leaf,life,na,number,ovary,perennial,position,rachi,reproduction,shape,spacing,staman,surface,texture,width
543	wfo-0001029784	success	237	92	71	166	21	0.3	-12,.5,0.25-0.3,0.4-0.45,0.5-1.5,0.6-1,1-1.2,1-4,2,5-10,abaxial,acute,angled,anther,apex,articulated,brown,capitate,cm,corolla,dark,densely,diameter,distal,due,eglandular,elliptic,filament,flower,fruit,globose,golden,green,hair-like,half,herb,imparipinnate,inflorescence,interrupted,like,mm,narrowly,obovate,outgrowth,ovary,pale,paler,pedicel,peduncle,pentagonal,perennial,petiole,plant,pubescence,pubescent,simple,soft,somewhat,sparsely,stem,stigma,straight,stripe,style,surface,trailing,trichome,unseriate,velvety,white,yellow	-5,.1,.2,0-4,0.1-,0.1-0.15,0.1-0.5,0.2,0.2-,0.2-0.3,0.2-0.5,0.3-0.35,0.3-0.4,0.3-0.5,0.3-1,0.4-,0.4-0.5,0.4-0.6,0.5,0.5-,0.7-1.2,0.9-1.2,1,1-,1-1.1,1-1.5,1-2,1-2-celled,1.0-1.3,1.2-2.5,1.5-,1.7-2.6,1/3,2-,2-2.5,2-3-celled,2-4,2-4.5,2-foliate,2-locular,2.5-3.5,2/3,3-,3-5,5-14,5-8,abaxially,absent,abundant,acuminate,adaxially,adpressed,along,anthesi,apical,appearance,appendage,arising,articulation,axi,basal,base,basicopically,beneath,berry,bract,broadly,calyx,cell,column,conical,crenate-serrate,crenation,decurrent,deeper,developed,distributed,eaf,edicel,eed,enclosing,entire,evenly,exserted,fruiting,giving,glabrescent,glabrous,glandular,gree,hal,halfway,head,included,interjected,internode,interspersed,irregularly,lamina,lanceolate,larger,lateral,leaflet,live,lobe,lon,long,long-acuminate,loosely,lower,margin,markedly,maturing,mostly,multicellular,nflorescence,node,northern,occasionally,often,orbicular,pair,patent,petiolule,population,present,primary,proximal,pseudostipule,rarely,reflexed,ripe,robust,ruit,scattered,secondary,sessile,silky,smaller,sometimes,sparse,spreadin,staminal,sterile,stout,strongly,tem,terminal,tertiary,testa,thick,truncate,tube,ud,undulate,unicellular,uniseriate,unit,usually,vein,wall,wide,winged,woody,x,ympodial	2-14,adaxial,arrangement,colour,form,growth,height,history,leaf,length,life,na,number,position,rachi,reproduction,seed,shape,spacing,staman,texture
544	wfo-0001029785	success	223	109	85	138	24	0.381	0.1-0.5,1-10,1-2,1.2-3.2,1.5-3.6,1.8-3.5,10-26,3-8,3.5-5,5-9,8-11,abaxially,adaxially,along,anther,apart,axillary,broadly,brownish,bud,cell,chartaceous,clavate,cm,condition,corolla,covering,dark,denser,diameter,drying,elliptic,especially,filament,flower,forked,fresh,fruit,glabrous,globose,green,greenish,hair-like,herb,lateral,leaf,membranous,midrib,minutely,mm,obovate,odd-pinnate,ovate,ovoid,pale,pedicel,peduncle,pentagonal,petiole,plant,puberulent,pubescent,purple,purple-tinged,rarely,ripe,rotate,rounded,seed,slightly,sparsely,stem,stigma,stripe,style,subtending,terminal,testal,thick,vein,violet,wall,white,whitish,yellow	0-2,0-3,0.3-2.2,0.4-4.9,0.8-1,1-1.2,1-5,1.8-7,2-4,3-4,3-6,3.8-7.2,4-10.5,5-16,5-merou,6,absent,acumen,acute,ag,alyx,apex,apparently,articulation,attenuate,axe,base,berry,blade,borne,capitat,commonly,connivent,cordate,cuneate,darker,decreasing,decumbent,digestion,distal,dorsally,eaf,edge,eed,end,enzyme,erec,exceeding,flat,folded,geminat,generally,glabrou,greatly,green-white,hair,half,homostylous,honeycomb-shaped,interjected,invested,lanceolate,larger,leaflet,lengthening,like,living,lobe,long,lower,make,margin,markedly,medium,middle,minute,mottled,much,mucilaginous,multiple-celled,nflorescence,non-glandular,oblique,obtuse,one-quarte,orbicular,orolla,outer,pair,perfect,petiolulate,petiolule,plurifoliate,point,pore,poricidal,present,quite,removed,ruit,scale-like,sessile,seudostipule,shallowly,short,singly,size,slit,sometimes,spaced,specimen,stamen,ste,stolo,straight,subglabrous,tall,tamen,tem,throughout,tip,toward,tri-,truncate,tube,tuber,typically,unbranched,unequal,unit,unwinged,usually,variable,vary,wet,wide,x,ympodial	abaxial,adaxial,arrangement,capitate,colour,form,growth,height,history,inflorescence,length,life,na,number,ovary,perennial,position,rachi,reproduction,shape,spacing,staman,surface,texture
545	wfo-0001029788	success	194	76	50	144	26	0.258	1-10,1-2,1.2-2,12-15,2-2.5,2-4,25-30,3.5-6,4-5,6.5-7,abaxially,adaxially,anther,apex,berry,chartaceous,cm,conical,corolla,densely,diameter,filament,flower,forked,glabrous,green,greenish,herb,leaf,light,long,minutely,mm,odd-pinnate,ovoid,pedicel,peduncle,petiole,plant,puberulent,pubescent,rotate,seed,sparsely,stigma,style,terminal,violet,whitish,yellow	.4,.7,0-5,0.5,0.7-2,1.5-2,2.4-5.5,3-4,4,4-6,4.5-5,5,5-13,5-merou,6,7-21,absent,acumen,acuminate,ag,along,alyx,apart,articulated,asymmetrical,attenuate,axe,axillary,base,basiscopic,blade,borne,brownish,bud,c.,capitat,cell,ciliate,commonly,condition,connivent,covering,decreasing,digestion,distal,dorsally,drying,eaf,edge,eed,elliptic,elliptic-lanceolate,end,enzyme,equal,erec,especially,flat,folded,fresh,geminat,generally,glabrou,gradually,green-white,hair-like,hal,half,homostylous,honeycomb-shaped,increasing,interjected,lanceolate,larger,lateral,leaflet,lengthening,living,lobe,lon,lower,make,margin,middle,midrib,minute,mottled,mucilaginous,narrow,nflorescence,orbicular,orolla,pair,petiolule,pilo,plurifoliate,pore,poricidal,purple,ray,removed,ripe,ruit,secondary,semierect,sessile,seudostipule,side,singly,size,slightly,slit,spaced,specimen,stolo,straight,subequal,subsessile,subtending,symmetrical,tall,tamen,tem,testal,thick,throughout,tip,tissue,toward,tri-,tube,tuber,typically,unit,unwinged,usually,vary,wall,wet,white,wide,wing,x,ympodial	abaxial,adaxial,arrangement,capitate,colour,form,fruit,growth,height,history,inflorescence,length,life,na,number,ovary,perennial,position,rachi,reproduction,shape,spacing,staman,surface,texture,width
546	wfo-0001029789	success	167	80	57	110	23	0.341	0.2-0.5,1-10,1-3,2-25,2-6.5,2.7-4.7,3-8.5,4-13,5-7,7-21,8-9,abaxially,adaxially,anther,apex,attenuate,axillary,blue,broadly,bud,clavate,cm,corolla,diameter,filament,flower,forked,fruit,glabrous,green,herb,leaf,light,lilac,minutely,mm,narrowly,odd-pinnate,ovary,ovate,pedicel,peduncle,pentagonal,petiole,plant,pubescent,rachi,rotate,sparsely,sterile,stigma,style,subglabrous,subtending,terminal,white,yellow	0-2,0.5-2.8,0.8-3.5,1-2,1.5-2,1.7-8.5,1.8-6.5,12,2-3,2-6,3-5,4-10,5-merou,6,6-7,7-16.6,acumen,acuminate,acute,adaxiall,ag,alyx,apart,apparently,articulated,axe,base,basiscopic,blade,capitat,chartaceous,connivent,dark,decreasing,decurrent,distal,dorsally,eaf,edge,eed,erec,exceeding,flat,folded,formed,geminat,generally,greatly,hair,hal,half,homostylous,interjected,lanceolate,lant,lateral,leaflet,lengthening,like,linear,lobe,long,long-attenuate,lower,lunate,maturing,membranous,minute,mottled,never,nflorescence,orbicular,orolla,pair,perfect,petiolulate,plurifoliate,pore,poricidal,pubescen,purpl,rarely,sessile,seudostipule,short,side,simple,size,slightly,slit,spaced,stamen,star,ste,straight,subequal,tall,tamen,tem,tinged,tip,toward,tri-,tube,typically,unit,usually,vary,x,ympodial	abaxial,adaxial,arrangement,capitate,colour,form,growth,height,history,inflorescence,length,life,na,number,perennial,position,reproduction,seed,shape,spacing,staman,surface,texture
547	wfo-0001029810	success	149	102	73	76	29	0.49	.25,.5,0.5-3,1-1.3,1-10,1.1-2.3,1.5-3,3-3.5,5-6,acuminate,acute,adaxially,along,anther,apex,apically,arachnoid,base,calyx,capitate,closely,cm,corolla,dark,dendritic,densely,dia,drying,elliptic,filament,glabrous,globose,green,inflorescence,internodal,leaf,lobed,margin,minutely,mm,narrowly,nearly,occasionally,opposite,ovary,ovoid-reniform,pale,papillose,pedicel,petiole,pitted,pointed,pubescent,reddish-brown,shining,shrub,simple,slender,small,spaced,sparsely,stigma,style,surface,tan,tapering,tip,tree,trichome,tube,vein,white,yellowish	0.5-1,1-1.5,1-2,1-3,2-3,2-5,2.5-3,3-4,3-6,4-10,5-15-flowered,5-16,8-12,abaxially,anthesi,ape,attenuate,bark,berry,brown,compact,compressed,congested,conical,deflexed,deltate,differing,difoliate,eaf,edicel,eed,ellipsoid,exserted,fleshy,free,fruiting,geminat,glabrou,large,later,lateral,lenticel,less,like,lobe,lon,long,lower,main,major,middle,minor,nflorescence,older,overlappin,papillo,planar,pore,poricidal,portion,rest,ruit,scar,shaped,size,stem,tall,tear-drop,tub,ud,unit,wide,widest,woody,ympodial,young	5-15,abaxial,adaxial,arrangement,colour,diameter,flower,form,fruit,growth,height,history,length,life,na,number,overlapping,peduncle,perennial,plant,position,rachi,reproduction,seed,shape,spacing,staman,texture,width
548	wfo-0001029811	success	225	72	56	169	16	0.249	-3,0-35,0.3-1,0.5-2,1-3,1.3-1.7,1.5-6,3-5.5,3-7,4.5-5,7-9,8-12,abaxial,adaxial,andromonoecious,anther,apart,berry,cell,chartaceous,cm,dark,diameter,filament,flattened-reniform,flower,fruit,glabrous,herb,leaf,length,lobed,margin,mauve,mm,moderately,orange-brown,outline,ovate,pedicel,peduncle,petiole,pit,plant,raised,shrub,simple,small,smooth,spherical,stellate,stellate-pubescent,style,surface,unbranched,yellow	-6,-merous,.5,/3,0,0-30,0.1-0.3,0.1-0.4,0.2,0.2-0.6,0.3-1.5,0.8-1.5,1,1-1.5,1-2.5,1.5-2.5,1/,1/2-2/3,1/3,1/3-2/3,10-22,13-20,15-23,15-50,2-2.5,2-5,2-5.5,2.5-3,2.8-3.2,20-100,3-5,3.5-4.5,4-8,5,5-11,5-17,5-40,5-9,6-12,7-18,8-18,abaxially,acicular,alyx,apar,apex,apically,apparently,articulated,bark,base,blade,broad-deltate,brown,calyx,connivent,cordate,cream,cuneate,densely,discolorous,distal,distance,drying,eaf,eed,elongate,elongating,equal,erect,extending,eye,faint,fewer,flattened,free,fruiting,glandular,green,green-brow,hair,hermaphrodite,heterostylous,inflated,infructescence,lateral,less,lobe,lobing,long,long-acuminat,long-styled,longer,lower,lowermost,marking,mature,maturity,midpoint,midvein,minute,multangulate,naked,narrow-deltate,nflorescence,obtuse,often,older,one,open,orolla,oung,pair,pale,pendulous,per,pericarp,perpendicular,plurifoliat,poricidal,porrect,portion,prickl,prickle,prickly,primary,ray,ruit,scandent,scar,secondary,sessile,short,short-styled,shorter,side,slightly,sometimes,spaced,sparsely,spreading,stalk,stalked,staminat,stem,stout,straight,tamen,tapering,terete,tertiary,time,tip,trichome,tube,unarmed,unit,upper,usually,vary,vein,venation,visible,way,wide,woody,yellow-green,ympodial,young	colour,corolla,form,growth,height,inflorescence,na,number,ovary,reproduction,seed,shape,spacing,staman,stigma,texture
549	wfo-0001029938	success	179	92	69	110	23	0.385	0.7-1.2,1-1.5,1-4,1.5-2,10-20,2.5-3,3-7,3/4,6-8,abaxially,anther,apex,appearing,base,becoming,berry,black,bright,capitate,clavate,cm,corolla,dendritic,densely,diameter,elliptic,filament,flattened,flower,fruit,glabrous,globose,greenish,growth,later,lateral,leaf,length,lenticular,lobe,maturity,minutely,mm,narrowly,near,occasionally,ovary,pedicel,pericarp,petiole,pitted,plant,pubescent,pyramidal,red,reddish-brown,shrub,small,stigma,style,surface,tapering,terminal,thin,tree,trichome,violet,way,white	.5,0,0.5,0.7-1,1,1-2.5,1-3,1.2-1.5,1.5-2.5,1/2,12,12-15,2-2.5,4,5,6-9,8-10,absent,accrescent,acute,adaxially,along,anthesi,apical,ba,bark,basal,blade,branching,broader,calyx,conical,deciduous,deflexed,deltoid,denser,dichasia,discussion,drying,eaf,edicel,eed,elliptical,entire,ew,exserted,fine,free,fruiting,glabrate,glabrou,grey,growing,horizontal,inserted,larger,lon,long,long-triangular,lower,m.,margin,monochasial,nflorescence,older,overtopping,pair,papillo,parallel,per,perhaps,planar,plane,plurifoliate,pore,poricidal,portion,prominent,raised,ruit,scar,secondary,see,shade,shoot,sleeve,slit-like,somewhat,soon,sparsely,specimen,stamen,stem,strongly,tall,time,tip,tub,tube,ud,unit,upon,upper,vein,wide,winged,woody,x,ympodial,young	abaxial,adaxial,arrangement,colour,form,height,history,inflorescence,life,na,number,papillose,peduncle,perennial,position,rachi,reproduction,seed,shape,spacing,staman,texture,width
550	wfo-0001029945	success	211	75	57	154	18	0.27	0-0.6,1-1.3,1.3-3.5,1.5-4,10-17,15-24,2.1-3.3,4-5.5,4-9,9-10,abaxial,acute,adaxial,adaxially,andromonoecious,anther,apex,broadly,chartaceous,cm,cylindrical,dark,densely,diameter,erect,extra-axillary,filament,flower,fruit,glabrous,globose,green,inflorescence,leaf,length,mm,ovate,pale,pedicel,peduncle,perennial,petiole,plant,pseudo-racemose,purple,rhizomatous,rotate,shrub,stellate-pubescent,stigma,streak,style,surface,triangular,white,yellow,yellowish	%,.05,0,0-0.3,0-0.5,0-1,0-10,0-2,0.15-0.25,0.2-0.3,0.35-0.45,0.4-0.5,0.4-0.7,0.5,0.7-1.2,0.8-1,1-1.5,1-3,1-8,1.2-1.6,1.4-2.7,1.7-4,1.8-2.4,17-26,2-30,2-4,2-5,2-locular,2.5-2.8,3-17,3-5,3-6,3-9,4-10,4-7,5-8,5-merou,5.5-17,6-10,6-7,6-8,7-14,7-24,7-9,9-24,abaxially,absen,absent,accrescent,acicular,across,adaxiall,adult,alyx,anvil-shape,apart,armed,articulated,attenuate,ba,base,blade,broad-based,calyx,connivent,cordate,cross-section,d.,deeply,directed,distall,distally,dult,eaf,eed,eglandular,exocarp,finger,fruiting,functional,geminate,gland-tipped,grey,hair,half,heterostylous,hig,index,juicy,juvenile,lanceolate,lateral,less,lobe,lobed,lobing,lon,long,longer,lower,margin,markedly,mature,mesocarp,mid-point,midpoint,midvein,minute,mixed,moist,nflorescence,oblique,obtuse,orolla,pair,part,per,placenta,pore,porrect,present,prickle,ray,ruit,sessile,shallowly,short,side,simple,sparsely,stalk,stalked,stellae,stellate,stem,straight,tamen,thick,thicker,throughout,time,transparent,truncat,tube,unarmed,unbranched,unit,upper,vary,vein,weakly,wide,x,ympodial	colour,corolla,form,growth,height,history,life,na,number,ovary,position,reproduction,seed,shape,spacing,staman,texture,truncate
551	wfo-0001029968	success	299	125	103	196	22	0.344	0,0.25-0.3,0.3-1,0.4,0.7-2,0.8-1.2,1.5-2.5,2.5-3.5,4-8,6-8,abaxially,adaxially,almost,along,anther,apex,apically,armed,berry,black,branch,branched,brown,capitate,chartaceous,clavate,clustered,cm,corolla,dark,deltoid,densely,diameter,dilated,discolorous,distributed,drying,evenly,except,fasciculate,filament,finely,flattened,flattened-reniform,flower,fruit,glabrous,gray,grey-green,inflorescence,inside,large,large-leaved,lateral,leaf,length,like,long,mature,maturity,middle,midvein,mm,oblong,orange-brown,outside,ovate,pale,paler,pedicel,peduncle,per,petiole,pitted,pubescent,rachi,reddish,reduced,rounded,seed,shiny,shoot,shrub,small,small-leaved,smooth,sparsely,spheroidal,stellate,stellate-pubescent,stem,stigma,style,surface,terete,terminal,tip,translucent,trichome,unarmed,virtually,x,young	-2,-3,.2,.25,.5,.7,/3,0.1-0.25,0.15,0.2-0.4,0.25,0.3,0.3-0.4,0.4-0.6,0.5,0.7-0.9,0.7-1,0°,1,1-2.5,1-3,1.2-5.5,1.5,1.5-3,1/4-1/3,1/6-1/8,2-2.3,2-3,2.5-4,2.5-5.5,2.8-3,3-11,3-4,4,4-6,4-7,4-merou,7-9,absent,accrescent,acicular,acuminate,acute,adjacent,age,alternate,alyx,anthesi,apart,apparently,area,arising,articulated,articulation,bark,basally,base,becoming,brachyblast,branching,ca,calyx,canaliculate,central,cordate,covered,cuneate,cupular,curved,dehiscence,detaching,development,divided,dry,eaf,early,edge,eed,ellipsoi,elongating,entire,equal,erect,extending,filiform,flat,flexuous,forming,free,fruiting,glabrescent,greyish,increasing,indumentum,invisible,irregular,irregularly,leave,leaved,lengt,lengthening,less,line,lobe,lobed,lobing,looping,lower,m.,main,margin,midpoint,minor,mixture,network,nflorescence,nther,obconical,oblique,obscured,obscurely,occasionally,often,opposite,orange,orolla,ovoid,pair,papillose,patch,pendulous,perfect,pericarp,pit,plurifoliat,pore,poricidal,porrect,portion,present,prickle,primary,prior,prominent,protruding,raised,ray,red,regular,remnant,ridged,rounded-undulate,ruit,scar,secondary,seemingly,seen,sessile,shorter,simple,sinus,size,smoot,sometimes,somewhat,sparse,specimen,spreading,stalk,stalked,straight,strongly,stump,tapering,tearing,tertiary,thicker,thin,toward,tube,ud,unarme,undulate,uneven,unit,usually,variable,vary,vein,venation,visible,white,wide,widening,wrinkled,ympodial	2.2,4-merous,abaxial,adaxial,arrangement,colour,form,growth,height,history,life,na,number,ovary,plant,position,reproduction,shape,spacing,staman,texture,width
552	wfo-0001029978	success	208	89	64	144	25	0.308	0.5-0.6,1-10,1-2,1.5-3.1,11-19,15-27,3.2-2.5,3.7-8.1,4-7,4.2-5.2,8-10,abaxially,adaxially,anther,apex,cell,chartaceous,clavate,cm,coarsely,conical,corolla,covering,dark,diameter,elliptic,filament,finely,flower,forked,fruit,glabrous,green,greenish,hair-like,herb,lateral,leaf,light,medium,membranous,minutely,mm,odd-pinnate,ovate,ovoid,pedicel,peduncle,pentagonal,petiole,plant,puberulent,pubescent,purple,rotate,seed,stigma,style,terminal,testal,thick,wall,whitish,yellow	0.3-0.4,0.3-0.7,0.7-1.9,0.8,0.9-2.3,1.3-1.5,1.4-1.5,1.8-5,2-4,3-5,3-7,3.1-6.3,3.5-9.5,4-11,5,5-16.5,5-merou,acumen,acuminate,ag,along,alyx,apart,apparently,arranged,articulated,asymmetrical,attenuate,axe,axillary,base,basiscopic,bead,berry,blade,brownish,bud,capitat,ciliate,commonly,condition,connivent,darker,decreasing,digestion,distal,dorsally,drying,eaf,edge,eed,enzyme,erec,especially,exceeding,flat,folded,fourt,fresh,geminat,generally,glabrou,gradually,green-white,hair,half,homostylous,honeycomb-shaped,interjected,lanceolate,larger,leaflet,lengthening,less,like,living,lobe,long,lower,make,margin,middle,midrib,minute,moniliform,mottled,mucilaginous,multiple,narrow,necklace,nflorescence,orbicular,orolla,pair,perfect,petiolule,plurifoliate,pore,poricidal,pubescen,ray,removed,ripe,ruit,secondary,semierect,sessile,seudostipule,side,simple,size,slightly,slit,spaced,sparsely,specimen,stamen,ste,stem,stolon,straight,subequal,subsessile,subtending,symmetrical,tall,tamen,tem,throughout,tip,tissue,toward,tri-,tube,tuber,typically,unit,usually,vary,wet,wide,wing,x,ympodial	abaxial,adaxial,arrangement,capitate,colour,form,growth,height,history,inflorescence,length,life,na,number,ovary,perennial,position,rachi,reproduction,shape,spacing,staman,surface,texture,width
553	wfo-0001029980	success	173	89	61	112	28	0.353	.5,0.1-0.25,0.5-1.2,0.5-2.5,0.5-5,0.7-1.3,1.2-2.5,2-5,2/3,acute,anther,apex,base,bright,calyx,cm,corolla,curved,elliptic,filament,flattened-reniform,glabrous,globose,green,greenish-white,leaf,lobed,minutely,mm,one,opposite,ovary,ovate,pale,papillose,pedicel,petiole,pitted,plant,rounded,shape,shiny,shrub,side,simple,slender,slightly,small-capitate,stigma,straight,style,surface,tan,tapering,trichome,tube,tuft,uniseriate,way,white,winged	.1,0.25-0.5,0.25-1,0.5-1,0.8-1.2,0.9-4.5,1-1.5,1-1.7,1.5-2,1.5-6,2-6,3-4,3-9,5-10,5-50-flowered,6.4-17,abaxially,adaxially,anthesi,apar,appearing,appressed,axil,ba,bark,berry,black,brown,bud,closely,conical,dark,decurrent,deflexed,deltoid,density,dia,differing,difoliate,dried,drying,eaf,edicel,eed,elevation,especially,exserted,five,free,fruiting,geminat,gray,greatly,high,impressed,incrassate,knob,lateral,live,lobe,lon,long,lower,main,major,margin,material,middle,minor,near,nflorescence,node,often,older,onto,orbicular,overlapping,pair,paler,pore,poricidal,portion,prominent,proximal,puberulent,race,reflexed,ruit,scar,shaped,size,somewhat,soon,spaced,specimen,stem,tall,tear-drop,tip,ud,unicellular,unit,varying,vein,venezuelan,whit,widest,woody,x,yellowish,ympodial,young	5-50,abaxial,adaxial,apart,arrangement,colour,diameter,flower,form,fruit,growth,height,history,inflorescence,length,life,na,number,peduncle,perennial,position,rachi,reproduction,seed,spacing,staman,texture,width
554	wfo-0001029989	success	161	85	57	104	28	0.354	.2,0.5-1,0.5-1.5,1-1.5,1-2.5,3-5,3-8,abaxial,abaxially,acute,adaxially,anther,apex,base,capitate,closely,cm,corolla,densely,difoliate,elliptic,filament,flattened,glabrous,globose,green,greenish-black,incrassate,inflorescence,internodal,leaf,lenticular,lobed,margin,minutely,mm,nearly,nodding,opposite,ovary,pedicel,petiole,pitted,pubescent,reddish-brown,shining,shrub,simple,small,spaced,sparsely,stigma,style,surface,tree,unifoliate,white	.5,/2,0.25-0.5,1-2,1-4,1.3-2.3,1.5-2.5,10-14,2.5-3,3.5-8,4-4.5,5-10-flowered,5-6,7-20,anthesi,bark,berry,branch,branched,broadly,brownish-re,calyx,central,collection,congested,conical,deflexed,deltoid,dendritic,dense,described,dia,dimaeter,discussion,drying,due,eaf,edicel,eed,erect,exserted,fleshy,free,fruiting,geminat,golden,gray,heteromorphic,inflorescenc,lamina,lateral,like,lobe,lon,long,lower,main,middle,nflorescence,northern,occasionally,older,overlappin,pair,papillo,peru,peruvian,perú,petal,petaloid,planar,population,pore,poricidal,portion,probably,pubescence,reddish,rest,ruit,scar,scattered,see,shaped,short-style,somewhat,stem,tall,tear-drop,tip,tree-like,trichome,tube,ud,unit,vein,way,wide,widest,woody,x,yellow,ympodial,young	2.5-6,5-10,adaxial,arrangement,colour,diameter,flower,form,fruit,growth,height,history,length,life,na,number,overlapping,peduncle,plant,position,rachi,reproduction,seed,shape,spacing,staman,texture,width
555	wfo-0001030000	success	155	83	53	102	30	0.342	-4,0.5-1,0.5-14,0.5-3,1-10,1.5-,1.5-2,15-25,2-2.5,3-16,30-50,4-5,apart,apex,articulated,base,chartaceous,cm,coriaceous,densely,diameter,ellipsoidal,flattened,flower,fruit,glabrous,globose,green,immature,mature,mm,orange,pedicel,peduncle,pubescent,purplish,rachi,rarely,shrub,small,spotted,stellate,stigma,style,tinge,tree,truncate,unbranched,white,x,yellow,yellow-brown,yellowish	-5,-50,-7,-pilose,0.5-,1,1-,1-2,10-,10-20,2-3,2-4,2-5,2.5-,2.5-3,2.5-3.5,25-30,3-,3-4,3.5-5,4,4-4.5,4-foliat,7-15,abaxially,absent,acute,adaxially,aggregate,also,ape,apiculate,axe,biglandula,calyx,cell,ciliat,connective,connivent,conspicuous,creamy-whit,cucullate,deltate,dia,dilated,directed,distally,eed,eglandular,equal,exceeding,hair,laterally,leaving,lobe,lon,long,lower,margin,moderately,narrowly,nflorescence,nther,oblong,obtuse,occasionally,orolla,ovoid,pedicellar,perfect,pilose,pore,produced,puberulent,pubescen,radiu,remnant,ruit,scar,shorter,slightly,smal,spaced,sparsely,stamen,stone,strongly,subcoriaceous,swelling,tal,tem,thecae,tip,tomentose,triangular,tube,ud,umbrella-shaped,unit,vary,wide,ympodial	abaxial,adaxial,anther,arrangement,biglandular,colour,corolla,filament,form,growth,height,history,inflorescence,leaf,length,life,na,number,ovary,petiole,plant,position,reproduction,seed,shape,spacing,staman,surface,texture,width
556	wfo-0001030000	success	178	87	58	120	29	0.326	-4,0.5-13,0.5-14,0.5-3,1-10,1.5-,1.5-2,15-25,2-2.5,3-16,30-50,4-5,apart,apex,articulated,base,chartaceous,cm,coriaceous,densely,diameter,ellipsoidal,flattened,flower,fruit,glabrescent,glabrous,globose,green,immature,mature,mm,moderately,orange,ovate,pedicel,peduncle,petiole,puberulent,pubescent,purplish,rachi,rarely,shrub,simple,small,spotted,stellate,stigma,style,tinge,tree,truncate,unbranched,white,yellow,yellow-brown,yellowish	-2,-5,-50,-7,-pilose,0.5-,0.5-1,1,1-,1-1.5,1-2,1-5,10-,10-20,2-,2-3,2-4,2-5,2.5-,2.5-3,2.5-3.5,25-30,3-,3-4,3.5-5,4,4-25,4-4.5,4-foliat,5-25,7-15,abaxially,absent,acuminate,acute,adaxially,aggregate,also,ape,apiculate,axe,basal,biglandula,blade,calyx,cell,ciliat,connective,connivent,conspicuous,cordate,creamy-whit,cucullate,deltate,dia,dilated,directed,distally,eaf,eed,eglandular,elliptic,entire,equal,exceeding,hair,laterally,leaving,lobe,lon,long,lower,margin,narrowly,nflorescence,nther,oblique,oblong,obtuse,occasionally,often,orolla,ovoid,pedicellar,perfect,pilo,pilose,pore,produced,pubescen,radiu,remnant,ruit,scar,shorter,slightly,smal,spaced,sparsely,stamen,stone,strongly,subcoriaceous,swelling,tal,tem,thecae,time,tip,tomentose,triangular,tube,ud,umbrella-shaped,unit,vary,vein,wide,x,ympodial	abaxial,adaxial,anther,arrangement,biglandular,colour,corolla,filament,form,growth,height,history,inflorescence,leaf,length,life,na,number,ovary,plant,position,reproduction,seed,shape,spacing,staman,surface,texture,width
557	wfo-0001030004	success	177	93	66	111	27	0.373	0-0.5,0-1.5,0.2-1,1-2,1.2-2,2-20,3-4,5-25,abaxial,acuminate,acute,adaxially,anther,apex,base,capitate,cm,corolla,crotaloid,densely,elliptic,erect,filament,flattened-reniform,fleshy,glabrous,globose,green,hard,inflorescence,later,lateral,leaf,lobed,minutely,mm,nearly,obovate,occasionally,onto,ovary,pale,papillate,pedicel,petiole,pitted,plant,plurifoliate,pubescent,seed,shrub,small,sparsely,stem,stigma,stout,style,surface,tan,terminal,tree,white,winged,woody,yellowish,yellowish-green	.3,0.3-1,0.8-1.1,1-1.5,1.5-2.5,15,15-20,20-200-flowered,3-3.5,3.5-5,4-15,9-30,abaxially,across,along,always,anthesi,apar,appearanc,axillary,barely,bark,basal,berry,blade,body,branched,branching,broadly,bushy,calyx,collection,cone,conical,decurrent,deltate,dendritic,dense,denser,dia,diamete,distal,drying,eaf,edicel,eed,especially,exserted,flat,free,fruiting,giving,greenish-yello,incrassate,juvenile,knob,lamina,large,like,lobe,long,loose,lower,main,many,margin,middle,much,nflorescence,obovoid,often,older,pair,papillo,pericarp,planar,pore,poricidal,portion,possessing,prominent,pubescence,rest,ruit,scar,sessile,shaped,simple,spaced,strongly,surpassing,tall,tear-drop,thick,thin,time,tip,translucent,trichome,tub,tube,tuft,ud,unevenly,variously,vein,wide,widest,x,ympodia,young	20-200,adaxial,apart,arrangement,colour,diameter,flower,form,fruit,growth,height,history,length,life,na,number,papillose,peduncle,perennial,position,rachi,reproduction,shape,spacing,staman,texture,width
558	wfo-0001030007	success	168	87	60	108	27	0.357	.4,.5,0.8-1,1-1.5,1-15,1-2,1.6-2.2,2-4,3/4,4.5-5,6-10-flowered,7-9,along,anther,apart,apex,base,beneath,brown,clavate,cm,corolla,decurrent,densely,elliptic,filament,flattened,fleshy,glabrous,globose,green,leaf,lobed,long,midrib,minutely,mm,opposite,ovary,pale,pedicel,petiole,pitted,plant,pubescent,reniform,shrub,simple,slender,small,stigma,style,surface,tapering,thick,tree,way,white,winged,x	.05,0.1-0.5,0.2-1,0.5-1,1.5-5,15-20,2-7,3-5,7-10,abrupt,acuminate,acute,anthesi,ba,bark,becoming,berry,branched,broadly,bud,calyx,campanulate,closely,cork,dark,deltoid,dia,difoliate,dry,edicel,eed,erect,exserted,free,fruiting,geminateleaf,glabrate,golden,golden-pubescent,gre,hooded,impressed,incrassate,inflorescenc,lateral,like,live,lobe,lon,longer,lower,main,major,margin,material,middle,minor,nflorescence,oblique,obovoid,occasionally,older,one,onto,outline,pair,papillo,papillose,planar,pore,poricidal,portion,prominent,raised,rest,rounded,ruit,scar,shaped,short,shorter,slightly,soft,soon,spaced,sparsely,specimen,stem,straight,tall,tear-drop,thickened,tip,trichome,trunk,tub,tube,two,type,ud,uniseriate,unit,vein,widening,widest,woody,ympodial,young	abaxial,adaxial,arrangement,colour,diameter,flower,form,fruit,growth,height,history,inflorescence,length,life,na,number,peduncle,perennial,position,rachi,reproduction,seed,shape,spacing,staman,texture,width
559	wfo-0001030010	success	156	77	50	106	27	0.321	0.5-5,0.9-1.1,1-1.5,1.2-1.5,1.5-2,2-2.2,2-7,4-4.5,5-7,anther,apex,brown,closely,cm,corolla,dark,deflexed,filament,fleshy,fruit,furcate,glabrous,globose,green,leaf,lobed,minutely,mm,nearly,obovate,opposite,ovary,ovoid-reniform,papillose,pedicel,petiole,pitted,shrub,simple,slightly,small,smooth,spaced,stigma,style,surface,tree,white,winged,x	.5,.75,/4,0.7-1,1-1.3,1-2,10-15,10-50-flowered,11-12,2.5,20-40,3-5,7-10,acuminate,acute,anthesi,appearing,area,attenuate,bark,basal,base,beneath,berry,bud,calyx,cyathiform,deciduous,decurrent,deltate,dia,differing,difoliate,distal,dry,eaf,edicel,eed,ellipsoid,exserted,f,free,fruiting,geminat,glabrate,grey,hooded,lateral,lobe,lon,long,lower,m.,main,major,margin,materia,material,middle,midrib,minor,minute,near,nflorescence,occasionally,often,older,one,orange,overlappin,pair,persistent,planar,pore,poricidal,portion,prominent,puberulent,rather,reddish,ruit,scar,shaped,shin,size,soon,stem,straight,styl,tall,tapering,tear-drop,tiny,tip,trichome,trunk,tube,ud,uniseriate,unit,vein,way,widest,woody,ympodial,young	10-50,abaxial,adaxial,colour,diameter,flower,form,growth,height,history,inflorescence,length,life,na,number,peduncle,perennial,plant,position,rachi,reproduction,seed,shape,spacing,staman,texture,width
560	wfo-0001030023	success	171	80	48	123	32	0.281	1-8,1.5-7,10-25,11-40+,2.5-3.5,30-50+,4-10,4-12,6-7,7-9,abaxially,adaxially,apart,apex,cm,diameter,ellipsoidal,elliptic,especially,finely,flattened,flower,fruit,glabrous,glandular-puberulent,globose,greenish-white,mm,moderately,ovate,pedicel,peduncle,peltiform,petiole,puberulent,pubescent,purplish-,rachi,simple,sparsely,stellate,stigma,style,tree,unknown,villous,yellowish,young	-,0-100+,0.5-1,1,1-,1-2,1.5-2,10-,12-18,13-20,2,2-3,20-30,3-4.5,3-5,4,4-foliat,5,5-,5-16,5-6,6-26,acute,aggregate,ape,apiculate,articulated,axe,basal,base,beyond,blade,branched,calyx,capitat,cell,ciliate,color,connective,connivent,cordate,cuneate,cylindrical,deeply,densely,denser,dilated,directed,distally,eaf,eed,entire,exceeding,except,exserted,fleshy,forked,glandular-puberulen,hair,highly,lanceolate,leaving,lobe,lon,long,loosely,lower,main,margin,membranaceous,narrow,narrowly,near,nflorescence,nther,oblique,oblong,obtuse,occasionally,often,orolla,pedicellar,perfect,pore,presen,present,probably,prominent,pubescen,pubescence,pubescent-pilo,radiu,remnant,ripe,ruit,short-acuminate,shorter,slightly,small,somewhat,spaced,stamen,stone,subcoriaceous,swelling,tal,tem,thecae,time,tip,triangular,truncate,tube,ud,unbranched,unit,unknow,usually,vary,vein,wide,x,ympodial	50-100+,abaxial,adaxial,anther,arrangement,capitate,colour,corolla,filament,form,growth,height,history,inflorescence,leaf,length,life,na,number,ovary,perennial,plant,position,pubescent-pilose,reproduction,seed,shape,spacing,staman,surface,texture,width
561	wfo-0001030032	success	250	85	65	185	20	0.26	+,0.5-0.6,1-1.3,1-1.5,1.5-2,2-4,2-5,2-60,2.4-3.5,3.5-12,30,8-10,8-20,abaxially,adaxial,anther,apex,articulated,branched,bright,brown,capitate,cm,conical,corolla,densely,diameter,elliptic,filament,flower,fruit,glabrous,golden,green,hair-like,imparipinnate,interrupted,leaf,length,many,middle,mm,oblanceolate,obovate,orbicular,outgrowth,ovary,pale,paler,pedicel,peduncle,petiole,pubescent,rachi,rotate,rotate-stellate,seed,soft,stigma,style,surface,time,vine,woody,yellow	.05,.5,0.1-0.4,0.1-0.5,0.2,0.2-0.3,0.2-0.5,0.25-0.4,0.4-1.5,0.5,0.5-0.7,0.5-1,0.5-1.5,0.5-2,0.6-1.1,0.7-0.8,0.8-1.0,0.8-1.1,1-2-celled,1-3,1-celled,1.5-2.5,11-20,13-35,2,2-10,2-3-locular,2-3.5,2-lobed,3,3-5,3.0-3.5,4-5,4-6-celled,4-celled,4.3-5.0,5-plurifoliate,6-11,60-80,7-16,7.5-10,8-10-celled,absent,abundant,acuminate,acute,adaxially,along,also,anthesi,apical,appearance,appendage,articulation,basal,basally,base,basiscopically,bent,border,branche,breaking,calyx,cell,clambering,column,completely,conspicuou,dark,decurrent,deltate,densest,desne,dry,eaf,ebracteate,edicel,eed,entire,exserted,free,fruiting,give,glandular,gree,greenish-brown,halfway,hea,head,herbarium,interjected,internode,irregularly,lamina,large,larger,lateral,leaflet,leave,like,lobe,long,longest,lower,margin,markedly,midvein,mixed,moderately,much,multicellular,nflorescence,node,oblique,occasionally,often,older,onto,opposite,pair,patent,petiolule,pithy,present,primary,pseudostipule,pubescence,reflexed,rest,rough,round,ruit,secondary,set,shorter,silky,simple,slightly,smaller,sometimes,somewhat,sparsely,sparser,specimen,splitting,spreading,stamen,staminal,stem,sterile,straight,subopposite,swollen,tall,tangled,tem,terminal,tertiary,testa,thick,thickened,tiny,tip,touch,transparent,trichome,truncate,tube,ud,unicellular,uniseriate,unit,usually,vegetatio,vein,venation,wall,weaker-walled,well-developed,white,wide,winged,ympodial,younger,½-3/4	abaxial,arrangement,colour,form,growth,height,history,inflorescence,life,na,number,perennial,plant,position,reproduction,shape,spacing,staman,texture,width
562	wfo-0001030048	success	156	89	60	96	29	0.385	.5,0.5-1.5,1.2-2,1.3-1.6,2-5,3-5,5-8,abaxial,acute,anther,apex,apically,arachnoid,base,bi-colored,bi-lobed,blue,clavate,closely,cm,corolla,deflexed,densely,elliptic,filament,glabrous,globose,green,internodal,leaf,lobed,matted,minutely,mm,nearly,opposite,ovary,ovoid-reniform,pale,papillose,pedicel,petiole,pitted,pointed,pubescent,reddish-brown,shiny,shrub,simple,small,spaced,sparsely,stigma,strongly,style,surface,tan,tree,trichome,white	1-1.5,1-2,1.5-3.5,1.5-7,10-16,2-3,3-3.5,4-15,4-4.5,5-10-flowered,5973,abaxially,adaxially,along,anthesi,ape,apparently,bark,becoming,berry,broadly,brown,calyx,completely,conical,covered,decurrent,deltate,dia,difoliate,drying,eaf,edicel,eed,ellipsoid,exserted,felt-like,fide,fleshy,four-angle,free,fruiting,geminat,glabrate,golden,greyish,impressed,inflorescenc,lamina,lateral,lightly,like,lobe,lon,long,lower,main,margin,middle,nflorescence,occasionally,older,onto,overlappin,pair,papillo,planar,pore,poricidal,portion,prominent,rather,rest,ruit,scar,shaped,solomon,somewhat,stem,tall,tear-drop,thick,thickened,tip,trifoliate,tub,tube,ud,unit,vein,wide,widest,woody,yellowish,ympodial,young	5-10,adaxial,arrangement,colour,diameter,flower,form,fruit,growth,height,history,inflorescence,length,life,na,number,overlapping,peduncle,perennial,plant,position,rachi,reproduction,seed,shape,spacing,staman,texture,width
563	wfo-0001030053	success	141	94	59	82	35	0.418	0.5-1,1-1.3,1-13,1.3-3.5,1.8-2,100,2-2.5,5,apart,apex,apical,branch,branched,brown,calyx,cell,cm,corolla,cyathiform,diameter,elliptic,entire,filiform,flattened,flower,fruiting,glabrous,greenish,growth,inflorescence,irregularly,many,margin,minutely,mm,near,new,nipple,pale,pedicel,peduncle,petiole,pitted,reniform,revolute,scar,shiny,simple,spaced,stem,surface,terminal,time,tip,turbinate,vine,white,woody,yellowish	0.5,1.5-5.5,10-20,2.5-3,3.5-4,4-,5-merou,7-11,7-9,<,abruptly,abscission,acuminate,acute,aiding,alyx,anthesi,apiculae,ark,around,articulated,base,berry,bfeore,climbin,completely,coriaceous,decurrent,eaf,eed,exserted,far,fide,fine,fragrant,frui,hyaline,leaving,lobe,lobed,long,lower,mentz,nflorescence,older,orolla,pair,papilla,papillo,parallel,peg,pendant,per,perfect,plurifoliat,primary,rectangular,rim,secondary,shallowly,shin,shining,sleeve,slightly,small,spreadin,spreading,strongly,support,tem,testal,tiny,truncate,tube,twining,ud,unit,usually,vein,venation,x,ympodial	5-merous,abaxial,adaxial,anther,arrangement,bark,bud,center,colour,filament,form,fruit,height,history,leaf,length,life,na,number,ovary,papillose,plant,position,prickle,rachi,reproduction,seed,shape,spacing,staman,stigma,style,texture,trichome,width
564	wfo-0001030057	success	141	74	35	106	39	0.248	1-10,2-4,2-4.5,2-6,20-30,20-80,4-10,apex,bud,cell,cm,diameter,elliptic,flower,forked,fruit,globose,green,greenish,herb,leaf,mm,odd-pinnate,ovate,ovoid,pedicel,peduncle,petiole,plant,pubescent,seed,stem,subglabrous,terminal,whitish	-2,1-2,2-3-celled,2.1-4.1,3-5,3.5-8,4.3-8.2,5.5-12,7-14,8,8-19,abaxially,absent,acuminate,acute,adaxially,apart,apparently,articulated,axe,axillary,base,berry,blade,borne,broadly,brownish,chartaceous,condition,cordate,covering,cuneate,decreasing,digestion,distal,drying,eaf,eed,end,enzyme,erec,extremely,fresh,geminat,generally,glabrou,greatly,green-white,hair,hair-like,half,high,honeycomb-shaped,interjected,larger,lateral,leaflet,like,living,long,lunate,make,membranous,mottled,mucilaginous,narrow,nflorescence,pair,perfect,petiolule,plurifoliate,purple,removed,ruit,scale-like,seudostipule,short,singly,size,small,sometimes,spaced,specimen,ste,stolo,suborbicular,subtending,tall,tem,testal,thick,thir,throughout,toward,tri-,truncate,tuber,typically,unit,unwinged,usually,wall,wet,wing,x,ympodial	abaxial,adaxial,anther,arrangement,bark,calyx,center,colour,corolla,filament,form,fruiting,glabrous,growth,height,history,inflorescence,length,life,margin,na,new,number,ovary,perennial,position,prickle,rachi,reproduction,scar,shape,spacing,staman,stigma,style,surface,texture,trichome,width
565	wfo-0001030057	success	197	80	56	141	24	0.284	-10,.5-3.5,1-10,2-4,2-4.5,2-6,20-30,20-80,4-10,5-6,abaxially,adaxially,anther,apex,cell,cm,corolla,covering,diameter,elliptic,filament,flower,forked,fruit,glabrous,globose,green,greenish,hair-like,herb,lateral,leaf,minutely,mm,odd-pinnate,ovate,ovoid,pedicel,peduncle,pentagonal,petiole,plant,puberulent,pubescent,rotate,seed,stigma,style,subglabrous,terminal,testal,thick,wall,white,whitish,yellow	-2,1-2,2-3,2-3-celled,2-5,2.1-4.1,3-5,3.5-8,4.3-8.2,5-10,5-merou,5.5-12,7-14,8,8-19,absent,acumen,acuminate,acute,ag,along,alyx,apart,apparently,articulated,axe,axillary,base,berry,blade,borne,broadly,brownish,bud,chartaceous,ciliate,condition,connivent,cordate,cuneate,decreasing,digestion,distal,dorsally,drying,eaf,edge,eed,end,enzyme,erec,especially,exceeding,extremely,flat,folded,fresh,geminat,generally,glabrou,globo,greatly,green-white,greenish-yellow,hair,half,high,homostylous,honeycomb-shaped,interjected,lanceolate,larger,leaflet,lengthening,like,linear,living,lobe,long,lower,lunate,make,margin,membranous,middle,midrib,mottled,mucilaginous,narrow,nflorescence,orolla,ovate-lanceolate,pair,perfect,petal,petiolule,plurifoliate,pore,poricidal,purple,removed,ruit,scale-like,seudostipule,short,singly,size,slit,small,sometimes,spaced,specimen,stamen,star,ste,stem,stolo,straight,striped,suborbicular,subtending,tall,tamen,tem,thir,throughout,tip,toward,tri-,truncate,tube,tuber,typically,unit,unwinged,usually,vary,wet,wing,x,ympodial	abaxial,adaxial,arrangement,colour,form,growth,height,history,inflorescence,length,life,na,number,ovary,perennial,position,rachi,reproduction,shape,spacing,staman,surface,texture,width
566	wfo-0001030067	success	206	78	55	151	23	0.267	.5,0-1,0-1.5,0.1-0.3,0.2-1,1-7,2-2.5,2.5-7,3.5-5.5,7-8,anther,apex,black,broadly,brown,chartaceous,cm,cylindrical,densely,depressed-globose,diameter,extra-axillary,filament,flower,fruit,glabrous,globose,green,grey,herbaceous,inflorescence,length,mm,obtuse,orbicular,ovate,pedicel,peduncle,perennial,petiole,pseudo-racemose,purple,rachi,recurved,resprouter,rhizomatous,rotate,shrub,simple,stellate-pubescent,stigma,style,unbranched,white,yellow	%,.05,0-0.1,0-0.2,0-0.7,0-2,0-30,0.1-0.25,0.1-0.5,0.15-0.3,0.2-0.35,0.2-0.4,0.3-0.4,0.3-0.8,0.4-1.1,0.5-0.8,0.5-13,0.6-0.9,0.7-1.3,0.8-1.4,0.9-2.8,1-3,1-6,10-16,12-16,13-15,2-3,2-foliate,2.5-3.5,3-8,3.6-5.3,4.5-6,5-merou,6-18,8-11,9-18,?,abaxially,absen,absent,abundant,accrescent,acicular,adaxiall,adaxially,alyx,apart,armed,articulated,axe,ba,basal,base,blade,broad,calyx,capitat,coating,connivent,cordate,decimetr,deltate,directed,distall,distinct,distributed,dult,eaf,eed,eglandular,entire,equal,erect,finger,frequently,fruiting,functional,geminat,gland-tipped,hair,half,homostylous,interpetalar,juic,lamina,lateral,less,lobe,long,longer,loosely,lower,margin,mature,mesocarp,mid-point,midpoint,midvein,minute,moderately,moist,multiradiate,nflorescence,oblique,obscure,obscured,often,orolla,ovate-oblong,part,per,perfect,petal,pore,porrect,present,prickle,probably,pubescent,ray,resinous,ruit,sessile,shallow,short,slightly,spaced,stage,stalk,stellae,stem,straight,tal,tamen,thick,thickened,throughout,time,tip,tissue,triangular,tube,unarmed,undulate,unit,unknow,uvenile,vary,wide,x,ympodial	abaxial,adaxial,arrangement,capitate,colour,corolla,form,growth,height,history,leaf,life,na,number,ovary,plant,position,reproduction,seed,shape,staman,surface,texture
567	wfo-0001030080	success	186	83	60	126	23	0.323	0.4-1.5,0.5-4,1-2,1.5-2.5,2.1-7.1,3-10,3-5,5-13.5,5-7,8-16,8-23,abaxially,adaxially,anther,apex,cell,clavate,cm,coriaceous,corolla,covering,dark,diameter,elliptic,filament,flower,forked,fruit,glabrous,green,greenish,hair-like,herb,lateral,leaf,light,mm,odd-pinnate,ovate,ovoid,pedicel,peduncle,petiole,plant,purple,pyriform,rachi,seed,stellate,stigma,style,terminal,testal,thick,throughout,wall,white,whitish,width,yellow	0.3-7,1-3,1.5-2,1.8-4.5,1999,2-3,2-4,3.3-7.7,4-12,4-7,5-merou,5.5-9.9,6.5-18.6,9.9-33,abaxiall,absent,acumen,acuminate,ag,along,alyx,apart,apparently,arranged,articulated,axe,axillary,base,bead,berry,blade,brownish,bud,capitat,ccording,condition,connivent,cuneate,decreasing,decurrent,digestion,distal,dorsally,dot,drying,eaf,edge,eed,enzyme,erec,exceeding,flat,folded,fresh,geminat,generally,glabrescent,glabrou,green-white,hair,hal,half,high,homostylous,honeycomb-shaped,inconspicuous,interjected,lanceolate,larger,leaflet,lengthening,like,linear,living,lobe,long,lower,make,medium,moniliform,mottled,mucilaginous,multiple,necklace,nflorescence,ochoa,onto,orolla,pair,perfect,plurifoliate,pore,poricidal,removed,second,seudostipule,size,slightly,slit,sometimes,spaced,specimen,stamen,stolon,straight,strongly,subequal,subtending,tall,tamen,tem,tiny,tip,toward,tri-,tube,tuber,typically,unit,unknown,usually,vary,wet,winged,x,ympodial	abaxial,adaxial,arrangement,capitate,colour,form,growth,height,history,inflorescence,length,life,na,number,ovary,perennial,position,reproduction,shape,spacing,staman,surface,texture
568	wfo-0001030081	success	157	84	58	99	26	0.369	0.5-1,0.5-1.5,0.5-2.5,1,1-4,1-5,1.5-3,10-20,4-6,5-15,absent,anther,apex,brown,center,chartaceous,cm,diameter,dm,drying,edge,elliptic,elliptic-ovoid,filament,fine,flower,fruit,glabrous,globose,herb,immature,long,margin,maturing,membranaceous,mm,moderately,nearly,parallel,pedicel,peduncle,petiole,pubescent,rachi,radiating,raised,ridge,rotate,running,semitransparent,shallow,sparsely,stigma,style,surface,white,x,yellow	.5,0.25-0.5,1-2,1-2-celled,1-3,1.5,1.5-7,10-35,1st,2-4,2-7,2-foliate,2nd,3-10,3-6,5-12,abaxially,abundant,acute,adaxiall,adaxially,along,apically,axe,base,berry,beyond,blade,calyx,cell,ciliate,connected,cordate,decurrent,dehiscing,densely,denser,eaf,eed,emarginat,entire,equal,explosively,exserted,few-branched,flat,frui,geminat,geniculate,hair,held,interpetalar,linear-lanceolate,lobe,longer,lower,lying,maturit,mesocarp,nfloresence,notch,oblong,obtuse,often,one,orolla,other,per,placenta,pointing,pressure,pubescen,rarely,rounded,ruit,short,single-,slightly,small,sometimes,stamen,straight,swollen,tal,tamen,tem,tissue,triangular,tube,two-celled,unbranched,unit,usually,vary,vein,watery,wid,woody,ympodial	abaxial,adaxial,arrangement,colour,corolla,form,growth,height,history,inflorescence,leaf,length,life,na,number,ovary,perennial,plant,position,reproduction,seed,shape,spacing,staman,texture,width
569	wfo-0001030083	success	146	83	53	93	30	0.363	0.5-2,0.8-1,0.8-3,1-2,1.5-3,3/4,4-6,anther,apex,base,calyx,closely,cm,corolla,deeply,drying,elliptic,flower,fruit,glabrous,globose,green,greenish-white,internodal,leaf,lobed,minutely,mm,narrowly,opposite,ovary,ovate,overlapping,ovoid-reniform,pale,papillose,pedicel,petiole,pitted,shrub,simple,slender,small-capitate,spaced,stigma,style,surface,tan,tapering,tube,way,white,winged	.5,.75,0.1,0.25-0.5,0.5-1,1-1.5,10-30,2,2-3,2-5-flowered,3-4,4-15,9-11,accrescent,acute,anthesi,bark,beginning,berry,broadly,cup-shaped,dar,deciduous,decurrent,deflexed,deltoid,dia,dry,eaf,edicel,eed,elongate,exserted,fleshy,fruiting,greyish-re,hyaline,inflorescenc,lateral,lobe,lon,long,long-acuminate,long-styled,lower,main,membranous,middle,near,nflorescence,older,onto,pair,paler,papillae,pore,poricidal,prominent,proximal,raised,red-papillose,reddish-gold,reflexed,ruit,scar,shallowly,shaped,short-styled,single-stemmed,slightly,somewhat,soon,specimen,stem,straight,strongly,tall,tear-drop,terminal,thickened,thin,tip,translucent,tub,ud,unifoliat,unit,vein,widest,woody,x,ympodial,young	2-5,abaxial,adaxial,arrangement,colour,dark,diameter,filament,form,growth,height,history,inflorescence,length,life,na,number,peduncle,perennial,plant,position,rachi,reproduction,seed,shape,spacing,staman,texture,unifoliate,width
570	wfo-0001030093	success	181	104	76	105	28	0.42	.5,0.1-0.3,0.5-1.1,0.75-1,1-12,1-5,2-2.5,3-4,4-6,8-9,anther,apex,base,beneath,brownish-tan,calyx,clavate,cm,corolla,densely,elliptic,erect,filament,flower,furcate,glabrous,globose,golden,green,greenish-white,growth,hirsutulous,leaf,lobed,long-styled,many,minutely,mm,nearly,obovate,occasionally,often,opposite,ovary,ovoid-reniform,pale,paler,pedicel,petiole,pitted,plant,puberulent,pubescent,shiny,short-styled,shrub,simple,slender,slightly,small,stigma,style,surface,tapering,terminal,thickened,time,tiny,tree,trichome,tube,uniseriate,vein,white,x,yellowish	.2,0,0.2,0.2-0.5,0.2-1,0.6-1.5,1-1.5,1.3-4.5,2.5-11,3.5-12,5-50-flowered,5-8,7-30,7-9,acuminate,acute,anthesi,apar,attenuate,bark,becoming,berry,branched,campanulate,case,closely,collection,commonly,continues,cuneate,deflexed,deltoid,dia,differing,difoliate,eaf,edicel,eed,ellipsoid,especially,evenly,except,expanded,exserted,forest,free,fruiting,geminat,greyish-brow,guyanese,hyaline,impressed,inundated,lateral,like,lobe,lon,long,lower,main,major,margin,member,middle,minor,narrowly,new,nflorescence,older,one,onto,open,orbicular,pair,papillo,persisting,population,pore,poricidal,portion,present,quite,reflexed,remaining,ruit,scar,shaped,shoot,size,soon,southern,spaced,stem,straight,tall,tear-drop,tip,tub,ud,underside,unit,widest,woody,ympodial,young	5-50,abaxial,adaxial,apart,arrangement,colour,diameter,form,fruit,height,history,inflorescence,length,life,na,number,papillose,peduncle,perennial,position,rachi,reproduction,seed,shape,spacing,staman,texture,width
571	wfo-0001030115	success	192	93	70	122	23	0.365	-100,.5,0.5-0.6,1-1.2,1.5-3,12,2.5-3,3-4,3.5-5,30-60,5-10,5-5.5,abaxially,adaxially,anther,apart,apex,base,c.,cm,conical,corolla,dark,densely,diameter,echinoid,echinoid-stellate,elliptic,erect,filament,flower,glabrous,globose,green,growth,inflorescence,lanceolate-elliptic,leaf,lobed,long-styled,minutely,mm,ovary,pedicel,peduncle,pentagonal,petiole,pubescent,purple,scattered,shallowly,shiny,short-styled,shrub,simple,small,stellate,stigma,stout,style,surface,terminal,thin,tree,trichome,violet,way,white,x,yellowish	-30,.2,0.1,0.2,0.5,1,1.5-2,10,10-,12-22,3,4,5-8,7,9-11,<,>,acuminate,acute,anthesi,armed,bark,basal,basall,beneath,berry,branched,broad-based,brow,calyx,closely,completely,cordate,curved,deep,discolorous,distant,drying,eaf,eed,ellipsoid,entire,equalling,exserted,free,fruiting,glabrescent,glandular,heterostylous,impressed,included,irregular,irregularl,know,known,lamina,later,lengthening,like,linear,lobe,long,long-triangular,lower,many,margin,midpoint,near,new,nflorescence,oblique,obscured,obvious,occasionally,often,older,pair,pale,papillate,papillo,pericarp,planar,plurifoliat,pore,poricidal,portion,prickle,prickly,primary,prominent,ray,reddish,ruit,scar,sessile,sinus,slightly,slit,somewhat,spaced,sparsely,splitting,stem,strongly,tapering,tearing,time,tip,translucent,trichoem,truncate,tube,ud,unarmed,underside,undulate,unit,upper,usually,vein,ympodial,young	abaxial,adaxial,arrangement,colour,form,fruit,height,history,length,life,na,number,papillose,plant,position,rachi,reproduction,seed,shape,spacing,staman,texture,width
572	wfo-0001030145	success	153	86	58	95	28	0.379	0.2-2,0.3-,0.5-1,1-2,1-2.5,1-3,1-5,1.5,1.5-2,1.5-4.5,2.5-6.5,3-10,3-4,3-5,6-40,abaxially,adaxially,also,apart,apex,base,campanulate,cm,compound,densely,diameter,ellipsoidal,flower,forked,fruit,glabrous,globose,hair,herb,leaf,long,mm,moderately,ovate-elliptic,pedicel,peduncle,petiole,pilose,puberulent,rachi,shrub,simple,sparsely,stigma,style,ternately,toward,truncate,unbranched,unknown,violet,x,yellow	-2,-3,0.5,0.5-4,1,1-1.5,1.5-7,10-12,2-3,2-4,3,4-5,4-8,4-foliat,8-11,absent,acute,adpressed,aggregate,ape,articulated,axe,basal,beyond,blade,calyx,cell,chartaceous,color,connective,cuneate,cylindrical,deltate,directed,distally,dunal,eaf,eed,elliptic,elliptic-ovate,entire,exceeding,exserted,fide,fleshy,glandular,lanceolate,larger,lateral,leaflet,leaving,less,lobe,lon,lower,margin,narrowly,near,nflorescence,nther,obtuse,orolla,pedicellar,pore,presen,puberulen,radiu,reddish,remnant,ripe,ruit,shorter,sinuate,slender,slightly,somewhat,spaced,stamen,stone,subcordate,subcoriaceous,tal,tem,terminal,thecae,time,tomento,triangular,truncat,tube,ud,unit,vary,wide,ympodial	abaxial,adaxial,anther,arrangement,colour,corolla,filament,form,growth,height,history,inflorescence,length,life,na,number,ovary,perennial,plant,position,reproduction,seed,shape,spacing,staman,surface,texture,width
573	wfo-0001030146	success	210	95	72	138	23	0.343	0.6–2,1.2–1.5,1–1.5,2.5–9,3–4,3–6,5–8,60+,8–15,9–9.5,abaxial,acuminate,acute,adaxial,anther,anthesi,apex,base,berry,bright,brown,c.,capitate,cm,coriaceous,corolla,dark,densely,diameter,echinoid,elliptic,filament,flattened-reniform,flower,globose,golden,green,growth,inflorescence,leaf,length,lobed,minutely,mm,multangulate,narrowly,nodding,pale,pedicel,peduncle,petiole,pitted,plant,pubescent,reddish,ripe,simple,small,stellate,stigma,stout,style,surface,terminal,tree,treelet,trichome,unevenly,way,white,yellow,–18	.1,.2,.5,0.2–0.4,0.5,0.5–1,0.6–0.7,0.9–1,1.5–2,16–20,1–1.1,20,20–30,2–5,40–50,4–30,4–4.5,5-merou,6.5–16,6–7,>,abaxially,absent,ag,almost,along,alyx,apar,appearing,ark,articulated,axe,beig,beneath,branched,branching,brownish,calyx,cell,center,closely,connivent,covered,cup-shaped,deeply,deltate,dense,dichasia,discolorous,drying,eaf,edge,eed,ellipsoidal,elongate,entire,erec,exserted,free,fresh,fruiting,fused,glabrous,gradually,halfway,ilament,impressed,lamina,layer,lengthening,less,like,lobe,long,loosely,lower,many,margin,midpoint,narrowing,new,nflorescence,older,olive,orolla,pair,papillose,part,peltate,per,perfect,pericarp,persistent,plurifoliate,pore,poricidal,portion,primary,projection,pubescence,ray,reflexed,regularly,revolute,rhachi,ruit,scar,scurfy,sessile,shiny,short-stalked,slit,spaced,sparsely,stem,strongly,subtended,tall,tan,tangled,tem,testal,thin,time,tiny,tip,tube,ud,undersurface,unit,upper,vary,varying,vein,visible,wide,woody,ympodial	5-merous,apart,arrangement,beige,colour,form,fruit,height,history,life,na,number,ovary,perennial,position,rachi,reproduction,seed,shape,spacing,staman,texture,width
574	wfo-0001030147	success	158	92	65	93	27	0.411	0.5-2,1-4,1-5,15-30,2-10.5,2-13,2-3,4-5.5,5-8,8-38,acute,apex,articulate,blue,branched,cell,cm,conical,corolla,covering,cyme,deep,diameter,dichasial,dichasially,distal,ebracteate,elliptical,filament,finely,flower,forked,green,green-white,hair-like,half,herbaceous,lateral,leaf,medium,mm,monochasial,narrowly,obtuse,odd-pinnate,ovate,ovoid,pedicel,peduncle,perennial,petiole,plant,proximal,pubescent,purple,rotate,seed,stigma,style,testal,thick,tip,wall,yellow,¼	-8,0-5,1.0-2.0,1.0-2.2,10-19,14-35,2,2-10,2-5,2.5-7.5,3-,3-6-foliat,4-3.,4.2-7.5,4.5-10,5-7,abaxiall,abaxially,acumen,acuminate,adaxially,apical,apically,attenuate,base,calyx,connate,cuneate,dehiscent,digestion,diminishing,dorsally,eaf,edge,eed,emoval,enzyme,exceeding,flat,folded,generally,globo,gradually,honeycomb,interjected,introrse,leaflet,living,lobe,lon,long,long-attenuate,lower,lunat,make,maturing,mucilaginous,nflorescence,nther,oblique,often,orolla,pair,pattern,perfect,petiolule,plan,poricidally,reveal,rounded,ruit,sessile,seudostipule,short,size,slit,specimen,stamen,straight,subequal,subsessile,tal,tem,terminal,throughou,throughout,toward,tuber-bearing,typically,unit,vary,wide,ympodial	abaxial,adaxial,anther,arrangement,colour,form,fruit,globose,growth,height,history,inflorescence,length,life,na,number,ovary,position,rachi,reproduction,shape,spacing,staman,stem,surface,texture,width
575	wfo-0001030151	success	175	80	54	121	26	0.309	-50,0.2-0.5,0.5-1,1-17,1-3,1-5,1.5-2.5,10-25,15-35,2-11,2-6,2-7-compound,3-14,4-5,6-9,adaxial,apex,blotch,chartaceous,cm,diameter,elliptic,flower,fruit,glabrous,globose,leaf,lilac-tinged,longitudinal,membranaceous,mm,obovate,pedicel,peduncle,petiole,pinnately,puberulent,pyriform,rachi,simple,sometimes,sparsely,stellate,stigma,stripe,style,surface,tree,truncate,unbranched,white,x,yellow,yellow-green	-3,0.3-0.5,0.5,1,1-1.5,1-2,1.5-2,10-20,2-25,2-3,20-30,3-5,3.5-32,4-foliat,5-6,?,abaxially,absent,abundantly,acuminate,acute,adaxially,aggregate,apart,ape,apiculate,around,articulated,axe,basal,base,beyond,blade,calyx,cell,channe,ciliat,compound,connate,connective,cordate,cuneate,cylindrical,decurrent,deltate,directed,distally,eaf,eed,eglandular,entire,exceeding,except,exserted,glabrate,glandular,glandular-puberulent,hair,lanceolate,leaflet,leaving,less,line,lobe,lon,long,lower,margin,narrowly,near,nflorescence,nther,oblique,oblong,obtuse,often,orolla,pedicellar,perfect,pore,presence,probably,purplish,radiu,remnant,ring,ripe,ruit,sand-punctat,sand-punctate,scattered,shallowly,short,shorter,slender,slightly,small,somewhat,spaced,stalked,stamen,stone,tal,tem,thecae,time,tip,toward,triangular,truncat,tube,ud,unit,unknow,vary,vein,veiny,white-puberulent,whitish,wide,ympodial	abaxial,anther,arrangement,colour,corolla,filament,form,growth,height,history,inflorescence,length,life,na,number,ovary,perennial,plant,position,reproduction,seed,shape,spacing,staman,texture,width
576	wfo-0001030153	success	147	88	64	83	24	0.435	/3,0.2-1,1-10,1-2,1.3-1.5,1.3-1.9,2-8,2-lobed,2.5-4,3-4,3-5,3-50,5-6,anther,anthesi,apart,apex,apparently,base,berry,branched,campanulate,clavate,cm,conical,corolla,diameter,distinct,domatia,elliptic,filament,flower,glabrous,globose,green,growth,internodal,lanceolate,less,lobed,minutely,mm,narrowly,nodding,ovary,papillate,pedicel,peduncle,petiole,pit-like,rachi,ripe,simple,slightly,small,stigma,style,surface,terminal,time,tree,treelet,way,white	.1,.2,0.8-0.9,0.8-1.3,1-1.2,1-1.5,1-2.5,1.5-2,3.5-10.5,6-8,abaxially,absent,acuminate,acute,adaxially,age,ape,apiculate,attenuate,axil,bark,brittle,broadly,caly,calyx,dark,deltate,densely,dot,dry,eaf,ellipsoid,enlarged,entire,erect,exerted,free,fruiting,glabrou,impressed,irregularly,known,lengthening,lobe,lower,margin,markedly,membranous,new,nflorescence,occasionally,older,ot,pair,paler,papillat,perfect,plane,plurifoliat,pore,poricidal,portion,primary,resinous,revolute,ruit,scar,slit,spaced,specimen,stem,straight,strongly,thin,tip,tube,ud,unit,vein,x,yellowish,ympodial,young	abaxial,adaxial,arrangement,colour,form,fruit,height,history,inflorescence,leaf,length,life,na,number,perennial,plant,position,reproduction,seed,shape,spacing,staman,texture,width
577	wfo-0001030155	success	183	105	90	93	15	0.492	0,0.4,0.5,0.5–1.2,0.7,12–20,2-4,2.5-3,2–,2–3,3.5,3–5,4,4–5,4–6,4–8,4–9,5–10,5–6,5–8,6–8,abaxially,acuminate,acute,anther,anthesi,apex,armed,basal,base,berry,branched,brown,chartaceous,cm,corolla,deeply,diameter,ellipsoid,entire,filament,flattened,flower,fruit,glabrous,globose,immature,imparipinnately,internode,lateral,leaflet,light,long,long-styled,major,margin,mature,middle,midrib,minutely,mm,oblong,pedicel,peduncle,pericarp,petiole,pinnatifid,pitted,prickle,purple,rachi,recurved,rounded,side,spreading,stellate,stem,stigma,strongly,style,surface,tapering,third,vein,vine,white,wide,widest,yellow,×	0.2,0.5-0.6,1-1.2,1/2,12–19,1–2,2,2.5,2/3,3,607,ag,alyx,articulated,ba,basally,becoming,blade,bud,calyx,campanulate,cell,central,clustered,confluent,connecting,connivent,corresponding,decurrent,degree,deltate,densely,eaf,eed,elongating,equal,et,exserted,fresh,glabrou,green,knob,lengthening,lobe,lobed,lower,narrowly,nflorescence,often,orolla,outline,papillate,part,petiolulate,plant,plurifoliat,pore,poricidal,present,prominent,protuberant,rectangular,recurve,robust,rodriguez,rounde,ruit,size,slender,slit,soon,stout,straight,subwoody,tamen,terminal,terminally,testal,time,tip,tissue,truncat,ttriangular,tub,tube,unit,vary,way,wing,woody,ympodial,–17,–27	arrangement,color,form,growth,inflorescence,leaf,length,number,ovary,seed,shape,staman,texture,truncate,width
578	wfo-0001030160	success	177	80	60	117	20	0.339	.5,.8,1,1-5,2,3,?,anther,apart,apex,base,bluish-violet,closely,cm,conical,corolla,densely,diameter,dioecious,elliptic,entire,filament,flower,fruit,glabrous,globose,growth,height,inflorescence,internodal,irregularly,lobed,margin,minutely,mm,narrowly,nearly,occasionally,orange-red,ovary,pedicel,peduncle,petiole,pitted,plant,pubescent,red,reniform,shiny,shrub,spaced,sparsely,stigma,style,surface,terete,thin,undulate-toothed,unisexual,unknown	.2,0.2,00,1-1.5,1-2,1-3,1.5-2,1.5-4.5,1030.,10300,2.5-3,3-11,3-3.5,3-4,4-rayed,5-6,7-10,8-9,absent,acicular,acuminate,acute,almost,amshoff,apparently,armed,bark,beneath,berry,broad-based,bud,calyx,capitat,completely,consisting,conspicuous,coriaceous,dry,eaf,eed,ekman,elongate,exserted,female,fide,flattened,flowered,forming,free,fruiting,glabrescen,like,lobe,long,long-triangular,m.,male,marginal,markedly,mere,midpoint,midrib,minute,near,new,nflorescence,oblique,often,older,other,ower,pair,pale,per,pericarp,plurifoliat,poricidal,portion,prickle,primary,prominent,ray,ruit,scar,scattered,several,shallow,short-stalked,simple,single,small,sometimes,somewhat,stellate,stem,stiff,strongly,stub,terminating,ti,tiny,tip,triangular,trichome,truncate,tube,ud,unit,usually,vein,vestigial,winged,woody,x,yellow,ympodial,young	abaxial,capitate,colour,form,hair,history,leaf,length,life,na,number,position,rachi,reproduction,seed,shape,spacing,staman,texture,width
579	wfo-0001030161	success	179	99	73	106	26	0.408	.5,0.1-0.2,0.2-0.5,0.2-1.3,0.4-0.8,0.5,1.1-1.3,2.5-3,4,4-20,4-5,anther,apex,bark,broad-based,calyx,cell,clavate,cm,conical,corolla,curved,densely,diameter,ellipsoid,elliptic,entire,filament,filiform,flattened,flower,fruit,fruiting,furcate,globose,growth,internodal,irregularly,leaf,lobed,margin,minutely,mm,narrowly,new,occasionally,orange,ovary,pedicel,peduncle,petiole,pitted,prickle,pubescent,red,reddish,reniform,scar,shiny,simple,slightly,spaced,sparsely,stellate,stem,stigma,style,surface,treelet,trichome,undulate-toothed,white,woody	.1,.2,.25,0,0.1,0.5-0.6,0.8-1,1,1.5-2,1.5-5,12-16,2-2.5,2-3,3-15,3-3.5,5197,8-9,9-10,<,?,abaxially,acuminate,acute,adaxially,almost,anthesi,apar,apparently,articulated,base,bearing,beneath,berry,breaking,coriaceous,difoliate,eaf,eed,egger,erect,especially,exserted,fide,free,fused,geminat,glabrescent,glabrous,impressed,later,leave,lengthening,lepidote,like,lobe,long,long-triangular,looping,lower,marginal,midpoint,midvein,near,nearly,nflorescence,older,outline,pair,pale,papillo,per,perfect,pericarp,planar,pore,poricidal,porrect,portion,prickly,primary,prominent,ray,rhomboid,ruit,scattered,sessile,shorter,slit,small,somewhat,stalked,straight,strongly,tapering,testal,thick,tip,tooth,tub,tube,ud,unit,vein,x,yellowish,ympodial	abaxial,adaxial,apart,arrangement,bud,center,colour,form,height,history,inflorescence,length,life,na,number,perennial,plant,position,rachi,reproduction,seed,shape,spacing,staman,texture,width
580	wfo-0001030167	success	141	85	48	93	37	0.34	.8,12,5-merous,abaxially,adaxially,anther,apex,chartaceous,climbing,cm,contiguously,densely,diameter,extra-axillary,filament,flattened,flower,fruit,glabrous,green,herbaceous,lanceolate,margin,membranaceous,membranous,mm,near,nearly,ovate,ovoid,pedicel,peduncle,petal,petiole,pointed,rachi,sand-punctate,simple,slender,somewhat,stellate,stigma,style,thinly,unbranched,vine,white,x	.9,0.1–0.2,0.5–0.6,0.5–0.7,0.6,0.6–0.8,0.7–1.2,0.8–1,1.2–2.5,1.5–2,1.5–7,14–19,15–20,17–58,1–1.2,1–1.5,2–3,2–4.5,4.5–8,4–10,4–4.5,4–5,4–7,8–10,accrescent,acuminate,acute,along,alyx,apar,apically,axe,base,berry,blade,branch,c.,calyx,ciliat,ciliate,clavate,eaf,eed,enlarged,entire,fertile,fruiting,gap,glabrou,immature,less,lobe,long,lower,m.,maturity,minutely,moderately,nflorescence,nternode,obtuse,orolla,pair,penden,perfec,pinnate,plurifoliat,reflexed,rounded,ruit,scar,secondary,seen,slightly,spaced,sparsely,subequal,symmetrical,tamen,tem,time,tip,truncat,tube,unit,unknown,vary,vegetation,vein,venation,weakly,wide,ympodial	0.1-0.2,0.7-1.2,0.8-1,1-1.5,1.5-2,15-20,17-58,2-4.5,4-10,4-4.5,8-10,abaxial,adaxial,apart,arrangement,colour,corolla,form,growth,height,inflorescence,leaf,length,na,number,ovary,plant,position,reproduction,seed,shape,spacing,staman,surface,texture,truncate,width
581	wfo-0001030170	success	230	90	53	177	37	0.23	1,2,8.5,acute,anther,apart,apex,blue,cm,densely,diameter,extra-axillary,filament,flattened,flower,fruit,glabrous,glandular-puberulent,globose,leaf,less,maturity,minutely,mm,nearly,obtuse,orbicular,pedicel,peduncle,perennial,petiole,pubescent,rachi,rarely,reniform,shrub,simple,smooth,stellate,stigma,stipitate-glandular,stout,style,subdeltoid,surface,thick,thin-textured,unbranched,violet,white,x,yellow,yellowish	-6,.2,/2,0,0.1,0.15–0.35,0.2–0.5,0.2–2,0.5–15,0.5–2,0–30,1.5,10–15,12.5,15–20,1–2-celled,1–2.5,1–4.5,2-foliate,2.5–3,20–25,20–30,2–3-celled,2–4,2–5,2–8,3,3.5–4,3.5–4.4,3–10,4,4–13-rayed,4–22,5,5–10,5–12,5–15,5–apiculate,abaxially,absent,accrescent,acicular,adaxially,also,appearing,around,articulated,axe,ba,base,blade,bud,calyx,capitat,coarse,confined,connivent,conspicuously,cordate,curved,cylindrical,directed,disappearing,distall,eaf,eed,enlarged,entire,erect,eventually,falling,fertile,few-branched,few-rayed,flexuous,frui,fruiting,geminat,geminate,gland,gland-tipped,glandular,ground,hair,horizontal,hyaline,interpetalar,lanceolate,larger,like,lobe,lobed,lon,long,longer,longest,lower,lowest,major,male,many,margin,mesocarp,minute,mostly,multangulate,near,nflorescence,numerous,oblique,oblong-apiculate,often,one,orolla,pair,perfect,pore,prickle,puberulent,pubescence,ranging,rare,ray,reflexed,rootstock,ruit,scarcely,scattered,senescent,sessile,shallow,short-puberulent,shorter,similar,single,size,slightly,small,solitary,sometimes,somewhat,spaced,spongy,spreading,stella,stellae,stem,sterile,stiffly,stipitate,straight,strongly,surfac,tall,tamen,tem,thic,tissue,tooth,toward,triangular,truncate,tube,twice,ultimately,unit,upper,usually,various,vary,vein,vestigial,way,wide,without,ympodial,–4	0.2-2,1-2.5,1-4.5,1.2,10,10-15,2-4,2-5,2-8,2.5-3,20-30,3-10,abaxial,adaxial,arrangement,capitate,colour,corolla,form,growth,height,history,inflorescence,length,life,na,number,ovary,plant,position,reproduction,seed,shape,spacing,staman,texture,width
582	wfo-0001030176	success	171	79	56	115	23	0.327	-6.25,.2,.7,0.4-1.5,0.5-2,0.7-1.4,0.7–0.8,1-5,1.2-2.5,1.6,2.25-3.25,3-5,3-lobed,3.75-5,4-9,6-8,anther,apart,bilobed,broadly,chartaceous,cm,depressed-globose,diameter,especially,few-branched,filament,flattened-reniform,flower,fruit,glabrous,herb,hermaphroditic,light,margin,mm,ovate,pale,pedicel,peduncle,petiole,plant,rachi,rarely,ripe,rotate-stellate,slightly,stigma,style,unbranched,violet,white,x,yellow,yellow-orange,young	-1.4,-4.25,.75-1.5,0.5,0.6-0.9,1,1-2,1.2,1.5-2,1.5-2.5,1/3,1/6,2-3,2-foliate,2.5,2.5–7.5,2.5–9,2–3,5-merou,6–8,abaxially,accrescent,acute,adaxiall,adaxially,alyx,angulate,apex,apparently,articulated,asymmetrically,attenuate,axe,ba,basal,base,berry,bi-lobed,blade,branch,broad,calyx,capitat,ciliate,connivent,contact,covering,cylindrical,decumbent,dehiscent,downward,eaf,eed,erec,extra-axillary,forming,fruiting,geminat,hair,hold,interlobal,juic,lance-ovate,lanceolate-oblong,lateral,line,lobe,lon,long,longitudinall,lower,major,mesocarp,midrib,minutely,near,nearly,nflorescence,node,numerous,oblong,often,orolla,partially,patch,perfect,pore,prostrate,pubescent,recurve,recurved,rooting,round,ruit,simple,sinus,soil,sometimes,somewhat,spaced,sparsely,tamen,tem,terminal,time,tip,triangular,tube,unit,vary,vein,white-puberulent,wide,winged,ympodial	abaxial,adaxial,capitate,color,corolla,form,growth,height,history,inflorescence,leaf,length,life,number,ovary,perennial,reproduction,seed,shape,spacing,staman,surface,texture
583	wfo-0001030180	success	135	66	39	96	27	0.289	.5,0.05-1,0.5-1,0.8-2,1.1-1.2,3-8,4.5-5,anther,apart,apex,clavate,cm,corolla,filament,fruit,furcate,glabrous,globose,green,height,leaf,linear,lobed,mm,opposite,ovary,pedicel,petiole,planar,rounded,shrub,slender,stigma,style,surface,unknown,white,winged,x	.1,.75,0.9-1.8,1-1.5,10-30-flowered,3-4,6,8-10,8.5-23,?,abruptly,accrescent,anthesi,apiculate,appearing,attenuate,bark,base,becoming,berry,calyx,clu,dark,decurrent,deflexe,deltoid,dia,eaf,edicel,eed,ellipsoid,erect,exserted,free,fruiting,glabrate,immature,inflorescenc,interpetalar,known,lateral,lenticellat,lobe,lon,long,long-acuminate,lower,main,middle,minute,minutely,narrowing,nearly,nflorescence,occasionally,older,overlapping,pair,papillate,papillose,peduncl,plurifoliat,pore,poricidal,portion,prominent,proximal,puberulent,raised,ruit,scar,shaped,sinus,slightly,soon,spaced,sparsely,stem,straight,tear-drop,terminal,thin,tip,trichome,tube,ud,unevenly,uniseriate,unit,vein,widely,widest,woody,yellowish,ympodial,young	10-30,abaxial,adaxial,arrangement,colour,diameter,flower,form,growth,history,inflorescence,length,life,na,number,peduncle,plant,plurifoliate,position,rachi,reproduction,seed,shape,spacing,staman,texture,width
584	wfo-0001030182	success	205	101	84	121	17	0.41	0.5-1,1-1.5,1-4.5,12-15,15-20,2-15,2-3,2-5,3-12,3-4,3-5,abaxially,acute,adaxially,anther,apex,base,berry,blue,brown,brownish,clavate-truncate,closely,cm,coriaceous,corolla,dark,diameter,elliptic,filament,finely,flattened,flower,fruit,glabrescent,glandular,globose,green,growth,heterostylous,immature,internodal,leaf,lobed,long-styled,microscope,mixed,mm,nearly,ovary,ovate,ovate-elliptic,papillose,pedicel,peduncle,petiole,plant,pubescent,red,reddish,reticulate,ripe,rusty,seen,short-styled,shrub,simple,stellate,stellate-glandular,stigma,style,subcoriaceous,subreniform,surface,terminal,tomentose,treelet,trichome,unarmed,variegated,velutinous,violet,yellow,yellowish	-12,0.2-0.3,0.3-0.5,1,1-1.7,1-celle,1-celled,1-multicellular,1-nerved,1.2-1.5,1.5-2,1/4,2-2.2,2-8,2.4-2.5,3-8,4-10,4-5,accrescent,adult,angulate-lobed,anthesi,armed,articulated,asymmetric,bark,basal,branched,calyx,cell,den,discolorous,distal,e,eaf,eed,eglandular,entire,erect,evident,exserted,ferruginous-tomentose,free,fruiting,hirsute,juvenile,later,lengthening,like,linear-lanceolate,lobe,long,lower,many,margin,midpoint,midrib,minute,minutely,mixture,multangulat,multicellular,new,nflorescence,oblique,obtuse,older,one,ovoid,papillo,per,perfect,pericarp,plurifoliat,pore,poricidal,porrect,porrect-,porrect-stellate,portion,prickle,prickly,pubescence,ray,recurved,reduced,reflexed,repand,rounded,ruit,scar,sessile,short,similar,slightly,slit,space,sparse,sparsely,stalked,staminate,stem,strongly,subsessile,tall,tapering,testa,tip,triangular-lanceolate,tub,tube,turbinate,ud,uniseriate,unit,upper,vein,wood,x,ympodial,¼	abaxial,adaxial,colour,form,height,inflorescence,length,mentioned,number,position,reproduction,seed,shape,spaced,spacing,staman,texture
585	wfo-0001030185	success	206	106	79	127	27	0.383	1,1-10,1-4,10,2-3,2.0-3.0,20-65,5-7,8-11,9-18,acuminate,acute,apex,beyond,blue,blue-violet,branched,cell,center,cm,commonly,corolla,covering,cyme,dark,darker,deep,densely,diameter,dichasial,dichasially,distal,ebracteate,elliptic,filament,flower,forked,glandular-pubescent,globose,green,green-white,hair-like,half,herbaceous,lanceolate,lateral,light,medium,mm,moderately,monochasial,narrowly,odd-pinnate,ovate,ovoid,pedicel,peduncle,perennial,plant,puberulent,purple,rhizomatous,rotate,scarcely,seed,shape,sometimes,spot,star,stigma,style,testal,thick,tinged,violet,wall,white,without,yellow	-0.5-1.3,0.2,1-8,1.0-1.3,1.5-4,1.7,15,2,21,25,3-6-foliat,3.5-4.2,35,4,4-7,5-10,5-lobed,abaxially,acumen,adaxially,angular,apical,apically,apiculate,articulate,b,ba,basal,base,becoming,calyx,caudate,cente,clasping,coat,collection,color,connate,cordate,cuneate,decreasing,dehiscent,digestion,eaf,eed,embryo,emoval,enzyme,erect,exceeding,formed,generally,glabrescent,glabrous,gland,globo,hair,honeycomb,interjected,introrse,leaflet,living,lobe,lon,long,lower,make,maturing,middle,mucilaginous,nearly,nflorescence,nther,obliquely,oblong,occasional,often,one,orolla,pair,pattern,pentagonal,perfect,petiolate,petiolulate,petiolule,poricidally,purpl,radiating,rare,reduced,reveal,rhizome,rotate-,rounded,ruit,semi-lunate,sessile,seudostipule,short,size,slightly,slit,somewhat,specimen,stamen,ste,stem,straight,subequal,symmetrically,tem,terete,terminal,tip,trailing,type,typically,unbranched,unit,usually,vary,visible,wid,wide,wider,ympodial	abaxial,adaxial,anther,arrangement,colour,form,fruit,growth,height,history,inflorescence,leaf,length,life,na,number,ovary,petiole,position,rachi,reproduction,rotate-pentagonal,spacing,staman,surface,texture,width
586	wfo-0001030189	success	188	82	57	131	25	0.303	/3,0-1,0.5-1.6,0.9-1.1,1,1-2,1.3-4.2,2-3,2-5.5,2.5-4,5-6,5-merous,abaxially,anther,articulated,base,berry,branched,cm,diameter,dull,erect,filament,flattened-reniform,flower,fruit,glabrescent,glabrous,lateral,leaf,length,lobed,long,maturity,mauve,mm,moderately,oblong,orange,ovate,pedicel,peduncle,petiole,purple,red,scandent,shrub,simple,sparsely,spherical,stellate-pubescent,style,surface,terminal,way,yellow,yellow-green	-1/2,-4,.2,0-15,0-30,0.1,0.1-0.2,0.2-0.3,0.2-0.5,1-1.5,1-3-cellular,1-4-cellula,1-4-cellular,1.1-2.7,1.5-2,1.5-4.5,1.5-5,1/,1/3,1/6-1/3,2,3-4,3.2-4.5,4-13,4-5.5,5-,5-10,6-10,6-12,8,8-10,8-18,acut,alyx,apar,apex,apically,apparently,appressed,bark,blade,calyx,chartaceous,concolorous,connivent,cordate,curved,deltate,densely,drying,eaf,eed,elliptic,elongating,entire,equal,evenly,faint,foliaceous,free,frui,fruiting,glabrescen,gland-tipped,gray,green,infructescence,lobe,longer,lower,margin,mature,midpoint,nflorescence,obtuse,often,older,one,open,orolla,oung,pair,per,perfec,pericarp,plurifoliat,poricidal,porrect,portion,primary,ray,recurved,red-brow,reflexed,rounded,ruit,scar,sessile,shorter,slender,smooth,sometimes,somewhat,spaced,spreading,stalk,stalked,stellate,stem,strongly,tamen,tapering,terete,tertiary,time,tip,trichome,tube,unarme,unarmed,unit,upper,variously,vary,vein,venation,visible,wide,woody,ympodial,young	abaxial,adaxial,apart,arrangement,colour,corolla,form,growth,height,history,inflorescence,life,na,number,ovary,plant,position,rachi,reproduction,seed,shape,spacing,staman,stigma,texture
587	wfo-0001030195	success	255	107	87	168	20	0.341	.2,.5,.6,0.1–0.2,0.2–1.0,0.5,0.5–0.6,0.5–4.0,0.8–0.9,0.9–4.8,1.2–1.6,1.3–2.6,1.5–1.9,1.7–2.2,2,2.3,3.8–4.8,5.5–6.5,acuminate,aequilateral,anther,apex,bark,base,based,blade,borne,broad,brochidodromous,brown,calyx,capitate,chartaceous,cm,corolla,cuneate,deltate,densely,diameter,entire,filament,flattened-orbicular,fruit,glabrous,globose,green,individually,internode,lateral,leaf,long,margin,midvein,mm,moderately,notched,oblique,obtuse,ovate,pedicel,petiole,prickle,pubescent,reddish,rounded,sessile,shoot,short,shot,shrub,spatulate,stellate,stellate-pubescent,stem,stigma,style,subcoriaceous,surface,terminal,vein,weakly,white,yellow,yellow-ferruginous,yellow-tan,±glabrous,×	.3,.7,/3,0.2–0.3,0.2–0.5,0.3–0.7,0.5–1.3,0.7–1.0,0.8,1,1.0,1.0–1.4,1.0–1.5,1.3–1.5,1.4–1.6,1.5–1.7,1.7–3.2,1.8–2.0,1.8–2.5,1/3,2.2–2.7,3–6,3–7.3,4-merou,4.9–7.0,6.3–7.7,6–8,6–9,abaxially,adaxial,adaxially,adnate,ag,along,alyx,anthesi,apical,apiculate,apparently,appearing,appresse,around,articulate,attachment,attenuate,ba,berry,broad-based,bud,channeled,connivent,dark,dentate,developed,directed,distal,distally,distinct,dry,eaf,edge,eed,either,elliptic,emerging,endocarp,evenly,exocarp,extending,extra-axillary,fertile,filiform,flat,flattened-irregular,flexed,flower,free,glandular,glossy,gradually,gree,hair,homostylous,hort,immature,increasing,indistinct,intact,interpetalar,intersepalar,isolated,juic,layer,laying,light,lobe,lon,longer,lower,m.,many,markedly,mature,middle,midpoint,midrib,minute,mottled,narrowly,nearly,nflorescence,nodding,oblong,occasionally,opaque,orolla,per,perforated,pitted,plurifoliat,point,poorly,pore,porrect,portion,potentially,presen,raised,ray,red,reflexed,remaining,restricted,ruit,scattered,side,simple,sinus,slightly,sloughing,smoot,sparsely,splitting,stamen,stellae,straight,striped,suture,tamen,tem,thin,time,tip,tissue,transparent,truncate,tube,typically,ud,unarmed,unit,vary,wide,yellow-ferruginou,ympodial,young,±90°,±equal	0.3,1.7,arrangement,colour,form,growth,height,history,inflorescence,length,life,ovary,perennial,plant,position,seed,shape,staman,texture,width
588	wfo-0001030198	success	234	138	111	123	27	0.474	0.7–,0.8–1.4,0.9–2,1.5–3.5,10–12,13–20,16,1–2.5,2–2.8,2–3-lobed,4–12-branched,5.3–7,5–12,60–150,7.5–10,abaxially,acute,adaxially,ampliate,angulate,anther,apart,apex,articulated,attenuate,basal,base,black,closely,cm,deeply,densely,diameter,distally,drying,entire,except,extra-axillary,filament,finely,flattened-reniform,flower,fruit,glabrate,glabrous,globose,gradually,green,hair,homostylous,initially,interpetalar,irregularly,lateral,leaf,like,lilac,lobe,lobed,midrib,minute,minutely,mm,much,nearly,orange,overtopped,part,pedicel,peduncle,persistently,petiole,pitted,purple,recurved,reflexed,sessile,shiny,shrub,simple,sinuate,somewhat,soon,sparse,spreading,stellae,stellate,stellate-tomentose,stem,stigma,strongly,style,surface,tan,terminal,thickened,tissue,tomentose,triangular,turning,upper,weak,well-developed,whitish,whitish-tomentose,yellow,yellowish,×,–20,–3,–3.5	.2,0.6,0.7–0.8,0.7–0.9,0.7–1.1,0.8,0.9–1.7,1,1.2,1.4–1.6,1.5–6.5,2,2.5,2.5–14,2.5–3.0,2–3,3.4–4.0,3.5–7,3–3.5,3–4,3–9,4,4.5,5-merou,5.5–13,6–10,acicular,adaxiall,alyx,apical,apparently,appearing,axe,berry,blade,branch,broad,broadly,calyx,capitat,caudate,contrasting,cordate,coroll,dark,darker,deltoid,directed,distall,eaf,eed,fewer,filiform,formed,free,frui,geminat,glabrescent,gland-tipped,hal,high,immature,internode,interwoven,larger,lon,long,lower,major,many,margin,midpoint,midri,midvein,midzone,near,nflorescence,oblong-lanceolate,often,one,orolla,ovate,ovoid,perfect,plurifoliate,pore,porrect,prickle,principal,ray,relatively,rounded,ruit,short-stalked,shorter,side,sinus,slightly,sometimes,spaced,splitting,stalk,stella,stout,straight,tamen,tem,time,tip,truncate,tube,ud,unarmed,unit,usually,vary,vein,white,white-tomentose,wide,ympodial,–17,–18	5-merous,abaxial,adaxial,arrangement,capitate,colour,corolla,form,growth,height,history,inflorescence,length,life,na,number,ovary,perennial,plant,position,rachi,reproduction,seed,shape,spacing,staman,texture
589	wfo-0001030212	success	188	85	64	124	21	0.34	0.2-0.4,0.5-1,1-1.5,1-15,1-3,1.5-2,2-2.5,2-5,2.1-3.4,2.4-3.3,3-5,3.5-5,4-23,4.5-6,abaxial,adaxial,andromonoecious,anther,apex,articulated,base,broadly,capitate,chartaceous,cm,compound,depressed-globose,diameter,filament,flower,fruit,glabrous,gland-tipped,green,hair,herbaceous,inflorescence,leaf-opposed,length,mm,ovate,pedicel,peduncle,petiole,pinnately,plant,prostrate,purple,rachi,resprouter,rotate,rotate-stellate,short,simple,slightly,sprawling,stigma,style,surface,unbranched,winged,x,yellow,yellowish-green	%,0-4,0.5-0.6,0.5-7,0.9-1.3,1-1.2,1-2,1-5,1-6,1.2-1.8,1.4-1.8,12-40,15-40,2-4,2.5-6,2.6-6.5,20-50,25-60,28-37,30-150,4-27,4-6,4-9,5-merou,6-9,7-11,8-9,9-10,abaxially,absen,absent,abundant,accrescent,acicular,acute,adaxiall,adaxially,alyx,apart,apparently,armed,attenuate,axe,ba,bilobe,blade,bristle-like,brown,calyx,center,connivent,cuneate,cylindrical,d.,deeply,deltate,directed,distall,divided,eaf,eed,finger,fruiting,functional,geminat,glandular-puberulent,half,heterostylous,index,interpetalar,juic,lamina,lateral,lobe,lobed,lobing,lon,long,lower,margin,mature,mesocarp,mid-point,midvein,minute,moist,narrowly,nflorescence,oblique,orolla,part,per,plurifoliate,pore,presen,present,pricke,prickle,ruit,side,spaced,sparse,sparsely,stage,straight,strongly,tal,tamen,tem,thick,throughout,time,tissue,toothed,triangular,tube,unit,unknown,uvenile,vary,vein,weakly,wide,ympodial	5-merous,arrangement,bilobed,colour,corolla,form,growth,height,history,leaf,life,na,number,ovary,position,reproduction,seed,shape,spacing,staman,texture
590	wfo-0001030219	success	191	93	66	125	27	0.346	0.1–0.3,0.2–2.3,0.5–,1.0–1.2,1.0–2.2,1.6–,2.0–2.5,2.0–3.2,4.5–5.5,4–7,60,6–10,6–8,9–10,abaxially,adaxially,anther,anthesi,apart,apex,black,blue,branched,brown,cm,densely,diameter,elliptic,filament,flattened,flower,fruit,glabrous,globose,green,lanceolate,leaf,lilac,marking,mm,moderately,number,oblong,olive,opposed,ovate,pale,paler,pedicel,peduncle,pentagonal,perennial,petiole,pitted,pubescent,purple,shallowly,shrub,sparsely,stigma,style,surface,velutinous,x,yellow,–9.5	0.4–1.0,0.5,0.7–1.1,0.8–3.0,0–,1.0–1.5,1.0–2.0,1.3–2.9,1.4–2.8,1.5,10,15,1–2.5,2.0–5.5,2.4–6.0,2–,2–2.5,2–3,2–4.5,3,4.8–11.5,4–5,5,5–,5–8,6–,7–11,8–18,9–12,abaxiall,acut,acute,adaxiall,adnate,ag,along,anisophyllous,apical,apparently,appearing,arising,arranged,articulated,axe,ba,basal,base,blade,bract–like,calyx,cell,chartaceous,clavat,concave,connivent,convex,cylindrical,decreasing,decurrent,deeply,diamete,difoliate,directed,distally,eaf,eed,equal,erect,geminat,glabrescent,hair,incised,indistinct,internode,lobe,long,longitudinal,lower,margin,multicellular,nflorescence,opening,oppositely,orolla,pair,perfect,pore,present,procumbent,rapidly,red–purple,regularly,rounded,ruit,serrate,sessile,sid,side,simple,size,smaller,spaced,split,stone,straight,stripe,strongly,tal,tamen,tem,time,tube,two,unicellular,uniseriate,unit,vary,white,wide,wing,winged,woody,ympodial,–3.0,–7.0	5–11,abaxial,adaxial,arrangement,clavate,colour,corolla,form,growth,height,history,inflorescence,length,life,na,opposite,ovary,plant,position,rachi,reproduction,seed,shape,spacing,staman,texture,width
591	wfo-0001030224	success	191	98	76	115	22	0.398	0.5-1,0.5-1.5,1-3.5,1.5-9,12-14,14-17,2-10,2-4,2-5,2.5-4.5,20-25,4-10,5-10,5-merous,6-15,abaxially,adaxially,andromonoecious,anther,apart,armed,black,brown,chartaceous,clavate,cm,dark,deflexed,densely,diameter,elliptic,extra-axillary,ferruginous,filament,flattened,flower,forked,form,fruit,glabrous,globose,green,hair,heteromorphic,lighter,mm,moderately,occasionally,orange,outline,pedicel,peduncle,petiole,pink,plant,pseudohair,pubescent,purple,rachi,red,reniform,scandent,shrub,simple,sparsely,stellate,stellate-pubescent,stigma,style,subcoriaceous,suborbicular,surface,tan,unbranched,x,yellow	-2.5,.25,.5,0.5-3,1-1.5,1-2,10-20,2-3-celled,2.5-4,2.5-8,3-4-foliate,4-4.5,4-6,4.5-5,6-10,6-8,7-10,8-12,absent,accrescen,acuminate,acute,adaxiall,ag,alyx,andromonoeciou,apex,articulated,axe,ba,bark,base,berry,blade,broad-based,calyx,capitat,cell,connivent,cylindrical,directed,distally,dry,eaf,eed,eglandular,equal,finely,fissure,free,fruiting,functionally,geminat,gradually,greyish,hermaphroditic,interpetalar,lateral,like,linear-lanceolate,lobe,long,long-,longer,longitudinal,lower,lowering,major,mature,maturit,midpoint,midvein,narrowly,nflorescence,one,opening,orolla,other,part,perfect,pericarp,pore,prickle,ray,recurved,reddish-brown,reflexed,ruit,sessile,shiny,short-styled,side,slit,small,spaced,sparse,staminate,stem,strongly,tamen,tapered,testal,tightly,time,tissue,triangular,tube,unit,vary,vein,wall,wide,wtih,yellowish,ympodial	abaxial,adaxial,arrangement,capitate,colour,corolla,growth,height,history,inflorescence,leaf,length,life,number,ovary,position,reproduction,seed,shape,spacing,staman,texture
592	wfo-0001030225	success	155	82	55	100	27	0.355	-30,.5-2.5,0-5,1,1-4,1-6,10-15,10-30,2,2-3,2-6,3-11-compound,3-4,4-5,apart,apex,articulated,base,campanulate,cm,coriaceous,densely,diameter,elliptic-ovate,expanded,fleshy,flower,forked,fruit,glabrous,globose,leaf,less,mm,moderately,obtuse,pedicel,peduncle,petiole,pinnately,possibly,puberulent,purple,rachi,shrub,simple,small,stellate,stigma,style,tree,truncate,unbranched,unknown,x	-1.5,-11,-4,-45,-7,.5,0,0-20,1.5,1.5-2.5,2-18,2-2.5,3-20,3-5,3-foliat,8-15,abaxially,absent,acuminate,acute,adaxially,ape,apical,apically,ature,axe,basal,beyond,bilobed,blade,calyx,color,compound,conivent,connective,cordate,cuneate,cylindrical,deltate,dilated,directed,distally,eaf,eed,entire,equal,especially,exceeding,exserted,glabrate,gland,immature,laterally,leaflet,leaving,lobe,long,lower,margin,minutely,narrowly,nflorescence,nther,oblong,one,orolla,papillose,perfect,pore,prominent,puberulen,radiu,scar,see,seen,shallowly,slightly,somewhat,spaced,sparsely,stalked,stamen,strongly,succulent,tal,tem,thecae,time,tip,tomento,toward,triangular,tube,two,ud,unit,unknow,vary,wide,ympodial	abaxial,adaxial,anther,arrangement,colour,corolla,filament,form,growth,height,history,inflorescence,length,life,na,number,ovary,plant,position,reproduction,seed,shape,spacing,staman,surface,texture,width
593	wfo-0001030244	success	226	88	70	156	18	0.31	0-0.3,0-0.6,0-1,0.2-1.3,0.25-0.5,0.5-1,0.5-1.2,1-1.5,1-2,2.5-6.5,3.5-9,7-24,abaxially,adaxially,andromonoecious,anther,base,blue,brown,cm,densely,diameter,erect,filament,flower,fruit,glabrous,globose,green,grey,hair,inflorescence,interpetalar,lanceolate,length,linear,mm,moderately,narrow,narrowly,oblong,pale,pedicel,peduncle,perennial,petiole,plant,pseudo-racemose,purple,rachi,red,reniform,rhizomatous,rotate,scattered,shrub,solitary,sparsely,stellate,stellate-pubescent,stigma,style,surface,tan,tissue,unbranched,white,x,yellow,yellowish	%,.05,.3,0-0.1,0-3,0.1-1.5,0.2,0.2-0.5,0.2-0.6,0.2-1,0.25-0.4,0.3-0.4,0.3-0.5,0.3-5,0.4-0.7,0.5-3.5,0.5-7,0.6-0.8,0.8-1.2,1-20,1-5,1-6,1-8,1-locular,1.5-,1.5-2,1.5-2.3,1.5-3,11-33,2-2.5,2-4,2-foliate,2.5-13.5,3.3-7.5,4-5,4-5-merou,4-6,5-6,6-8,7-15,7-16,7-8,7-9,8-18,absen,absent,accrescent,acicular,across,acute,alyx,apart,apex,apparen,articulated,attenuate,axe,ba,blade,calyx,capitat,chartaceous,common,confined,connivent,cuneate,cylindrical,decimetre,deltate,directed,distall,distally,distributed,eaf,eed,eglandular,entire,exocarp,extra-axillary,finger,fruiting,geminat,gland-tipped,half,heterostylous,homostylous,incomplete,juicy,lamina,lateral,less,lobe,long,longer,lower,margin,markedly,mature,mesocarp,mid-point,midpoint,midrib,minute,nflorescence,oblique,obtuse,orolla,part,per,perfect,placenta,plump,pore,porrect,present,prickle,pubescent,ray,reticulate,ruit,septum,sessile,short,simple,slightly,spaced,sparse,stage,stalk,stalked,stellae,straight,strongly,succulent,tal,tamen,tem,thick,thicker,thicknes,throughout,time,tissu,triangular,tube,unarme,unarmed,unit,unknow,usually,uvenile,vary,weakly,wid,wide,ympodial	abaxial,capitate,colour,corolla,form,growth,height,history,leaf,life,ovary,reproduction,seed,shape,spacing,staman,stem,texture
594	wfo-0001030250	success	169	77	50	119	27	0.296	0.5-1,1-3,1.1-1.2,1.4-1.5,1.7-7,2.5-3.25,5-6,anther,apart,apex,berry,broadly,brown,capitate,cm,corolla,cup-shaped,dark,elliptic-ovate,filament,glabrous,globose,green,greenish-white,greenish-yellow,inflorescence,leaf,lobed,long-acuminate,minutely,mm,opposite,ovary,ovoid-reniform,pale,papillose,pedicel,petiole,pitted,sea-green,seed,shape,shrub,simple,stigma,style,surface,tan,tapering,translucent	.5,/4,0-seeded,1-1.5,1.1-3.5,1.25-1.5,1.9-2.6,11.2-22,11.3,2-2.5,2.1-6,25,3-5,3.4-6.6,3.5-4,4-7,5-50-flowered,6-8,across,anthesi,appearing,arching,attenuate,bark,base,beginning,beneath,bullate,calyx,carinate-hooded,conical,consisting,cuneate,curved,decurrent,deflexed,dia,differing,difoliate,dry,eaf,edicel,eed,elliptic,exerted,five,free,fresh,fruiting,geminat,glabrou,horizontally,inflorescenc,irregularly,lateral,lobe,lon,long,lower,main,major,maturity,middle,minor,n,nflorescence,node,occasionally,older,one,orbicular,orbiculate,pair,paler,papillo,pendulous,pit,pore,poricidal,portion,projection,prominent,proximal,raised,reflexed,rim,ruit,scar,shallow,shaped,size,slender,slightly,smooth,soon,spaced,specimen,spreading,stem,straight,tall,tear-drop,tip,translucent-green,tube,two,ud,unit,usually,vein,way,white-lenticellat,white-lenticellate,wide,widest,winged,woody,x,ympodial	0.5,5-50,abaxial,adaxial,arrangement,colour,diameter,flower,form,fruit,growth,height,history,length,life,na,number,peduncle,perennial,plant,position,rachi,reproduction,spacing,staman,texture,width
595	wfo-0001030271	success	195	83	58	137	25	0.297	0.15-0.75,0.7-9.5,1-2,1.4-2.1,15-61,2.4-5.6,3-10,3-5,4-22,4-7,6-15,acute,anther,apex,articulated,berry,blue,clavate,cm,coloration,coriaceous,corolla,dark,deep,diameter,elliptic,filament,flower,forked,fruit,glabrous,green,greenish,herb,leaf,light,lilac,medium,mm,mucilaginous,odd-pinnate,ovate,ovoid,pedicel,peduncle,pentagonal,petiole,plant,purple,rotate,seed,spot,stigma,style,terminal,white,whitish,yellow	0-2,0.5-1.2,0.9-2.5,0.9-3.6,1-2.5,1-3,1-4,1-6,1-7,1.9-6.6,2-2.7,2-3,2-4,2-6,3.4-7.5,5-8,5-merou,5.6-12.3,abaxially,acumen,adaxiall,adaxially,ag,along,alyx,apart,apparently,arranged,asymmetric,attenuate,axe,axillary,base,basiscopic,bead,blade,brownish,bud,capitat,cell,completely,condition,connivent,considerably,covering,decreasing,digestion,distal,dorsally,drying,eaf,edge,eed,enzyme,erect,exceeding,flat,folded,fresh,geminat,generally,glabrou,green-white,habi,hair-like,half,homostylous,honeycomb-shaped,interjected,lanceolate,larger,lateral,leaflet,lengthening,like,linear,living,lobe,long,lower,make,middl,moniliform,mottled,multiple,necklace,nflorescence,orbicular,orolla,pair,perfect,petiolulate,plurifoliate,pore,poricidal,removed,ripe,rosette,rounded,ruit,sessile,seudostipule,side,size,slightly,slit,sometimes,spaced,specimen,stamen,stolon,straight,subtending,symmetric,tall,tamen,tem,testal,thick,throughout,tip,tissue,toward,tri-,tube,tuber,typically,unit,unwinged,usually,vary,vein,wall,wet,wide,x,ympodial	abaxial,adaxial,arrangement,capitate,colour,form,growth,height,history,inflorescence,length,life,na,number,ovary,perennial,position,rachi,reproduction,shape,spacing,staman,surface,texture,width
596	wfo-0001030272	success	179	66	43	136	23	0.24	-6,.5,0.5-1.5,0.65-1,0.7-2.5,0.8-1.5,1,1.2-1.8,1.5-2.5,3.5-5,4-8,anther,bright,cm,diameter,elliptic,evenly,filament,flattened-reniform,flower,fruit,glabrescent,glabrous,green,leaf,length,less,lobed,mauve,membranous,mm,orange-brown,pedicel,peduncle,petiole,red,red-brown,shrub,spherical,stellate,style,surface,unbranched	.3,/4,0-20,0.05-0.1,0.05-1.5,0.5-1,0.5-2,0.6-0.9,1-1.5,1-2.8,1.5-3,1/3,1/3-2/3,10-20,2-2.5,2-6.5,2.5-3,2.5-3.5,2.8-3.5,3-8,4-10,4-15,4-6,5-7,5-merous,abaxially,acut,acute,almost,alyx,ame,apar,apex,apically,apparently,articulated,ba,bark,base,berry,blade,c.,calyx,concolorous,connivent,deltate,densely,difoliate,drying,eaf,eed,elongating,entire,equal,erect,free,fruiting,geminat,glabrescen,gland,glandular,gra,hair,infructescence,lateral,lobe,long,long-attenuate,longer,lower,margin,mature,maturity,midpoint,minute,moderately,multangulate,narrow-deltate,near,nflorescence,obtuse,older,one,open,orolla,oung,pair,per,perfec,pericarp,poricidal,porrect,portion,primary,ray,reduced,reflexe,rounded,ruit,scar,sessile,shallowly,shorte,simple,slender,smooth,sometimes,spaced,sparsely,spreading,stellate-pubescent,stem,straight,tamen,tapering,terete,terminal,tertiary,time,tip,trichome,tube,unarme,unarmed,undulate,unit,upper,vary,vein,venation,visible,way,wide,woody,ympodial,young	abaxial,adaxial,apart,colour,corolla,form,growth,height,history,inflorescence,life,number,ovary,perennial,plant,reproduction,seed,shape,spacing,staman,stigma,texture,unknown
597	wfo-0001030278	success	235	107	84	151	23	0.357	0-0.2,0-1,0.6-1,1-2,12-25,2,2-6,3-4,5-20,6-12,7-10,7-12,abaxially,achlorophyllous,adaxial,adaxially,anther,apex,base,branched,broadly,brown,closely,cm,coarsely,contiguous,corolla,dark,densely,diameter,divergently,ellipsoid,elliptic,elongate,erect,extra-axillary,filament,flexuous,flower,fruit,glabrous,hermaphroditic,hirsute,inflorescence,length,lenticular,lignescent,midpoint,minutely,mm,moderately,nearly,orange,outline,ovate,pedicel,peduncle,perennial,petiole,pitted,prickly,pubescent,rachi,ripe,sessile,simple,slender,spaced,sparsely,spreading,spreading-hirsute,stellae,stellate,stigma,style,subglobose,surface,tan,thin-textured,truncate,unbranched,white,x,yellow	0.1-0.3,1-several,1/3-1/2,10-20,10-30,15-20,2-4,2-7,2-foliate,2.5-3,3-5,3-7,3.5-5,3.5-7,4-12,4-8,4-locular,5-8,6-18,7-20,8-30,9-18,absent,accrescent,acute,acute-,adaxiall,along,also,armed,articulated,ascending,attenuate,axe,ba,basally,blade,breaking,broad-based,calyx,capitat,capitate-glandular,cauline,collection,commonly,completely,compressed,concentrated,connivent,cordate,covering,cylindrical,deltoid,density,dentate,directed,distal,distall,eaf,eed,entire,female-sterile,finally,fine,flesh,fruiting,geminat,glabrou,gland-tipped,glandular-puberulen,hair,immature,inserted,interlobal,intermixed,large,lateral,laterally,less,linear-lanceolate,lobe,long,longer,lower,major,margin,maturit,medium-sized,midrib,mixed,mostly,much,narrowly,nflorescence,numerous,obtuse,obtuse-tipped,occasionally,often,open-campanulate,orolla,ovate-lanceolate,pale,per,petaloid,pore,prickle,principal,prominent,ray,recurved,reduced,resembling,rigid,ruit,section,short-stalked,short-styled,side,similar,sinus,small,smaller,sometimes,somewhat,stalked,ste,stem,straight,straighter,subequal,surrounding,tal,tamen,tem,termination,tip,toothlike,trichome,tube,unarmed,uniseriate,unit,usually,vary,varying,vein,weakly,wide,widely,ympodial	abaxial,arrangement,capitate,colour,dense,form,growth,height,history,leaf,life,na,number,ovary,plant,position,reproduction,seed,shape,spacing,staman,texture,width
598	wfo-0001030281	success	193	84	66	127	18	0.342	0.5-1.0,0.5-3,1-2,1-2.5,10-13,10-14,12-16,12-20,2-4.5,2.5-5,3-12,3-6,4-7,5-10,abaxial,acute,adaxial,andromonoecious,anther,apex,brown,capitate,chartaceous,cm,dark,densely,diameter,filament,flower,fruit,functionally,glabrous,globose,green,hermaphroditic,leaf,lobed,male,many,mm,moderately,netlike,orange,ovate,pedicel,peduncle,petiole,pit,plant,pubescent,rachi,raised,red,reniform,ridge,separated,small,stigma,style,surface,unbranched,vine,white,whitish-green,x,yellow	0.2-0.8,0.5,0.5-1,0.5-1.5,1,1-.,1.5,1.5-3,10-25,2-4,2-5,2.5-3,2.5-3.5,20-30,4-6,4-8,5-16,5-merou,6-8,abaxially,absen,absent,accrescent,adaxiall,adaxially,alyx,anthesi,apar,apical,armed,asymmetrical,attenuate,axe,base,berry,beyond,blade,calyx,connivent,cordate,curved,cylindrical,difoliate,directed,discolorous,distally,eaf,eed,either,em,expanded,exserted,extra-axillary,flattened,frui,fruiting,geminate,glabrou,glandular,gree,hair,heteromorphic,interpetelar,introrsel,lacking,leathery,like,lobe,long,long-styeld,lower,major,mature,midpoint,midrib,midvein,multicellular,multiseriate,narrowly,nearly,nflorescence,obtuse,often,older,orolla,pair,per,planst,pore,porrect-stellate,prickle,ray,recurved,reflexed,roselike,ruit,rusty,short,short0styled,side,simple,slightly,spaced,sparsely,stalk,stamen,staminate,ste,stellate,stem,tamen,tan,tapering,tissue,triangular,tube,unarmed,unequa,unicellular,unit,unlobed,usually,vary,vein,wide,ympodial,young	1-4,5-merous,apart,colour,corolla,form,growth,height,inflorescence,length,number,ovary,reproduction,seed,shape,spacing,staman,texture
599	wfo-0001030285	success	279	120	96	183	24	0.344	.1,.6,1.6–5.0,1/3,10.8–12.3,2.2–4.8,3.5–6.0,3.7–5.4,4,4.3–11.8,45,5,9.9–14.9,abaxially,acuminate,adaxial,adaxially,age,alveolate,anther,apart,apex,area,base,becoming,capitate,central,channel,chartaceous,cm,congested,corolla,densely,diameter,distally,dry,elliptic,erect,extra-axillary,filament,flattened-irregular,flattened-orbicular,flattened-reniform,flower,fruit,glabrous,globose,gradually,green,growth,homostylous,increasing,internode,interpetalar,lateral,lavender,leaf,long,many-flowered,margin,maturing,mm,moderate,moderately,nearly,obovate,ovoid,pedicel,peduncle,petiole,poorly-developed,pubescence,pubescent,purple,red,restricted,shrub,simple,slightly,small,smooth,sparse,stellate,stigma,straight,style,surface,tall,tissue,tree,upper,white,yellow,yellow-ferruginous,young,±glabrous	.04,.4,.8,0.1–1.1,0.2–0.3,0.3–0.4,0.3–0.6,0.3–0.7,0.4–0.5,0.4–0.6,0.5–0.7,0.6–0.9,0.7–1.1,0.7–1.3,0.7–1.5,0.7–1.7,0.9–1.5,1.0–1.3,1.0–2.2,1.2–2.1,1.2–2.3,1.3–1.8,1.4–1.9,1.4–2.0,1.6–2.3,1.9–4.0,10–14,13.5,15.0–25.5,1984,2.4–3.2,2.8–3.1,3/4,4.0–7.0,4.6–8.8,4–5-merou,5.7–6.5,6.0–9.0,6–10,6–8-ray,9.2–15.2,90°,adnate,aequilateral,alyx,anthesi,apical,apiculate,apparently,appearing,appressed,armed,articulated,attached,attachment,attenuate,axe,ba,basal,berry,bilobe,blade,branch,brochidodromous,bu,bud,calyx,channeled,clinate,conical,connivent,cuneate,deciduous,dehiscence,dentate,difoliate,dorsally,eaf,eed,either,emerging,enclosing,endocarp,entire,exocarp,fertile,filiform,flat,flexed,fork,forking,free,frui,fully,geminat,glandular,hair,immature,inclined,intersepalar,juic,lanceolate,large,laying,less,line,lobe,lon,lower,major,mature,midpoint,midrib,midvein,minor,minute,nflorescence,notched,oblique,occasionally,often,orolla,peekel,per,perforate,point,pore,porrect,porrect-stellate,portion,potentially,prickle,protuberance,raised,ray,reduced,reported,rigid,ripe,rounded,row,ruit,sessile,shiny,shorter,side,single,sinus,soon,sparsely,splitting,spread,stellae,stellate-pubescent,stem,suture,tamen,tem,thin,time,tip,toward,transparent,triangular,truncate,tube,two,ud,unarme,unarmed,unbranched,vary,vein,vigorous,wavy,weakly,wide,ympodia,±90°,±90°and,±equal,±overlapping,×	4–5-merous,abaxial,arrangement,bilobed,colour,form,height,history,inflorescence,length,life,na,number,ovary,perennial,plant,position,rachi,reproduction,seed,shape,spacing,staman,texture
600	wfo-0001030287	success	150	92	61	89	31	0.407	-11,-40,0-15,0.5-1,1-10,1-15,1-2,1-4,1-5.5,1.5-2.5,1966,2-,2-12,3-9,4-5,4.5-6,apart,apex,bluish,chartaceous,cm,compound,dendritically,densely,diameter,down,ellipsoidal,elliptic-ovate,fide,flattened,flower,forked,glabrous,herb,leaf,lilac,membranaceous,mm,moderately,ovoid,pedicel,peduncle,petiole,pinnately,pubescent,purple,rachi,rugulose,shrub,simple,smith,stellate,stigma,strongly,style,subcoriaceous,truncate,unbranched,unknown,x,yellow	-foliat,-many,.5-2.5,1,1-2.5,1-3,1.5-10,2,2-10,2-5,2.5-4,3,4-6,5-10,8-13,?,abaxially,acute,adaxiall,adaxially,aggregate,articulated,axe,base,basiscopically,blade,branched,calyx,cell,color,connivent,cylindrical,decurrent,deltate,dendritic,dendritic-pubescen,directed,distall,eaf,eed,eglandular,entire,gland,glandular,hair,lanceolate,lateral,leaflet,leaving,lobe,lon,long,long-stalked,lower,margin,narrowly,nflorescence,nther,oblong,obtuse,often,orolla,pedicellar,pore,presen,puberulent,radiu,ruit,scar,scattered,slightly,spaced,sparsely,sparser,stalked,stone,subcapitat,subcordate,tal,tem,time,tip,triangular,tube,unit,upper,vary,wide,ympodial	abaxial,adaxial,anther,arrangement,colour,corolla,dendritic-pubescent,filament,form,fruit,growth,height,history,inflorescence,length,life,na,number,ovary,perennial,plant,position,reproduction,seed,shape,spacing,staman,subcapitate,surface,texture,width
601	wfo-0001030299	success	179	88	61	118	27	0.341	-40,-50,1-1.5,1-10,1.5-2,1.5-3,10-20,2-,2-10,2-20,2.5-12,25-50,3-13,3-9-compound,4-6,6-22,6-9,abaxially,adaxially,apart,apex,campanulate,capitate,cm,densely,diameter,ellipsoidal,flattened,flower,forked,fruit,glabrous,leaf,mm,moderately,ovate,pedicel,peduncle,petiole,pink,pinnately,pubescent,pubescent-pilose,purple,rachi,rugose-reticulate,shrub,simple,small,sparsely,stigma,style,tomentose,tree,truncate,unbranched,urceolate-,violet,white,x,yellow	-2,-6,.5-2,0.5-1,1-2,1-3,1-5,1.5-4,10-16,2,2-4,20-30,3,3-30,3-4,3-5,4,4-5,4-8,4-foliat,5-10,5-40,5-8,?,absen,absent,acuminate,acute,aggregate,also,ape,apiculate,articulated,axe,basal,base,basiscopically,beyond,blade,calyx,cell,chartaceous,color,compound,connective,connivent,cordate,coriaceous,cylindrical,decurrent,diamete,dilated,directed,distally,eaf,eed,entire,equal,exceeding,expanded,exserted,fide,globose,hair,lateral,laterally,leaflet,leaving,lobe,lon,long,lower,margin,midnerve,narrowly,nflorescence,nther,obtuse,often,orolla,pavón,pedicellar,perfect,perhaps,pilose-hirsute,pore,present,prominent,puberulent-pubescen,puberulent-pubescent,pubescent-pilo,radiu,remnant,ruit,ruiz,shorter,slightly,spaced,stamen,stone,tal,tem,thecae,thickened,time,tip,tomento,toward,triangular,tube,ud,unequal,unit,unknow,upper,vary,wide,ympodial	abaxial,adaxial,anther,arrangement,colour,corolla,filament,form,growth,height,history,inflorescence,length,life,na,number,ovary,plant,position,reproduction,seed,shape,spacing,staman,surface,texture,width
602	wfo-0001030300	success	235	84	63	172	21	0.268	-1,-7,0.5,0.5-4,0.6-0.8,0.9-1,1,1-2,1-4,2-2.1,4-11,6-15,abaxially,adaxial,anther,apex,bifid,broadly,brown,capitate,cm,corolla,densely,diameter,elliptical,filament,flower,fruit,globose,golden,green,hair-like,herb,imparipinnate,inflorescence,interrupted,large,less,mm,moderately,obovate,once-branched,orbicular,outgrowth,ovary,pale,pedicel,peduncle,pentagonal,perennial,petiole,plant,pubescent,rounded,simple,slightly,sparsely,stigma,style,surface,yellow,yellowish,zygomorphic	-0.9,.5,0.1,0.1-0.15,0.15-1,0.2,0.2-0.5,0.2-1.5,0.4-0.5,0.4-1.5,0.4-4.5,0.5-0.6,0.5-1,0.5-5,0.6-0.7,0.7-0.8,0.7-1.2,0.7-1.5,0.8-1,0.8-3,0.8-4,1-1.3,1-2-celled,1-6,1-celled,1.2-,1.4-2.4,1.5-,1.5-2.5,2-2.5,2-3,2-4,2-foliate,2-locular,2.2-7.5,3.5-13,3/4,4-celled,6-8-celled,9-12,absent,abundant,acute,adaxially,almost,although,always,anthesi,apical,appearance,appendage,articulated,articulation,ba,basal,base,bent,beyond,bract,bracteate,brittle,calyx,cell,coherent,column,cordate,crenat,crenate,curved,deltate,developed,diamete,distal,eaf,edicel,eed,eglandular,ellipsoidal,elongate,entire,even,exserted,face,finely,frequently,fruiting,give,glabrous,glandular,glutinous-viscose,gree,halfway,head,interjected,internode,introrse,irregularly,lamina,larger,lateral,leaflet,leave,like,lobe,lon,long,longer,margin,markedly,midvein,minute,multicellular,narrowly,nflorescence,node,oblique,occasionally,pair,papillae,partially,petal,petiolule,pith,population,pore,present,primary,pseudostipule,pubescence,reflexed,rest,ruit,secondary,silky,spathulate,spreadin,spreading,staminal,stem,sterile,straight,strongly,tall,tem,terminal,tertiary,testa,thick,tip,triangular,trichome,tube,two,ud,underlying,unicellular,uniseriate,unit,united,upper,usually,vein,velvety,wall,weak,well,wide,wider,winged,woody,yellowish-green,ympodial	abaxial,arrangement,colour,form,growth,height,history,leaf,length,life,na,number,position,rachi,reproduction,seed,shape,spacing,staman,texture,width
603	wfo-0001030311	success	182	82	45	137	37	0.247	.2,5-pinnate,abaxially,adaxial,adaxially,anther,apex,brown,chartaceous,cm,densely,diameter,extra-axillary,filament,flower,fruit,glabrous,granular,green,herbaceous,lenticular,membranaceous,membranous,mm,orangish,ovoid-rhomboid,pedicel,peduncle,petiole,pubescent,purplish,rachi,sand-punctate,slender,sparsely,stellate,stigma,style,surface,tan,terrestrial,unbranched,vine,white,x	.5,.5–1.8,0.1,0.1–0.2,0.3–1.5,0.4–2,0.5–0.8,0.5–1,0.5–2,0.5–2.5,0.6–1,0.6–2.4,0.8–1.2,0.8–4,0.8–4.5,1.2–7,1.5–2,1.5–3,1.5–5.5,1.5–6,1.5–8,1.8–2,15–22,1–1.2,1–1.5,1–2,1–2.5,1–3,2.2–2.5,2.2–3,2.5–9,2–10,2–2.5,2–6,3–5,3–7,5–10,<,accrescent,acuminate,acute,along,alyx,apar,apical,appearance,axe,basal,base,berry,blade,c.,calyx,capitat,ciliat,ciliate,clavate,color,cordate,cuneate,deltoid,dense,distal,eaf,eed,elliptical,entire,especially,falcate,fallen,flattened,fruiting,giving,glabrou,groov,groove,ground,hair,half,lanceolate,lateral,leaflet,like,lobe,log,lon,long,lower,m.,margin,midvein,minutely,nflorescence,nternode,oblique,obovate,obtuse,occasionally,orolla,pair,papillose,petiolulate,petiolule,plurifoliat,present,proximal,pubescence,rhomboid,rounded,ruit,scattered,sessile,short,shortly,side,slightly,smaller,spaced,stem,strongly,tamen,tem,thick,thickened,thinner,tip,trailing,trichome,tube,unit,upper,vary,vein,wide,wide-diameter,widely,ympodial	0.5-1,0.6-1,0.8-1.2,1-1.5,1-3,1.5-5.5,15-22,2-10,2-2.5,2-6,3-5,3-7,5-10,abaxial,apart,arrangement,capitate,colour,corolla,form,growth,height,inflorescence,leaf,length,na,number,ovary,plant,position,reproduction,seed,shape,spacing,staman,texture,width
604	wfo-0001030311	success	203	81	55	148	26	0.271	.2,0.5-1,0.6-1,0.8-1.2,1-1.5,1-3,1.5-5.5,15-22,2-10,2-2.5,2-6,3-5,3-7,5-10,abaxially,adaxial,adaxially,anther,apart,apex,brown,chartaceous,cm,densely,diameter,filament,flattened,flower,fruit,glabrous,granular,green,herb,lenticular,membranaceous,mm,orangish,ovoid-rhomboid,pedicel,peduncle,petiole,pubescent,purplish,rachi,slender,sparsely,stellate,stigma,style,surface,tan,unbranched,white,x,yellow	.5,.5-1.8,0-2.5,0.1,0.4-2,0.5-0.8,0.5-2,0.6-2.4,0.8-4,0.8-4.5,1-1.2,1-2.5,1.2-7,1.5-2,1.5-3,1.5-6,1.5-8,1.8-2,2.2-2.5,2.2-3,2224,5-merou,5-pinnate,8031,<,[,],absen,absent,accrescent,acuminate,acute,ag,aggregate,along,alyx,apical,apparently,appearance,articulated,axe,ba,basal,basally,base,blade,capitat,cell,ciliat,ciliate,clavate,color,connivent,cordate,cuneate,deltoid,dense,dig,directed,distal,distally,eaf,eed,elliptical,entire,equal,especially,falcate,fallen,formation,g,geminat,gh,giving,groov,groove,ground,hair,half,interjected,large,lateral,leaflet,like,lobe,log,lon,long,longitudinal,lower,m.,margin,midvein,minutely,nflorescence,node,oblique,oblong,obovate,obtuse,occasionally,opening,orolla,pair,papillose,perfect,petiolulate,petiolule,pittier,plurifoliate,pore,present,proximal,rhomboid,rooting,rounded,ruit,scattered,sessile,short,shortly,side,simple,sinple,slightly,slit,smaller,spaced,stem,stone,strongly,tamayo,tamen,tem,thick,thickened,thinner,tip,trailing,tube,uniseriate,unit,upper,vary,vein,wide,widely,ympodial	abaxial,arrangement,capitate,colour,corolla,form,growth,height,history,inflorescence,leaf,length,life,na,number,ovary,pinnate,plant,position,reproduction,seed,shape,spacing,staman,texture,width
605	wfo-0001030335	success	153	102	72	81	30	0.471	.1,.25,0-5,0.25-0.5,0.7-1,1-2,1.1-1.4,2-2.5,2-5,3/4,5-6,acute,along,anther,apex,base,beneath,berry,bi-lobed,calyx,cm,corolla,dark,decurrent,densely,dia,dry,elliptic,filament,filiform,gently,glabrous,globose,green,leaf,lobed,long,material,minutely,mm,narrowly,onto,opposite,ovary,ovoid-reniform,pale,papillose,pedicel,petiole,pitted,prominent,puberulent,pubescent,raised,ripe,shrub,simple,slightly,sparsely,stigma,style,surface,tan,tapering,trichome,tube,uniseriate,vein,way,white,yellow,yellowish-green	.5,.75,0.05-0.2,0.1-0.5,0.5-1,1-1.5,1-3-flowered,1.1.5,2-2.2,2-4.5,2.5-3,5-7,7-13,acuminate,anthesi,aspec,ba,bark,branch,bud,conical,deciduous,deflexed,deltoid,eaf,edicel,eed,erect,except,expanded,exserted,flattened,free,fruiting,geminate,giving,greyish-red,horizontally,lamina,lateral,lenticellate,lightly,like,lobe,lon,lower,main,middle,minute,nflorescence,obovoid,occasionally,often,older,pair,papillo,pore,poricidal,portion,puberulen,reflexed,ruit,shaped,soon,spreading,stem,straight,strongly,tall,tear-drop,tip,ud,underside,unifoliat,unit,widest,winged,woody,x,ympodial,young	1-3,abaxial,adaxial,arrangement,colour,diameter,flower,form,fruit,growth,height,history,inflorescence,length,life,na,number,peduncle,perennial,plant,position,rachi,reproduction,seed,shape,spacing,staman,texture,unifoliate,width
606	wfo-0001030336	success	266	105	78	188	27	0.293	0.15-0.2,0.5,0.5-0.7,1-1.5,1-3,1.5-2,1.7-2.3,4-10,8-20,acute,almost,anther,apex,articulated,bifurcate,bluntly,bright,brown,calyx,capitate,cm,conical,corolla,crenate,dark,deeply,densely,diameter,elliptic,elongate,entire,filament,flower,fruit,fruiting,globose,grayish,green,greenish,hair-like,herb,imparipinnate,inflorescence,interrupted,lanceolate,leaf,less,lobed,margin,mm,obovate,once-branched,orbicular,outgrowth,ovary,pedicel,peduncle,perennial,petiole,pubescent,rachi,rotate,rounded,shrub,simple,slightly,small,stellate,stem,stigma,style,surface,trichome,uniseriate,usually,velvety,white,yellow	-1.5,-10,-19,-2,.5,0-,0.1-0.3,0.1-0.5,0.1-0.7,0.1-1,0.15-0.9,0.2,0.2-0.25,0.2-0.8,0.2-1,0.2-1.5,0.3-0.4,0.3-1.1,0.5-1,0.5-1.5,0.6-0.8,0.6-1.5,0.8-0.9,0.8-1.2,0.8-1.3,0.8-3,1,1-1.4,1-celled,1.0-1.4,1.5-,1.5-3.5,1.5-5,1.6-7,1.8-3.0,1/4-1/3,10,2-4,2-9,2-foliate,2-locular,2/3,3-5,4,4-,4-celled,6,8-16,8-celled,absent,adpressed,amongst,anthesi,apical,appearance,appearing,appendage,articulation,basal,base,basiscopically,bent,berry,bract,bracteate,branch,cell,clavat,coat,column,completely,cordate,curved,darker,decurrent,developed,diamete,distal,divided,eaf,edicel,eed,eglandular,entir,erect,essentially,exserted,extremely,first,flushed,giving,glandula,glandular,half,halfway,head,interjected,internode,investing,large,larger,largest,lateral,leaflet,leave,like,lobe,lon,long,longer,loosely,lower,markedly,maturity,mere,middl,midvein,minute,minutely,mixed,mostly,narrowing,narrowly,nflorescence,node,oblique,occasionally,often,pair,pale,papillate,part,petiolule,population,present,primary,proximal,pseudostipule,puberulent,purple,range,reflexed,rest,ruit,scattered,secondary,sessile,shaggy,shorter,silky,sinus,soft,sometimes,southern,sparse,spreadin,spreading,staminal,sterile,straight,stripe,strongly,surrounding,tall,tem,ten,terminal,tertiary,testa,thick,tip,truncate,tube,two,ud,unicellular,uniformly,unit,united,upper,wall,way,weak-walled,wide,winged,woody,ympodial,young	1.5-4,abaxial,adaxial,arrangement,bark,bud,clavate,colour,form,growth,height,history,length,life,na,new,number,plant,position,prickle,reproduction,seed,shape,spacing,staman,texture,width
607	wfo-0001030342	success	155	80	52	103	28	0.335	.2,0.8–1.5,1-6.5,1.5–13,1.5–5,10–25,1–1.5,2–2.5,3-pinnate,3–12,4–5,4–8,5-merous,abaxially,adaxially,anther,brown,chartaceous,cm,diameter,entire,extra-axillary,filament,flower,fruit,glabrous,greenish,herbaceous,leaf,lenticular,light,margin,membranous,mm,ovoid-rhomboid,pedicel,peduncle,petiole,pubescent,rachi,rarely,smooth,stellate,stigma,style,surface,unbranched,undulate,vine,white,x,yellowish	.5,0.1–0.2,0.3–1.2,0.5–1,0.5–3,0.5–5,0.8–4,1-5,1.2–3,1.5,1.5–2,1.5–7.5,1–1.2,1–2.5,1–3,1–5.5,1–6,1–7,2–,2–4,3,6–7,abundant,accrescent,acuminate,acute,along,alyx,apar,apex,apical,apiculate,axe,base,berry,blade,broadly,c.,calyx,capitat,ciliat,cordate,cuneate,cylindrical,deltoid,dense,eaf,eed,elliptical,flattened,fruiting,glabrou,lanceolate,lateral,leaflet,like,lobe,lon,long,lower,m.,minutely,mottled,nflorescence,nternode,oblique,obtuse,often,orolla,perfec,petiolule,plurifoliat,pointed,proximal,pubescen,revolute,rhomboid,rounded,ruit,sand-punctate,scattered,side,slender,slightly,spaced,sparsely,stem,tamen,tem,terrestria,tip,trichome,truncate,truncate-acuminat,tube,unit,vary,vein,wide,wide-diameter,widely,ympodial,–7	2–7,abaxial,adaxial,apart,arrangement,capitate,color,corolla,form,growth,height,history,inflorescence,length,life,na,number,ovary,perfect,plant,position,reproduction,seed,shape,spacing,staman,terrestrial,texture
608	wfo-0001030342	success	153	84	57	96	27	0.373	-7,.2,1-1.5,1-6.5,1.5-13,1.5-5,10-25,2-2.5,2-3,3,3-12,3-pinnate,4-5,4-8,abaxially,adaxially,anther,apart,apex,brown,chartaceous,cm,diameter,extra-axillary,filament,flower,fruit,glabrous,hair,herb,leaf,lenticular,light,membraceous,mm,pedicel,peduncle,petiole,pubescent,rachi,rarely,scattered,simple,slender,smooth,stellate,stigma,style,surface,terrestrial,trailing,unbranched,uniseriate,white,widely,x,yellow	.5,0.5-1,0.5-3,0.5-5,0.8-4,1-1.2,1-3,1-5,1-5.5,1-6,1-7,1.2-3,1.5-2,1.5-7.5,2-,5-merou,6-7,absent,abundant,accrescent,acuminate,acute,ag,along,alyx,apical,apiculate,apparently,articulated,axe,ba,basally,base,blade,broadly,calyx,capitat,ciliat,connivent,cordate,cuneate,cylindrical,deltoid,directed,distally,eaf,eed,elliptical,entire,equal,fruiting,geminat,interjected,lanceolate,lateral,leaflet,lobe,long,longitudinal,lower,margin,minutely,nflorescence,node,oblique,oblong,obtuse,opening,orolla,perfect,petiolule,plurifoliate,pore,proximal,pubescen,revolute,rhomboid,rooting,rounded,sagittate,side,slightly,slit,spaced,tamen,tem,tip,truncate,truncate-acuminat,tube,undulate,unit,vary,vein,wide,ympodial	5-merous,abaxial,adaxial,arrangement,capitate,colour,corolla,form,growth,height,history,inflorescence,length,life,na,number,ovary,perennial,plant,position,reproduction,seed,shape,spacing,staman,texture,width
609	wfo-0001030353	success	227	94	76	151	18	0.335	-6,-merous,.7,0-6,0.5-0.9,0.8-1.2,1-2,1-6,1-7,1.8-3,1/2-2/3,3-5.5,3.5-4,5,abaxial,abaxially,acute,adaxial,almost,andromonoecious,anther,apart,apex,articulated,base,berry,brown,chartaceous,cm,connivent,densely,diameter,ellipsoid,elliptic,erect,evenly,filament,flattened-reniform,flower,fruit,green,leaf,length,lobed,long,long-styled,maturity,mauve,mm,moderately,pedicel,peduncle,petiole,plant,poricidal,reddish-green,shape,short-styled,shrub,small,smooth,sometimes,stellate-pubescent,stout,straight,style,surface,tapering,tip,tree,unbranched,warty,way,white-gray,yellow,young	-0.2,-1.5,-1/2,-2,-3,-5,.1,.2,.5,0,0-15,0-2,0.1-0.2,0.1-0.3,0.15-0.3,0.5,0.8,1,1-3,1.2-1.8,1.8-2.2,1/,1/3,1/5,1/6,1/6-1/4,10-15,11-16,2-10,2-7,2.5-4,2.8-3.7,20-200,3-4,4-,4-4.5,4-5,5-6,6,6-15,6-8,7-10,8-15,alyx,apar,apically,apiculat,apparently,bark,blade,broad-deltate,c.,calyx,conical,cuneate,curved,deltate,development,discolorous,distal,distance,drying,eaf,eed,elongating,equal,extending,flattened,free,fruiting,glabrescent,glabrous,half,hermaphrodite,heterostylous,infructescence,lateral,less,lobe,longer,lower,lowermost,margin,mature,midpoint,midvein,multangulate,narrow-deltate,nflorescence,older,one,open,orange-brown,orolla,oung,pair,patch,pendulous,per,pericarp,plurifoliat,pointed,porrect,portion,prickle,prickly,primary,ray,red-brown,reflexed,retaining,rounded,ruit,scar,sessile,shorter,side,simple,somewhat,spaced,sparsely,spreading,stalk,stalked,staminat,stellate,stem,strongly,subentire,tamen,terete,terminal,tertiary,throughout,time,trichome,tube,unarme,unarmed,unit,upper,vary,vein,venation,visible,weakly,whit,wide,wo,woody,ympodial	/,colour,corolla,form,growth,height,history,inflorescence,life,number,ovary,perennial,reproduction,seed,spacing,staman,stigma,texture
610	wfo-0001030407	success	182	87	62	120	25	0.341	.5,1-10,1-2,12-14,12-15,2-7,3-6.5,3.5-9.5,30-60,4-5,7-8,abaxially,adaxially,anther,apex,berry,brownish,cell,cm,condition,conical,corolla,covering,densely,diameter,drying,elliptic-lanceolate,filament,flower,forked,fresh,fruit,glabrous,green,greenish,hair-like,herb,lateral,leaf,light,long,mm,odd-pinnate,ovate,ovoid,pedicel,peduncle,pentagonal,petiole,plant,pubescent,purple,ripe,seed,stigma,style,terminal,testal,thick,wall,whitish,yellow	.2,0.7-3.2,1-3,1-4,1.5-5,2-2.5,2-5,2-6.7,3-10.5,3-4,3-9,5,5-merou,6-7,6.5-18.5,absent,acumen,acuminate,ag,alyx,apart,apparently,articulated,axe,axillary,base,blade,bud,capitat,chartaceous,ciliate,connivent,decreasing,digestion,distal,dorsally,eaf,edge,eed,end,enzyme,especially,exceeding,flat,folded,geminat,generally,glabrou,gradually,green-white,hair,half,homostylous,honeycomb-shaped,interjected,lanceolate,larger,leaflet,lengthening,like,living,lobe,lower,make,margin,middle,minute,mottled,mucilaginous,nflorescence,obtuse,one,orolla,pair,perfect,petiolule,placed,plurifoliate,pore,poricidal,proximal,pubescen,ray,removed,round,ruit,secondary,semierec,seudostipule,size,slit,spaced,specimen,stamen,ste,stolo,subequal,subsessile,subtending,symmetrical,tall,tamen,tem,thir,throughout,tip,toward,tri-,tube,tuber,typically,unit,unwinged,usually,vary,wet,white,wide,x,ympodial	abaxial,adaxial,arrangement,capitate,colour,form,growth,height,history,inflorescence,length,life,na,number,ovary,perennial,position,rachi,reproduction,shape,spacing,staman,surface,texture,width
611	wfo-0001030417	success	242	83	62	180	21	0.256	-5,0.5-0.7,0.5-1,0.7-1,1-1.3,1.2-3,2-3,3,4-25,7-30,abaxially,annual,anther,apex,biennial,bright,broadly,brown,capitate,cm,conical,corolla,densely,diameter,elliptic,filament,flower,fruit,glandular,globose,green,hair-like,herb,imparipinnate,inflorescence,interrupted,leaf,length,minutely,mm,obovate,occasionally,once-branched,outgrowth,ovary,ovate,pale,pedicel,peduncle,perennial,petiole,pubescent,rachi,red,simple,sparsely,stellate,stigma,style,surface,white,yellow	.5,0.05-0.1,0.1-0.25,0.2,0.2-0.4,0.2-0.7,0.25-0.4,0.25-0.5,0.3-0.4,0.5-0.8,0.5-1.2,0.5-2,0.8,1,1-1.2,1-1.5,1-2,1-2-celled,1-2.3,1-3.5,1-4,1.5-2,1.5-3.5,1.5-5,1.5-8,1/3,2-4,2-8,2-locular,2.5-5,2/3,3-foliate,3/4,4-12,8-11,absen,absent,abundant,acuminate,acute,along,also,anthesi,apical,appearance,appendage,articulation,basal,base,basiscopically,bent,branch,calyx,cell,cente,column,common,cordate,crenate,decreasing,decurrent,dentate,distal,eaf,ebracteate,edicel,eed,eglandular,elongate,entire,erect,exserted,extended,extending,extremely,free,fruiting,generally,giving,glabrous,gree,hal,head,hybrid,included,initially,interjected,internode,lanceolate,larger,largest,later,lateral,leaflet,like,lobe,lon,long,lower,margin,maturation,mature,minute,mixture,multicellular,narrowly,nflorescence,northern,oblique,often,pair,parallel,part,patent,pedice,peruvian,petiolule,point,population,portion,primary,procumbent,proximal,pseudostipule,pubescence,putatively,range,rarely,reflexed,rest,ripe,robust,round-crenate,rounded,ruit,scattered,secondary,sessile,several,shaggy,short,silky,size,slightly,sometimes,somewhat,species,staminal,stem,sterile,straight,strongly,tem,terminal,tertiary,testa,theseadpressed,thick,thin,third,tip,toward,trichome,truncate,tube,type,ud,unicellular,uniseriate,unit,usually,variable,vein,velvety,viny,wall,way,wide,winged,ympodial	0.8-5,abaxial,adaxial,arrangement,colour,form,growth,height,history,life,na,number,plant,position,reproduction,seed,shape,spacing,staman,texture,width
612	wfo-0001030420	success	170	101	74	96	27	0.435	-20,-30,-9,-pubescent,0.5-1,0.5-4,0.5-8,1-,1-3,1-4,1-6,1.5-3,10-,15-25,2-,2-3,2-6,2-9,3-lobed,4-7,5-,5-15,6-7,abaxially,adaxially,also,apart,apex,articulated,base,chartaceous,cm,densely,diameter,eglandular,ellipsoidal,elongated,flower,forked,fruit,glabrous,glandular-puberulent,hair,leaf,long,mm,moderately,often,pedicel,peduncle,petiole,pilose,pinnately,puberulent,puberulent-pubescent,pubescent-pilose,purple,rachi,rarely,shrub,simple,small,sparsely,stellate,stigma,style,subcoriaceous,tree,truncate,unbranched,unknown,unlobed,x,yellow	-2,-35,-4,0.5-,1,1-1.5,1-2,1-7.5,1.5-5,1/2,10-25,2-14.5,2-5,3-7,4-foliat,5-6,7-19,7-22,7/8,absent,acuminate,acute,aggregate,ape,axe,basal,beyond,blade,calyx,cell,color,connective,connivent,cordate,cylindrical,dark,deltate,directed,distally,divided,eaf,eed,eglandular-pilo,eglandular-puberulent,elliptic-ovate,entire,equal,exserted,glabrate,glandular-,lanceolate,leaving,lobe,lobed,lon,lower,margin,midrib,narrowly,nearly,nflorescence,nther,obtuse,orolla,ovate,pedicellar,perfect,pore,presen,pubescent,pubescent-pilo,radiu,remnant,ripe,ruit,shorter,sinus,spaced,stamen,stone,tal,tem,thecae,time,tip,tomento,triangular,truncat,tube,ud,unit,vary,vein,wide,yello,ympodial	abaxial,adaxial,anther,arrangement,colour,corolla,filament,form,growth,height,history,inflorescence,length,life,na,number,ovary,plant,position,reproduction,seed,shape,spacing,staman,surface,texture,width
613	wfo-0001030426	success	158	74	49	109	25	0.31	-30,0.4-0.7,1-4,1-4.2,15-25,2.5-4,2.5-6,3-12,6-8,9,apex,branched,cm,corolla,cyme,diameter,dichasial,dichasially,distal,ebracteate,filament,flower,glandular,globose,green,green-white,half,heart-shaped,herbaceous,leaf,mm,monochasial,mucilaginous,odd-pinnate,ovoid,pedicel,peduncle,perennial,petiole,pilose,plant,rachi,seed,spot,stellate,stigma,style,white,yellow	0.3-7,0.3-8,1.5-3,1.5-6.5,1.7-3.2,10,2,2-3,3-4,3-6,3-6-foliat,4-10,4-6.5,6-11.5,abaxially,absen,acumen,acute,adaxially,apical,apically,apiculate,articulate,base,calyx,caudate,cell,connate,covering,decurrent,dehiscent,digestion,diminishing,dorsally,eaf,edge,eed,elliptic-lanceolate,emoval,enzyme,exceeding,flat,folded,forked,generally,globo,gradually,hair-like,honeycomb,interjected,introrse,lanceolate,larger,lateral,leaflet,linear,linear-lanceolate,linear-oblong,living,lobe,lon,long,lower,make,maturing,nflorescence,nther,oblique,oblong,obtuse,often,orolla,pair,pattern,perfect,pinnatifi,plan,poricidally,proximal,reveal,rounded,ruit,second,sessile,seudostipule,short,size,slit,specimen,stamen,straight,stripe,tal,tem,terminal,testal,thick,throughout,toward,tuber-bearing,typically,unit,vary,wall,whit,wide,without,ympodial,¼	abaxial,adaxial,anther,arrangement,colour,form,fruit,growth,height,history,inflorescence,length,life,na,number,ovary,pinnatifid,position,reproduction,shape,spacing,staman,surface,texture,width
614	wfo-0001030430	success	171	94	54	117	40	0.316	.2,abaxially,anther,anthesi,apart,apex,articulated,axillary,base,blade,blue,branched,brown,capitate,chartaceous,clavate,cm,densely,diameter,filament,flattened,fleshy,flower,fruit,glabrous,globose,green,indumentum,leaf,mm,moderately,occasionally,pale,pedicel,peduncle,pentagonal,perennial,petiole,pubescent,purple,shoot,shrub,simple,stigma,style,subglabrous,surface,terminal,time,unifoliate,violet,white,x,yellow	.5,0.25,0.3,0.4,0.5,0.5–12,0.6,0.6–0.8,0.6–1.0,0.8–3.0,0.8–5.6,0.9–1.0,0–20,1.0–1.2,1.0–1.5,1.0–2.0,1.2–2.0,1.3–8.0,1.4–1.5,1.5–1.7,1.6–1.8,1.8–5.0,12–20,12–30,1–3,1–9,2.0–3.0,2.0–4.2,2–3,3.0–4.5,30–200,3–17,3–24,3–4,3–5,3–8,5,5.5–12,5–10,5–6,6–10,abundant,acute,adaxiall,adaxially,ag,apical,appressed,axe,ba,basal,borne,brittle,bud,calyx,cell,connivent,convex,cylindrical,decurrent,dentate,diamete,eaf,eed,elliptic,equal,erect,especially,few-seeded,geminat,hair,lobe,lobed,lon,long,longitudinal,lower,m.,margin,multicellular,nflorescence,oblong,opening,orolla,ovate,pair,perfect,pitted,pore,poricidal,present,regularly,rounded,ruit,serrate,shallowly,shaped,side,slit,spaced,stone,straight,tal,tamen,tear-drop,tem,tip,toward,tube,uniseriate,unit,vary,wide,woody,ympodial,–2.7,–40	0-20,0.5-12,1.0-1.5,1.0-2.0,12-20,12-30,2-3,3-17,3-5,3-8,3.0-4.5,30-200,40,5-10,5-6,abaxial,adaxial,arrangement,colour,corolla,form,growth,height,history,inflorescence,length,life,na,number,ovary,plant,position,rachi,reproduction,seed,shape,spacing,staman,texture,width
615	wfo-0001030441	invalid_json	178	111	80	98	31	0.449	+,.5,0.5,0.5-0.75,0.5-3,1-1.4,1-1.5,1-2-celled,10-40,2,2-10,2-5.5,3-4,5-7.5,6-11,<,acuminate,acute,anther,apart,apex,berry,branched,bright,capitate,cell,cm,corolla,diameter,elliptic,entire,filament,flattened,flower,glabrous,glandular,globose,green,growth,lateral,lobed,long,many,margin,membranous,minutely,mm,narrowly,occasionally,open,pale,papillose,pedicel,peduncle,perfect,petiole,plant,pubescent,red,reniform,shrub,simple,spot,spreading,stellate,stigma,style,surface,time,tip,trichome,tube,uniseriate,usually,vine,violet,wall,white,woody,yellow	0.5-1,1,1.2-1.4,1.5-2,2-3,2.5,30,4-5,5-14,5-6,5-7,5-merou,>,ag,along,alyx,anthesi,ark,articulated,attenuate,base,brow,c.,calyx,closely,decurrent,deltate,distall,eaf,eed,ellipsoid,exerted,eye,flexuous,free,fruiting,glabrou,glandula,hair,ilament,impressed,irregularly,juicy,leaving,lengthening,lobe,lon,lower,making,markedly,midvein,new,nflorescence,older,onto,orolla,otherwise,pair,papillat,peg,per,pericarp,plurifoliat,pore,poricidal,portion,primary,reflexed,ridged,ripe,ruit,scandent,scar,shiny,short,shrubby,slightly,slit,small,somewhat,spaced,spreadin,stem,strongly,tem,terminal,thin,trailing,triangular,ud,undulate,unit,upper,vary,vein,way,wide,ympodial	'','hair,5-merous,[,],``,abaxial,adaxial,characteristic,color,form,fruit,height,history,inflorescence,leaf,length,life,number,ovary,papillate,perennial,reproduction,seed,shape,spacing,texture,value,width,{,}
616	wfo-0001030444	success	196	77	52	144	25	0.265	0.15-0.8,0.8-2,1-10,1-2,11-45,2.4-3.8,3-10,3-5,4-39,4-7,7.1-17.5,anther,apex,berry,blue,clavate,cm,coriaceous,corolla,dark,deep,diameter,elliptic,filament,flower,forked,fruit,glabrous,green,greenish,herb,leaf,light,lilac,medium,mm,mucilaginous,odd-pinnate,ovate,ovoid,pedicel,peduncle,pentagonal,petiole,plant,rotate,seed,stigma,style,terminal,whitish,yellow	0-24,1,1-4,1-5,1.1-2.7,1.2-1.8,2-3,2-6,2-8,2.3-3.6,3.7-6.8,4-17,5-merou,5.3-9,6.1-12.8,9.4-20.1,abaxiall,abaxially,acumen,acuminate,acute,adaxially,ag,along,alyx,apart,apparently,arranged,articulated,asymmetric,attenuate,axe,axillary,base,basiscopic,bead,blade,brownish,bud,capitat,cell,ciliate,condition,connivent,covering,decreasing,digestion,distal,dorsally,dot,drying,eaf,edge,eed,enzyme,erec,exceeding,flat,folded,fresh,geminat,general,generally,glabrou,green-white,hair-like,hal,half,high,homostylous,honeycomb-shaped,interjected,lanceolate,larger,lateral,leaflet,lengthening,like,linear,living,lobe,long,lower,make,margin,moniliform,multiple,narrow,necklace,nflorescence,orbicular,orolla,pair,perfect,petiolulate,plurifoliate,pore,poricidal,purple,removed,ripe,rough,rounded,ruit,sessile,seudostipule,shortly,side,size,slit,sometimes,spaced,specimen,stamen,stolon,straight,subequal,subtending,symmetric,tall,tamen,tem,testal,thick,throughout,tip,tissue,touch,toward,tri-,tube,tuber,typically,unit,unwinged,usually,vary,wall,wet,white,wide,wing,x,ympodial	abaxial,adaxial,arrangement,capitate,colour,form,growth,height,history,inflorescence,length,life,na,number,ovary,perennial,position,rachi,reproduction,shape,spacing,staman,surface,texture,width
617	wfo-0001030445	success	226	106	81	145	25	0.358	0.2-0.4,0.2-0.5,0.6-2.2,0.6-3.5,1-7,1.3,1.3-2,1.5-2.1,1.7-2.4,2.1-5.2,3.5-4.2,4.1-8.7,4.2-10,6.1-9.1,7.5-16,8.2-18,abaxial,abaxially,adaxially,along,anther,apart,apex,articulated,base,black,blade,branched,brown,capitate,cm,corolla,deltoid-reniform,diameter,drying,elliptic,elliptical,elongated,ferruginous,ferruginous-tomentose,filament,flower,fruit,glabrate,globose,green,leaf,long,many,mm,oblong-lanceolate,obovate,orange,orangish-tan,orbicular,pedicel,peduncle,petiole,pseudoterminal,rachi,reniform,reticulate-punctate,semi-spherical,shrub,simple,small,stellate,stigma,style,surface,thick-textured,thin-,time,tomentose,tree,vein,white,x,yellow,yellowish,yellowish-tan	.1,.5,/5-2/3,0.1-0.7,0.2,0.2-0.7,0.3,0.4,0.5,0.7,0.8,1,1-1.3,1.1-4.3,1.3-1.8,1.6-2,1.8-3.5,10-14,10-16,14,15-35,2.2-2.9,2.2-3.5,2.4-4.7,3-5.4,3.1-5,3.4-5.6,5-125,5-merou,5.2-7.1,5.9-15,5.9-8.3,8.1-10,accrescent,acuminate,acute,ag,alyx,appressed,around,axillary,bark,berry,blunt-tippe,blunt-tipped,branch,brownish-yellow,bud,bulbous-based,calyx,concentrated,cylindrical,decurrent,directed,distally,eaf,earl,edge,eed,entire,erect,exserted,ferruginous-granular,free,fruiting,geminate,glabrescen,glabrous,greyish-tan,hair,high,homostylous,inserted,intermediate,lackin,lateral,lengthening,lobe,lobed,lon,longitudinal,lower,m.,main,margin,midrib,midvein,mostly,multangulat,multangulate,nflorescence,oblong,obscured,obtuse,older,open,orolla,ovate,ovate-lanceolate,plurifoliate,pore,poricidal,porrect-stellat,porrect-stellate,pubescence,pubescent,ray,relatively,resorption,rounded,ruit,runk,sessile,side,slightly,slit,somewhat,soon,spaced,sparse,sparsely,splitting,stalk,stamen,stem,stout,subcampanulate,sulcate,suture,tamen,thick,thicknes,thin,tip,tissue,tomentum,tube,unarme,unit,vary,vestigial-rayed,way,wide,ympodial,young	55-125,adaxial,arrangement,colour,form,glabrescent,growth,height,history,inflorescence,length,life,na,number,ovary,perennial,plant,position,reproduction,seed,shape,spacing,staman,texture,width
618	wfo-0001030447	success	276	164	141	135	23	0.511	.2,.5,/5,0.4-0.9,0.5-0.65,0.5-10,0.5-3,0.7-1,0.8-1.7,0.8-3.5,1,1-10,1-3,1.5,1.5-7,1/3,2-4,2.5-10,3,5-15,6-16,7-8,abaxially,accrescent,acute,always,anther,apart,apex,apical,apically,armed,bark,berry,broad-deltate,c.,calyx,cell,chartaceous,clavate,cm,corolla,covering,curved,densely,diameter,discolorous,distance,drying,elongating,erect,extending,filament,filiform,finely,flattened,flattened-reniform,flower,fruit,fruiting,gently,glabrescent,glabrous,globose,irregular,lateral,leaf,length,lobe,lobed,long,long-styled,lower,margin,mature,maturity,midvein,mm,moderately,oblong,obtuse,often,older,one,open,orange,orange-brown,orange-red,orange-translucent,outline,ovate,pale,pedicel,peduncle,persisting,petiole,pit,porrect,prickle,prostrate,pubescent,purple,rachi,raised,red-brown,ridged,rounded,sessile,shallowly,shiny,shortly,shrub,side,small,smooth,sometimes,somewhat,spaced,sparse,sparsely,stalked,stellate,stellate-pubescent,stem,stigma,straight,straw-yellow,style,subsessile,surface,terete,thin,time,translucent,trichome,unarmed,unbranched,weakly,white,yellow,yellow-orange	.3,0,0.1,0.1-0.3,0.15-0.3,0.2,0.2-0.4,0.4-0.7,0.5,1-1.5,1-2,1-2.5,1-5,1-6,1.5-2.5,1.8-2.5,1/3-1/2,1/3-2/3,1/4-1/3,2.2-2.8,2.5-6.5,3-4.5,3-5,30-45°,4-8,5,5-merou,6,6-10,6-7,6-8,6-9,6.5-9,8,adaxially,age,alyx,apar,apparently,articulated,axe,base,beyond,blade,branche,characteristically,cuneate,cupular,dark,deltate,development,difoliate,divided,eaf,eed,equal,exserted,fine,finger-hair,flat,free,geminat,herbaceous,infructescence,irregula,lengthening,less,long-ovoi,longer,longitudinal,midpoint,minute,mostly,narrow-deltate,nflorescence,obconical,oblique,opening,orolla,oung,pair,papillo,pendulous,per,perfect,pericarp,point,pore,poricidal,portion,primary,pronounced,ray,reduced,rest,ri,ridge,ruit,scar,shallow,short-styled,shorter,simple,sinus,slender,slit,spherical,spreading,stalk,stout,stump,tamen,tapering,terminal,tertiary,thick,throughout,tip,toward,tube,ud,unequal,unit,usually,variously,vary,vein,venation,visible,wide,widest,woody,x,ympodial,×	5-merous,abaxial,adaxial,branched,branching,colour,form,growth,height,inflorescence,moderate,ovary,papillose,plant,position,reproduction,seed,shape,spacing,staman,texture,width,young
619	wfo-0001030452	success	199	91	56	143	35	0.281	80,abaxially,anther,apex,black,broadly,cm,curved,diameter,dull,filament,flattened,flower,fruit,glabrous,glandular-puberulent,globose,hair,immature,leaf,mature,mm,moderately,narrowly,nearly,opposite,orbicular,ovate,pedicel,petiole,pilose,prickle,pubescent,rachi,reddish,sessile,shape,shrub,similar,simple,slightly,smooth,spreading,stellate,stem,stigma,strongly,style,subopposite,surface,thin-textured,truncate,white,x,yellow,yellowish	.5–4.5,.6,0.1–0.4,0.2–0.3,0.4,0.6,0.7,0.8,1.2,1.2–1.6,1.5–3,100,10–15,1–1.3,1–2,1–3-celled,1–4,2,2.5–3,2.5–4,2.5–6,20–30,2–2.5,2–4,2–5.5,2–foliate,3,3.7–5.2,4,4–5-rayed,5,5–6,5–7,6–12,8–11,911,absent,accrescent,acuminate,acute,adaxially,also,apparently,appressed,attenuate,axe,base,blade,broad,calyx,canthophora,capitat,central,collected,contiguou,cordate,counted,cylindrical,deflexed,dense,developing,directed,distall,drying,eaf,eed,eglandular,enlarged,enlarging,f,free,fruiting,fully,geminat,glabrou,gland-tipped,gland–tipped,gradually,half,herter,hig,hyaline,imple,initially,internode,larger,less,lobe,lon,long,longer,lower,major,margin,matur,maturity,minutely,nflorescence,numerous,often,one,orolla,per,pore,probably,proximal,pubescence,ray,reflexed,ruit,sec,short,sinuate,size,small,sof,sometimes,somewhat,sparse,sprawling,ste,stellae,straight,sulcate,tamen,tem,terete,thin–textured,tip,toward,triangular,tube,ultimately,uniform,unit,usual,various,vary,vein,wide,wing,ympodial,–9	-9,0.2-0.3,1-1.3,1-2,1-4,10-15,2.5-3,20-30,5-6,abaxial,adaxial,arrangement,capitate,colour,corolla,form,growth,height,history,inflorescence,length,life,na,number,ovary,peduncle,perennial,plant,position,reproduction,seed,spacing,staman,texture,width
620	wfo-0001030453	success	127	63	44	83	19	0.346	.5,/4,0.8-1.5,1-1.3,1-1.5,1.5-1.6,1.5-2.5,3-3.5,4-5,9-14,anther,arachnoid,base,broadly,calyx,clavate,cm,corolla,cup-shaped,divided,elliptic,glabrous,leaf,minutely,mm,narrowly,occasionally,ovary,papillose,pedicel,petiole,poricidal,pubescent,shiny,shrub,simple,sparsely,stigma,style,surface,tip,trichome,tube,way	.25,0.25-0.5,9-12,abaxially,acuminate,acute,adaxially,along,anthesi,apex,arachnoid-pubescent,attenuate,axi,bark,closely,dark,deflexed,delicate,deltate,dendritic,densely,dia,eaf,edicel,eed,ellipsoid,especially,exserted,filament,fine,flat,floccose,free,glabrate,know,known,later,lateral,less,lobe,lon,long,lower,main,margin,middle,midrib,minute,near,nearly,nflorescence,older,opposite,overlappin,pair,papillat,planar,pore,portion,reddish,reddish-brow,rounded,ruit,scar,shaped,slender,soon,spaced,stem,straight,strongly,tall,tear-drop,tub,ud,unifoliat,unit,vein,white,wide,widest,ympodial,young	abaxial,adaxial,arrangement,diameter,flower,form,growth,height,history,inflorescence,length,life,papillate,perennial,plant,shape,texture,unifoliate,width
621	wfo-0001030486	success	141	93	65	76	28	0.461	.5,1-1.5,1-5,1.1-1.4,1.7-2,1/2,1/4,2-3,3/4,4.5-5,6-7,acute,anther,apex,basal,base,brown,calyx,clavate,closely,clustered,cm,corolla,dark,dia,distal,dry,elliptic,f,filament,fleshy,fresh,glabrous,globose,green,internodal,leaf,lobed,material,minutely,mm,opposite,ovary,overlapping,ovoid-reniform,papillose,pedicel,petiole,pitted,shrub,simple,slightly,small,spaced,stigma,style,surface,tan,tapering,treelet,tube,way,white,x,yellow-green	0.8-2.2,1.5-2,10-12,10-14.5,2-5.5,3-3.5,3-5,4-4.5,4-6.5,5-8-flowered,abaxially,adaxially,anthesi,ba,bark,beneath,berry,completely,conical,deflexed,deltate,differing,difoliate,drying,eaf,edicel,eed,ellipsoid,erect,exserted,free,fruiting,geminat,inflorescenc,later,lateral,lobe,lon,long,lower,m.,main,major,margin,middle,minor,nflorescence,older,pair,pale,papillo,planar,pore,poricidal,portion,reddish,ruit,scar,shaped,shin,size,stem,stout,tall,tear-drop,thickened,tip,tub,ud,unit,usually,vein,widest,woody,ympodial,young	5-8,abaxial,adaxial,arrangement,colour,diameter,flower,form,fruit,growth,height,history,inflorescence,length,life,na,number,peduncle,plant,position,rachi,reproduction,seed,shape,spacing,staman,texture,width
622	wfo-0001030489	success	196	99	75	121	24	0.383	-6.5,0.25-0.4,0.5-3,0.75-0.9,1.2-1.6,1.6-2.1,100,2.1-2.9,3-6,3-8,4-8,5,7-15,abaxially,adaxially,anther,apart,apex,appressed-pubescent,articulated,base,branched,broadly,brown,chartaceous,cm,conical,corolla,deltoid,diameter,elliptic,elongate,filament,flower,fruit,glabrate,globose,greenish,growth,high,honeycombed,leaf,length,long-acuminate,minutely,mm,ovate-lanceolate,pedicel,peduncle,petiole,probably,pubescent,pulverulent,rachi,reniform,reticulate-punctate,ripe,shrub,simple,small,somewhat,sparingly,stellate-pubescent,stellate-rotate,stigma,style,subglobose,suborbicular,testa,toward,tree,white,x,yellow,yellowish	.5-2.8,.5-3,.75-5.25,0.6-0.9,0.9-1.1,1-1.3,1-3,1-3.75,1.1-1.3,1.2-1.5,1.7-2,1.75-2,1.9-2.6,1/3-1/2,1/5-1/2,12-24,4.5-9,5-6,6-8,abruptly,absen,acuminate,acute,adaxiall,ag,anthesi,apical-lateral,apparently,appressed,attenuate,axe,axillary,ba,bark,becoming,berry,blade,blunt-tipped,branch,bud,calyx,cinereous,closely,continued,cylindrical,dehiscing,densely,dichotomously,due,eaf,echinoi,echinoid,eed,entire,fleshy,free,glabrous,hair,inserted,introrse,large,lateral,lobe,lobed,long,long-exserted,longitudinal,lower,main,margin,midvein,minute,mostly,multangulate,narrowly,nflorescence,oblong,obtuse,older,orolla,ovate,pale,perfect,plurifoliate,pore,porrect-stellate,pseudo-terminal,puberulent,pulverulen,ruit,runk,sessile,several,short,short-stalked,side,slender,slit,smooth,spaced,sparse,stem,subcampanulate,subcapitat,tamen,terete,thick,time,tomentose,tube,turn,unarme,unarmed,unit,usually,vary,vein,way,wide,ympodial,young	abaxial,adaxial,arrangement,colour,form,height,history,inflorescence,life,na,number,ovary,plant,position,pseudoterminally,reproduction,seed,shape,spacing,staman,subcapitate,surface,texture,width
623	wfo-0001030492	success	221	103	80	141	23	0.362	0.25-0.5,1-1.5,1-8,1.5-2,1.5-6,10-50+,15-20,2-2.5,2-3,2-5,3-10,3-8,5-7,9-11,?,abaxially,acute,adaxially,anther,apart,apex,articulated,base,branched,brown,chartaceous,cm,densely,diameter,elliptic,erect,extra-axillary,filament,flattened,flower,forked,fruit,fully,glabrous,glandular-puberulent,globose,green,lanceolate,leaf,light,maturity,midvein,minutely,mm,moderately,often,ovate,pedicel,peduncle,perfect,perhaps,petiole,pitted,plant,pubescent,rachi,ripe,shape,shrub,simple,small,somewhat,sparsely,stellate,stellate-pubescent,stigma,style,surface,tree,unbranched,white,woody,x,yellow,yellowish	-2,.1,.5,0.1-0.5,0.1-1,0.3-0.5,0.5-1,1,1.5,10,10-35+,12-25,2,2-4,25-50+,3-5,3-7,30-40+,4,4-6,4-7,4-8,5-30+,5-6,7-18,accrescent,adaxiall,also,apparently,armed,axe,ba,blade,broad-based,calyx,capitat,caudate-acuminate,coarse,coarsely,connivent,covering,cylindrical,deeply,difoliate,directed,distall,divided,eaf,eed,eglandular,emerging,entire,female-sterile,ferruginous,ferruginous-pubescent,first,frui,fruiting,geminat,gland,glandular,hair,halfway,held,interpetalar,juvenile,larger,later,lateral,less,like,lobe,lobed,lon,long,longer,lower,lowering,major,margin,midpoint,midrib,mostly,much,narrow,near,nearly,nflorescence,oblique,occasionally,orolla,pair,part,pinnatifid,pore,prickle,ray,rectangular,recurved,ruit,rusty,scattered,sessile,short,short-stalked,shorter,similar,sinus,size,slightly,sometimes,spaced,sparse,splitting,sprout,stalk,ste,stellae,stem,straight,subcordate,tal,tamen,tapered,time,tip,tissue,toothed,truncate,tube,unarmed,uniform,unit,upper,uprigh,vary,vein,wide,ympodial,younger,youngest	abaxial,adaxial,arrangement,capitate,colour,corolla,form,growth,height,history,inflorescence,length,life,na,number,ovary,perennial,position,reproduction,seed,spacing,staman,texture
624	wfo-0001030509	success	220	84	66	154	18	0.3	0-5,0.3-2.5,0.8-1.2,1-1.5,1-2,1-6,2-2.5,2-4.2,2-4.5,2-6,2/3-3/4,4.5-8,5-merous,abaxially,andromonoecious,anther,apart,apex,base,berry,cm,cream,dark,densely,diameter,erect,filament,flattened-reniform,flower,fruit,glabrous,green,half,herb,inflated,leaf,length,lobed,marking,maturity,mauve,mm,moderately,obtuse,orange,orange-brown,ovate,pale,pedicel,peduncle,petiole,plant,purple,rounded,shrub,spherical,stellate,stellate-pubescent,style,surface,unbranched,upper,way,yellow,yellow-green,young	-10,-2,-6,/3,0,0-0.3,0-100,0-15,0-3,0.1,0.1-0.2,0.1-0.25,0.1-0.3,0.2,0.5-1.5,0.6-1,0.8-4,1,1-3,1-4,1.3-2,1.5-2,1.7-2,1/,1/3-2/3,1/4,2-3,2.8-3,3-10,3-4,4.5-10,4.5-12,5-10,7-15,7-9,8-16,alyx,apar,apical,apically,apparently,articulated,bark,becoming,blade,broad-deltate,brow,calyx,chartaceous,connivent,cordate,cuneate,curved,difoliate,discolorous,distal,distance,drying,eaf,eed,elongating,entire,equal,extending,eye,free,fruiting,geminat,glabrescent,gland,globular,gray,herbaceous,hermaphrodite,heterostylous,infructescence,lateral,lobe,long,long-acuminat,long-styled,longer,lower,lowermost,margin,mature,midpoint,midvein,naked,narrow-deltate,narrow-oblong,nflorescence,occasional,occasionally,often,older,one,open,orolla,oung,pair,pendulous,per,pericarp,perpendicular,poricidal,porrect,portion,prickle,prickly,primary,ray,reduced,ruit,scar,short-styled,shorte,shorter,side,simple,slender,smooth,sometimes,spaced,sparsely,spreading,stalk,stalked,staminat,stem,straight,subsessile,tamen,tapering,terete,terminal,tertiary,time,tip,trichome,tube,unarme,unarmed,unit,usually,variously,vary,vein,venation,visible,weakly,wide,woody,ympodial	abaxial,adaxial,colour,corolla,form,growth,height,inflorescence,na,number,ovary,reproduction,seed,shape,spacing,staman,stigma,texture
625	wfo-0001030511	success	166	63	45	121	18	0.271	.5,0.1-0.15,0.4-0.5,0.5,1-2,bright,closely,cm,difoliate,filiform,flattened,flower,globose,growth,inflorescence,internodal,lanceolate,leaf,linear,minutely,mm,pale,pedicel,peduncle,petiole,pitted,plant,porrect,prickly,pubescent,red,reniform,sessile,shiny,shrub,simple,spaced,sparsely,stellate,surface,tan,thin,trichome,unit,yellow	-6,0.1,0.5-0.6,0.5-1,0.8-1,1,1.5,1.5-4,4-7,4-8,4-merous,5-7,5-9,6-8,?,abaxially,absent,acicular,adaxially,almost,along,also,anther,anthesi,apex,arising,articulated,attenuate,barely,bark,base,berry,brow,calyx,cell,conical,corolla,curved,deeply,deltate,densely,diameter,eaf,eed,either,ellipsoid,entire,erect,especially,exserted,filament,free,fruiting,geminat,glabrous,leave,lengthening,less,like,lobe,lobed,long,lower,margin,membranous,midpoint,midrib,midvein,minute,nearly,new,nflorescence,noddin,nodding,older,ovary,overlappin,pair,papillo,per,perfect,pericarp,planar,pore,poricidal,portion,prickle,primary,rarely,ray,rest,ripe,rounded,ruit,scar,short-stalked,sinuate,sometimes,stem,stigma,strongly,style,tall,tapering,testal,tip,toward,triangular,tube,ud,upper,vein,violet,visible,white,woody,x,yellowish,ympodial,½,¾	abaxial,colour,form,fruit,geminate,height,history,length,life,number,perennial,position,reproduction,seed,shape,spacing,sympodial,texture
626	wfo-0001030516	success	172	91	65	107	26	0.378	0.4-1.5,1-4,1-7,1.8-2.4,3-8,4-22,4-6,8-9,9-32,apex,articulate,branched,cell,cm,corolla,covering,cyme,darker,diameter,dichasial,dichasially,distal,ebracteate,elliptical,filament,flower,globose,green,green-white,hair-like,half,herbaceous,lateral,leaf,light,mm,monochasial,odd-pinnate,outline,ovate,ovoid,pedicel,peduncle,pentagonal,perennial,petiole,pilose,plant,proximal,puberulent,pubescent,rotate,seed,slightly,sometimes,stigma,stripe,style,testal,thick,throughout,triangular,wall,yellow,¼	1-2.5,1.1-3.5,1.1-4.1,1.5-2,1.7,2-12,2-2.,2-3,2-4,3-6,3-6-foliat,3-9.8,4-4,4-7,4.2-10.7,6-15,9-22,abaxially,acumen,acuminate,acute,adaxially,apical,apically,base,calyx,connate,cordate,covered,cuneate,decurrent,dehiscent,densely,digestion,diminished,dorsally,eaf,edge,eed,emoval,enzyme,exceeding,first,flat,folded,forked,generally,gland,globo,gradually,hair,honeycomb,interjected,introrse,leaflet,less,living,lobe,lon,long,long-attenuate,longer,lower,lunat,make,maturing,mucilaginous,nflorescence,nther,oblique,often,orolla,pair,pattern,perfect,plan,poricidally,rarely,reveal,ruit,second,sessile,seudostipule,short,short-petiolate,short-stalked,size,slit,specimen,spreading,stamen,straight,tal,tem,terminal,time,toward,triangulat,tuber-bearing,type,typically,unit,vary,whit,wide,ympodial,’	abaxial,adaxial,anther,arrangement,colour,form,fruit,growth,height,history,inflorescence,length,life,na,number,ovary,position,rachi,reproduction,shape,spacing,staman,surface,texture,white,width
627	wfo-0001030522	success	192	83	64	128	19	0.333	0.3-0.7,0.5-0.6,0.5-1,1-1.4,2-lobed,20-30,3-4.5,3-5,4,abaxially,absent,adaxially,anther,apart,berry,brown,cm,completely,corolla,cup-shaped,densely,diameter,dioecious,ellipsoid,elliptic,entire,erect,filament,flattened,flower,fruit,glabrous,globose,green,growth,inflorescence,internodal,leaf,lobed,margin,minutely,mm,orange,ovary,ovate,pedicel,petiole,pitted,plant,pubescent,reddish,reniform,ripening,shrub,small,sparsely,stellate,stigma,style,surface,thin,treelet,vestigial,white	-4,-8,.2,.5,.7,/4,0,0.05-0.15,0.3-0.4,0.5,0.7,0.9-1.3,1,1-1.5,1-5-2,1.5,1.7-3,2,2.5-2.8,2.5-6,3,3-4,4-10,4-9,5-10,6-7,7-10,acute,almost,also,anthesi,apex,armed,articulated,ba,bark,base,bearing,broad-based,brow,calyx,cell,conical,consisting,cordate,dark,darker,dense,diamete,difoliate,directed,eaf,eed,female,fleshy,free,fruiting,geminat,impressed,included,irregularly,juvenile,lamina,le,less,like,lobe,lon,long,lower,male,mature,membranous,midpoint,minute,mixture,new,nflorescence,notably,oblique,obscured,obtuse,occasionally,often,orbicular,pair,per,pericarp,pistillate,planar,pollen-bearing,pore,poricidal,porrect,portion,prickle,primary,pubescence,ray,rounded,ruit,scar,sessile,shallowly,short-stalked,single,somewhat,sparser,staminate,stem,straight,testal,tip,toward,trichome,tube,ud,unarmed,unisexual,unit,upper,upwardly,usually,vein,way,woody,x,ynpodial	abaxial,adaxial,colour,form,height,history,length,life,na,number,peduncle,position,rachi,reproduction,seed,shape,spacing,staman,texture
628	wfo-0001030551	success	167	87	57	110	30	0.341	-12,0.5-1,1-10,1-2,1-3.5,1-4,1.5-2.5,10-20,10-40,2,2-6,3-12,4-5,abaxially,adaxially,also,apart,apex,articulated,base,blue,campanulate,cm,concave,densely,diameter,fading,flower,fruit,glabrous,globose,mm,moderately,oblong-fusiform,often,ovate,ovate-elliptic,papillose,pedicel,peduncle,petiole,puberulent,puberulent-pubescent,pubescent-pilose,rachi,shrub,simple,sparsely,stellate,stigma,style,truncate,unbranched,unknown,violet,x,yellowish	-30,-5,0-2,0.6-1.5,1,1-,1-2.5,1-5,1.5-,13.,2-3,2.5-4,2.5-5,20-25,3-,3-5,3-8,4-,4-7,4-foliat,5-17,5-6,9-20,abruptly,absent,acuminate,acute,adpressed,aggregate,ape,axe,basal,beyond,bilobe,blade,broad,calyx,cell,chartaceous,clavate,color,connective,cordate,dia,dilated,directed,distally,eaf,ed,ellipsoidal,entire,equal,et,exceeding,exserted,fleshy,glandular-puberulent,hair,lanceolate,laterally,leaving,lobe,lon,long,lower,margin,martinelli,narrow,narrowed,narrowly,nflorescence,nther,obtuse,orolla,ovoid,pedicellar,perfect,pilose,pore,puberulen,pubescent-pilo,radiu,remnant,ripe,round,ruit,seen,shorter,slightly,small,spaced,stamen,stone,subcoriaceous,tal,tem,thecae,time,tip,tomento,triangular,triangular-elliptic,tube,ud,unit,unknow,vary,wide,widening,ympodial	4-6,abaxial,adaxial,anther,arrangement,bilobed,colour,corolla,filament,form,growth,height,history,inflorescence,leaf,length,life,na,number,ovary,plant,position,reproduction,seed,shape,spacing,staman,surface,texture,width
629	wfo-0001030570	success	173	94	66	107	28	0.382	0.3-0.5,1-4,1-5,1-8,10-25,15-35,2-3,2-7,2-7-lobed,2-8,3-10,3.5-5,4-5,abaxially,adaxially,apart,apex,articulated,base,campanulate,cm,cylindrical,diameter,dilated,distally,ellipsoidal,flattened,fleshy,flower,forked,fruit,glabrous,glandular-puberulent,globose,green,leaf,mm,near,occasionally,pedicel,peduncle,petiole,pilose,pinnately,pubescent,purplish,rachi,rarely,rugose,simple,slightly,sparsely,stellate,stigma,style,subcoriaceous,submarginally,tree,truncate,unbranched,unknown,unlobed,vein,white,x,yellow	-1,.3-0.5,0-,0.5-,0.5-1,1,1-,1-1.5,1-2,1-3,1.5,1.5-2.5,1/2,10-17,15-20,2-2.5,2-4,2-5,2.5-22,20-30,3-5,3-6,4-25,4-7,4-foliat,4/5,5-,8-,absent,acuminate,acute,aggregate,ape,apiculate,axe,basal,beyond,blade,calyx,cell,color,connective,connivent,cordate,directed,divided,eaf,eed,eglandular,elliptic-oblong,entire,exceeding,exserted,glabrat,hair,lanceolate,leaving,lobe,lobed,lon,long,lower,margin,midrib,narrowly,nflorescence,nther,obtuse,often,orolla,ovate,ovoid,pedicellar,perfect,pilo,pore,presen,punctate,purpl,radiu,remnant,ripe,rounded,ruit,shorter,sinus,small,sometimes,somewhat,spaced,stamen,stone,tal,tem,thecae,time,tip,tomento,triangular,truncat,tube,ud,unequal,unit,vary,wide,ympodial	abaxial,adaxial,anther,arrangement,colour,corolla,filament,form,growth,height,history,inflorescence,length,life,na,number,ovary,perennial,plant,position,reproduction,seed,shape,spacing,staman,surface,texture,width
630	wfo-0001030580	success	230	89	56	174	33	0.243	.0,.7,2,anther,apex,arching,area,attachment,becoming,black,brown,bud,central,chartaceous,cm,corolla,densely,developed,diameter,elliptic,extra-axillary,filament,flattened-orbicular,flattened-reniform,flower,fruit,glabrous,globose,interpetalar,lateral,leaf,margin,mm,nearly,notched,ovate,pedicel,petiole,pitted,point,pubescent,sessile,shrub,simple,slightly,smooth,sparsely,stellate,stigma,straight,style,surface,tissue,well,white,yellow	.0–6.2,.2,.3,.5,/2,/3,0.2–0.3,0.3–0.4,0.3–0.7,0.4–0.5,0.4–0.7,0.6–1.1,0.6–2.1,0.7–0.8,0.9–1.2,1.2–1.5,1.3–1.5,1.3–3.0,1.5–,1.5–2.0,1.5–4.0,1.5–9.0,1.6–1.8,1.6–2.5,1.7–1.8,1/3,1–2,2.0–2.2,2.0–3.1,2.3–5.5,3,3.7–5.4,3–5,4–6,4–8,5-merou,5–5.4,6–8,8.3–10.0,abaxially,acute,adaxially,adnate,ag,along,alyx,anthesi,apical,apparently,appearing,appresse,around,articulate,attenuate,ba,base,berry,blade,broad,brochidodromous,calyx,capitat,caudate,channeled,connivent,curved,deltoid,dentate,difoliate,directed,distal,distally,distinct,dramatically,dry,eaf,edge,eed,either,emerging,endocarp,entire,erect,exocarp,extending,ferruginous,fertile,filiform,flat,flexed,free,geminat,glabrescent,glossy,gradually,hair,homostylous,increasing,indistinct,inter-sepalar,internode,intersepalar,juic,laying,lobe,lon,long,longer,lower,mainly,many,mature,middle,midpoint,midrib,midvein,minute,moderately,much,nflorescence,oblong,orolla,per,perforate,persistent,pore,porrect,portion,potentially,probably,raised,ray,rounded,ruit,scattered,sepal,side,sinus,smoot,sometimes,splitting,spread,stamen,stellae,stellate-pubescent,stem,strongly,suture,tamen,tardily,tem,thin,though,time,tip,toward,translucent,truncate,tube,typically,ud,unarmed,unit,vary,vein,weakly,wide,ympodial,young,±90°,±aequilateral,×,–2.5,–8	1-2,1.5-9.0,1.6-1.8,3.7-5.4,5-merous,abaxial,adaxial,age,arrangement,capitate,colour,form,growth,height,history,inflorescence,length,life,na,number,ovary,peduncle,perennial,plant,position,rachi,reproduction,seed,shape,spacing,staman,texture,width
631	wfo-0001030581	success	187	98	69	118	29	0.369	.5,5-merous,9,abaxial,abaxially,acute,adaxial,aggregate,anther,apex,base,berry,black,bright,capitate,cell,central,cm,conical,corolla,densely,diameter,elliptic,filament,flattened-reniform,flower,fruit,globose,green,growth,herb,inflorescence,intermodal,lacking,lateral,leaf,live,markedly,maturity,minutely,mm,near,once-branched,ovary,ovate,pedicel,peduncle,petiole,pitted,plant,portion,pubescent,purplish,rachi,ripe,shiny,simple,sparsely,spreading,stellate,stigma,stone,straight,style,surface,turning,white,yellow,yellowish	.3,0.2–0.8,0.4–0.6,0.4–1.6,0.5,0.5–0.7,0.5–2.5,0.6–0.7,0.7–0.8,0.9–1,1,1-4-celled,1.2–1.5,1.8–8,1–2,1–2-celled,1–2.5,1–4-celled,2,20–50,2–3-celled,35–45,3–4,3–5,4.5–12,4–7,4–9,5–6,5–8,adaxially,along,angle,angled,anthesi,apar,appressed,articulated,basal,becoming,beyond,branched,calyx,clustered,cone,decurrent,denser,difoliate,drop,eaf,eed,ellipsoid,entire,exserted,florescence,free,fruiting,geminat,glabrous,halfway,individual,later,leave,less,like,lobe,lobed,lon,long,lower,margin,minute,narrowly,new,occasionally,often,outline,pair,papillate,pentagonal,per,perfect,primary,reflexe,reflexed,remaining,ridge,rounded,ruit,scar,shallow,shorter,slightly,somewhat,spaced,sprawlin,stem,strongly,tall,tangled,tem,terete,testal,third,translucent,trichome,tube,ud,uniseriate,unit,upper,usually,vein,wide,winged,woody,ympodial,–15,–5	0.4-0.6,0.4-1.6,0.5-2.5,0.6-0.7,1-2.5,20-50,3-4,3-5,5,5-6,apart,arrangement,colour,form,height,history,length,life,na,number,perennial,position,reproduction,seed,shape,spacing,staman,texture,width
632	wfo-0001030582	success	190	76	42	148	34	0.221	.5,5,abaxially,adaxially,anther,apex,blue,brown,cm,densely,diameter,filament,finely,flattened-reniform,flower,fruit,glabrous,globose,lateral,leaf,light,lighter-colored,minutely,mm,moderately,orange,ovate-lanceolate,pedicel,peduncle,petiole,pitted,red,shrub,simple,stellate-pentagonal,stellate-tomentose,stigma,style,surface,terminal,tomentose,yellow	.1,0,0.1,0.2,0.4,0.4–0.5,0.4–1,0.6,0.8–1,1.4–2,1.5,1.5–3,10,10–12,12,1–1.5,2.5–3,2–10-branched,2–2.5,2–4.5,3.5–9.5,3–3.2,3–3.5,3–5,4–4.5,4–9-rayed,5-merou,5–8,6–8-rayed,7–11,7–20,acute,adaxiall,age,alyx,apart,apparently,articulated,attenuate,axe,ba,base,becoming,blade,branch,branched,broad,c.,capitat,caudate,closely,cordate,dark,dichotomously,directed,distall,eaf,eed,ellipsoid,entire,evenly,except,extra-axillary,filiform,free,geminat,glabrescent,gland-tipped,hair,homostylous,initially,internode,interpetalar,larger,later,lea,less,like,linear-attenuate,lobe,lon,long,lower,margin,maturit,midpoint,midzone,minute,narrowly,nearly,nflorescence,numerous,obscurely,often,orolla,overtopped,ovoid,part,per,perfect,plurifoliate,pore,principal,probably,ripe,rounded,ruit,sessile,shiny,short,short-stipitate,side,sinuate,sinus,slender,somewhat,soon,spaced,sparsely,splitting,stellae,stellate-tomento,stem,stipe,tall,taller,tamen,tardily,tem,thick-chartaceous,tip,tissue,triangular,truncate,tube,ud,ultimate,unarme,unarmed,underside,vary,vein,visible,well-developed,wide,ympodia,young,×	0.4-1,1.4-2,10-12,2-4.5,3-5,7-11,abaxial,adaxial,arrangement,capitate,colour,corolla,form,growth,height,history,inflorescence,length,life,maturity,na,number,ovary,perennial,plant,position,rachi,reproduction,seed,shape,spacing,staman,texture,width
633	wfo-0001030583	success	166	102	79	87	23	0.476	.5,0.2-1,0.3-1,1,1-1.5,1-8,1/2,2.5,3-4,3/4,5-6,abaxial,acute,anther,apex,base,berry,cell,closely,cm,corolla,cultivar,cultivated,dark,deep,deflexed,dendritic,densely,dia,elliptic,especially,flattened-reniform,flower,form,fruit,glabrous,globose,green,immature,incrassate,leaf,live,lobed,long-rectangular,margin,minutely,mm,narrowly,opposite,orange-red,outline,ovary,overlapping,pale,papery,papillose,pedicel,petiole,pitted,plant,pubescent,ripe,rounded,shrub,simple,small-capitate,spaced,stigma,stout,style,surface,tan,thin,tip,trichome,way,white,x,yellow	.2,0.1-0.5,0.4-2.7,0.5-1,0.7-4.5,0.8-1,0.9-3.5,1-2,1.5-4,2.5-3,2.5-9,4-6,5-7,6-7,abaxially,adaxially,along,anthesi,ba,bark,brow,calyx,conical,corky,crisped,differing,difoliate,dry,eaf,edicel,eed,ellipsoid,enlarged,erect,filament,free,frui,fruiting,geminat,golden,included,irregular,lateral,leave,like,lobe,lon,long,long-triangular,lower,main,major,midvein,minor,nflorescence,occasionally,often,older,pair,papillo,pericarp,planar,pore,poricidal,portion,prostrate,rest,ruit,scar,shaped,size,small,soon,spathulate,specimen,stem,tall,tear-drop,testal,tube,ud,uniseriate,unit,vein,woody,ympodial,young	adaxial,arrangement,center,colour,diameter,growth,height,history,inflorescence,length,life,na,number,peduncle,perennial,position,rachi,reproduction,seed,shape,spacing,texture,width
634	wfo-0001030605	success	144	98	72	72	26	0.5	.4,.5,0.1,0.3-0.5,1-4,1.5-2,1.7,2,7,acute,adaxially,almost,anther,apart,apex,area,base,branched,brown,cinereous,cm,coriaceous,corolla,dark,dendritic-echinoid,filament,glabrous,globose,green,growth,inflorescence,internodal,leaf,less,lobed,long,minutely,mm,nearly,obovate,obtuse,occasionally,olive,opposite,ovary,ovate,overlapping,ovoid-reniform,pedicel,peduncle,petiole,pitted,pubescent,rarely,rounded,scattered,shiny,shrub,simple,slender,slightly,smooth,sparsely,stigma,style,surface,thickened,tip,trichome,unifoliate,way,white	1,1.5-5.5,1/3-1/2,12-19-flowered,2-3,2.5,5-12.5,abaxially,along,anthesi,ape,apical,attenuate,beginning,beneath,berry,branch,calyx,commonly,conical,covered,cylindrical,deflexed,densely,dia,difoliate,dry,drying,eaf,edicel,eed,ellipsoid,entire,exerted,free,fruiting,geminat,glabrate,gold,inflorescenc,light,lobe,lower,margin,material,midrib,new,nflorescence,otherwise,papillate,papillosefruit,pore,poricidal,portion,reflexed,revolute,scar,shaped,somewhat,soon,sparesly,tear-drop,tinged,tub,tube,ud,unit,vein,woody,x,yellow,ympodial	12-19,abaxial,adaxial,arrangement,colour,diameter,flower,form,fruit,height,history,length,life,na,number,papillose,perennial,plant,position,rachi,reproduction,seed,shape,spacing,staman,texture
635	wfo-0001030611	success	217	100	75	142	25	0.346	0,0-0.5,0.5,0.5-1.5,1,1.5-10,1.5-2,1mm,2-3.5,2-7,3.5-5.5,6-9,abaxially,adaxially,anther,apart,apex,articulated,base,branched,broadly,cm,development,diameter,divergently,elliptic,elongated,erect,felty-pubescent,filament,flower,fruit,glabrous,globose,hair,inflorescence,leaf-opposed,length,lenticular,less,long,minutely,mm,orange,outline,ovate,pedicel,peduncle,perennial,petiole,pitted,pubescent,rachi,resembling,ripe,sessile,simple,slightly,spreading,spreading-hirsute,stellae,stellate,stigma,style,suffrutescent,surface,tan,thin-textured,truncate,unbranched,white,whitish,x,yellow,yellow-orange	-1.3,-35,0.1-0.3,0.5-2.5,0.7-1.5,1-2,1-3,1.5-3,1/4-1/3,12-10,12-15,15,2,2-4,2-6,2-foliate,2.2-2.5,3,3-4,3-5,4-5,4-6,4-8,5-10,5-15,5-8,7-25,9-30,abaxiall,acicular,acute,adaxiall,along,appearing,attenuate,axe,ba,basally,blade,blunt-tipped,calyx,campanulate,capitat,cauline,coarsely,commonly,composed,connate,connivent,crowded,cylindrical,deltoid,densely,dentate,depressed-deltoid,directed,distal,distally,eaf,eed,elongate,entire,equaling,exceeding,female-sterile,finally,flesh,free,geminat,glabrou,glandula,hermaphroditic,inserted,interlaced,interlobal,intermixed,lacking,larger,lateral,light,lobe,lon,long-stalked,longer,longest,lower,main,margin,midpoint,midrib,midvein,much,nflorescence,numerous,oblong-tapering,obtuse,often,one,orolla,ovate-lanceolate,part,per,pore,predominantly,present,prickle,principal,prominent,radiu,ray,reduced,round-tipped,ruit,section,short,short-stalked,short-styled,side,sinus,small,sometimes,somewhat,spaced,stalk,ste,stellate-pubescent,stellate-woolly,stipitate,tal,tamen,tem,termination,time,tube,unarmed,unit,usually,vary,vein,wide,widely,ympodial	abaxial,adaxial,arrangement,capitate,colour,corolla,form,growth,height,history,leaf,life,na,number,ovary,plant,position,reproduction,seed,shape,spacing,staman,stem,texture,width
636	wfo-0001030624	success	170	76	47	123	29	0.276	0.5-1.5,0.9-1,1-3,1.2-1.8,1.5-2,2-10,3-3.5,acute,anther,anthesi,apart,apex,base,clavate,cm,corolla,elliptic,filament,flattened-reniform,furcate,glabrous,globose,green,greyish,leaf,lobed,minutely,mm,narrowly,nearly,occasionally,opposite,ovary,pedicel,petiole,pitted,planar,shrub,simple,slender,small,stigma,style,surface,tree,white,yellowish	.25,.5,0.5,0.5-1,1.2-2,2,2-3,2.5-5.5,25-40-flowered,3,3.5-4,4.5-8,6-13,7-9,apiculate,appearing,attenuate,axil,ba,bark,beginning,berry,branch,caly,calyx,cell,decurrent,deflexed,dia,differing,difoliate,dimorphic,distal,dry,eaf,edicel,eed,ellipsoid,end,erect,except,expanded,exserted,extreme,falcate,free,fruiting,geminat,glabrate,glandular,hyaline,incrassate,inflorescenc,large,later,lateral,like,lobe,lon,long,longitudinally,lower,main,major,margin,material,middle,midrib,minor,near,nflorescence,older,one,outer,pair,pale,papillose,pore,poricidal,portion,prominent,puberulent,raised,remaining,round,rugo,ruit,scar,shining,short,size,slightly,somewhat,soon,spaced,square,stem,straight,tall,tapering,thickened,three,ti,tip,trichome,trunk,tube,tuft,two,ud,unevenly,uniseriate,unit,vein,wall,widest,woody,x,yellow,yellowish-green,yellowish-grey,ympodial,young	25-40,7,abaxial,adaxial,arrangement,colour,diameter,flower,form,fruit,growth,height,history,inflorescence,length,life,na,number,peduncle,plant,position,rachi,reproduction,seed,shape,spacing,staman,texture,width
637	wfo-0001030628	success	229	93	62	167	31	0.271	.1,.2,.5,5-merous,abaxial,adaxial,andromonoecious,anther,branched,brown,capitate,chartaceous,cm,dark,densely,diameter,discolorous,ellipsoidal,elliptical,extra-axillary,filament,flattened,flower,fruit,glabrous,green,heterstylous,inflorescence,juicy,lanceolate,leaf,length,light,mm,moderately,ovary,ovate,pedicel,peduncle,petiole,plant,pubescent,purple,rachi,reddish,reniform,rotate-stellate,rugose,simple,slightly,stellate,stigma,strongly,style,surface,tree,turbinate,violet,whitish-,yellow,yellowish-green,×	.5–1.7,0.1–0.3,0.5–3,0.7–0.9,1,10+,10–20,10–40,10–55,11–16,12–20,16–18,1–1.5,1–10,1–2,2.5–8,20–35,2–10,2–3,3.5–4,3.5–5,4,4–4.4,4–6,4–6.5,4–8,5–,5–6,5–8.5,6–10,6–8,7–25,7–40,8–1,8–25,abaxially,acuminate,acute,adaxially,age,along,alyx,andromoneciou,anthesi,apart,apex,articulated,axe,ba,bark,base,becoming,berry,bilobe,blade,broad-based,broadly,calyx,central,congested,connivent,cordate,curved,cylindrical,db,difoliate,directed,distally,dried,eaf,eed,eglandular,either,entire,fissure,flowering,free,fresh,frui,fruiting,functionally,geminat,glandular,hair,half,hermaphroditic,inclusion,inflated,interpetalar,knobby,like,lobe,lobed,long,longitudinal,lower,major,margin,maturit,maturity,membranaceous,midpoint,midvein,moderate,multangulate,multangulate-stellate,multiseriate,near,nearly,nflorescence,oblique,often,one,opening,orolla,part,pericarp,point,pore,porrect-stellate,portion,prickle,ratio,ray,reddish-tan,remaining,rounded,ruit,runk,sclerified,sessile,shallow,shallowly,sharp,side,similar,slit,spaced,sparsely,stalk,stalked,staminate,stellate-pubescent,stem,stout,straight,subtending,tamen,tapered,thick,thin,tissue,tube,unarmed,unequal,unit,vary,vein,whitish-golden,width,woody,ympodial,young,–30,–5,–50,–9	1-2,10-20,10-55,11-16,16-18,2-10,2.5-8,30,5,5-6,5-8.5,8-25,9,arrangement,bilobed,colour,corolla,form,growth,height,history,life,na,perennial,position,reproduction,seed,shape,spacing,staman,texture
638	wfo-0001030638	success	177	76	52	125	24	0.294	0.5-1,0.5-1.5,0.7-1.5,1-1.2,1.5-2,1.6-2.2,3-10,4-6,8-9,acute,anther,apex,broadly,closely,cm,corolla,cup-shaped,elliptic,filament,fleshy,fruit,glabrous,glandular,globose,green,inflorescence,leaf,lobed,minutely,mm,obovate,opposite,ovary,paler,papillose,pedicel,petiole,red,seed,shape,shrub,simple,spaced,stigma,style,surface,tapering,terminal,thickening,tree,white,x	0.1,0.5,0.5-0.7,0.5-2,1-1.5,1-2,1.4-1.7,2-3,2-5,2-7-flowered,2.5-4,3-13,8,8-11,along,anthesi,apically,appear,appearing,axi,axil,ba,bark,base,beginning,beneath,berry,blade,branched,bud,calyx,conspicuously,corky,cucullate,deflexed,deltoid,densely,dia,differing,difoliate,dry,eaf,eed,entire,erect,exfoliating,extending,flattened,free,fruiting,geminat,geminate,glabrate,gre,impressed,irregular,known,lamina,large,later,lateral,less,like,lobe,lon,long,lower,main,major,margin,material,middle,minor,near,nearly,nflorescence,occasionally,often,older,one,open,overlapping,ovoi,pair,pale,papillae,papillo,persistent,planar,pore,poricidal,portion,present,prominent,rather,red-glandular,reddish,rest,roundish,rugose,ruit,scar,shaped,size,soon,speciman,stem,straight,tall,tear-drop,thick,thickened,tip,transversely,trichome,tube,uniseriate,unit,usually,vein,wall,widest,woody,ympodial,young	2-7,abaxial,adaxial,arrangement,colour,diameter,flower,form,growth,height,history,length,life,na,number,peduncle,plant,position,rachi,reproduction,spacing,staman,texture,width
639	wfo-0001030661	success	183	96	73	110	23	0.399	0.5-0.6,0.5-0.75,0.5-2,1-1.4,1-1.5,1.5-2,1.5-7,4-15,5-5.5,50-100+,anther,anthesi,apex,attenuate,base,berry,brown,capitate,cm,corolla,densely,diameter,elliptic,filament,flattened,flower,glabrous,globose,growth,inflorescence,lateral,leaf,lobed,margin,mature,membranous,minutely,mm,narrowly,nodding,occasionally,pedicel,peduncle,petiole,pitted,pubescent,red,reddish,reniform,shiny,shrub,simple,slender,small,sparsely,stellate,stigma,strongly,style,surface,terminal,thin,tinged,tip,tree,trichome,uniseriate,violet,way,white,x,½,¾	-24,.2,.5,0,0.7-0.8,1-,1-.,1-1.2,1-1.3,1.2-7,12-16,2-,2-2.5,3-20,3-3.5,3-4,4-6,5-10,5-merou,acute,ag,along,alyx,ark,articulated,branch,branched,brow,calyx,cell,clustered,conical,connivent,dar,deltate,denser,drying,eaf,eed,ellipsoid,em,entire,erec,erect,exserted,extending,free,fruiting,glabrescent,glabrou,group,ilament,insertion,lamina,lengthening,lobe,lon,long,loosely,lower,many,midrib,minute,near,never,new,nflorescence,older,onto,orolla,otherwise,pair,pale,papillo,per,perfect,pericarp,planar,platform,plurifoliat,point,pore,poricidal,portion,primary,rectangular,ruit,scar,scattered,sleeve,slightly,slit,spreading,stem,tangled,testal,time,tube,twinin,ud,unit,upper,usually,vary,vein,winged,woody,yellow,yellowish,ympodial	1-5,5-merous,abaxial,adaxial,arrangement,colour,form,fruit,height,history,length,life,na,number,ovary,plant,position,rachi,reproduction,seed,shape,spacing,texture
640	wfo-0001030665	success	191	83	59	132	24	0.309	0.2-0.4,0.2-0.6,0.5-11,0.5-2,1.5-2,1.5-2.5,2-5,2.5-3.5,3-5,absent,adaxially,anther,apex,brown,campanulate,chartaceous,cm,cordate,depressed-globose,diameter,elliptical,extra-axillary,filament,flower,flushed,fruit,glabrous,globose,green,greenish,grey-green,herbaceous,inflorescence,leaf-opposed,length,light,lilac,minutely,mm,obtuse,ovate,pale,papery,pedicel,peduncle,petiole,prostrate,purple,rachi,resprouter,reticulate,rotate,simple,sprawling,stigma,style,surface,unbranched,yellow	%,-5,-7,0.4-0.6,0.5-1,0.7-1,0.8-1.1,1-17,1-2,1-4,1.1-2.8,1.4-1.7,1.5-3,1.6-4.5,10-200,2-16,2-3,2-6,2-8,2.3-10,2.5-9,20-30,3-10,3-3.8,4-5,5-8,5-merou,6-8,abaxially,absen,abundant,accrescent,acicular,acute,adaxiall,adult,alyx,appearance,appessed,armed,articulated,axe,ba,base,blade,branche,broad,broad-based,calyx,capitat,cut,cylindrical,decimetre,deeply,deflexed,deltate,depression,directed,distall,dr.,eaf,eed,ellipoidal,finally,finger,folded,fruiting,geminat,give,gland-tipped,grey,hair,half,homostylous,index,interpetalar,inward,lamina,lateral,less,lobe,lobed,lobing,lon,long,longer,lower,margin,mature,mesocarp,midvein,minute,nflorescence,oblique,orolla,part,per,perfect,pore,present,prickle,puberulent,rather,reflexed,rounded,ruit,scarcely,short,side,sinus,sparsely,stage,stellate-campanulate,straight,tal,tamen,tem,thick,thin,throughout,time,tissue,tube,unifoliate,unit,uvenile,vary,vein,wide,x,ympodial,¾	abaxial,adaxial,arrangement,capitate,colour,corolla,form,growth,height,history,leaf,life,na,number,ovary,plant,position,reproduction,seed,shape,spacing,staman,texture,width
641	wfo-0001030676	success	220	105	79	141	26	0.359	1-1.2,1-3,1.1-1.4,14-17,2.2-5.7,3-6,4-6,7-10,7-8,8-10,abaxially,adaxially,anther,anthesi,apart,apex,appressed-tomentose,articulated,base,becoming,branched,brown,calyx,chartaceous,cm,conical,corolla,deltoid,diameter,dichotomously,elongate,exserted,filament,finely,flower,fruit,glabrescent,globose,granular-tomentose,green,growth,honeycombed,lateral,leaf,length,lined,longitudinally,minutely,mm,oblong-elliptic,openly,pedicel,peduncle,petiole,probably,pseudo-terminal,pulverulent,rachi,reniform,reticulate-punctate,ridged,ripe,scabrous,shrub,simple,small,somewhat,stellate,stigma,strongly,style,subglobose,suborbicular,tree,velutinous,white,whitish,yellow,yellowish	-1.6,-2.5,-3.9,-8.5,/10-1/5,0-100,0.4,0.6-1.2,1,1.1-1.9,1.2-1.3,1.3-1.5,1.7-2,1/4,11-14,16,19-35,2.1-2.3,2.1-2.6,2.4-3.1,2.5-5.5,2.75-3.25,3-3.5,3-5,4-6.5,7-9,8-12,abruptly,acute,along,angled,apical-lateral,apparently,appearing,axillary,ba,bark,berry,blade,blunt-tipped,branch,bud,closely,continued,crown,cylindrical,dehiscing,densely,due,eaf,echinoi,echinoid,eed,entire,except,flat-topped,fleshy,forming,free,glabrescen,glabrous,greenish,grooved,hair,high,horizontal,initially,inserted,introrse,lackin,lamina,large,lengthen,lobe,lobed,long,longitudinal,lower,main,margin,midvei,midvein,minute,moderately,mostly,multangulate,nearly,nflorescence,oblique,oblong,obtuse,occasional,often,older,opening,orolla,ovate,ovate-lanceolate,parallel,perfect,plurifoliate,pore,pubescent,rather,ray,ruit,runk,scattered,sessile,short-attenuate,short-stalked,side,slit,spaced,sparsely,spreading,stellate-pubescent,stem,subcampanulate,subcapitat,tamen,tending,terete,testa,thick,thin,time,tip,tomentose,tube,tuft,unarme,unit,usually,vary,vein,way,wide,x,ympodial,young	3-3.9,50-100,abaxial,adaxial,arrangement,colour,form,height,history,inflorescence,life,na,number,ovary,perennial,plant,position,reproduction,seed,shape,spacing,staman,subcapitate,surface,texture,width
642	wfo-0001030686	success	182	83	65	117	18	0.357	.5-1,1-1.1,1-1.2,1-2,1.5-4.5,1.6-3,2-2.5,2.5-4,2.5-8,5-25,5-30,abruptly,acuminate,acute,anther,apart,apex,bifid,branched,brittle,brown,cm,conical,corolla,cup-shaped,dark,deeply,diameter,elliptic,erect,filament,flattened,flower,form,fruit,globose,height,internodal,leaf,leaf-opposed,lepidote,lilac,lobed,mm,orange,ovary,pale,pedicel,peduncle,petiole,pitted,plant,pubescent,purple,rachi,seed,shallowly,shiny,simple,stigma,style,surface,thin,tree,yellow	.2,.5,0.5-1,1-1.5,1.2-1.5,1.5-2,15,1972,2-3,2-6.5,3-3.5,5-12,5-6,8-9,?,abaxially,aborted,adam,adaxially,age,anthesi,bark,basal,base,beneath,berry,black,breast,bu,c.,calyx,centre,closely,darker,densely,denser,different,difoliate,discolorous,dry,drying,eaf,edicel,eed,empty,entire,exerted,fide,fragrant,free,fruiting,geminat,glabrescen,glabrous,golden,half,heteromorphic,lamina,lengthening,less,lobe,long,lower,many,margin,maturity,midrib,midvein,minutely,nflorescence,noddin,oblique,older,overlapping,pair,paler,papillae,papillose,pericarp,planar,pore,poricidal,portion,primary,pubescen,ruit,scar,scarious,shallow,short,slightly,slit,somewhat,space,spaced,sparsely,spreading,stellate,stem,strongly,styl,time,tip,tissue,trichome,tube,ud,uniformly,unit,usually,vein,visible,way,woody,x,ympodial,–	abaxial,adaxial,arrangement,colour,growth,history,inflorescence,length,life,na,number,position,reproduction,shape,spacing,staman,texture,width
643	wfo-0001030696	success	202	83	59	143	24	0.292	0.1-0.3,0.8-1.8,1-3,12-18,3-4,3-6,4-4.5,7-10,absent,acute,adaxially,andromonoecious,anther,apex,articulated,base,chartaceous,cm,contiguous,densely,diameter,elliptical,extra-axillary,filament,flower,fruit,glabrous,globose,green,herbaceous,inflorescence,length,mm,moderately,nearly,obtuse,ovate,pale,pedicel,peduncle,petiole,plant,prostrate,pseudo-umbellate,rachi,resprouter,simple,solitary,sparsely,sprawling,stellate,stellate-pubescent,strongly,style,unbranched,usuallu,white,yellow,yellowish	%,.5,0-0.1,0-3,0.05-0.2,0.1-0.4,0.2-1,0.3-1.1,0.4-0.6,0.5-3,0.7-1,0.7-1.1,0.8-1.2,0.8-1.3,0.8-1.5,0.8-1.7,0.9-1.5,1,1-1.5,1-2.5,1-4,1-9,1.5-2,1.5-3,1.6-2.2,10-16,10-50,2-3-foliate,2-4,2-5.5,2-8,2-locular,2.3-4,2.5-6,20-35,3.8-4,4-17,4-7,4-8,5-merou,8-18,abaxially,absen,accrescent,acicular,across,adaxiall,adult,alyx,apart,armed,ascending,axe,ba,blade,branche,brown,calyx,cross-section,cuneate,cylindrical,decimetre,deeply,deltate,directed,distall,distally,distributed,eaf,eed,eglandular,exocarp,finger,frui,fruiting,functional,geminate,gland-tipped,hair,half,heterostylous,index,juicy,lamina,lanceolate,lateral,less,lobe,lobed,lobing,long,longer,lower,margin,markedly,mature,mesocarp,mid-point,midpoint,midvein,minute,moist,nflorescence,oblique,onl,orolla,part,per,placenta,pore,porrect,present,prickle,probably,ray,ruit,semi-circula,sessile,short,side,spaced,sparse,stage,stalk,stellae,straight,tal,tamen,tem,thick,thicker,thicknes,throughout,time,tube,unit,uvenile,vary,vein,wide,winged,x,ympodial	5-merous,abaxial,adaxial,arrangement,colour,corolla,form,growth,height,history,leaf,life,na,number,ovary,position,reproduction,seed,shape,spacing,staman,stigma,surface,texture
644	wfo-0001030699	success	195	93	71	124	22	0.364	0,0.5-0.7,1-1.5,1-2,12-15,2-5,2.5-3,3-10,3-5,4-5,4-7,8-10,acute,anther,apart,apex,apical,base,berry,blue,clavate,cm,corolla,corymbose,cyme,diameter,filament,flower,glandular-lanate,globose,green,greenish,grey,growth,inflorescence,lanate,length,lobed,long-styled,middle,midpoint,mm,multicellular,nearly,ovary,ovate,ovate-elliptic,ovate-lanceolate,pedicel,peduncle,petiole,plant,porrect,purple,sessile,short-styled,shrub,simple,spaced,stellate,stigma,style,subscabrous,surface,trichome,unevenly,velutinous,winged,x,yellow,¼	-13,-8.5,0.2-0.3,1.4-1,1.5-2,1/10,1/6,11-12,2-2.5,2-3,2-4,3-6,4-6,4-6-celled,5,5-6,6-,9-11,abaxially,adaxially,anthesi,antrorse,apically,armed,articulated,bark,basal,branched,brow,brown,calyx,cell,compressed,cordate,curved,decurrent,densely,discolorous,distal,eaf,eed,elongate,entire,erect,exserted,foliaceous,free,fruiting,glabrous,glandular,golden,half,heterostylous,hirsute,immersed,induman,juvenile,known,lengthening,like,linear-lanceolate,lobe,lobed-angulate,long,lower,many,margin,minute,mixed,multangulate,new,nflorescence,older,onto,ovoid,papillat,partially,perfect,pericarp,plurifoliat,pore,poricidal,portion,prickle,prickly,pubescence,pubescent,rarely,ray,red,reduced,reflexed,rotate,ruit,rusty,scar,single,slightly,slit,sparsely,stalked,staminate,stellate-puberulent,stem,straight,subcoriaceous,subrounded,subscandent,subsessile,tall,tapering,time,tip,tomentose-lanate,tube,ud,unit,upper,vein,villous,without,wood,yellowish,ympodial	abaxial,adaxial,arrangement,colour,form,fruit,height,history,leaf,life,na,number,papillate,position,rachi,reproduction,seed,shape,spacing,staman,texture,width
645	wfo-0001030709	success	217	79	61	156	18	0.281	0.7-1,1-1.6,1-4.5,1.3-1.4,1/3-1/2,2-6,2.3-3,5-10,5-20,5-6,6-7,abaxially,acuminate,acute,anther,apart,apex,articulated,base,berry,chartaceous,cm,diameter,dull,elliptic,erect,filament,finely,flattened-reniform,flower,fruit,inflorescence,lateral,leaf,length,lobed,long,maturity,mauve,mm,moderately,orange-brown,pedicel,peduncle,petiole,pitted,purple,red-green,seed,shrub,smooth,sparsely,spherical,stellate,stellate-pubescent,style,surface,terminal,way,yellow,yellow-green	-2,-5,-9,0,0-,0-20,0-30,0.1-0.2,0.15-0.5,0.2-0.5,0.3-1.5,0.4,0.8-4,0.9-1.5,1-1.2,1-6,1.4-2,1.6-2.1,1.9-2.8,1/2-2/3,1/4,1/4-1/3,10-14,10-50,2-4,2-5,2-8,2/3-3/4,3-,4-5-merous,5-7,5-9,6-10,6-21,6-8,7-8,7-9,8-11,8-15,adaxially,almost,alyx,ame,apar,ape,apically,apparently,bark,blade,branched,bright,broad-deltate,brow,c.,calyx,conical,connivent,cordate,cuspidate,deltate,discolorous,distance,drying,eaf,edge,eed,elongating,equal,extending,free,fruiting,glabrescent,glabrous,increasing,infructescence,lanceolate,lengt,lobe,lobing,lon,long-acuminat,longer,lower,margin,mature,middle,midpoint,midvein,narrow-deltate,nflorescence,occasionally,often,older,one,open,orolla,oung,pair,pendulous,per,perfect,pericarp,perpendicular,pit,plurifoliat,poricidal,porrect,portion,prickl,prickle,prickly,primary,ray,red-orange,reflexed,retrorse,rounded,ruit,scar,secondary,short-styled,shorter,side,simple,size,slender,sometimes,spaced,spreading,stalk,stalked,stem,straight,tamen,tapering,terete,tertiary,time,tip,toward,trichome,truncate,tube,unarmed,unit,upper,usually,variously,vary,vein,venation,visible,weakly,wide,woody,ympodial	abaxial,adaxial,colour,corolla,form,growth,height,na,number,ovary,plant,position,reproduction,shape,spacing,staman,stigma,texture
646	wfo-0001030714	success	178	91	79	99	12	0.444	-3,.2,/3,0.1-0.3,0.5,0.5-1.9,0.7-0.8,1-1.2,1-1.3,1.2-1.5,1.2-4,2-2.6,3-3.5,5-100,7-17,adaxially,along,anther,bark,base,beneath,berry,blue,blue-black,clavate,cm,conical,corolla,dark,diameter,elliptic,especially,except,flattened,flower,fruit,glabrous,globose,gradually,greyish,growth,herbaceous,liana,lobed,membranous,midrib,minute,mm,narrowly,new,ob-ellipsoid,ob-elliptic,ovary,overall,pale,pedicel,peduncle,petiole,pubescent,reniform,ripe,shape,simple,sparsely,stellate,stem,stigma,style,surface,tapering,trichome,uniseriate,vein,vine,violet,way,woody,x,yellow	.5,0.3-0.4,0.5-0.8,0.8-1,1-1.5,1-2.5,1.4-3.5,1.5-2,1/3,2-2.5,20,3-7,5-6,>,abaxial,abaxially,acuminate,acute,age,aid,anthesi,apar,apex,articulating,basal,becoming,branching,calyx,campanulate,climbin,cordate,cup,densely,denser,eaf,eed,ellipsoid,entire,exserted,fide,filament,free,grading,gree,howard,joined,leaf-opposed,leaving,lengthening,like,lobe,long,lower,many,margin,minutely,narrow,nflorescence,nodding,node,oblique,occasionally,older,pair,paler,papillat,papillate,pedice,peg,per,perfect,pitted,planar,plurifoliat,pore,poricidal,portion,primary,prominent,quadrate,ruit,scar,slightly,slit,spaced,strongly,submarginal,terminal,thickened,time,tip,truncate,tub,tube,twining,ud,unit,widely,ympodial	apart,arrangement,colour,form,green,inflorescence,leaf,length,number,seed,spacing,texture
647	wfo-0001030730	success	205	79	59	146	20	0.288	0.1-0.3,0.8-4.4,1-8,2-2.5,2-2.9,2.3-6,3-15,4-11,5.5-6.5,9-10.5,anther,chartaceous,cm,densely,depressed,diameter,drooping,extra-axillary,filament,fruit,glabrous,globose,grey,herbaceous,inflorescence,length,light,lobed,margin,minutely,mm,ovate,pale,pedicel,peduncle,perennial,petiole,pink,pseudo-racemose,purple,rachi,resprouter,rhizomatous,rugose,shallowly,shrub,smooth,spreading,stellate,stellate-pubescent,stigma,style,surface,toward,white,x,yellow,yellow-brown,yellowish	%,0-0.8,0-1,0-1.2,0-1.6,0-6,0.05-0.1,0.05-0.2,0.5-0.9,0.5-1,0.6-1.2,0.7-1.2,0.8-1.2,1-1.2,1-1.7,1-10,1-3,1.1-1.9,1.5-4.5,1.7-2.3,10,11-17,11-20,15-60,2-4,2-5,2-8,2-foliate,2.5-7,240-700,3-20,4-7,4-locular,5-40,5-merou,5.5-14.5,7-8,9-15,abaxially,absent,accrescent,acicular,across,acute,adaxiall,adaxially,alyx,apart,apex,armed,articulated,ascending,attenuate,axe,ba,base,blade,bony,calyx,connivent,cuneate,curved,cylindrical,d.,deltate,directed,distall,distributed,eaf,eed,eglandular,entire,finally,finger,first,flower,fruiting,geminate,glabrou,gland-tipped,green,hair,half,hard,lamina,lanceolate,later,lateral,less,lobe,lon,long,longer,loosely,lower,marbled,mature,mid-point,midpoint,midvein,minute,nflorescence,oblique,obtuse,orolla,part,per,perfect,pore,porrect,presen,present,prickle,probably,ray,ridged,ruit,rusty,short,simple,slightly,spaced,sprawling,stage,stalk,stellae,straight,subcordate,tal,tamen,tem,thick,throughout,time,truncat,tube,unarmed,unbranched,unit,unknow,uvenile,vary,vein,wide,yellowish-green,ympodial	abaxial,colour,corolla,form,growth,height,history,leaf,life,na,ovary,plant,position,reproduction,seed,shape,spacing,staman,texture,truncate
648	wfo-0001030733	success	130	82	47	83	35	0.362	1-1.2,1-1.5,1-2,3-5,4.5-5,6-7,abaxially,acute,adaxially,anther,apex,bi-lobed,brown,capitate,closely,cm,corolla,dark,densely,elliptic,filament,glabrous,globose,green,leaf,lobed,minutely,mm,moderately,narrowly,opposite,ovary,ovoid-reniform,pedicel,petiole,pubescent,shrub,simple,smooth,spaced,stigma,style,surface,treelet,trichome,uniseriate,white	.5,/4,0.5-1,1.5-5,1.7-2.7,2-2.5,3-4,4-15,5-8-flowered,6-9,?,acuminate,along,anthesi,ape,bark,base,berry,broadly,calyx,clearly,conical,coriaceous,decurrent,deltate,denser,dia,eaf,eed,ellipsoid,elongate,embryo,erect,exserted,free,fruiting,grayish-brow,lamina,later,lateral,like,lobe,lon,long,lower,main,margin,middle,nflorescence,older,onto,overlappin,pair,papillo,planar,pore,poricidal,portion,rounded,ruit,scar,shaped,somewhat,sparsely,stem,strongly,tall,tear-drop,testa,thick,tip,tube,ud,unifoliat,unit,vein,visible,way,widest,woody,x,ympodial,young	0.5,5-8,abaxial,adaxial,arrangement,cell,center,colour,diameter,flower,form,fruit,growth,height,history,inflorescence,length,life,na,number,overlapping,papillose,peduncle,perennial,plant,position,rachi,reproduction,seed,shape,spacing,staman,texture,unifoliate,width
649	wfo-0001030751	success	226	94	71	155	23	0.314	-7,.5,0,0-0.5,0-1,0.5-1mm,1,1-24,1-3,2-3,2-3.5,3-5,5-15,7-15,abaxially,adaxially,anther,apart,apex,articulated,base,branched,broadly,closely,cm,densely,diameter,divergently,elliptic,erect,felty-pubescent,filament,flower,form,fruit,glabrous,globose,hair,inflorescence,leaf-opposed,length,lenticular,light,minutely,mm,orange,ovate,pedicel,peduncle,perennial,petiole,pitted,pubescent,rachi,ripe,sessile,simple,spaced,sparsely,spreading-hirsute,stellate,stigma,style,surface,tan,thin-textured,unbranched,white,x,yellow,young	-5,.2,0.1-0.3,0.1-0.4,0.5-1.5,0.6-1.5,1-2,1-4,1/4-1/2,10-15,11-40,13-50,14-20,2,2-foliate,2.5-4,20-25,3-6.5,3.5-4.5,4-6,5-6,5-7,5-8,6-9,7-13,8-13,accrescent,acute,acute-,adaxiall,along,also,among,attenuate,axe,ba,basally,blade,broad,calyx,campanulate,capitat,cast,cauline,clas,coarsely,commonly,completely,connivent,cordate,covering,cylindrical,deciduou,deltoid,dentate,depressed-deltoid,directed,distal,distall,distinct,divergent,dominant,eaf,eed,elongate,entire,equaling,especially,essentially,female-sterile,finally,flesh,foliar,frui,fruiting,geminat,green,inserted,interlobal,interwoven,lanceolate,larger,lateral,less,lignescent,like,lobe,long,longest,lower,major,margin,midpoint,mixture,mostly,multiseriate,nflorescence,numerous,obtuse-tipped,occasionally,often,one,orolla,ovate-lanceolate,per,petaloid,pore,present,prickl,prickle,prickly,principal,prolonged,pubescence,purplish,ray,recurve,ruit,scattered,shallowly,short,shorter,side,sinus,small,smaller,somewhat,spreading,stalk,stalked,stellae,stellate-pubescent,stellate-woolly,stem,stipitate,straight,tal,tamen,tem,termination,tip,tooth-like,trichome,truncate,tube,typically,unarmed,unit,usually,variable,vary,vein,vivo,wide,ympodial	abaxial,adaxial,arrangement,capitate,colour,corolla,growth,height,history,leaf,life,na,number,ovary,plant,position,reproduction,seed,shape,spacing,staman,texture,width
650	wfo-0001030772	success	155	75	48	107	27	0.31	-2,0.2-0.8,0.25-0.5,0.75-1,0.9-1,1-2,1.5-2,3-3.5,3-5,5-6,acuminate,anther,apex,capitate,closely,cm,corolla,dark,elliptic,filament,fruit,glabrous,globose,green,leaf,lobed,minutely,mm,opposite,ovary,overlapping,ovoid-reniform,pale,paler,pedicel,petiole,pitted,shape,shrub,simple,spaced,stigma,style,surface,tan,tapering,white,x	.05,.2,.25,.5,0.5-1,0.9-3.1,1-2.5,1.2-5,1.4-1.6,2-7,4.2-6.5,5-10-flowered,8-10,9-15,acute,anthesi,archin,attenuate,ba,bark,base,becoming,beginning,beneath,berry,branch,bud,calyx,deflexed,dia,differing,difoliate,eaf,edicel,eed,ellipsoid,erect,extreme,free,fruiting,geminat,gently,grey,impressed,inflorescenc,large,later,lateral,lenticellate,lobe,lon,long,long-acuminate,long-triangular,lower,main,major,margin,methyl,middle,minor,nearly,nflorescence,node,occasionally,older,one,pair,papillo,papillose,per,pore,poricidal,portion,prominent,reflexed,ripe,rounded,ruit,salicylate,scar,shaped,shining,size,slender,slightly,smelling,soon,stem,straight,strongly,swollen,tall,tear-drop,tip,trichome,tube,ud,uniseriate,unit,usually,vein,widest,wintergreen,woody,ympodial,young	5-10,abaxial,adaxial,arrangement,colour,diameter,flower,form,growth,height,history,inflorescence,length,life,na,number,peduncle,perennial,plant,position,rachi,reproduction,seed,spacing,staman,texture,width
651	wfo-0001030781	success	213	108	84	129	24	0.394	0.5-6,1-10,1-12,1-2,10-40,15-35,2.5-14,2.5-3.5,4-15,5-6,7.5-9,abaxially,adaxially,anther,apex,apiculate,axillary,brownish,bud,cell,chartaceous,cm,condition,corolla,covering,dark,deep,densely,diameter,dot,drying,filament,finely,flower,forked,fresh,fruit,glabrous,globose,gray-green,green,greenish,hair-like,herb,lateral,leaf,light,membranous,minutely,mm,obovate,odd-pinnate,ovate,ovoid,pedicel,peduncle,pentagonal,petiole,pilose,plant,pointed,puberulent,pubescent,purple,rachi,rotate-pentagonal,rounded,scattered,seed,slightly,small,sometimes,stigma,style,subovoid,subtending,terminal,testal,thick,violet,wall,white,whitish,yellow	0-5,0.2-4,0.5-8,1-1.5,1-4,1-8,1.5-12,1.5-2,1.5-9,1.6-2.2,2-20,2-3,3-4,3-6,5-7,5-8,5-merou,6-7,abruptly,acumen,ag,along,alyx,apart,apparently,articulated,axe,base,berry,blade,borne,broadly,brown,caly,capitat,ciliate,connivent,cuneate,decreasing,decurrent,digestion,distal,dorsally,eaf,edge,eed,elliptic,end,enzyme,erect,especially,exceeding,flat,folded,geminat,generally,glabrou,glandular,gradually,green-white,hair,half,high,homostylous,honeycomb-shaped,interjected,lanceolate,larger,leaflet,lengthening,like,living,lobe,long,low-growin,lower,make,margin,midrib,mucilaginous,narrowed,nflorescence,orbicular,orolla,ovate-lanceolate,pair,papillose,perfect,petiolulate,plurifoliate,pore,poricidal,rarely,removed,ruit,sessile,seudostipule,short,simple,singly,size,slit,somewhat,spaced,sparsely,specimen,stamen,ste,stem,stolo,straight,tall,tamen,tem,throughout,tip,toward,tri-,tube,tuber,typically,unit,unwinged,usually,vary,wet,wide,x,ympodial	abaxial,adaxial,arrangement,capitate,colour,form,growth,height,history,inflorescence,length,life,na,number,ovary,perennial,position,reproduction,shape,spacing,staman,surface,texture,width
652	wfo-0001030782	success	198	85	61	137	24	0.308	0.4-1.5,1-2,1.5-7.5,12-30,13-22,2,2.2-4,3-10,3-5,6-8,7-15.6,abaxially,adaxially,anther,apex,cell,clavate,cm,coriaceous,corolla,covering,dark,deep,diameter,elliptic,filament,flower,forked,fruit,glabrous,globose,green,greenish,hair-like,herb,lateral,leaf,light,lilac,medium,mm,odd-pinnate,ovate,ovoid,pedicel,peduncle,pentagonal,petiole,plant,rachi,rotate,seed,stigma,style,terminal,testal,thick,wall,white,whitish,yellow	0-1,0-7,1-3,1-5,1-6,1.2-3.9,1.3-1.6,1.5-2,1.6-4.6,11-47,15,2-3,2.4-11.5,4-11.6,4-6,4.6-26,5-20,5-merou,abaxiall,acumen,acuminate,acute,ag,along,alyx,apart,apparently,arranged,articulated,asymmetric,attenuate,axe,axillary,base,basiscopic,bead,berry,blade,broadly,brownish,bud,capitat,condition,connivent,cuneate,decreasing,digestion,distal,dorsally,drying,eaf,edge,eed,enzyme,exceeding,flat,folded,fresh,geminat,generally,glabrescent,glabrou,green-white,hair,hal,half,high,homostylous,honeycomb-shaped,inconspicuous,interjected,lanceolate,leaflet,lengthening,like,living,lobe,long,lower,make,moniliform,mottled,mucilaginous,multiple,necklace,nflorescence,orbicular,orolla,pair,perfect,petiolulate,plurifoliate,pore,poricidal,prominently,purple,removed,ripe,rounded,ruit,scarce,second,sessile,seudostipule,short,side,size,slit,smaller,sometimes,spaced,specimen,stamen,stolon,straight,subequal,subtending,tal,tamen,tem,throughout,tip,tissue,totally,toward,tri-,tube,tuber,typically,unit,usually,vary,wet,wide,winged,x,ympodial	abaxial,adaxial,arrangement,capitate,colour,form,growth,height,history,inflorescence,length,life,na,number,ovary,perennial,position,reproduction,shape,spacing,staman,surface,texture,width
653	wfo-0001030802	success	171	78	48	123	30	0.281	0.5-1,1,1-1.1,2-3,abaxially,anther,apex,campanulate,cm,corolla,difoliate,filament,flattened-reniform,fruit,glabrous,glandular,globose,heart-shaped,internodal,irregularly,leaf,length,lobed,minutely,mm,ovary,ovoid,pale,papillate,pedicel,petiole,pitted,plant,pubescent,red,shrub,simple,somewhat,spaced,stigma,style,subshrub,surface,unifoliate,white,widely,yellow,yellowish	.3,.5,.5mm,0,0.25-0.4,0.5-0.75,0.5-1.5,0.7-1cm,0.75-1,0.9-1,1-1.2,1-1.5,2-2.5,2-5,2.5-3,3-3.5x,3-4,3-6,4-5mm,4-6,5-10-flowered,abrupt,acuminate,acute,adaxially,along,anthesi,appearing,bark,basal,base,becoming,beginning,beneath,berry,brown,bud,calyx,cordate,cucullate,deeply,deflexed,densely,denser,dia,dry,eaf,edicel,eed,ellipsoid,evenly,except,exerted,exudate,filiform,free,fruiting,geminat,gland,glandurla,halfway,hanging,incrassate,inflorescenc,invest,lamina,later,lateral,line,live,lobe,long,long-triangular,lower,m.,main,margin,markedly,material,midvein,near,nflorescence,obconic,older,pair,palmate,papillose,per,persistently,pore,poricidal,portion,prominent,pubescen,raised,reddish,ruit,scar,shaped,single-celled,slender,soon,specimen,stem,stigm,straight,strongly,tapering,tear-drop,tip,tipped,trichoem,trichome,tube,ud,uniseriate,unit,variable,vein,woody,x,ympodial,young	0.5,0.7-1,3-3.5,4-5,5-10,abaxial,adaxial,arrangement,colour,diameter,flower,form,growth,height,history,inflorescence,life,na,number,peduncle,perennial,position,rachi,reproduction,seed,shape,spacing,staman,texture,width
654	wfo-0001030803	success	185	83	59	126	24	0.319	0.5,1.5-3,2.5,5,abaxially,adaxially,anther,anthesi,articulated,base,berry,branched,cm,connivent,corolla,diameter,elliptic,flattened-reniform,glabrous,globose,imparipinnately,internode,leaf,leaflet,lobed,long,minutely,mm,ovate,pedicel,peduncle,petiole,pinnatifid,pitted,prickle,puberulent,rachi,ranging,rarely,recurved,rugose,shape,simple,size,slender,stellate,stem,stigma,stout,strongly,style,surface,tapering,truncate,variable,vine,wide,yellow,×	.5,0.2,0.2–0.3,0.3,0.4,0.5–1.5,0.75–1,0.9–1.5,1,1-,1.5,1.5-,1/3,10967,10–15,1–2.5,1–3,20–40,2–,3-6,3–10,3–4,3–5,4–10,6–12,6–8,7–9,?,absent,acuminate,acute,adaxiall,adjacent,ag,almost,alyx,apex,armed,axe,basal,becoming,blade,broadly,brown,bud,calyx,campanulate,chartaceous,confluent,connecting,corresponding,dr.,eaf,eed,elongating,entire,equal,exserted,filament,flower,fruiting,green,hair,hinton,lanceolate,lateral,lengthening,light,lobe,long-styled,lower,major,margin,middle,midri,midrib,minute,narrowly,nflorescence,often,orolla,outline,papillae,pericarp,petiolule,pinnate,plurifoliat,pointed,pore,poricidal,present,purple,recurve,rounded,ruit,sharply,side,slit,somewhat,spreading,straight,subwoody,swolle,tamen,terminal,time,tip,tissue,triangular,truncat,tube,turbinate,unit,usually,variously,vary,vein,widest,wing,wood,woody,yellowish,ympodial,–10,–16,–5	0.2-0.3,0.5-1.5,1-2.5,1.5-6,10,10-15,16,2-10,3,3-10,3-5,6,6-12,7-9,color,form,fruit,growth,inflorescence,length,ovary,seed,staman,texture
655	wfo-0001030809	success	154	91	58	96	33	0.377	0.2,1.2-1.4,1.4-1.5,1.5-3.5,4.5-5,6-8,8,anther,apex,appearing,base,beneath,branched,calyx,cm,corolla,densely,elliptic,filament,fruit,glabrous,globose,golden,green,large,leaf,lobed,long,long-papillose,mm,nearly,opposite,ovary,ovate,overtopping,pedicel,petiole,pubescent,scattered,several,shining,shoot,simple,slender,small,stem,stigma,style,tapering,terminal,time,tip,tomentose,tree,trichome,tube,uniseriate,white	.5,0.5-1,1-1.25,1-1.5,1.5-2.4,2-2.5,2.3-5.5,20-60-flowered,5-8,9.9-12,across,acute,along,also,anthesi,apar,bark,berry,broadly,caly,campanulate,clavate,curl-tipped,curved,dark-papillo,deciduous,deflexed,deltoid,dense,dia,difoliate,distally,eaf,edicel,eed,ellipsoid,erect,especially,evenly,exserted,falcate,free,fruiting,geminat,hair,hidden,interpetalar,known,lateral,leave,like,lobe,lon,lower,main,major,markedly,mature,membranous,middle,midrib,minor,minutely,nflorescence,older,one,planar,pore,poricidal,portion,present,round,ruit,scar,shinin,sinus,size,slightly,soon,spaced,straight,tall,three,triangular,two,ud,underside,unequal,unit,vein,wide,widest,x,yellow-brown,ympodial,young	2,2.5,20-60,abaxial,adaxial,apart,arrangement,colour,dark-papillose,diameter,flower,form,growth,height,history,inflorescence,length,life,na,number,peduncle,perennial,plant,position,rachi,reproduction,seed,shape,spacing,staman,surface,texture,width
656	wfo-0001030810	success	191	102	63	128	39	0.33	0.2,abaxially,adaxially,anther,apart,articulated,axillary,base,bipinnate,blue,borne,branched,brown,chartaceous,clavate,cm,colour,dark,densely,diameter,filament,flattened,fleshy,flower,fruit,glabrous,globose,green,greyish,hair,indumentum,leaf,leafy,long,mm,moderately,pale,pedicel,peduncle,pentagonal,petiole,pinnate,pitted,pubescent,shallowly,shiny,shoot,shrub,simple,stem,stigma,style,surface,time,tomentose,unicellular,uniseriate,unknown,violet,white,woody,x,yellow	0.2–0.3,0.3,0.4,0.5–,0.5–0.8,0.6–1.0,0.7–1.4,0.8–5.5,0.95–2.0,0–,1,1.0–1.5,1.0–2.0,1.0–3.0,1.1–2.0,1.1–2.2,1.2–1.5,1.5–1.9,1–2,1–3,1–5,2.9–4.5,20–100,2–3,2–4,3.0–5.0,3.3–5.5,3.3–8.5,3.5–4.6,3–19,4–14,4–5,4–7,5,5–15,5–30,5–32,6–10,6–22,7–10,7–11,8–10,absen,accrescent,acute,adaxiall,ag,along,anthesi,apex,axe,ba,blade,calyx,cell,connivent,cylindrical,decreasing,denser,divided,eaf,eed,elliptic,elliptical,equal,erect,especially,geminat,half,hig,irregular,lobe,lon,longitudinal,lower,m.,margin,midrib,midvein,multicellular,narrow,nflorescence,oblong,obtu,occasionally,older,opening,opposed,orolla,oung,pair,perfect,pinnae,plurifoliate,pore,poricidal,primary,rarely,reflexed,rounded,ruit,secondary,shaped,side,size,slit,sometimes,spaced,sparsely,stone,straight,subglabrous,tamen,tardily,tear-drop,tip,tube,unit,vary,wide,wing,ympodial,–2.5,–3,–3.4,–4.5,–5.0,–8	0.2-0.3,0.6-1.0,1-2,1.0-1.5,1.1-2.2,20-100,3,3.3-5.5,3.5-4.6,4-14,5-15,5-32,6-22,7-10,8-10,abaxial,adaxial,arrangement,corolla,form,growth,height,history,inflorescence,length,life,na,number,ovary,perennial,plant,position,rachi,reproduction,seed,shape,spacing,staman,texture
657	wfo-0001030814	success	223	109	85	138	24	0.381	-3.5,.5,0-0.2,0-0.3,0.4,0.5-1.5,1.5,1.5-2,1.8-3.5,15-20,3-5,5-12,5-15,5.5,6-15,6-9,abaxially,adaxially,almost,anther,apart,apex,articulated,base,branched,broadly,cm,cultivated,densely,diameter,divergently,divided,elongating,essentially,extra-axillary,felty,filament,flower,form,fruit,glabrous,globose,hair,immature,inflorescence,interwoven,length,lenticular,lignescent,long,mature,minutely,mm,narrower,obsolete,oval,ovate,ovoid,pedicel,peduncle,perennial,petiole,pitted,pubescent,rachi,ripe,sericeous,sessile,short,short-stalked,simple,somewhat,specimen,stellae,stellate,stellate-pubescent,stigma,style,tan,thin-textured,unbranched,weakly,white,x,yellow	-0.5,-1.5,-4,.5-3,0.1-0.2,0.1-0.3,0.3-0.6,1-2,1-4,1/8-1/3,10-12,10-25,14-15,15-16,16-30,2-3,2-foliate,23-31,3-7,4-,4-5,4-6,5,5-8,5-9,6-locular,7-11,7.5-11,absent,acute,acute-tipped,adaxiall,along,apiculate,appressed,ascending,asymmetric,attenuate,axe,ba,basal,become,becoming,blade,bulge,calyx,campanulate,capitat,capitate-glandular,coarsely,connivent,cylindrical,dentate,depressed-deltoid,developed,diffusely,directly,distal,distall,eaf,eed,elongate,entire,female-sterile,geminat,glabrescent,hirsute,inserted,interlobal,intermixed,invested,lanceolate,lateral,less,lobe,lon,lower,major,margin,midpoint,midvein,minute,much,nflorescence,obtuse,obtuse-tipped,often,orolla,oung,ovate-lanceolate,per,pericarp,pore,prominent,pubescence,ray,replaced,rip,rounded,ruit,scattered,shorter,side,similar,simple-,simple-haired,sinus,slightly,small,sometimes,soon,spaced,spreading,stalk,stellate-,stellate-pubescen,stem,strongly,swollen,tal,tamen,termination,time,trichome,truncate,tube,unarme,unarmed,uniseriate,unit,unknown,usually,vary,vein,weak,wide,ympodial,young	abaxial,adaxial,arrangement,capitate,colour,corolla,growth,height,history,leaf,life,na,number,ovary,plant,position,reproduction,seed,shape,spacing,staman,surface,texture,width
658	wfo-0001030822	success	146	70	44	102	26	0.301	.2,0.5-1.5,0.9-1,1-1.5,2-2.5,2-5,3-3.5,3-5,5-6,anther,apex,clavate,closely,cm,corolla,elliptic-obovate,filament,filiform,flattened-reniform,flower,glabrous,globose,green,inflorescence,internodal,leaf,lobed,minutely,mm,ovary,pale,pedicel,petiole,pitted,shiny,shrub,simple,spaced,stigma,style,surface,tan,white,x	0-0.5,0.1-0.2,0.4,0.4-1,0.8-1,1-1.2,1.5-2,11-15.5,2-3.8,3.5-7,5-7,8-9,abaxially,acute,adaxially,anthesi,attenuate,ba,base,beneath,berry,broadly,calyx,clustered,completely,cucullat,cucullate,cup,decurrent,deflexed,deltate,dia,differing,difoliate,eaf,edicel,eed,erect,exserted,fleshy,free,fruiting,geminat,incrassate,inflorescenc,later,lateral,lobe,lon,long,long-ellipsoid,lower,main,major,margin,middle,minor,minute,near,nearly,nflorescence,occasionally,older,onto,open,opposite,pair,papillo,papillose,perhaps,planar,pore,poricidal,portion,present,red-papillose,revolute,ruit,scar,shaped,size,slightly,somewhat,sparsely,stem,strongly,tall,tapering,tear-drop,tip,tube,ud,unit,usually,vein,widest,winged,woody,yellowish,yellowish-brown,ympodial,young	abaxial,adaxial,arrangement,colour,diameter,form,fruit,growth,height,history,length,life,na,number,peduncle,perennial,plant,position,rachi,reproduction,seed,shape,spacing,staman,texture,width
659	wfo-0001030846	success	214	94	74	140	20	0.346	-0.8,0.5-0.7,1-1.5,1-2,1-3,1-4,10-15,2-10,2-3,2.5-3,5-15,8-10,abaxial,abaxially,anther,apart,apex,base,beige,berry,branching,brown,clavate,cm,corolla,cream,dark-green,diameter,elliptic,filament,flattened,flower,fruit,glandular-viscous,grey,growth,hirsute,inflorescence,leaf,lobed,many,mm,nearly,oblanceolate,obovate,opposite,ovary,ovate-elliptic,pedicel,peduncle,perfect,petiole,plant,pubescent,rachi,reniform,rhombic,rugose,rusty,scabrous,shrub,simple,stellate,stigma,style,subglobose,surface,time,tomentose,tomentose-velutinous,trichome,undulate-reticulate,white,yellowish	-11,-4,.3,0.1,0.1-0.3,0.2-0.4,0.2-0.5,0.8-1,1-1.2,1-2-celled,1-2.5,1-multicellular,1.5-2,3-,3-3.5,3/4,4-4.5,4-5,4-6,5-8,6-18,6-8,acuminate,acute,adaxially,adult,angulate,anthesi,anthesisflower,antrorse,apical,armed,articulating,assymetric,bark,basal,brownish,calyx,chartaceous,cuneate,curved,deciduous,decurrent,densely,discolorous,distal,eaf,eed,entire,erect,exserted,ferruginous,free,fruiting,glabrescent,gland,glandular,golden,heterostylous,juvenile,lanceolate,larger,lateral,lengthening,like,linear,linear-lanceolate,lobe,long,long-styled,longer,lower,margin,midpoint,midrib,mixture,much-branched,multiangulate,multicellular,near,new,nflorescence,obliqu,oblong,obverse,ochraceous,older,oval,papillat,pendant,pericarp,persistent,plurifoliat,pore,poridical,porrect,portion,prickle,prickly,prominent,puberulent,pubescence,raised,ray,red,reddish,reflexed,relatively,rest,rotate,ruit,scar,sessile,short,short-styled,similar,slightly,slit,sometimes,sparsely,stalked,staminate,stem,stipitate,straight,terete,testa,thick,tip,tube,ud,unarmed,unit,upper,wide,without,x,ympodial,young,¼	adaxial,arrangement,colour,form,height,history,length,life,na,number,papillate,perennial,position,reproduction,seed,shape,spacing,staman,texture,width
660	wfo-0001030850	success	240	90	68	172	22	0.283	0.5-2,1-2,1-2.5,1-8,2-25,3-10,3-15,3.5-6,4,5-merous,6-11,8.5-11.5,abaxial,abaxially,adaxial,andromonoecious,anther,apex,articulated,base,berry,bright,cell,chartaceous,climber,cm,densely,diameter,elliptic,erect,filament,flattened-reniform,flower,fruit,green-brown,lateral,leaf,length,lobed,mauve,mm,moderately,orange,orange-brown,outline,ovate,pedicel,peduncle,petiole,pit,plant,purple,raised,red-green,red-orange,scandent,shrub,simple,small,smooth,sparsely,spherical,stellate,stellate-pubescent,style,surface,terminal,yellow	-6,.5,/4,0-,0-0.5,0-30,0-40,0.1-0.2,0.1-0.3,0.1-0.4,0.1-0.5,0.2,00,1-,1-10,1-20,1-3,1-4,1-5,1.2,1.5,1.5-2.5,1/2,1/2-1/5,1/2-3/4,1/3,1/3-3/,1/3-3/4,10-100,10-20,15-20,2-15,2-3,2-4,2-6,3-3.7,3-4,3-5,3-6,4-8,5-10,5-12,5-13,6-8,7-15,7-22,8-20,acuminat,acuminate,acute,alyx,apar,apart,apically,apparently,bark,blade,branched,broad-deltate,broadly,brow,calyx,connivent,cordate,cream,cuneate,curved,dark,deltate,difoliate,discolorous,distal,distance,drying,eaf,eed,elongate,elongated,elongating,entire,equal,extending,flattened,free,fruiting,geminat,gently,glabrescent,glabrous,gray,green,hermaphrodite,heterostylous,infructescence,lobe,lobing,long,long-styled,longer,lower,lowermost,margin,marking,mature,maturity,midpoint,midvein,nflorescence,oblong,obovate,obtuse,often,older,one,open,orolla,oung,pair,pale,pendulous,per,pericarp,poricidal,porrect,portion,prickl,prickle,prickly,primary,pubescent,ray,red-brown,reduced,rounded,ruit,scar,secondary,sessile,short-styled,shorter,side,sometimes,somewhat,spaced,spreading,stalk,stalked,staminat,stem,stout,straight,tamen,tapering,terete,tertiary,time,tip,trichome,truncate,tube,unit,upper,variously,vary,vein,venation,visible,way,wide,woody,ympodial,young	arrangement,colour,corolla,form,growth,height,history,inflorescence,life,na,number,ovary,position,rachi,reproduction,seed,shape,spacing,staman,stigma,texture,width
661	wfo-0001030867	success	259	112	99	160	13	0.382	.25,.5,0.6-1.5,1-1.5,1-2.5,1.5,1.5-4.5,1/4,12-15,2.5-3,3-5,6-7,abaxially,acute,adaxially,andromonoecious,anther,apex,band,base,berry,branched,cell,chartaceous,cm,corolla,densely,diameter,either,elliptic,expanded,filament,flower,fruit,glabrous,globose,growth,herbaceous,inflorescence,lateral,leaf,leathery,length,less,like,lobed,long,long-styled,margin,mature,membranous,midvein,mm,occasionally,opposite,outline,ovary,ovoid,pale,pedicel,peduncle,pentagonal,petal,petiole,plant,pubescent,ray,reniform,rest,sessile,shallowly,short-stalked,short-styled,shrub,side,simple,sinuate,slightly,somewhat,sparsely,stellate,stellate-pubescent,stem,stigma,style,subshrub,surface,tan,testal,thick,thickened,tip,translucent,trichome,way,wide,x,yellow,yellowish	-1/3,-6,.3,0-,0.3,0.5,0.6,1,1-2,1-5,10,100,14,18,2-2.5,2-3,2-5,2-6,2.5-3.5,3-4,3.5-8.5,4,4-4.5,4-5,4-6,4.5-14,5-25,5-6,5-merous,6,<,>,abundant,acumen,alyx,anthesi,apart,approximately,area,armed,articulated,attenuate,bark,bi-lobe,borne,broad-based,brown,bud,calyx,cast,concolorous,cup-shaped,curve,curved,dark,decurrent,denser,difoliate,directed,distal,distall,distance,dry,drying,eaf,easily,eed,ellipsoid,elongate,equal,erect,exposed,exserted,flowering,free,fruiting,functionally,geminate,glabrescen,greatest,green,greyish,halfway,hermaphroditic,heterostylous,immature,infructescence,internodal,interpetalar,lamina,larger,lobe,lon,longer,lower,lowermost,mal,markedly,maturing,maturit,midpoint,midrib,mottled,narrowly,near,new,nflorescence,nodding,often,older,onto,orolla,pair,pendent,per,pericarp,planar,pore,poricidal,portion,prickle,prickly,primary,re,reflexed,ruit,scar,shap,size,small,spaced,splitting,still,stouter,straight,strongly,tall,tamen,tapering,thinne,tissue,triangular,tube,type,ud,unevenly,unit,upper,usually,vary,varying,vein,violet,visible,white,whitish,winged,woody,ympodial,¼	0-1-2,abaxial,adaxial,bi-lobed,colour,form,height,position,reproduction,seed,shape,staman,texture
662	wfo-0001030871	success	248	109	85	163	24	0.343	0.2-0.4,0.3-4,0.4-1.8,0.6-1.5,1-1.3,1-18,1.3-2,2-8,3-32,3-4.4,3-6,4.5-6.5,5-33,abaxially,abruptly,acuminate,acute,adaxial,adaxially,anther,apart,apex,becoming,berry,branched,brown,chartaceous,cm,conical,continued,corolla,dark,deltoid,diameter,due,elongate,filament,fleshy,flower,fruit,glabrescent,granular-tomentose,grayish,green,greenish,growth,honeycombed,lateral,leaf,length,mm,mostly,orbicular,ovate,pale,pedicel,peduncle,petiole,probably,purple,rachi,reniform,reticulate-punctate,ripe,rotate-stellate,scabridulous,short,shrub,simple,stellate-tomentose,stem,stigma,style,suborbicular,terminal,time,tomentose,tree,velutinous,violet,white,x,yellow,yellowish,young	.2-3,.8-3.5,.9-1.2,/30-1/5,0-120,0.7-1.3,0.7-2.5,1.3-3,1.4-2.7,1.5-3,1.5-6,1.8-2.6,1.8-3.5,1/2,1/2-3/4,1/4,1/4-1/3,11,2-3,2.8-4.5,3-5,3.5-14,30,4.8-9.5,5-7,6-40,7-12,9-13,accrescent,ag,along,anthesi,apical-lateral,apparently,appressed,appressed-tomentose,articulated,attenuate,axe,axillary,ba,bark,base,blade,blunt-tipped,branch,bud,calyx,campanulate,capitat,closely,decurrent,dehiscing,dendritic-echinoi,dendritic-echinoid,dendritic-multangulate,densely,directed,distal,eaf,earl,early,echinoi,echinoid,eed,elliptic,entire,equal,erect,evident,exserted,extend,free,fruiting,glabrescen,glabrous,hair,held,high,inserted,introrse,large,lobe,lobed,long,long-,long-stalked,longer,longitudinal,lower,m.,main,margin,midvein,minute,mixed,multangulat,multangulate,narrowly,nearly,nflorescence,nodding,oblong,obtuse,occasionally,often,older,open,orbicula,orolla,ovate-lanceolate,overlapping,partly,perfect,plait,plurifoliate,pore,porrect-stellate,present,prominent,pubescent,rather,ray,reflexed,relatively,ruit,runk,sessile,short-,short-stalked,side,slit,small,sometimes,somewhat,soon,spaced,sparingly,sparsely,splitting,stamen,striate,strongly,subglobose,sulcate,suture,tamen,terete,testa,thick,thick-stalked,thin-stalked,toward,tube,unarme,unarmed,unit,usually,vary,vein,way,wide,ympodial	0.2-3,30-120,abaxial,arrangement,capitate,colour,form,height,history,inflorescence,life,na,number,ovary,perennial,plant,position,reproduction,seed,shape,spacing,staman,surface,texture
663	wfo-0001030872	success	166	79	51	115	28	0.307	.5,0.8-1,1-1.5,1.2-1.5,1.5-5,2-5,4-6,5.5-7,acuminate,adaxial,anther,apex,area,base,broadly,closely,cm,corolla,crateriform,dark,deflexed,elliptic,erect,filament,fleshy,glabrous,globose,green,leaf,lobed,mm,nearly,opposite,ovary,ovate,paler,papillose,pedicel,petiole,shining,simple,slightly,small,spaced,stigma,style,tip,tree,treelet,white,x	0.5,0.5-1,0.8-2,1-1.2,1-2,1.2-3,1.5-2,12-18,3-7,4-6-flowered,5-6,6-12.5,acute,age,along,anthesi,appearing,bark,beginning,berry,black,brown,caly,calyx,center,closed,completely,consisting,corky,cucullate,darker,deltoid,densely,dia,difoliate,dry,eaf,edicel,eed,ellipsoid-ovoid,exserted,free,fruiting,full,geminat,glabrate,hooded,incurved,inflorescenc,known,large,lenticel,lenticellate,less,like,live,lobe,lon,long,lower,major,margin,material,middle,minor,minutely,nerve,nflorescence,oblique,older,one,overlapping,pair,pale,petal,planar,pore,poricidal,portion,primary,prominent,proximal,puberulent,raised,rather,red-glandular-puberulent,reddish-glandular,reddish-glandular-puberulent,relative,rest,ridge,rounded,ruit,scar,shaped,shorter,side,size,soon,specimen,stem,straight,strongly,styl,tall,tapering,tear-drop,thickened,tube,ud,unit,widest,woody,ympodial,young	abaxial,arrangement,colour,diameter,flower,form,fruit,growth,height,history,inflorescence,length,life,na,number,peduncle,perennial,plant,position,rachi,reproduction,seed,shape,spacing,staman,surface,texture,width
664	wfo-0001030877	success	223	86	65	158	21	0.291	0-0.5,0-5,0.1-0.6,0.1-1,0.5-1,0.7-1.4,1-1.5,1-2,1.5-2,2-15,2-3,5-6,6-11,7.5-10,acute,andromonoecious,anther,apex,articulated,base,broadly,chartaceous,cm,cylindrical,densely,diameter,erect,extra-axillary,filament,flattened,flower,fruit,glabrous,globose,green,inflorescence,leaf,length,minutely,mm,ovate,pale,pedicel,peduncle,perennial,petiole,plant,pseudo-racemose,purple,rachi,reticulate,rhizomatous,rotate-stellate,shrub,simple,stellate-pubescent,stigma,style,surface,unbranched,weakly,x,yellow,yellowish,yellowish-green	%,0-0.2,0-10,0-15,0-4,0.1-0.4,0.2-0.6,0.3-0.4,0.4-0.5,0.4-0.8,0.5-0.6,0.5-0.8,0.7-1.6,0.9-1.2,1-1.3,1-1.4,1-3,1.5-2.4,1.5-3,1.8-2.6,10-14,10-30,10-40,17-26,2,2-3-locular,2-foliate,2.2-2.7,2.9-4.8,2.9-8,3-10,4-10,4-6,4-8,5,5-11,5-merou,6-12,6-15,6-9,7-9,8-14,8-15,8-9,9-14,9-15,abaxially,absen,absent,abundant,accrescent,acicular,across,adaxially,adult,alyx,anvil-shape,apart,ascending,attenuate,axe,ba,blade,branch,branche,brown,calyx,capitat,connivent,cross-section,cuneate,directed,distall,distributed,dm,dult,eaf,eed,eglandular,entire,exocarp,finger,fruiting,functional,geminat,gland-tipped,hair,half,heterostylous,index,interpetalar,juicy,juvenile,lamina,lanceolate,lateral,less,lobe,lobed,lobing,long,longer,loosely,lower,margin,mature,mesocarp,mid-point,midpoint,midrib,midvein,minute,moderately,moist,nflorescence,oblique,obtuse,orolla,pair,part,per,placenta,pore,porrect,present,prickle,pubescent,ray,ruit,rusty,shallowly,short,side,spaced,sparsely,stalk,stalked,stellae,stellate,stem,straight,tal,tamen,thick,throughout,time,tissu,tissue,triangular,tube,unarme,unarmed,unit,upper,vary,vein,wide,ympodial	5-merous,abaxial,adaxial,arrangement,capitate,colour,corolla,form,growth,height,history,life,number,ovary,position,reproduction,seed,shape,spacing,staman,texture
665	wfo-0001030882	success	144	75	47	97	28	0.326	.1,.5,0.5-1,0.5-1.1,0.9-1.1,1-1.3,1-4,3-3.5,acuminate,anther,apex,capitate,closely,cm,corolla,elliptic,filament,fruit,glabrous,globose,green,leaf,lobed,minutely,mm,narrowly,occasionally,opposite,ovary,overlapping,ovoid-reniform,papillose,pedicel,petiole,pitted,shrub,simple,small,spaced,stigma,style,surface,tan,tapering,tree,white,yellowish	0.5-0.75,0.75-1,0.8-1.1,0.8-2.4,1-1.5,1.6-2,2,2-5.4,2-6,2.2-4.6,3/4,6.5-15.6,8-12,?,accrescent,anthesi,attenuate,bark,base,beginning,beneath,berry,calyx,conical,crenulate,deflexed,deltoid,dia,differing,difoliate,eaf,edicel,eed,erect,exserted,extreme,free,fruiting,geminat,inflorescenc,lateral,lightly,lobe,lon,long,lower,main,major,margin,middle,minor,nearly,nflorescence,older,one,ovoid,pair,pale,paler,papillo,peelin,planar,pore,poricidal,portion,prominent,raised,ruguse,ruit,scar,shaped,short,size,slender,slightly,soon,stem,straight,tall,tear-drop,terminal,thick,thickened,tip,transversely,truncate,tub,tube,ud,unit,vein,way,widest,woody,x,ympodial,young	abaxial,adaxial,alternate,arrangement,colour,diameter,flower,form,growth,height,history,inflorescence,length,life,na,number,peduncle,perennial,plant,position,rachi,reproduction,seed,shape,spacing,staman,texture,width
666	wfo-0001030883	success	179	74	49	130	25	0.274	.1,.5,0.5-3,0.5-5,1-1.2,1-1.3,1.5-3.5,2-5,5-6,anther,apart,apex,brown,clavate,cm,corolla,elliptic,filament,fruit,glabrous,globose,green,hard,inflorescence,leaf,lobed,massive,minutely,mm,occasionally,opposite,ovary,ovate,ovoid-reniform,pedicel,petiole,pitted,plant,puberulent,russet,seed,shrub,stigma,stout,style,surface,tapering,white,woody	-3,.05,1-1.1,1-1.5,1-4,1.5-2,10-18,18-44.5,20-50-flowered,3-3.5,3-4,3/4,9.5-27.5,accrescent,across,acuminate,acute,anthesi,appearing,approximatately,arching,bark,base,becoming,berry,branched,bu,calyx,cell,collapsed,collection,dark,deflexed,dia,differing,difoliate,dry,eaf,edicel,eed,epidermal,erect,evenly,finely,fleshy,free,fruiting,furcate,geminat,geminate,glandular,hollow,imbedded,laminar,large,later,lateral,lenticellat,less,like,little,live,living,lobe,lon,long,long-acuminate,lower,main,malodorous,markedly,material,middle,midrib,minute,narrowly,nflorescence,oblique,older,pair,pale,papillate,papillo,papillose,perpendicular,petaloid,placenta,pore,poricidal,portion,present,proximal,pulp,quite,rather,reflexed,reticulate,ruit,scar,shaped,size,slender,slightly,sometimes,soon,spaced,stem,straight,strongly,tall,tan,tear-drop,thick,time,tip,triangular,trichome,tube,two,ud,uniseriate,unit,upper,vein,wall,way,widest,x,ympodial,young	20-50,abaxial,adaxial,arrangement,colour,diameter,flower,form,growth,height,history,length,life,na,number,peduncle,perennial,position,rachi,reproduction,shape,spacing,staman,texture,width
667	wfo-0001030884	success	218	83	61	157	22	0.28	0.4-3,0.5-1.2,0.8-1,0.9-5,1-1.5,1.5-2.5,2-5,4.5-5,5-30,5-merous,9-11,abaxial,acute,adaxial,anther,apex,berry,brown,capitate,cm,conical,dark,densely,diameter,elliptic,filament,flower,gray-tinged,green,greenish,growth,inflorescence,lateral,leaf,length,lobed,mature,minutely,mm,moderately,ovary,ovoid-reniform,pedicel,peduncle,petiole,plant,pubescent,reddish,shrub,simple,slender,sparsely,spherical,stellate,stellate-pubescent,stigma,style,surface,treelet,weakly,white	.2,.5,.7,0.3,0.3-0.5,0.5,1,1-1.2,1-3,1.5,1.5-2,10,100,2,4-13,4-5,5,5-6,5.5-7,6-10,6-25,6-8,7-8,>,abaxially,abruptly,adaxiall,along,also,alyx,andromonoeciou,anthesi,apar,arme,articulated,bark,basal,base,blade,broad-based,c.,calyx,connivent,curved,decurrent,di-,differing,directed,discolorous,distal,eaf,eed,equal,extend,extending,flowering,free,fruiting,geminate,glabrous,glandular,gree,half,herbaceous,heterostylous,infructescence,leafy,like,lobe,long,long-stalked,long-styled,long-triangular,lower,magnification,margin,midpoint,midrib,minute,mixture,new,nflorescence,node,occasionally,older,one,onto,open,orolla,oung,outlin,pair,pale,papillat,per,pore,poricidal,porrect,portion,present,prickle,prickly,primary,principal,ray,red,reflexe,reflexed,regularly,rest,ruit,sagittate,scar,scattered,sessile,shallowly,shap,short,short-stalked,short-styled,similar,size,spaced,spreading,stem,stiff,still,strongly,tall,tamen,tannish,tapering,time,tip,trichome,trifoliate,tube,unarmed,unicellular,uniformly,uniseriate,unit,upward,usually,vary,varying,vein,visible,way,wide,wing,winged,without,woody,yellow,ympodial,young	andromonoecious,apart,arrangement,colour,corolla,form,fruit,height,history,life,na,number,papillate,perennial,position,rachi,reproduction,seed,shape,spacing,staman,texture
668	wfo-0001030899	success	146	85	56	90	29	0.384	.5-2,0.3-0.5,0.5-1,1-3,10-20,2,2-3,2-3.5,2.5-3.5,3-12,3-4,4-5,5-10,?,abaxially,acuminate,adaxially,apex,articulated,base,bronze,cm,coriaceous,densely,diameter,ellipsoidal,end,flattened,flower,fruit,glabrous,glandular-puberulent,green,inside,mm,obconical,outside,ovate,pedicel,peduncle,petiole,puberulent,pubescent,purple,rachi,shrub,simple,splotch,stellate,stigma,stripe,style,unbranched,white,x,yellow	-45,0.5,1,1-1.5,1-2,1-6,1.5-2,10-13,20-25,3-5,3-foliate,3.5-4,5-6.5,6.5-31,7-27,8-11,absent,acute,aggregate,apart,ape,axe,basal,beyond,blade,calyx,cell,chartaceous,connective,connivent,cordate,deeply,desc,dilated,directed,distally,eaf,eed,entire,ex,exceeding,exserted,extrorse,globose,leaving,less,light,lobe,lon,long,lower,margin,mucronate,narrowly,nflorescence,nther,oblong,obtuse,orang,orolla,ovoid,pedicellar,peltifor,perfect,pore,presen,puberulen,radiu,remnant,ruit,shorter,slightly,spaced,stamen,stone,strongly,tal,tem,thecae,time,tomento,triangular,tube,ud,unit,upward,vary,vein,wide,ympodial	abaxial,adaxial,anther,arrangement,colour,corolla,filament,form,growth,height,history,inflorescence,leaf,length,life,na,number,ovary,peltiform,plant,position,reproduction,seed,shape,spacing,staman,surface,texture,width
669	wfo-0001030902	success	159	101	70	89	31	0.44	-2,-20,0.6-1.5,1-2,1-6,1.5-13,1.5-2.5,10-15,15-50,2,2-3,2-5,3-20,3.5-4,4-22,5-7,abaxially,acuminate,adaxially,angled,apart,apex,articulated,base,branched,brown-pilose,cm,dark,densely,diameter,eglandular,ellipsoidal,flattened,fleshy,flower,forked,fruit,glabrescent,glabrous,globose,hair,leaving,long,margin,mature,mm,occasionally,orange,ovate,pedicel,pedicellar,peduncle,petiole,pinkish,purple,purplish,rachi,rarely,reddish,remnant,simple,stellate,stigma,style,subcoriaceous,tree,truncate,unbranched,x,yellow	-5,0-15,1.5-,1.5-2,2.5,2.5-4,3-13,3-4,30-50,4,4-6,4-7,4-foliat,5-9,6-24,8-14,absent,acute,aggregate,along,ape,apically,apiculate,axe,basal,beyond,blade,brow,calyx,cell,connective,connivent,cordate,cylindrical,deltate,dilated,directed,distally,eaf,eed,entire,equalling,exceeding,except,exserted,glabrat,glandular,glandular-puberulen,laterally,lobe,lon,lower,narrowly,nflorescence,nther,oblong,obtuse,orolla,perfect,pore,presen,present,puberulence,radiu,ruit,shorter,slightly,small,somewhat,spaced,sparse,sparsely,stamen,stone,subcapitat,tal,tem,thecae,time,tip,tomento,triangular,tube,ud,unit,vary,vein,wide,ympodial	abaxial,adaxial,anther,arrangement,colour,corolla,filament,form,growth,height,history,inflorescence,leaf,length,life,na,number,ovary,perennial,plant,position,reproduction,seed,shape,spacing,staman,subcapitate,surface,texture,tomentose,width
670	wfo-0001030906	success	134	83	40	94	43	0.299	1,1-1.4,1.0-1.4,1/3-2/3,2.3-3.5,38,4-11,8-13,annual,anther,blade,broad-based,broadly,calyx,cm,flattened-ovoid,foveolate,glabrous,herb,internodal,length,long,minutely,mm,ovate,pedicel,pentagonal,petiole,pinnatifid,plicate,prickle,seed,somewhat,spherical,stellate-pubescent,stellate-tomentose,stem,subulate,surface,yellow	1.5-2.5,2.0-2.6,40-80,6-10,6-8,7-12-flowere,7-16,9-12,accrescent,across,almost,along,alyx,ample,anthesi,arcuate,armed,ascending,base,bearing,berry,branched,bristly,campanulate,cauline,da,densely,developing,dia,difoliate,divided,dry,eaf,essentially,exceeding,externall,faces,flat,geminat,interpetalar,invested,lateral,linear,lobe,long-stalked,main,maturity,n,near,nearly,nflorescence,numerous,obtuse,often,orolla,partly,per,pinnatisect,prickl,prickly,purple,purpli,red,rounded,ruit,sessil,short,slender,slightly,sometimes,splitting,spreadingly,stellae,strait,suffused,tamen,taprooted,throughout,tightly,tigma,tissue,tub,tube,twice,tyle,ultimate,undulate,unexpande,unit,usually,vary,vein,yello,ympodial	7-12,abaxial,adaxial,apex,arrangement,bark,bud,cell,center,colour,corolla,diameter,filament,flower,form,fruit,fruiting,growth,height,history,inflorescence,leaf,life,margin,na,new,number,ovary,peduncle,plant,position,rachi,reproduction,scar,shape,spacing,staman,stigma,style,texture,trichome,unexpanded,width
671	wfo-0001030914	success	186	99	74	112	25	0.398	/4,0-0.25,0.7-1,1-1.5,1.2-1.5,1.5-3,1.5-8,2-10,3-4,7-8,along,anther,apex,base,beneath,berry,capitate,closely,cm,corolla,decurrent,deflexed,elliptic,evenly,filament,flower,furcate,glabrous,globose,green,inflorescence,leaf,lemon-yellow,length,lobed,long-styled,many,minutely,mm,obovate,occasionally,opposite,otherwise,ovary,ovoid-reniform,pale,pedicel,petiole,pitted,plant,puberulent,rest,ripe,shape,short-styled,shrub,simple,small,spaced,sparsely,stigma,style,surface,tan,time,tree,trichome,uniseriate,usually,vein,way,white,winged,x	.1,.5,0.1-0.5,0.5-1,0.8-1,0.8-1.3,1-2,1.5-2,2-2.5,2.5-11,2.5-3,3.5-17,5-17,5-25-flowered,7-10,9-35,acute,anthesi,attenuate,bark,blade,bud,calyx,campanulate,constriction,dark,deltoid,densely,dia,differing,difoliate,distal,dry,eaf,edicel,eed,ellipsoid,equal,erect,even,exserted,free,fruiting,geminat,glabrate,golden,greyish-brow,individual,later,lateral,like,live,lobe,lon,long,lower,main,major,margin,middle,minor,narowly,nflorescence,often,older,one,onto,overlappin,pair,papillo,papillose,planar,pore,poricidal,portion,prominent,pubescent,quite,raised,reddish-brown,rounded,ruit,scar,shaped,size,slender,slightly,sometimes,soon,specimen,stem,straight,tall,tapering,tear-drop,thick,third,ti,tip,trunk,tub,tube,ud,unit,variable,weight,widest,within,woody,yellow,ympodial,young	5-25,abaxial,adaxial,arrangement,colour,diameter,form,fruit,growth,height,history,life,na,number,overlapping,peduncle,perennial,position,rachi,reproduction,seed,spacing,staman,texture,width
672	wfo-0001030918	success	230	84	66	164	18	0.287	-3.2,-40,0.3-1.5,0.5-2,0.6-2.5,0.7-1.7,1,1-1.5,1.5-2.5,2-10,2-25,3-6.5,3-7,5-merous,5.5-7,abaxial,abaxially,acute,adaxial,anther,apex,articulated,base,berry,cell,chartaceous,cm,diameter,dull,elliptic,erect,filament,flattened-reniform,flower,fruit,glabrescent,lateral,leaf,length,lobed,margin,mm,moderately,obtuse,orange,orange-brown,outline,pedicel,peduncle,petiole,pit,raised,red,scandent,seed,shrub,small,smooth,sparsely,spherical,stellate,stellate-pubescent,style,surface,terminal,yellow	-12,-2.3,-4,-4.5,-5,-6,-9,.5,.7,0-10,0-20,0-25,0-4,0-6,0.1,0.1-0.25,0.2-0.4,0.25-0.45,0.5-0.7,0.5-2.5,0.6,0.7-1.2,1-1.8,1-2,1-4,1.5-2,1.5-5.5,1/2-2/3,1/2-3/4,1/3,1/3-,1/3-1/2,1/4-1/3,2-2.5,2-3,2-4,2-7,2-8,2.8-3,2/,3-15,3-4,3.5-6,4-7,5-7,5-8,6-8,7-10,acicular,alyx,ame,apar,apart,apically,apparently,bark,blade,branched,brow,c.,calyx,caudat,connivent,cuneate,curved,dark,deltate,densely,difoliate,discolorous,distance,drying,eaf,elongated,elongating,equal,evenly,extending,faint,flattened,free,fruiting,geminat,glabrous,green,green-brown,infructescence,lobe,lobing,long,longer,lower,mature,maturity,mauve,midpoint,midvein,mixture,narrow-deltate,nflorescence,oblong,occasionally,older,one,open,orolla,oung,pair,pale,pendulous,per,perfec,pericarp,perpendicular,poricidal,porrect,portion,prickl,prickle,prickly,primary,pubescent,purple,ray,red-brown,reduced,reflexed,ruit,scar,secondary,sessile,side,simple,slender,sometimes,somewhat,spaced,spreading,stalk,stalked,stem,straight,strongly,tamen,tapering,terete,tertiary,time,tip,trichome,tube,unit,upper,usually,vary,vein,venation,visible,way,weakly,wide,woody,ympodial,young	colour,corolla,form,growth,height,inflorescence,na,number,ovary,plant,position,reproduction,shape,spacing,staman,stigma,texture,width
673	wfo-0001030919	success	219	91	59	160	32	0.269	12,2,5-merous,abaxial,abaxially,acute,adaxial,andromonoecious,anther,apart,apex,branched,brown,chartaceous,cm,coriaceous,densely,diameter,distally,elliptic,extra-axillary,filament,flower,fruit,glabrous,globose,green,leaf,length,mm,moderately,ovate,pedicel,peduncle,petiole,plant,protrusion,pubescent,rachi,reddish,reniform,rugose,scandent,shrub,simple,small,stellate,stellate-pubescent,stigma,style,subopposite,surface,swollen,twice,unbranched,white,whitish,yellow,×	.2–0.4,.2–0.6,0.1–0.2,0.1–0.3,0.3–0.6,0.5–1,0.5–1.5,0.5–3,1.2–2,1.5,10–13,10–14,10–20,12–16,12–18,1971,1–2,1–3,2.5,25–50,2–3,2–4,2–8,3,3–4,3–6,3–8,4–7,4–8,5–10,5–7,5–8,7–10,7–11,8–12,absent,accrescent,adaxially,alyx,anthesi,apparently,armed,articulated,asymmetrical,attenuate,axe,ba,base,berry,beyond,blade,calyx,capitat,connected,connivent,cordate,covering,cylindrical,directed,discolorous,eaf,eed,entire,exserted,festooning,flattened,frui,fruiting,functionally,fused,glabrou,glandular,hair,hard,hermaphroditic,horizontal,incompletely,interpetalar,introrsely,lateral,like,linear-lanceolate,lobe,lobed,long,longitudinal,lower,male,margin,maturity,midpoint,midrib,midvein,moderate,multicellular,multiseriate,narrowly,nearly,nflorescence,notch,obtuse,occasionally,often,older,opening,orange,orolla,partially,per,perfec,petiolate,pinnate,placenta,plurifoliat,pore,porrect-stellate,positioning,prickle,proximally,ray,recurved,reflexed,roe,roselike,ruit,rusty,secondary,see,shortly,side,slightly,slit,spaced,sparsely,spine,stalk,stamen,ste,stem,subsessile,tal,tamen,tan,tapering,tem,terminology,tissue,triangular,triangular-ovate,tube,unarmed,unicellular,uniseriate,unit,vary,vein,venation,wide,ympodial,young	0.5-1.5,0.5-3,1-2,1-3,10-20,2-4,2-8,3-4,4-7,7-10,7-11,arrangement,capitate,colour,corolla,form,growth,height,history,inflorescence,life,na,number,ovary,perennial,position,reproduction,seed,shape,spacing,staman,texture
674	wfo-0001030921	success	185	82	59	126	23	0.319	0,0.4-0.5,1-2,1-3,2-6,3-3.5,3-5,4-10,7-8,acuminate,acute,anther,apart,apex,berry,brown,cm,corolla,corymbose,cyme,deep,diameter,elliptic,filament,flattened,flower,fruit,globose,green,grey,growth,inflorescence,internodal,lanceolate-elliptic,liana,lobed,many,mm,ovary,pedicel,peduncle,petiole,pubescent,purple,reniform,reticulate-undulate,rugose,scabrous,stellate,stigma,style,subspherical,subtruncate,surface,velutinous,violet,white,woody,yellowish	.5,1-1.2,1-1.5,1/3,10,2-2.5,2-3,3-4,3.5-5,4-6,6-7,9-15,abaxially,adaxially,anthesi,antrorse,appressed,armed,articulated,asymmetric,bark,basal,base,branched,caly,calyx,campanulate,channelled,compressed,congested,coriaceous,curved,deeply,densely,diamete,discolorous,distal,eed,elongating,entire,erec,erect,exceeding,exserted,free,fruiting,glabrescent,glabrous,half,hermaphroditic,heterostylous,included,like,linear-lanceolate,lobe,long,long-styled,longer,lower,margin,midpoint,minute,multicellular,near,nearly,new,nflorescence,oblong,obverse,older,one,ovoid-conical,partially,perfect,pericarp,plurifoliateleaf,pore,poricidal,porrect,porrect-stellate,portion,prickle,prickly,puberulent,pubescence,raise,ray,recurved,reddish,reduced,reflexed,ruit,rusty,scar,sessile,short-styled,shorter,shrub,slightly,slit,spaced,sparse,sparsely,staminate,stellate-pubescent,stem,straight,strongly,subequal,tapering,terete,testa,time,tip,tomentose,triangular,trichome,tube,ud,unevenly,unicellular,unit,upper,x,ympodial,young	abaxial,adaxial,arrangement,colour,form,height,history,leaf,length,life,na,number,plant,plurifoliate,position,rachi,reproduction,seed,shape,spacing,staman,texture,width
675	wfo-0001030941	success	259	102	74	185	28	0.286	-1.5,0.1-0.3,0.5-1.5,0.8-1.3,1-1.4,1-9,1.4-1.6,2-3.2,2-5,4-6,6-22,7-23,9,abaxially,adaxially,anther,apart,apex,articulated,base,becoming,brown,cm,conical,continued,corolla,deltoid,diameter,due,elliptic,filament,flower,fruit,glabrescent,globose,growth,honeycombed,lateral,leaf,length,minutely,mm,moderately,mostly,narrowly,obovate,ovoidal,pedicel,peduncle,petiole,pubescent,rachi,reticulate-punctate,ripe,scabridulous,scabrous,shrub,simple,small,sparingly,stelliform,stem,stigma,style,suborbicular,subreniform,terminal,testa,tomentose,tree,white,x,yellow,yellowish	-16,-4,-6,.01-0.3,.03-0.25,.04-0.1,.04-0.12,.04-0.22,.04-0.4,.2-0.8,.5-5,/50-1/15,0-100,0.01-0.22,0.02-0.04,0.02-0.06,0.02-0.25,0.02-0.3,0.02-0.4,0.03-0.05,0.03-0.06,0.03-0.6,0.04-0.08,0.04-0.1,0.04-0.35,0.04-0.5,0.04-0.6,0.06-0.35,0.06-0.42,0.07-0.4,0.08-0.35,0.08-0.5,0.8-1.1,1.1-1.3,1.1-1.7,1.1-2.8,1.2-2.1,1.2-2.2,1.3-2.5,1.3-4.5,1.4-3.5,1.5-3.5,1.5-4.5,1/3-1/2,10,10-25,2-3.3,3-4.5,3-5,3.5-10,3/4,4-12,4-8,4-9,5-9,5-merou,6-10,6-9,7-10,absen,accrescent,acuminate,acute,ag,along,alyx,anthesi,apical-lateral,apparently,appressed-tomentose,axe,axillary,bark,berry,blade,blunt-tipped,branch,branched,bud,calyx,campanulate,chartaceous,color,darker,decurrent,dehiscing,dense,densely,directed,eaf,eed,ellipsoid,entire,exserted,extend,few-rayed,fleshy,free,fruiting,glabrous,glandular,gray,hair,high,inserted,introrse,lanceolate,large,less,lobe,lobed,lon,long,long-attenuate,longer,longitudinal,lower,m.,main,margin,midpoint,midvein,mixed,multangulat,multangulate,multiseriate,nearly,nflorescence,oblong,obscured,obtuse,occasionally,often,older,orolla,ovate,pale,perfect,plurifoliate,pore,porrect-stellat,porrect-stellate,rarely,rather,ray,ruit,runk,sessile,short,short-stalked,side,slit,sometimes,somewhat,spaced,sparse,sparsely,stalk,stamen,stipitate-glandular,strongly,subcapitat,subcoriaceous,suture,tamen,terete,thick,thick-stalked,time,tomentu,touching,toward,triangular,tube,unarme,unarmed,unit,usually,vary,vein,way,weakly,wide,ympodial,young	0.2-0.8,0.5-5,20-100,5-merous,abaxial,adaxial,arrangement,colour,form,height,history,inflorescence,life,na,number,ovary,perennial,plant,position,reproduction,seed,shape,spacing,staman,subcapitate,surface,texture,width
676	wfo-0001030943	success	167	75	53	114	22	0.317	1-1.2,1-1.5,1.8-2.2,10-25,12-15,2-6,4-4.5,abaxial,acuminate,adaxial,anther,apex,becoming,bi-lobed,cm,corolla,densely,diameter,elliptic,filament,flattened,flower,glabrous,globose,golden-yellow,growth,lateral,leaf,lenticular,lobed,minutely,mm,narrowly,ovary,pedicel,pericarp,petiole,pitted,plurifoliate,pubescent,purplish-black,reddish-brown,shrub,small,sparsely,stigma,style,surface,tapering,terminal,thin,tree,violet	.5,0,0.5-1,0.5-3,1.1,1.5-2,1/2,3,3-4,3/4,4-5,4-6,7-13.5,7-8,8-10,abaxially,absent,acute,adaxially,age,along,anthesi,apical,bark,basal,base,belo,berry,black,branch,branching,calyx,conical,cupulate,dark,decurrent,deflexed,dendritic,denser,drying,eaf,echinoid,edicel,eed,elongate,erect,ew,exserted,fide,free,fruiting,glabrat,golden,horizontal,im,inserted,large,lobe,lon,long,lower,m.,main,minute,monochasia,nflorescence,nodding,often,older,outline,overtopping,pair,pale,papillo,pearce,per,planar,pore,poricidal,portion,raised,ruit,scar,scattered,secondary,shoot,showy,sleeve,slightly,slit-like,somewhat,stamen,stem,strongly,tall,time,tip,tree-like,triangular,trichome,tub,tube,ud,unit,upper,vein,way,wide,woody,x,yellow,yellowish-white,ympodial,young	arrangement,colour,form,fruit,height,history,inflorescence,length,life,na,number,peduncle,plant,position,rachi,reproduction,seed,shape,spacing,staman,texture,width
677	wfo-0001030959	success	164	59	34	130	25	0.207	.8,0.5-1.5,0.7-1.2,1-10,1.2-1.8,10-15,5-6,5-9,almost,anther,apex,brown-green,cm,diameter,elliptic,erect,filament,flower,glabrous,inflorescence,lateral,leaf,length,membranous,mm,pedicel,peduncle,petiole,shrub,sparsely,stellate,stellate-pubescent,style,surface	.05,.2,/5,0.5,1-2,1-7,1.5-2,1.5-3.5,1/5-1/10,2-4,2.5-4,2.5-4.5,2.5-5,4-6,4-8,5-merous,6-8,9-12,abaxially,alyx,ame,apar,apart,apically,apparently,armed,articulated,bark,base,blade,branched,brown,c.,color,concolorous,connivent,cuneate,curved,deltate,densely,difoliate,distributed,drying,eaf,eed,equal,evenly,free,fresh,geminat,gently,glabrescent,glabrou,glandular,green-brow,hair,know,known,less,like,lobe,lobed,long,long-acuminat,long-acuminate,longer,lower,margin,midpoint,minute,narrow-deltate,nflorescence,numerous,older,one,open,orolla,oung,pair,part,perfec,perpendicular,poricidal,porrect,portion,present,prickl,prickle,prickly,primary,prominent,ray,ruit,scar,scrambling,secondary,sessile,several,short,side,simple,slender,spaced,spreading,stem,straight,straw,subentire,tamen,tapering,terete,tertiary,time,tip,toward,trichome,tube,unarmed,unit,usually,vary,vein,venation,visible,way,whole,wide,yellow,ympodial,youngest	abaxial,adaxial,colour,corolla,form,fruit,growth,height,history,life,number,ovary,perennial,plant,position,rachi,reproduction,seed,shape,spacing,staman,stigma,texture,unknown,width
678	wfo-0001030982	success	215	91	67	148	24	0.312	0.05,0.05-0.5,0.1,0.2-3,0.5-0.9,0.5-1,1.5,1.5-2,3-8,4-5,6-8,anther,apex,bud,calyx,capitate,cm,conical,corolla,dark,diameter,ellipsoid,elliptic,entire,filament,flattened-reniform,fleshy,flower,form,fruit,fruiting,glabrous,globose,green,growth,later,leaf,less,lobed,margin,minutely,mm,new,opposite,ovary,ovate,pale,pedicel,peduncle,petiole,pitted,plant,rhizomatous,scar,seed,simple,sinuate,slightly,stem,stigma,style,subshrub,surface,trichome,white,yellowish,young	-2-2.5,.1,.2,.5,0.1-0.15,0.3-2,0.5,0.5-3,1,1-1.5,1-8,1.5-3,2/3,3-21,4-12,abaxially,acuminate,acute,adaxially,age,angular,anisophyllous,anthesi,ape,appressed,ba,base,beneath,berry,broadly,brown,brownish,caducous,central,channelled,chartaceous,ciliate,closely,conic,cream,cucullate,cuneate,curved,deflexed,deltate,differing,difoliate,distall,distally,distichou,dry,drying,eaf,edicel,eed,enlarged,exerted,extension,external,foliage,free,fresh,geminate,glabrescent,glandular,glandular-papillose,golden-green,greenish,hilum,impressed,inconspicuously,internal,isostylous,larger,lengthening,like,live,lobe,long,lower,major,materia,material,maturity,midvein,minor,mostly,near,nflorescence,oblique,obovate,occasionally,often,olive,one,overlappin,packed,pair,papillae,papillat,papillate,papillose,planar,pore,poricidal,portion,primary,projection,prominent,prominently,puberulent,pubescent,reddish,reflexed,rest,revolute,ruit,sagittate,separated,shoot,sigmoidally,situated,size,slit,somewhat,sparsely,stamen,straight,stripe,strongly,testa,tetramerous,tightly,time,tip,transverse,tub,tube,ud,uniseriate,unit,vegetative,vein,veined,way,weakly,x,ympodial	abaxial,adaxial,arrangement,bark,cell,center,colour,distichous,height,history,inflorescence,length,life,na,number,position,prickle,rachi,reproduction,shape,spacing,staman,texture,width
679	wfo-0001030989	success	177	94	68	109	26	0.384	0.5-1,1-1.5,1-10,12-15,3-20,3-4,3-7.5,6-6.5,9-10,abaxially,adaxially,anther,apart,apex,articulated,axillary,berry,brownish,bud,cell,ciliate,cm,condition,conical,corolla,covering,densely,diameter,drying,filament,flower,forked,fresh,fruit,glabrous,green,greenish,hair-like,herb,lateral,leaf,light,long,margin,mm,odd-pinnate,ovate-lanceolate,ovoid,pedicel,peduncle,petiole,plant,proximal,pubescent,ripe,rotate,seed,sparsely,stigma,style,subtending,terminal,testal,thick,violet,wall,whitish,yellow	.5,1-2,15-27.5,2-3.5,3-5.5,4-5,4-7,4-8,5,5-merou,5.5-7.9,6-13,acuminate,ag,alyx,apparently,axe,base,blade,capitat,chartaceous,connivent,decreasing,digestion,distal,dorsally,eaf,edge,eed,end,enzyme,erec,especially,flat,folded,geminat,generally,glabrou,gradually,green-white,hair,half,homostylous,honeycomb-shaped,interjected,lanceolate,larger,leaflet,lengthening,like,living,lobe,lower,make,minute,mucilaginous,nflorescence,obtuse,occurring,orbicular,orolla,ovate,pair,pale,perfect,petiolule,plurifoliate,pore,poricidal,present,pubescen,ray,removed,ruit,secondary,semierect,seudostipule,singly,size,slit,spaced,specimen,ste,stem,stolo,subequal,subsessile,symmetrical,tall,tamen,tem,thir,throughout,tip,toward,tri-,triangular,tube,tuber,typically,unit,unwinged,usually,vary,wet,wide,wider,x,ympodial	abaxial,adaxial,arrangement,capitate,colour,form,growth,height,history,inflorescence,length,life,na,number,ovary,perennial,position,rachi,reproduction,shape,spacing,staman,surface,texture,third,width
680	wfo-0001030991	success	204	106	81	123	25	0.397	.5,0.5-1.5,0.7-1.2,1-1.6,1-2.2,1-2.5,3-,4-10,5-5.5,9-11,abaxially,absent,anther,apex,apparently,appressed,ascending,base,berry,brown,capitate,cm,color,corolla,densely,diameter,different,elliptic,eye,filament,filiform,flattened,flower,furcate,glabrous,globose,growth,herb,inflorescence,lanceolate,lateral,leaf,leaf-opposed,lobed,minutely,mm,narrowly,nearly,occasionally,often,pedicel,peduncle,petiole,pinnatifid,pitted,pubescent,red,reniform,ripe,scattered,shiny,short,shrub,simple,small,sparsely,stellate,stigma,style,suffrutescent,surface,terminal,thin,trichome,uniformly,uniseriate,variably,violet,white,x,yellowish	0,0.1,0.2,0.2-0.7,0.3-0.4,0.5,0.5-0.7,0.5-1,0.5-3.5,0.6-0.8,1-1.5,1-7,1.5,10-20,2-plurifoliat,2.5-10,2.5-3,2/3,3-5-lobed,5-merou,<,acuminate,acute,adaxiall,adaxially,ag,along,alyx,angled,anthesi,arising,ark,articulated,attenuate,basal,bulbous,calyx,cell,conical,connivent,distally,drying,eaf,eed,ellipsoid,ellipsoidal,elongate,enlarged,entire,exerted,free,frui,fruiting,fusiform,glabrescen,grey,ilament,incised,leave,lengthening,less,like,lobe,long-triangular,loosely,lower,margin,midrib,minute,new,nflorescence,nodding,older,orolla,outline,packed,pair,papillo,part,particularly,pendant,per,perfect,pericarp,platfor,pointing,pore,poricidal,portion,primary,pseudoumbel,rectangular,reflexed,rest,rootstoc,ruit,scar,shallowly,sleeve,slightly,slit,somewhat,spreading,stem,strongly,tangled,tem,testal,tightly,tip,tube,twinin,ud,unit,upper,vary,vein,weak,weight,winged,woody,ympodial,young	5-merous,abaxial,adaxial,arrangement,colour,form,fruit,height,history,length,life,na,number,ovary,perennial,plant,position,rachi,reproduction,seed,shape,spacing,staman,texture,width
681	wfo-0001031005	success	231	136	123	108	13	0.532	.5,/3-1/2,0-0.5,0.1,1-1.5,1-2,1-2.5,1-3,2-3.2,2.5,3-10,3-4,3-6.5,5-7,abaxial,abaxially,adaxially,almost,along,anther,anthesi,apex,apically,bark,base,berry,black,blue,brachyblast,branch,branched,branching,brown,calyx,capitate,chartaceous,clearly,clustered,cm,common,concolorous,conical,corolla,cupular,dark,dendritic,dendritic-pubescent,diameter,dilated,discolorous,domatia,drying,elliptic,elongated,evenly,eye,filament,fine,flat,flattened,flexuous,flower,form,fruit,glabrous,greenish,lateral,leaf,length,liana,like,lobed,longitudinally,main,membranous,midvein,mm,naked,network,oblong,obovate,occasional,often,orange-brown,outside,ovoid,pair,pedicel,peduncle,petiole,primary,prominent,pubescent,purple,rachi,raised,ridged,seed,short,side,slender,smooth,sometimes,somewhat,sparsely,stem,stigma,style,surface,terete,terminal,tertiary,tip,toward,trichome,unarmed,usually,vein,venation,visible,weakly,white,x	.4,0.3-0.5,0.5-1.5,0.8,0.9,1,1.5-2.5,1.5-4,10,2.3-3,2.5-4,4-6,5,5-8,5°,6-12,accrescent,acuminate,acute,age,alyx,apar,apparently,articulated,attenuate,clum,curved,datum,deeply,delineated,deltoid,denser,density,detaching,developing,divided,eaf,ellipsoi,entire,equal,extending,fertilisation,forming,free,fruiting,immature,increasing,inside,junction,known,leave,lengthening,linear,lobe,long,loop,lower,m.,margin,minute,much,nflorescence,nther,obscure,occasionally,older,onl,orolla,ou,ovate,pendulous,perfec,pericarp,plurifoliat,pointed,pore,poricidal,portion,protruding,ray,region,rest,ruit,scar,secondary,simple,smaller,smoot,soon,spread,spreading,standing,strongly,stump,surrounding,tangling,tearing,thick-chartaceous,thin,tube,ud,uneven,unit,vary,well-developed,wide,ympodial,young	adaxial,arrangement,colour,growth,inflorescence,na,number,ovary,presence,shape,spacing,texture,width
682	wfo-0001031007	success	207	119	101	106	18	0.488	0.5-1,0.5-10,0.75-1.5,1,1-1.2,1-1.5,1-3.5,1.2-1.5,1.5-2,1.9-3,15,4.5-5,50-100,6,7-10,alfway,almost,along,anther,apex,base,berry,bifid,black,branched,brown,c.,capitate,clustered,cm,completely,corolla,dark,dendritic,densely,diameter,drying,dull,elliptic,entire,extending,filament,flattened-reniform,flower,fruit,glabrous,globose,growth,herbarium,inflorescence,irregularly,lamina,lax,lilac,lobed,long,loose,lower,many,margin,matte,midvein,minutely,mm,narrowly,new,occasionally,often,outline,papillate,pedicel,peduncle,petiole,pitted,pubescent,reddish,revolute,shrub,slender,slightly,spaced,sparsely,specimen,stellate,stellate-pentagonal,stem,stigma,style,surface,tangled,thin,time,tip,trichome,upper,usually,vein,vine,woody,x,yellow	.5,0.2,0.5,1.3-,1.6-2,1/3,11-14,2.5-,2.5-5,3-4,4-6,4-7,5,5-12,5-merou,5.5-6,8-10,<,abaxiall,abruptly,acute,ag,alyx,anthesi,apar,apparently,ark,articulated,becoming,beginning,branching,broad,broadly,calyx,campanulate,cell,chartaceous,connivent,cuneate,cup-shaped,deltate,dilated,eaf,eed,ellipsoid,exserted,fleshy,free,fruiting,geminat,glabrescen,glabrou,ilament,impressed,intramarginal,junction,leaving,lengthening,lobe,looping,loosely,m.,markedly,multi-celled,narrowing,near,nflorescence,nodding,older,orolla,pale,papillat,peg,per,perfect,pericarp,planar,plurifoliate,pore,poricidal,portion,primary,prominent,rat,round-rectangular,ruit,sagittate,scar,shiny,simple,sleeve,slit,splitting,spreading,stout,strongly,terminal,testal,tiny,tube,twining,ud,unit,vary,way,ympodial	5-merous,abaxially,apart,bark,colour,form,glabrescent,height,leaf,length,na,number,ovary,plant,seed,shape,spacing,texture
683	wfo-0001031007	success	206	92	70	136	22	0.34	0.75-1.5,1,1-3.5,1.2-1.5,1.9-3,15,4.5-5,50-100,6,7-10,anther,apex,berry,bifid,black,broad,brown,capitate,clustered,cm,corolla,dendritic,densely,diameter,dull,elliptic,filament,flattened,flower,fruit,glabrous,globose,growth,inflorescence,irregularly,lax,lilac,long,loose,matte,minutely,mm,narrowly,often,papillate,pedicel,peduncle,perfect,petiole,pitted,pubescent,reddish,reniform,shrub,simple,slender,spaced,sparsely,stellate,stellate-rotate,stigma,stout,style,surface,tall,terminal,thin,trichome,vine,woody	.5,0.2,0.5,0.5-1,0.5-10,1-1.2,1-1.5,1.3-,1.5-2,1.6-2,1/3,11-14,2.5-,2.5-5,3-4,4-6,4-7,5,5-12,5-merou,5.5-6,8-10,<,abaxially,abruptly,acute,adaxial,ag,alfway,almost,along,alyx,anthesi,apar,apparently,articulated,bark,base,becoming,beginning,branched,branching,broadly,c.,calyx,campanulate,cell,chartaceous,completely,cuneate,cup-shaped,dark,deltate,dilated,drying,eaf,eed,ellipsoid,entire,exserted,extending,fleshy,free,fruiting,glabrescen,glabrou,herbarium,ilament,impressed,intramarginal,junction,lamina,leaving,lengthening,lobe,lobed,looping,lower,m.,many,margin,markedly,midvein,multi-celled,narrowing,near,new,nflorescence,nodding,occasionally,older,orolla,outline,pale,papillat,peg,per,pericarp,planar,plurifoliat,pore,poricidal,portion,primary,prominent,rat,revolute,round-rectangular,ruit,sagittate,scar,shiny,sleeve,slightly,slit,specimen,splitting,spreading,stem,strongly,tangled,testal,time,tiny,tip,tube,twinin,ud,unit,upper,usually,vary,vein,way,wide,ympodial	5-merous,abaxial,arrangement,colour,form,height,history,leaf,length,life,na,number,ovary,perennial,plant,position,rachi,reproduction,seed,shape,spacing,texture
684	wfo-0001031022	success	287	111	74	213	37	0.258	12.9,14.9,8.8,abaxially,acuminate,acute,adaxially,along,anther,apart,apex,area,base,becoming,bent,black,calyx,capitate,central,chartaceous,cm,corolla,cream,densely,diameter,dry,evenly,extra-axillary,filament,flattened-reniform,flower,forking,fruit,glabrous,globose,green,lanceolate,lateral,leaf,length,less,long,margin,mature,mm,moderately,ovate,pedicel,peduncle,petiole,pubescent,purple,reticulate,short,shrub,simple,small,smooth,spaced,sparsely,stellate,stigma,straight,style,surface,toward,tree,unbranched,vein,well,white,yellow,yellow-tan,±90°	.04,0.1,0.2–0.3,0.2–0.9,0.3–0.6,0.3–0.8,0.4–0.5,0.4–1.2,0.4–1.3,0.5–1.4,0.5–1.5,0.5–2.2,0.5–5.8,0.6–1.0,0.6–1.2,0.6–1.6,0.6–2.4,0.6–2.6,0.7,0.7–1.7,0.8–1.2,0.8–1.3,0.8–2.9,0.8–3.4,0.9–1.9,1.0–2.6,1.0–4.5,1.1–3.4,1.1–8.3,1.2–2.3,1.2–2.6,1.4–4.0,1.5–2.5,1.6–4.8,1.8–12.1,1.9–2.8,1/3,1/4,1/4–1/3,10,10.5,17–145,2.3–3.1,2.8–6.3,2/3,3.2–4.9,3.2–7.0,3.8,3.9–6.5,4.5–21.9,4–6-merou,4–9,5.1–8.7,5.8–11.4,5–7,5–8,6.9,6–10,8.2,8.9,90°,absent,adnate,aequilateral,alyx,anthesi,apical,apiculate,apparently,appearing,appressed,arching,arcuate,around,articulate,attenuate,axe,ba,bark,basal,berry,blade,branch,broad,brochidodromous,brown,bud,bulge,caudate,channeled,clinate,crea,cuneate,deciduous,dentate,development,difoliate,directed,directly,distal,distally,distinct,eaf,edge,eed,either,emerging,endocarp,entire,erect,exocarp,extending,ferruginous,fertile,filiform,free,geminat,glandular,glossy,gradually,hair,heterostylous,immature,increasing,intac,internode,interpetalar,intersepalar,juic,large,layer,lobe,lobed,lon,longer,lower,major,many,markedly,midpoint,midrib,midvein,minor,minute,nearly,nflorescence,oblique,opaque,opposed,orolla,oval,ove,per,perforated,poorly,pore,porrect,portion,potentially,raised,ray,reddish,reflexe,remaining,ridge,rigid,rounded,row,ruit,semicraspedodromous,sessile,several,shorter,side,sinus,sloughing,sometimes,splitting,spread,spreading,stellae,stellate-pubescent,stem,stipe,stipitate,suture,tamen,tardily,tem,terete,thin,time,tip,tissue,transparent,truncate,tube,two,ud,unarmed,unit,upper,various,vary,weakly,well-developed,wide,yellow-ferruginous,ympodial,young,±equal,±glabrous,×	0.5-1.5,0.5-5.8,0.6-1.6,0.6-2.6,0.8-3.4,0.9-1.9,1.1-8.3,1.2-2.3,1.2-2.6,1.6-4.8,1.9-2.8,17-145,2.3-3.1,abaxial,adaxial,arrangement,colour,form,growth,height,history,inflorescence,life,na,number,ovary,perennial,plant,position,rachi,reproduction,seed,shape,spacing,staman,texture,width
685	wfo-0001031036	success	150	74	45	105	29	0.3	.2,0.8-1,0.8-1.2,1-2.5,1.2-1.5,1.5-3,2-2.5,5-6,acute,anther,apex,bi-lobed,brown,closely,cm,corolla,dark,elliptic,filament,filiform,flattened-reniform,glabrous,globose,green,greenish-white,leaf,lobed,minutely,mm,opposite,ovary,pedicel,petiole,pitted,planar,shiny,shrub,simple,spaced,stigma,style,surface,white,winged,x	.25,.5,0.5-1,1-1.3,10-20-flowered,12-15,2.2-3.7,3-4,3-5,3.5-5.5,4.5-6.5,7-8,abaxially,acuminate,adaxially,along,angle,anthesi,arising,axil,ba,base,becoming,berry,broadly,calyx,conical,crisped,decurrent,deflexed,dia,differing,difoliate,dry,drying,eaf,edicel,eed,ellipsoid,enlarged,erect,exserted,fleshy,free,fresh,fruiting,geminat,knob-like,lamina,lateral,lobe,lon,long,lower,main,major,margin,material,middle,minor,nearly,nflorescence,oblique,older,onto,overlappin,pair,papillo,papillose,perhaps,pointed,pore,poricidal,portion,rounded,ruit,sagittate,scar,shaped,short,sinus,size,slightly,soon,spathulate,stem,strongly,tall,tapering,tear-drop,thickened,tip,trichome,tub,tube,ud,uniseriate,unit,usually,vein,widest,woody,yellowish,ympodial,young	10-20,abaxial,arrangement,colour,diameter,flower,form,fruit,growth,hair,height,history,inflorescence,length,life,na,number,peduncle,perennial,plant,position,rachi,reproduction,seed,shape,spacing,staman,texture,width
686	wfo-0001031040	success	217	95	58	159	37	0.267	.5,6,abaxially,adaxially,anther,apart,apex,broadly,cm,diameter,dull,filament,flattened-reniform,flower,fruit,glabrous,globose,green,inflorescence,lanceolate,lateral,lavender,leaf,lighter,longer,minutely,mm,narrowly,ovate,pedicel,peduncle,petiole,pitted,plant,purple,rarely,recurved,scabrous,sessile-stellate,shape,shrub,simple,slightly,small,somewhat,sparsely,stellate,stigma,straight,style,surface,tree,triangular,violet,white,yellow,yellow-brown,×	0.1–0.3,0.2–0.6,0.3–3,0.8–7.5,1.2–1.3,1.2–2.1,1.4–2.7,1.5–4,1.5–5,1.7,1.7–3.1,10,10–10.5,10–13,12–14,15–23,1–1.4,2,2.2–2.5,2.4–3,2.5–4,2.5–9,2–10,2–5-branched,3,3.5–5,3–26,3–4.5,3–5,4–6,5,5-merou,6.5–25,6–6.5,6–8,7–9,8–30,accrescent,acuminate,acute,adaxiall,age,also,alyx,anthesi,apical,apparently,articulated,attenuate,axe,ba,base,becoming,berry,blade,branch,broad-based,calyx,capitat,contrasting,dark,deeply,densely,depending,difoliate,directed,distall,eaf,eed,either,entire,especially,filiform,finely,flowering,free,geminat,glabrescent,glabrou,gland-tipped,glandular,hair,highly,homostylous,immature,internode,interpetalar,larger,like,lobe,lobed,lon,long,lower,major,margin,midpoint,midvein,midzone,minute,much,nflorescence,numerous,older,orolla,outside,ovoid,pale,perfect,persistent,pinnatifid,pore,porrect,prickle,principal,probably,ray,rounded,ruit,scarcely,sessile,several-celled,short,side,similar,size,sometimes,soon,spaced,sparse,splitting,sprout,stellae,stellate-pubescent,stem,subcordate,subcoriaceous,tamen,tem,thickened,time,tissue,triangular-attenuate,tube,turning,ud,unarmed,unit,upward,usually,variable,vary,vein,vigor,vigorous,wide,yellowish-tawny,ympodial,–6	0.3-3,0.8-7.5,1.2-1.3,1.5-4,10-10.5,12-14,15-23,2-10,2-5-branched,2.4-3,3-5,5-merous,7-9,8-30,abaxial,adaxial,arrangement,capitate,colour,corolla,form,growth,height,history,length,life,na,number,ovary,position,rachi,reproduction,seed,spacing,staman,texture,width
687	wfo-0001031062	success	216	85	52	164	33	0.241	-5.5,0.5,1,2-3.5,20,3-8,?,anther,apart,apex,articulated,base,bud,chartaceous,cm,densely,diameter,extra-axillary,ferruginous-tomentose,filament,flattened-reniform,flower,forked,foveolate,fruit,fully,glabrous,globose,green,leaf,minutely,mm,ovate-lanceolate,pedicel,pentagonal,perhaps,petiole,plant,rachi,ripe,rotate-stellate,shape,simple,stellate-tomentose,stigma,style,surface,treelet,unbranched,white,x,yellow	.5,0,0.3,0.5–0.6,0.7–0.8,1.2–1.4,1/3,13–15,15,16,17,1–2.5,1–4,2,2.5,22,2–3,2–5.5,3,3–10,4,4–10,4–4.5,5,5–7-rayed,7,7–15,7–8-rayed,9–11,abaxially,absent,accrescent,acute,adaxiall,adaxially,ag,ample,apiculate,appearing,armed,axe,ba,blade,bottom,branch,brownish,calyx,campanulate,capitat,clustered,colored,connivent,count,cuneate,curved,cylindrical,diamete,difoliate,directed,distally,eaf,eed,entire,even,eventually,except,fertile,fragrance,fruiting,geminat,glabrou,grading,hair,heavily,ilament,interpetalar,juvenile,larger,lateral,least,less,lighter,lobe,lobed,long,longitudinal,loosely,lower,m.,main,margin,midpoint,midrib,much,nearly,nflorescence,numerous,obscuring,obsolete,often,one,opening,orolla,overtopped,part,partially,per,perfect,pore,prickle,pubescent,rarely,recurved,rest,ruit,scabrous,sessile,shallow,short,short-stalked,shub,side,size,slightly,slit,small,sometimes,spaced,sparsely,sprout,stellae,stellate,stem,stipitate,straight,sweet,tall,tapered,tem,terminal,thick,thick-based,tip,tissue,tomentose,toward,triangular,truncate,tube,unarme,unarmed,unifoliate,uniform,unit,uppermost,usually,vary,vigorous,visible,wide,ympodial,young,younger,–3	1-2.5,1-4,13-15,2-3,2-5.5,3-10,4-4.5,9-11,abaxial,adaxial,arrangement,capitate,colour,corolla,form,growth,height,history,inflorescence,length,life,na,number,ovary,peduncle,position,reproduction,seed,shrub,spacing,staman,texture,width
688	wfo-0001031064	success	179	71	46	133	25	0.257	0.5,0.5-0.7,1-2,1-3,1.2,10-12,2.5-3,3.5-4,5-6,anther,apex,attenuate,bright,cm,conical,corolla,diameter,elongate,filament,flower,fruit,glabrous,green,inflorescence,leaf,lightly,lobed,mm,nodding,obovate,ovary,ovoid-reniform,papillate,pedicel,petiole,pinnate,pubescent,purple,rachi,rugose,shrub,simple,stigma,style,surface,white	.0-2.5,.05,.5,.5-1,0,0-15,0.5-0.8,1,1-1.2,1.5-2,1.7-4.2,10-12.5,10-17,2,3,3-5.5,3-7,4-5-celled,5-10.5,6-16,7-16,8-10-celled,abaxially,acroscopic,acuminate,adaxially,along,anthesi,anticlinal,arising,axil,basal,base,bearing,berry,blade,broader,calyx,cell,clavat,commentary,completely,conspicuous,dark,deltate,densely,denser,distal,dr.,eaf,edicel,eed,epidermal,erec,exserted,fleshy,free,fruiting,globose,half,highly,irregular,irregularly,lamina,lateral,leaflet,leave,lenticel,like,lobe,lon,long,lost,lower,margin,minute,minutely,narrower,near,nearly,nflorescence,node,occasionally,often,open,ovate,pair,per,petiolule,planar,poricidal,portion,projection,prominent,pubescen,ruit,scar,scattered,see,short-pubescent,side,single,sinuous,sinus,slender,smaller,somewhat,sparsely,splitting,stem,strongly,swollen,tal,tem,terminal,thickening,time,tip,translucent,trichome,tub,tube,ud,unifoliat,uniseriate,unit,usually,vein,wand-like,winged,without,x,ympodial	abaxial,adaxial,arrangement,axillary,clavate,colour,form,growth,height,history,length,life,na,number,peduncle,perennial,plant,position,reproduction,seed,shape,spacing,staman,texture,width
689	wfo-0001031065	success	140	75	46	94	29	0.329	.2,.3,.6,1-celled,aculeate,anther,apex,chestnut,cm,concolorous,corolla,eglandular,extra-axillary,filament,flower,fruit,glabrous,glandular,green,green-striate,herb,light,lilac,margin,mm,nonglandular,ovary,ovate-lanceolate,ovoid,pale,pedicel,peduncle,petiole,rough,scabrid,simple,sometimes,spheroid,stellate,stigma,style,subshrub,surface,trichome,umbelliform,white	.1–0.3,.4,.5–2,0.2–1.1,0.5–1.6,0.5–5,0–30,1,1-,1.8–7.8,2,4,4-merous,5-merous,accrescent,acicular,acuminate,acute,almost,also,alyx,apical,apparently,armed,asymmetrical,attenuate,base,berry,beyond,calyx,cell,celled,central,color,composed,deltate,dense,dia,difoliate,eaf,eed,either,entire,erect,externally,ferruginous,frui,geminate,held,indumentum,lamina,lateral,lobe,lobed,lower,many,many-celled,midpoint,midvein,multi-celled,narrowly,nflorescence,non-glandular,occasionally,orolla,per,perfec,perhaps,persistent,porrect-stellate,portion,puberulous,radial,rare,rarely,rounded,ruit,sessile,shor,short,short-pedunculate,slightly,solitary,sparse,spine,stem,tall,terete,unifoliat,unit,upper,usually,x,ympodial	0-30,0.2-1.1,0.5-1.6,abaxial,adaxial,arrangement,colour,diameter,form,growth,height,history,inflorescence,leaf,length,life,na,number,perennial,plant,position,rachi,reproduction,seed,shape,spacing,staman,texture,width
690	wfo-0001031071	success	186	91	66	120	25	0.355	0.2-0.8,1-2,2.1-3,2.4-3.4,3-10,3-5,4-25,4-6,8-28,abaxially,adaxially,anther,apex,blue,brownish,cell,clavate,cm,color,condition,coriaceous,corolla,covering,dark,deep,diameter,drying,elliptic,filament,flower,forked,fresh,fruit,glabrous,globose,green,greenish,hair-like,herb,lateral,leaf,lilac,medium,mm,odd-pinnate,ovate,ovoid,pedicel,peduncle,pentagonal,petiole,plant,purple,rotate,seed,spot,star,stigma,style,terminal,testal,thick,wall,white,whitish,yellow	0-10,0.4-2,1-1.5,1-3,1-7,1.5-2.2,2-3,2-5,2-8,3-6,3.8-5.4,5-9.4,5-merou,5.7-8.8,6-8,7-16.5,7-8,abaxiall,acumen,acute,ag,along,alyx,apart,apparently,arranged,articulated,asymmetric,attenuate,axe,axillary,base,basiscopic,bead,berry,blade,bud,capitat,connivent,decreasing,digestion,distal,dorsally,eaf,edge,eed,enzyme,erec,exceeding,flat,folded,geminat,generally,glabrou,green-white,half,homostylous,honeycomb-shaped,interjected,lanceolate,leaflet,lengthening,like,living,lobe,long,lower,make,middl,moniliform,mottled,mucilaginous,multiple,narrowly,necklace,nflorescence,orbicular,orolla,pair,perfect,petiolulate,plurifoliate,pore,poricidal,removed,ripe,round,ruit,sessile,seudostipule,short,side,size,slightly,slit,spaced,specimen,stamen,stolon,straight,subequal,subtending,tall,tamen,tem,throughout,tip,tissue,toward,tri-,tube,tuber,typically,unit,usually,vary,wet,winged,x,ympodial	abaxial,adaxial,arrangement,capitate,colour,form,growth,height,history,inflorescence,length,life,na,number,ovary,perennial,position,rachi,reproduction,shape,spacing,staman,surface,texture,width
691	wfo-0001031097	success	174	101	78	96	23	0.448	0.45,1-4,1-4.5,1.6-5.5,13-30,2-3,2-3.3,2-4,3-5,3.7-8.4,4-6,4-7,8-11,abaxial,abaxially,adaxially,along,articulate,branched,cm,corolla,cyme,darker,deep,diameter,dichasial,dichasially,distal,dotted,ebracteate,edge,elliptical,flower,forked,green,green-white,half,herbaceous,lateral,leaf,leaflet,light,lighter,margin,medium,mm,monochasial,mottled,mucilaginous,narrow,obovate,odd-pinnate,ovate,ovoid,pair,pedicel,peduncle,pentagonal,perennial,petiole,plant,proximal,puberulent,pubescent,purple,rotate,seed,side,stigma,strigose,style,terminal,throughout,violet,violet-blue,wide,yellow,¼	0.5,1,1-3,1.5,1.8-2.5,1.8-2.6,3-6-foliat,3.5-6,5-11,5-12,5-9,9-21,acumen,acuminate,acute,apex,apical,apically,base,calyx,cell,connate,covering,cuneate,decurrent,dehiscent,digestion,diminishing,dorsally,eaf,eed,emoval,enzyme,exceeding,filament,flat,folded,frequently,generally,globo,gree,hair-like,highly,honeycomb,interjected,interpetalar,introrse,living,lobe,lon,long,lower,lunat,make,maturing,nflorescence,noticeably,nther,oblique,often,orolla,pattern,perfect,petal,petiolulate,petiolule,plan,poricidally,rachi,rapidly,rarely,reveal,ruit,sessile,seudostipule,short,size,slit,sometimes,specimen,stamen,straight,tal,tem,testal,thick,tissu,toward,tuber-bearing,typically,unit,vary,vbase,wall,without,ympodial	anther,arrangement,colour,form,fruit,globose,growth,height,history,inflorescence,length,life,number,ovary,position,reproduction,shape,spacing,stem,surface,texture,wet,width
692	wfo-0001031101	success	197	103	78	119	25	0.396	-5,/2,0.5-0.8,0.5-3,0.8-,1-2,1-2.3,1-3,1.3-2,1.4-1.7,1/4-1/2,10-30,2-6,3-15,3.5-4.5,4-5-merous,abaxial,abaxially,acuminate,adaxial,almost,anther,apex,apical,articulated,base,berry,bright,cm,diameter,dull,erect,evenly,filament,filiform,flattened-reniform,flower,glabrescent,glabrous,glandular,green,green-brown,hair,lateral,leaf,length,lobed,long-acute,maturity,mauve,membranous,minute,mm,moderately,orange-brown,orange-red,ovate,pedicel,peduncle,petiole,red,scandent,shrub,simple,sparsely,spherical,stellate,stellate-pubescent,straight,style,surface,terminal,umbel,way,white,yellow,yellow-green,young	-1,-16,-20,-30,-8,/2-equal,0.05-0.2,0.1-0.2,0.1-0.3,0.3-0.5,0.6-0.8,0.7-0.8,1-,1.3-2.5,1.5-3,1/3-1/2,2-2.8,2-4,2-5,2.5-,2.5-3.5,2.5-3.8,3-10,3-8,4-10,4-7,4.5-9,5-20,5-6,6-10,8-15,alyx,ame,apar,apically,apparently,ba,bark,blade,branched,c.,calyx,concolorous,connivent,deltate,difoliate,drying,eaf,eed,elongating,entire,equal,free,frui,fruiting,geminat,herbaceous,infructescence,lobe,long,long-acuminat,longer,lower,margin,mature,midpoint,multangulate,narrow-deltate,near,nflorescence,obtuse,often,older,one,open,orolla,oung,pair,pale,pendulous,per,perfec,pericarp,poricidal,porrect,portion,primary,ray,red-brow,resembling,rounded,ruit,scar,sessile,smooth,spaced,spreading,stalk,stalked,stellate-pubescen,stem,tamen,tapering,terete,tertiary,time,tip,trichome,tube,unarme,unarmed,unit,variously,vary,vein,venation,visible,wide,ympodial	apart,arrangement,colour,corolla,form,fruit,growth,height,history,inflorescence,life,na,number,ovary,plant,position,rachi,reproduction,seed,shape,spacing,staman,stigma,texture,width
693	wfo-0001031114	success	208	100	75	133	25	0.361	.2,0.5,0.5-1,0.8-1.2,1-10,1-7,1-8,1.5-4,2-3,25-50,3-10,4-10,4.5-6,abaxially,adaxially,anther,apart,apex,becoming,branched,brown,chartaceous,cm,dark,densely,diameter,elliptic-ovate,erect,especially,filament,first,flattened,flower,fruit,glabrous,globose,green,leaf,leaf-opposed,light,margin,membanaceous,mm,nearly,nodding,outline,ovate,pedicel,peduncle,petiole,purple,rachi,reniform,ripe,rugulose,shrub,simple,small,sparsely,stellate,stellate-pubescent,stigma,strongly,style,subcoriaceous,surface,thickened,toward,tree,truncate,white,white-pubescent,x,yellow,yellowish	.1,.5,0-0.3,0.3-0.5,0.7-1.5,1-1.5,1-2,1-4.5,1.5-2.5,10-15,2-17,2-4,2-7,2.5-3,2/3,3-4,3-5,3-7,4-5,4-8,5-10,5-8,5-merou,6-7,7-15,absen,accrescent,acuminate,acute,adaxiall,ag,alyx,apparently,articulated,axe,ba,base,berry,blade,calyx,capitat,connivent,covering,cylindrical,deltate,differentiated,directed,discolorous,distal,distally,dried,eaf,echinoid,eed,entire,equal,fleshy,free,frui,fruiting,geminate,hair,highly,homostylous,impressed,interpetalar,introrsely,juic,lacking,large,like,lobe,long,long-stalked,longitudinal,lower,major,midpoint,minor,multangulate,nflorescence,oblong,obtuse,often,one,opening,orolla,paired,part,perfect,pericarp,plurifoliate,pore,porrect,prominent,pubescent,ray,rounded,ruit,sessile,short,short-,short-stalked,side,slightly,slit,somewhat,spaced,stalk,ste,stem,straight,subcucullate,subcuneate,subtending,tall,tamen,tem,thin,time,tip,tissue,triangular,tube,unarme,unit,vary,vein,white-stellate,whitish,wide,without,ympodial	abaxial,adaxial,arrangement,capitate,colour,corolla,form,growth,height,history,inflorescence,length,life,na,number,ovary,plant,position,reproduction,seed,shape,spacing,staman,texture,width
694	wfo-0001031116	success	191	91	66	125	25	0.346	.5,/4,0.3-0.5,1,1-5,2-5,3.5-4,30-100,4-7,5-merous,8-11,abaxial,abaxially,acuminate,adaxial,anther,apart,apex,base,berry,caudate,cm,diameter,dull,elliptic,erect,evenly,filament,flattened-reniform,flower,fruit,glabrescent,glaucous-green,green,lateral,leaf,length,less,lobed,long,maturity,mauve,mm,moderately,obovate,orange-brown,orange-red,pedicel,peduncle,petiole,recurved,red-brown,sharply,shortly,shrub,simple,small,spherical,stellate,stellate-pubescent,style,surface,tree,way,yellow,young	-10,.2,.8,0,0.05-0.15,0.1,0.4-0.7,0.7-0.9,0.7-1,1/2,1/3-2/,1/6-1/4,10-14,15-25,2.7-3.2,30-50,4-10,5,5-15,9-13,almost,alyx,ame,apar,apically,apparently,arachnoid,articulated,attenuate,bark,blade,branching,bristle,broad-deltate,brow,c.,calyx,clearly,collapsed,connivent,densely,dirty-white,discolorous,drying,eaf,eed,elongated,elongating,epidermi,equal,flat,flexuous,fragile,free,fruiting,glabrous,hair,infructescence,lobe,longer,lower,margin,mature,membranous,midpoint,minute,multangulate,narrow-deltate,nflorescence,obtu,obtuse,often,older,one,open,orolla,oung,pair,per,perfec,pericarp,perpendicular,plurifoliat,poricidal,portion,primary,ray,reflexed,rounded,ruit,scar,secondary,sessile,single,slender,smooth,soft,sometimes,spaced,sparsely,stalk,stalked,stem,straight,subentire,tamen,tapering,terete,tertiary,time,tip,trichome,tube,unarme,unarmed,unit,upper,vary,vein,venation,visible,weakly,wide,woody,ympodial	1.8,arrangement,colour,corolla,form,glaucous,growth,height,history,inflorescence,life,na,number,ovary,plant,position,rachi,reproduction,seed,shape,spacing,staman,stigma,texture,width
695	wfo-0001031127	success	196	112	89	107	23	0.454	+,0.4-1.5,0.5-1,0.5-1.3,0.8-2,1-1.5,1.5-2,1.5-2.5,2,2-lobed,3.5-4,30-100,6-6.5,7-30,abaxially,acicular,adaxially,almost,anther,apex,bark,brown,calyx,capitate,cell,cm,conical,corolla,cupuliform,deep,densely,diameter,ellipsoid,elliptic,filament,flattened,flower,fruit,fruiting,glabrous,globose,growth,inflorescence,internodal,lanceolate-elliptic,leaf,lobed,long-styled,margin,minutely,mm,new,number,opposite,ovary,pale,pedicel,peduncle,pentagonal,petiole,pinnatifid,pitted,prickle,pubescent,purple,red-violet,reddish,relatively,reniform,scar,scattered,shallowly,shiny,short-styled,shrub,simple,somewhat,sparsely,stellate,stem,stigma,stout,style,surface,tan,thin,trichome,x,yellowish	-2,.5,0.3-0.4,0.5,0.5-3,0.8-1,1,1-5-2,1.5-3,12268,2-3,3-4,3-5,3.5-7,3/4,4,5,5-8,8,8-16,?,acute,anthesi,apar,apparently,armed,articulated,attenuate,base,berry,chartaceous,eaf,eed,ekman,elongate,elongating,equal,even,extremely,fide,free,heterostylous,hyaline,included,individual,lamina,like,linear,lobe,long,long-triangular,lower,m.,membranous,midpoint,midrib,minute,near,nflorescence,nodding,older,open,outline,pair,papillat,per,pericarp,planar,plurifoliat,pore,poricidal,porrect,portion,prickly,primary,prominent,ray,rectangular,reduced,rest,ruit,sessile,shin,short-stalked,sinuate,sinus,slightly,slit,sometimes,spaced,spreading,tapering,testal,time,tip,tube,ud,unit,upper,variable,vein,way,widely,woody,yellow,ympodial,½	abaxial,adaxial,apart,arrangement,bud,center,colour,form,height,history,length,life,na,plant,position,rachi,reproduction,seed,shape,spacing,staman,texture,width
696	wfo-0001031128	success	213	83	64	149	19	0.3	-100,-4.5,-6.5,0.5-0.7,0.5-0.8,0.5-5,0.6-1,0.8-1.7,1-,1.5-3,2-5,2.3-,20-50,20-60,3-4,4-5-merous,5-19,abaxial,anther,apart,apex,branched,cm,diameter,dull,elliptic,erect,evenly,filament,flattened-reniform,flower,fruit,glabrescent,glabrous,green,inflorescence,lateral,leaf,length,lobed,mauve,membranous,mm,moderately,orange-brown,pale,pedicel,peduncle,petiole,purple-black,recurved,red,red-brown,shrub,smooth,spherical,stellate,stellate-pubescent,style,surface,terminal,white,yellow,yellow-green	-10,/4,0,0-30,0.05-0.2,0.05-0.25,0.2,0.2-0.4,0.3-0.8,0.5-1.5,1,1-1.6,1.2-2,1.5-3.5,1/,1/6-1/3,10-20,10-35,2-9.5,2.5-10,2.5-3.5,3.5-4.5,4-7,5-,5-15,5-30,8-12,8-23,abaxially,acute,almost,alyx,apar,ape,apically,apparently,articulated,bark,base,berry,blade,branching,bristle,brown,calyx,concolorous,connivent,cuneate,deltate,densely,drying,eaf,eed,elongated,elongating,entire,equal,eye,filiform,flexuous,free,fruiting,gland,glandular,gra,hair,infructescence,less,lobe,lon,long,long-acuminat,long-acuminate,longer,lower,margin,mature,maturity,midpoint,minute,multangualte,multangulate,naked,narrow-deltate,near,nflorescence,occasionally,often,older,one,open,orolla,oung,pair,per,perfect,pericarp,perpendicular,plurifoliat,poricidal,portion,primary,ray,reduced,reflexed,ruit,scar,secondary,sessile,shallowly,short-attenuate,short-styled,side,simple,single,soft,spaced,spreading,stalk,stalked,staminate,stem,straight,tamen,tapering,terete,tertiary,time,tip,trichome,tube,unarme,unarmed,undulate,unit,usually,variously,vary,vein,venation,visible,way,weakly,whitish,wide,woody,yellow-brown,ympodial,young	adaxial,colour,corolla,form,growth,height,na,number,ovary,plant,position,reproduction,seed,shape,spacing,staman,stigma,texture,width
697	wfo-0001031135	success	189	111	82	107	29	0.434	1-,1-1.5,1-10,1-3,1.5-2,1.5-3,1.5-9,10-20,2-,2-3,2-4,3-10,3-4,3.5-12,4-5,5-30,5-9-pinnate,abaxially,adaxially,along,also,apart,apex,articulated,base,campanulate,cm,compound,darker,deflexed,densely,diameter,eglandular-pubescent,ellipsoidal,especially,fading,flattened,flower,frequently,fruit,fusiform,glabrous,glandular-,green,leaf,light,longitudinal,midrib,mm,moderately,often,ovoid,papillose,pedicel,peduncle,peltiform,petiole,pilose,pink,pinnatifid,puberulent,pubescent,purple,rachi,ripe,shrub,simple,spaced,sparsely,stigma,stripe,style,toward,tree,unbranched,unlobed,violet,white,whitish,x,yellow-green,yellowish	-7,0-2,0.5-2,0.7-2,1-2.5,1-4,2,2-2.5,2-23,2-3.5,2-5,2.5-28,3-5,4-foliat,5-11,7-15,absent,acuminate,acute,adpressed,aggregate,ape,axe,basal,basiscopically,beyond,biglandula,blade,broad,calyx,cell,chartaceous,color,connective,cordate,coriaceous,cuneate,cylindrical,decurrent,deltate,dilated,directed,distally,eaf,eed,ellipsoida,elliptic,entire,equal,exceeding,exserted,hair,interstitial,irregularly,lateral,laterally,leaflet,leaving,lobe,lobed,lon,long,lower,margin,narrowed,nflorescence,nther,obconical,oblique,oblong,obtuse,occasionally,orolla,ovate,pedicellar,perfect,pilo,pinnately,pore,present,radiu,remnant,ruit,shorter,slightly,small,smaller,stamen,stone,strongly,subcoriaceous,tal,tem,thecae,time,tip,tomento,triangular,truncate,tube,ud,unit,unknow,upper,vary,wide,ympodial	abaxial,adaxial,anther,arrangement,biglandular,colour,corolla,filament,form,growth,height,history,inflorescence,length,life,na,number,ovary,perennial,plant,position,reproduction,seed,shape,spacing,staman,surface,texture,width
698	wfo-0001031143	success	217	93	51	166	42	0.235	2.5,4,anther,apart,apex,articulated,base,broadly,cm,densely,diameter,elliptic,evenly,extra-axillary,filament,flattened-reniform,flower,fruit,glabrous,globose,green,homostylous,interpetalar,lateral,leaf,length,minutely,mm,moderately,narrowly,nearly,ovate,pale,pedicel,peduncle,petiole,pitted,shrub,simple,smooth,stellate,stellate-tomentose,stigma,style,surface,tissue,well-developed,white,yellow,yellow-orange,×	0.3–0.5,0.3–0.8,0.4–0.8,0.4–1,0.7–0.9,0.9–1,0–50,1.1–2,1.4–1.7,1.5,1.5–1.9,1.5–2.5,1.5–3,1.5–5.5,10,10.5–11,15–23,1–1.2,1–1.5,1–4,2,2.3–2.5,2.5–4,2.5–4.5,2–2.5,2–3,2–3-branched,2–9,3,3–3.5,4–8-rayed,5,5-merou,5–7,6–8,7–12,8–10,9,abaxially,acicular,acute,adaxially,alyx,apical,apparently,appearing,armed,attenuate,axe,ba,berry,bifoliate,blad,blade,branch,broad,broad-based,bud,capitat,contrast,dark,directed,distall,dried,eaf,eed,entire,except,fertile,filiform,finely,forming,free,geminat,glabrescent,glabrou,hair,half,high,immature,internode,irregularly,lanceolate,large,layer,leaving,like,lobe,lon,long,lower,major,margin,material,maturing,midpoint,midrib,midvei,midvein,minor,minute,mixed,mostly,much,near,nflorescence,oblong,often,orolla,overlapping,ovoid,per,pore,porrect,potentially,prickle,principal,rarely,ray,remaining,repand,ruit,sessile,set,several,shallow,short-caudate,shorter,side,sinus,slender,soon,spaced,splitting,stellae,stellate-tomento,stem,stipe,stipitate,straight,subcordate,tamen,tardily,tem,thick-chartaceous,time,tip,tomentum,truncate,tube,ud,unarme,unarmed,usually,various,vary,vein,weak,wide,yellow-ferruginous,ympodia,–11,–2.5,–4,–4.5,–8	0.3-0.8,0.9-1,1-1.2,1-1.5,1.1-2,1.5-2.5,1.5-3,2-3,2-3-branched,2.5-4.5,20-50,4.5,5-merous,6-8,8,8-10,abaxial,adaxial,arrangement,capitate,colour,corolla,form,growth,height,history,inflorescence,life,na,number,ovary,perennial,plant,position,rachi,reproduction,seed,shape,spacing,staman,texture,width
699	wfo-0001031144	success	231	110	84	147	26	0.364	0.2,0.8-1.4,1-1.5,1-4,1.1-2.5,100,2-3,2-6,25,6,7-10,acuminate,acute,anther,apart,apex,berry,bright,broadly,brown,calyx,capitate,cell,cm,corolla,densely,diameter,elliptic,filament,flattened-reniform,flower,form,fruiting,glabrous,globose,groove,growth,inflated,inflorescence,irregularly,later,lateral,leaf,lobed,margin,minutely,mm,new,number,pale,pedicel,peduncle,petiole,pinnately,pinnatifid,pitted,pubescent,red,reddish,scar,seed,shiny,simple,slightly,spaced,sparsely,stellate-rotate,stem,stigma,style,surface,tan,terete,terminal,tiny,triangular,trichome,uniseriate,vine,violet,woody,x,yellow,yellowish	-11,-13,.2,.5,0.5,1-,2,2-,2-9,2.5-3,2/3,3-4.5,3-7,3.5-10,4,4-20,4-4.5,4-6,5,5-9,5-merou,<,adaxially,ag,alyx,anthesi,apicula,apiculae,appearing,ark,around,articulated,asymmetric,away,axi,basal,base,basiscopically,blac,branch,branche,brow,closer,commonly,connivent,cordate,corresponding,cupped,curved,divaricate,drying,eaf,eed,ellipsoid,elongate,elongating,entire,exserted,extending,flattened,four,free,geminat,ilament,lamina,larger,leaflet,leaving,lengthening,less,like,lobe,long,longer,longest,loosely,lower,many,markedly,membranous,mere,minute,near,nflorescence,oblique,occasionally,often,older,one,open,orolla,outline,pair,papillo,peg,pendant,pentagonal,per,perfect,pericarp,plurifoliate,pore,poricidal,portion,primary,progress,quite,rim,ripe,ruit,sleeve,slit,small,smaller,sometimes,spreading,strongly,tangle,tem,testal,thin,third,tip,together,truncate,tube,tuft,twinin,twining,two,ud,unequal,unit,upper,usually,variable,vary,vein,wall,way,weight,white,widest,wing,wood,ympodial,½	5-merous,abaxial,adaxial,arrangement,bark,bud,center,colour,fruit,height,history,length,life,na,ovary,plant,position,prickle,rachi,reproduction,shape,spacing,staman,tangled,texture,width
700	wfo-0001031152	success	232	107	83	149	24	0.358	-10,.4,0.2-0.3,0.2-1.5,0.3-1.3,0.3-3,1-1.5,1-6,1.2-1.8,11,2.7-3.7,4-19,4-6,4-8,8-20,abaxially,acuminate,adaxially,anther,apart,apex,becoming,brown,bullate,chartaceous,cm,conical,continued,corolla,deltoid,densely,diameter,due,filament,flower,fruit,globose,green,greenish,growth,honeycombed,lanceolate,lateral,lavender,leaf,length,lilac,long,mm,mostly,narrowly,oblanceolate,orbicular,pale,pedicel,peduncle,petiole,pitted,probably,pubescent,rachi,reniform,reticulate-punctate,ripe,rotate-stellate,scabrous,shrub,simple,sparingly,sparsely,stellate-pubescent,stem,stigma,style,suborbicular,surface,terminal,tree,violet,x,yellow,yellowish,young	-1.5,-5.5,/100-1/16,0-100,1-3,1.1-2.2,1.1-3,1.3-4,1.4-2.6,1.5-3,1.5-3.5,1/2-2/3,1/2-3/4,13-27,2-5,2.5-7.5,2.7-4.5,2.7-6,2.8-4,3.7-7,4-7,5-6,6.5-10,9-13,accrescent,acute,ag,along,anthesi,apical-lateral,apparently,articulated,attenuate,axe,axillary,ba,basal,base,berry,blade,blister,blunt-tipped,branch,branched,bud,calyx,capitat,closely,decurrent,dehiscing,directed,eaf,earl,eed,entire,evident,exserted,extend,few-rayed,fleshy,free,fruiting,glabrescen,glabrous,granular-tomentose,hair,high,inserted,introrse,lackin,large,less,lobe,lobed,long-,longer,longitudinal,lower,m.,main,margin,midvein,mixed,moderately,multangulat,multangulate,nearly,nflorescence,oblong,obtuse,occasionally,one,open,openly,orolla,ovate,partly,perfect,persistently,plurifoliate,pore,porrect-stellate,rather,ray,reddish,reddish-brown,relatively,ruit,runk,sessile,short-,short-stalked,side,slightly,slit,somewhat,soon,spaced,splitting,stamen,stelliform,stipitate-glandular,stout-stalked,strongly,suture,swelling,tamen,terete,testa,thick,thick-stalked,thin,thin-,thin-stalked,time,tomentose,touching,toward,tube,unarme,unarmed,unit,usually,variously,vary,vein,way,wide,ympodial	30-100,abaxial,adaxial,arrangement,capitate,colour,form,glabrescent,height,history,inflorescence,life,na,number,ovary,perennial,plant,position,reproduction,seed,shape,spacing,staman,texture
701	wfo-0001031155	success	193	117	89	104	28	0.461	.5,0.2-1.2,0.5,1,1-1.2,1-1.5,1.5-2,2-5,2.5-3.2,4-,4-6,5-20,7-15,abaxially,almost,anther,apart,apex,bark,base,beneath,bilobed,calyx,cell,closely,cm,corolla,cream,dark,deeply,densely,diameter,distally,echinoid,elliptic,evenly,filament,flower,glabrous,globose,growth,height,inflorescence,internodal,lanceolate,leaf-opposed,like,lobed,lower,margin,midrib,minutely,mm,multangulate,new,once-branched,orange,pale,part,pedicel,peduncle,petiole,prickle,prickly,pubescent,scar,shallowly,shiny,shrub,simple,spaced,sparsely,stellate,stem,stigma,strongly,style,surface,tan,terminal,tip,trichome,unknown,white,whitish,widely,within,x,yellowish	0,0.1,0.2,0.3-0.4,0.7,0.7-1.5,1.5,1.5-1.6,1.5-5,3-4-foliate,4.5-7,5-7,8.5-13,acuminate,acute,adaxially,age,along,anthesi,apparently,appearing,armed,articulate,axi,broader,bullate,central,climbing,common,cup-shaped,deltate,discolorous,distall,due,eaf,eed,enlarged,equal,exserted,ferrugineous,fine,glabrescen,glandular,halfway,heavily,heterostylous,hub-like,intertwined,know,known,larger,leaving,lengthening,lobe,long,longer,los,midpoint,mixed,mixture,multiseriate,narrowly,nflorescence,oblique,obtuse,occasionally,older,open,outline,pair,papillat,peg,plurifoliate,pore,poricidal,porrect,primary,principal,purple,ray,reddish,ruit,seen,sessile,short-stalked,short-styled,size,slightly,small,somewhat,sparse,sparser,split,stalk,stout,straight,tapering,tube,ud,unevenly,unit,variable,vein,ympodial	abaxial,adaxial,arrangement,bud,center,colour,form,fruit,fruiting,glabrescent,history,leaf,length,life,na,number,ovary,papillate,plant,position,rachi,reproduction,seed,shape,spacing,staman,texture,width
702	wfo-0001031162	success	241	94	70	171	24	0.29	.5,0.7-5,1-1.5,1-15,1-5,1.5-2,1.5-3,1.5-8,1.7-4.5,10-30,2-,3-10,3-branched,3.5-5.5,5-10,7-9,angled,anther,apex,black,broadly,chartaceous,cm,cordate,densely,diameter,erect,extra-axillary,filament,flower,fruit,glabrous,globose,green,inflorescence,irregularly,leaf,length,minutely,mm,obtuse,outline,ovate,pale,pedicel,peduncle,pendant,perennial,petiole,pseudohair,pubescent,purple,rachi,reniform,reticulate,rhizomatous,shrub,simple,sparsely,stellate,stellate-pubescent,stigma,style,surface,tan,unbranched,white,x,yellow,yellowish	%,-74,0,0-1.2,0-1.5,0-2.5,0-25,0.05-0.1,0.1-0.15,0.1-0.2,0.1-0.8,0.15-0.4,0.25,0.4-0.8,0.5-0.7,0.5-0.8,0.5-1.5,0.5-2,0.5-3,0.5-7,0.6-0.8,0.7-1.2,0.8-1.2,1-1.7,1-10,1-13,1-2,1-locular,1.2-1.4,1.5-1.9,1.5-2.5,10,10-12,15-20,2-2.8,2-7,2-foliate,20-40,26-,3-4,3.5-10,35-200,4-5,4-6,4-8,4-9,5-6,5-7,5-merou,6,6-7,6-8,60,600-1400,7-17,7-70,8-14,abaxially,absent,accrescent,acicular,across,acute,adaxially,adult,alyx,apart,apparen,armed,articulated,ascending,attenuate,axe,ba,base,blade,branch,branche,calyx,capitat,connivent,cylindrical,decimetre,deeply,deltate,directed,distall,distributed,dm,eaf,eed,eglandular,exocarp,finger,fruiting,geminat,generally,gland-tipped,hair,half,homostylous,incomplete,index,interpetalar,juicy,juvenile,lamina,lanceolate,lateral,less,lobe,lobed,lobing,lon,long,longer,lower,margin,mature,mesocarp,mid-point,midpoint,midvein,minute,moderate,moderately,narrow,nflorescence,oblique,orolla,pair,part,per,perfect,placenta,pore,porrect,presen,present,prickle,ray,ruit,septum,sessile,short,side,somewhat,spaced,sparse,stalk,stellae,straight,succulent,tal,tamen,tem,thick,throughout,time,tissu,tissue,transparent,triangular,tube,unit,upper,vary,vein,wide,wing,ympodial	5-merous,abaxial,adaxial,arrangement,capitate,colour,corolla,form,growth,height,history,life,na,number,ovary,plant,position,reproduction,seed,shape,spacing,staman,texture,width
703	wfo-0001031178	success	167	75	48	119	27	0.287	0-0.2,0.3-0.6,0.7-1.7,1-3,4-4.5,5-11,6-14,7-11,7.5-8.5,abaxially,acute,adaxially,anther,apex,cm,densely,diameter,erect,extra-axillary,flower,fruit,glabrous,globose,green,grey,inflorescence,length,lobed,mm,ovate,pedicel,peduncle,perennial,petiole,pseudo-racemose,purple,rhizomatous,rusty,shallowly,shrub,simple,solitary,sparsely,stellate,stellate-pubescent,style,unbranched,yellow	%,0-0.25,0-0.4,0-0.6,0-10,0-5,0-6,0.1-0.2,0.1-0.25,0.4-0.6,0.6-0.9,0.6-1,0.6-1.2,0.7-1,0.8-1.2,0.9-1.2,1-2,1-4,1.2-1.4,1.2-1.5,1.2-3.4,1.5-5.2,1.5-6,11-18,180-400,19-30,2-3.5,2-5,3.5-9,4-9,40-65,5-merou,6-8,7-8,absent,accrescent,acicular,across,adaxiall,alyx,apart,armed,articulated,ascending,attenuate,axe,ba,base,blade,brown,calyx,chartaceous,cuneate,cylindrical,d.,directed,distall,distributed,dult,eaf,eed,eglandular,entire,finger,fruiting,glabrou,gland-tipped,hair,half,hig,juic,lamina,lanceolate,lateral,lobe,lon,long,longer,lower,margin,mature,mesocarp,midpoint,midvein,minute,moist,nflorescence,oblique,orolla,part,per,pore,porrect,presen,present,prickle,ray,ruit,short,spaced,stage,stalk,stellae,stem,straight,tamen,thick,throughout,time,tube,unit,unknow,unknown,uvenile,vary,vein,wide,x,ympodial	5-merous,abaxial,adaxial,arrangement,colour,corolla,filament,form,growth,height,history,leaf,life,na,number,ovary,plant,position,rachi,reproduction,seed,shape,spacing,staman,stigma,surface,texture
704	wfo-0001031185	success	213	97	75	138	22	0.352	0.5-3,1-10,1-5,10-40,2.5-16,3-4,4.5-7.5,7-10,anther,apart,apex,branched,bright,broadly,capitate,cm,corolla,densely,diameter,eye,filament,flattened,flower,glabrous,globose,green,growth,inflorescence,lateral,lax,leaf,lobed,long,many,meter,minutely,mm,moderately,open,ovate,pale,papillate,pedicel,peduncle,petiole,pinnatifid,pitted,pubescent,red,reniform,seed,several,shape,shiny,shrub,simple,slender,slightly,sparsely,spreading,stellate,stigma,style,surface,tan,terminal,thin,time,tip,vine,violet,white,woody,yellow,yellowish	-10,-8,.2,.5,0.5,0.5-1.5,0.8-1,0.8-1.3,0.9-,1,1-,1-1.2,1-1.5,1-4,1.2-5,1.5-4,2-9,2/3,20,4-6,5-merou,>,acuminate,acute,ag,alyx,anthesi,apically,appearing,appressed,ark,articulated,attenuate,away,axi,basal,base,berry,blade,brown,calyx,cell,closer,commonly,conical,connivent,curved,deeply,deltate,distal,dry,eaf,eed,ellipsoid,elongate,entire,exserted,extremely,free,fruiting,glabrescen,ilament,inflorescenc,irregular,irregularly,leaving,lengthening,like,living,lobbing,lobe,lon,loosely,lower,margin,materia,material,mature,midrib,new,nflorescence,older,onto,orolla,outline,pair,part,particularly,peg,per,perfect,pericarp,plurifoliat,pointing,pore,poricidal,portion,reflexed,ripe,rounded,ruit,scar,sinus,size,slit,small,spaced,spreadin,stem,still,strongly,tem,thickened,third,toward,trichome,truncate,tube,ud,ultimate,uniseriate,unit,upper,usually,variable,variously,vary,visible,wall,way,weak,whitish,wide,widest,winged,within,ympodial,½	5-merous,abaxial,adaxial,arrangement,colour,form,fruit,height,history,length,life,na,number,ovary,plant,position,rachi,reproduction,spacing,staman,texture,width
705	wfo-0001031195	success	216	82	63	153	19	0.292	0.3,0.5-1,0.6-1.5,1,1-1.5,2-2.5,3.5-5.5,7.5-8,acute,andromonoecious,anther,apex,base,broadly,chartaceous,cm,cylindrical,deeply,densely,diameter,ellipsoidal,extra-axillary,filament,finely,flattened,flower,fruit,glabrous,globose,green,inflorescence,leaf,length,lobed,mm,moderately,obtuse,ovate,pale,perennial,petiole,plant,prostrate,pseudo-racemose,purple,reticulate,rusty,shallowly,shrub,solitary,stellate-pubescent,stigma,stoloniferous,style,surface,unbranched,weakly,white,whitish,x,yellow,yellowish,yellowish-green	%,0-0.7,0-3,0-8,0.05-0.3,0.2-0.4,0.2-0.5,0.25-0.35,0.3-0.4,0.5-0.7,0.6-0.8,0.6-3,1-2,1-4,1-locular,1.4-1.6,1.4-2.9,1.5-2.5,10-13,10-14,10-19,11-28,15-35,2,2-4,2-5,2.5-4,20-32,3-3.5,3-4,3-5,3-6,3.5-4,4-5,4-7,4-9,5-9,5-merou,5.5-10,6-10,7-8,8-9,9-15,abaxially,absen,absent,accrescent,acicular,across,adaxially,alyx,apart,articulated,attenuate,axe,ba,blade,calyx,capitat,center,confined,connivent,cuneate,d.,difoliate,directed,distal,distall,distributed,eaf,eed,eglandular,entire,exocarp,filiform,finger,fruiting,functional,geminate,gland-tipped,grey,hair,half,heterostylous,incomplete,interpetalar,irregularly,juic,lamina,lateral,less,lobe,long,longer,loosely,lower,margin,mature,mesocarp,midpoint,midrib,midvein,minute,moist,narrowly,nflorescence,oblique,orolla,part,pedicel,peduncle,per,pore,porrect,presen,present,prickle,probably,rachi,ray,ruit,septum,sessile,short,simple,spaced,sparse,sparsely,splitting,stage,stellae,stellate,straight,tal,tamen,tem,thick,throughout,time,tip,tissu,tissue,transparent,triangular,tube,unarme,unarmed,unit,uvenile,vary,vein,wide,ympodial	5-merous,abaxial,adaxial,capitate,colour,corolla,form,growth,height,history,life,na,ovary,position,reproduction,seed,shape,staman,texture
706	wfo-0001031202	success	198	87	64	134	23	0.323	0-0.5,0-1,0.6-1.1,0.8-1,1-5,1.5-2.5,2-8,2/3,3.5-4,6-25,anther,apart,apex,base,broadly,capitate,cm,complex,corolla,cup-shaped,deflexed,filament,fleshy,flower,fruit,furcate,glabrous,globose,green,hard,inflorescence,later,lateral,leaf,lobed,many,minutely,mm,obovate,opposite,ovary,overtopping,ovoid-reniform,pale,pedicel,petiole,pitted,plant,puberulent,shape,shoot,shrub,small,stigma,style,surface,tan,terminal,time,tip,tree,way,white,woody	.1,.5,0.1-0.3,0.5,0.5-1,1-1.5,1-1.7,1.5-2,1.5-9,15-40,2-3,2.5-13,2.5-3.5,2.5-4,20-100-flowered,9-11,9-20,abrupt,accrescent,acute,along,anthesi,apiculate,axi,bark,beneath,berry,bud,calyx,completely,condition,cordate,corky,decurrent,deltoid,densely,dia,differing,difoliate,distal,dry,due,eaf,edicel,eed,enclosed,erect,exserted,extremely,free,frui,fruiting,geminat,glabrate,golden,greenish-white,greyi,irregularly,large,like,live,lobe,lon,long,long-ellipsoid,long-styled,longer,lower,main,major,margin,material,middle,minor,minute,narrowing,nflorescence,occasional,occasionally,often,older,one,orbicular,pair,paler,papillo,papillose,planar,pore,poricidal,portion,prominent,pubescent,quite,raised,reddish-brown,rounded,ruit,scar,scattered,sessile,shaped,short-styled,size,slender,slightly,spaced,sparsely,specimen,stem,straight,tall,tapering,tear-drop,thick,thickened,thicker,third,trichome,tub,tube,ud,uniseriate,unit,usually,variable,vein,weight,whitish,widest,winged,x,ympodial,young	20-100,abaxial,adaxial,arrangement,colour,diameter,form,growth,height,history,length,life,na,number,peduncle,position,rachi,reproduction,seed,spacing,staman,texture,width
707	wfo-0001031203	success	218	118	85	133	33	0.39	.7-1,0-0.5,0-0.8,0-2.5,0.3-0.6,1-2,1.5-2.5,1.8-2.8,2-7,3-10,4-16,5-8.5,6-16,6.5-9.5,8-11,abaxially,adaxially,almost,anther,apart,apex,articulated,base,berry,broadly,calyx,cinereous-tomentose,cm,coarsely,deciduous,deep,densely,dentate,diameter,erect,essentially,extra-axillary,filament,first,flower,foveolate,fruit,glabrous,globose,greenish-white,hair,inflorescence,length,lenticular,lignescent,margin,maturity,minutely,mm,orange-red,outline,ovate,ovoid,pedicel,peduncle,perennial,perfect,petiole,rachi,rarely,red,reniform-ovate,ripe,sericeous,simple,smooth,sparsely,spreading,stellate,stellate-pubescent,stem,stigma,style,surface,thin-textured,unbranched,usually,white,x,yellow	-1.5,-2,.2,0.05-0.15,0.05-0.2,0.1,0.1-0.8,0.3,0.4-1,0.5-1.8,1-3,1-5,1/10-1/4,11-18,15-22,15-50,2-3.5,2-5,2-foliate,2.1-2.7,2.5-9.5,21-39,25-45,3.2-4,4-12,4-6-locular,4-6.5,5-7,5-8,5-9,5.5-8,8-14,abaxiall,acute,acute-tipped,adaxiall,along,apparently,asymmetric,attenuate,axe,ba,blade,campanulate,capitat,connivent,consisting,curved,cylindrical,deltoid,directed,distall,distributed,downcurved,eaf,eed,elongate,flesh,geminat,interlobal,interwoven,invested,lanceolate,lateral,less,linear-lanceolate,lobe,lon,long,longer,lower,lowermost,lying,major,midpoint,midvein,much,nflorescence,numerous,obsolete,obtuse,often,orolla,ovate-lanceolate,pair,parallel,per,plane,pore,present,prickl,projecting,prominent,pubescence,ray,reduced,relatively,ruit,sessile,short,short-stalked,shorter,side,sinus,smaller,somewhat,spaced,stalk,stellae,stellate-pubescen,surfac,tal,tamen,tem,terete,termination,thickened,three,time,tip,tooth-like,truncate,tube,unarmed,unit,uppermost,upward,vary,vein,weakly,well-developed,wide,ympodial	abaxial,adaxial,arrangement,bark,bud,capitate,cell,center,colour,corolla,form,fruiting,growth,height,history,leaf,life,na,new,number,ovary,plant,position,prickle,reproduction,scar,seed,shape,spacing,staman,texture,trichome,width
708	wfo-0001031207	success	219	77	58	161	19	0.265	-8,0,0.25-0.5,0.5-1,0.6-1.2,0.85-1.4,1.4-2,2-3,5-8,abaxially,anther,apart,berry,cell,cm,densely,diameter,dull,evenly,filament,flattened-reniform,flower,fruit,glabrous,green,herb,lateral,leaf,length,lobed,maturity,mauve,mm,moderately,orange-brown,outline,ovate,pale,pedicel,peduncle,petiole,pit,raised,red,shrub,small,smooth,sometimes,spherical,stellate,stellate-pubescent,style,surface,terminal,white,yellow,yellow-green,young	-0.4,-1/2,-11,-4,-5,-7,.1,/5,0-0.5,0-10,0-20,0.1-0.2,0.1-0.3,0.1-0.5,0.2,0.2-0.3,0.3-0.5,0.6-0.9,0.7-2,0.8,0.9-1.6,1,1-3,1-4,1-5,1.5-5,1/,1/3,1/3-equal,1/4-1/3,2-4,2.1-2.3,2.5-,2.8-3,3-5,3.5-7,5-merous,6-8,6.5-8,9,acuminat,acute,alyx,ame,apar,apex,apically,apparently,articulated,bark,base,blade,branched,bristle,bristly,broad-deltate,brow,c.,calyx,chartaceous,concolorous,cordate,curved,dark,difoliate,discolorous,distance,drying,eaf,eed,elongated,elongating,equal,erect,extending,eye,filiform,free,fruiting,geminat,gently,glabrescent,gray,herbaceous,infructescence,lanceolate,less,like,lobe,long,longer,lower,margin,mature,midpoint,midvein,multangulate,naked,narrow-deltate,nflorescence,oblong,obtuse,occasionally,older,one,open,orolla,oung,pair,pendulous,per,perfec,pericarp,perpendicular,persistent,poricidal,porrect,portion,prickl,prickle,prickly,primary,ray,reflexed,rounded,ruit,scandent,scar,sessile,shorter,side,simple,spaced,spreading,stalk,stalked,stem,straight,subentire,tamen,tapering,terete,tertiary,time,tip,toward,trichome,tube,unarmed,unit,upper,usually,variously,vary,vein,venation,visible,way,weakly,wide,ympodial	abaxial,adaxial,colour,corolla,form,growth,height,inflorescence,na,ovary,plant,position,reproduction,seed,shape,spacing,staman,stigma,texture
709	wfo-0001031217	success	222	96	76	146	20	0.342	.5,0.1-0.3,0.25-1.3,0.5-0.75,0.6-1.8,1-1.5,1.5-2,13-21,2-9,3.5-4.5,5.5-7,7-17,abaxially,absent,adaxially,anther,articulated,base,borwn,chartaceous,cm,contiguous,densely,diameter,elliptical,erect,extra-axillary,filament,flower,fruit,geminate,glabrous,gland-tipped,globose,green,greenish-white,hair,inflorescence,interpetalar,lanceolate,leaf,length,light,mm,moderately,nearly,ovate,overlapping,pale,pedicel,peduncle,perennial,petiole,plurifoliate,pseudo-umbellate,purple,rachi,red,reticulate,rhizomatous,scattered,shape,short,shrub,sparsely,stellate,stellate-pubescent,stigma,style,surface,tissue,unbranched,unit,violet,x,yellow	%,.5-2,0-0.1,0-3.5,0-5,0-6,0.1-0.2,0.15-0.25,0.2-0.3,0.25-0.4,0.3-0.4,0.3-0.5,0.3-1,0.35-0.6,0.4-0.7,0.5-3,0.8-4,1,1-2,1-20,1-4,1-locular,1.5-4,1.5-4.2,2-2.5,2-3,2-5,2-8,2.5-4,2.6-3,3-4,3-4.2,4-11,4-6,5-12,5-7,5-merou,6-12,6-8,7-8,7-9,9-10,absen,accrescent,acicular,across,acuminate,acute,adult,alyx,apart,apex,apparen,axe,ba,blade,branch,branche,broad-based,brown,calyx,confined,connivent,cuneate,cylindrical,directed,distall,distributed,dm,eaf,eed,eglandular,elliptic,entire,exocarp,finger,fruiting,half,incomplete,juicy,juvenile,lamina,lateral,less,lobe,lobed,long,longer,loosely,lower,margin,mature,mesocarp,mid-point,midpoint,midrib,midvein,minute,much,narrowly,nflorescence,oblique,orolla,pair,paired,part,pendent,per,perfect,placenta,pore,porrect,present,prickle,ray,ruit,scarcely,septum,sessile,shallowly,simple,smaller,sometimes,spaced,sparse,stalk,stellae,straight,succulent,tal,tamen,tem,thick,throughout,time,tissu,transparent,triangular,truncat,tube,unarme,unarmed,upper,vary,wide,ympodial	5-merous,abaxial,adaxial,colour,corolla,form,growth,height,history,life,number,ovary,plant,position,reproduction,seed,staman,sympodial,texture,truncate
710	wfo-0001031218	success	154	98	67	87	31	0.435	-5,0.5-1,1-2,15-25,2-2.5,2-22,2-3,3-14,3-5,4-8,40-100+,6-7,8-20,abaxially,adaxially,apart,apex,articulated,base,branched,cm,coriaceous,dark,densely,diameter,eglandular-pilose,ellipsoidal,especially,flattened,flower,fruit,glabrous,glandular-puberulent,globose,greenish-purple,lavender,leaving,long,minutely,mm,moderately,mottled,orange,ovate,ovate-elliptic,ovoid,pedicel,pedicellar,peduncle,perfect,petiole,puberulent,pubescent,purple,rachi,remnant,ripe,simple,sparsely,stellate,stigma,style,toward,tree,violet,x,yellow	0.5,1-3,1-4,10-19,2.5-3,3,4-28,4-5,4-7,4-foliat,40,5-37,5-7,5.5-7,6-10,6-9,8-17,acuminate,acute,aggregate,ape,apiculate,axe,basal,beyond,blade,calyx,cell,connective,connivent,cordate,cylindrical,directed,distally,eaf,eed,eglandular,entire,equal,exceeding,exserted,glabrou,glandular,hair,introrse,lanceolate,less,lobe,lon,lower,margin,narrowly,nflorescence,nther,oblique,obtuse,orolla,papillo,pore,presen,present,purpl,radiu,ruit,shorter,slightly,small,sometimes,spaced,stamen,stone,subcoriaceous,succulent,tal,tem,thecae,time,tip,tomento,triangular,truncat,tube,ud,unit,vary,wide,ympodial	abaxial,adaxial,anther,arrangement,colour,corolla,filament,form,growth,height,history,inflorescence,leaf,length,life,na,number,ovary,papillose,perennial,plant,position,reproduction,seed,shape,spacing,staman,surface,texture,truncate,width
711	wfo-0001031225	success	163	88	64	99	24	0.393	0.2,0.5,0.7-6,0.75-1,0.8-1,1-1.5,1-5,2.5-3,3/4,5-6,7-9,acute,anther,apart,apex,base,broadly,calyx,closely,cm,corolla,cup-shaped,elliptic,filament,furcate,glabrous,globose,green,growth,inflorescence,leaf,less,lobed,long,minute,minutely,mm,often,opposite,ovary,ovate,ovoid-reniform,pale,papillose,pedicel,petiole,pitted,plant,pubescent,shape,shrub,slender,small,spaced,stigma,style,surface,tan,tapering,tree,tube,way,white,x	.25,.5,/3,0.1-0.75,0.2-0.75,0.5-1,1-1.7,1-3,1.5-5,2,3-9,5-50-flowered,6-8,9-16,along,anthesi,bark,beginning,berry,bud,characteristic,conspicuous,darker,decurrent,deltoid,dia,differentiated,differing,difoliate,dry,eaf,edicel,eed,ellipsoid,erect,exserted,flattene,fragrant,free,fruiting,geminat,glabrate,greyish-brow,inflorescenc,lateral,like,live,lobe,lon,lower,main,major,margin,middle,minor,much,narrowly,nflorescence,older,one,outline,pair,papillo,pore,poricidal,portion,prominent,proximal,raised,red-papillose,reflexed,rest,rhomboidal,rounded,ruit,scar,shaped,size,slightly,soon,specimen,stem,straight,strongly,sweetly,swelling,tall,tear-drop,tip,trichome,ud,unevenly,uniseriate,unit,vein,widest,woody,ympodial,young	5-50,abaxial,adaxial,colour,diameter,flower,form,fruit,height,history,length,life,na,number,peduncle,perennial,position,rachi,reproduction,seed,spacing,staman,texture,width
712	wfo-0001031231	success	175	95	71	104	24	0.406	-2,.5,0.5-1.5,1.5-2,13,2-3,37/2,37/3,5-7,8-10,absent,anther,apex,aromatic,axillary,branch,branched,brown,campanula,campanulate,cm,colour,corolla,dark,discoidal,elliptic,filament,flower,fork,glabrous,glandular,globose,green,greyish,hair,juvenile,lanceolate,leaf,len,less,marbled,mauve,minute,mm,occasionally,often,ovary,pedicel,peduncle,pentagonal,petal,pinnatisect,plant,purple,rh,ripe,ripening,rotate,rugose-ruminate,seed,short,shrub,simple,sometimes,stigma,style,succulent,surface,tinged,tip,violet	1-1.5,1-2,1-3,1-4,2-4,2.5-3,25-35,3-4,4-8,80-110,acumen,acuminate,acute,adherent,almost,along,anthesi,aspect,axi,basal,base,becoming,berry,beyond,blunt,bluntly,calyx,cell,clonal,cluster,declinate,developed,dia,eaf,eed,ellipsoid,entire,equal,erect,exceeding,except,exerted,expanded,facetted,fleshy,flowering,folded,general,gree,habit,herbarium,interacuminal,lasting,lengthening,lobe,lon,long,loosely,lower,margin,mature,midrib,nflorescence,oblong,pedice,pedicellate,plurifoliat,pore,poricidal,projecting,rarely,readily,recurve,rounded,ruit,sessile,several,shallow,shed,sinus,slightly,slit,small,soft,specimen,stone,stonrgly,stout,tissue,toward,translucent,triangular,tub,ud,unit,usually,variable,vigorous,well,without,wooded,x,year,ympodial	abaxial,adaxial,arrangement,diameter,form,fruit,growth,height,history,inflorescence,length,life,na,number,perennial,petiole,position,rachi,reproduction,shape,spacing,staman,texture,width
713	wfo-0001031252	success	170	94	68	102	26	0.4	0.2-1.5,0.3-1.1,1-2,1.75-5.2,12-20,16-33,2.8-3.6,3-10,3-5,5-8,5-9,abaxially,acute,adaxially,anther,apex,axillary,brownish,bud,cell,clavate,cm,condition,coriaceous,corolla,covering,dark,deep,diameter,drying,elliptic,filament,flower,forked,fresh,fruit,glabrous,globose,green,greenish,hair-like,herb,lateral,light,medium,mm,ovate,ovoid,pedicel,peduncle,petiole,plant,purple,rotate,rounded,seed,simple,stigma,stripe,style,subtending,terminal,testal,thick,wall,white,whitish,yellow	0.4-3,1-3,1.3-1.9,2-3,2.5-7,3-6,5-17,5-merou,5.5-6.5,7-18,absent,acumen,adaxiall,ag,along,alyx,apart,apparently,arranged,articulated,attenuate,axe,base,bead,berry,blade,capitat,ciliate,connivent,cuneate,digestion,distal,dorsally,eaf,edge,eed,entire,enzyme,erec,exceeding,flat,folded,geminat,generally,glabrou,green-white,hal,half,high,homostylous,honeycomb-shaped,interjected,lanceolate,leaflet,lengthening,like,linear,living,lobe,long,lower,make,margin,moniliform,mottled,mucilaginous,multiple,necklace,nflorescence,orolla,perfect,plurifoliate,pore,poricidal,removed,ripe,ruit,serrate,seudostipule,slit,sometimes,spaced,specimen,stamen,stolon,straight,tall,tamen,tem,throughout,tip,tri-,tube,tuber,typically,unit,unwinged,usually,vary,wet,x,ympodial	abaxial,adaxial,arrangement,capitate,colour,form,growth,height,history,inflorescence,leaf,length,life,na,number,ovary,perennial,position,rachi,reproduction,shape,spacing,staman,surface,texture,width
714	wfo-0001031257	success	206	85	56	150	29	0.272	-5,-6,0.75-2.5,1-1.2,1-1.3,2-4.5,3.5-,4-4.5,7.5-9,abundant,anther,anthesi,apex,base,berry,blue-violet,bud,campanulate,cm,corolla,dark,diameter,filament,globose,herb,honey-combed,leaf,length,light,little,long,longer,margin,mm,non-glandular,ovate,petiole,pubescent,purple,rarely,ring,robust,seed,shrub,solitary,stigma,style,subglobose,tip,trans-ovoidal,trichome,tube,white,within,x,yellow	-12,-22.5,0,0.4,0.5,0.5-0.8,0.7-1,1.1-1.2,1.5,1.5-1.7,1.5-2,1/10,10-16,11.5-15,2-,3,3.5-5.7,4-10,4.5-,5,5-,5-8.5,6-12,6-celled,7-,8,8-celled,abaxially,accrescen,acuminate,adaxially,ag,aggregate,antrorse,ascending,attenuate,basal,bicellular,branch,broad,calyx,cell,coarsely,coat,connectival,cotyledon,cuneate,curved,cuticle,deep,densely,dentate,diamete,difoliate,directed,dorsally,eaf,edentate,eed,ellipsoidal,elliptical,embryo,endosperm,epidermal,erect,finely,flexuous,foliage,free,fruiting,geminat,glabrous,glandular,hair-like,half,head,herbaceous,high,hollow,inconspicuous,inserted,lamina,lateral,like,lobe,lon,long-stalked,longitudinal,longitudinally,lower,many-seeded,midvein,narrowly,odorles,opening,orolla,outward,pair,papillate,patent,pericarp,pore,poricidal,portion,prolongation,reduced,ree,rest,ridged,ruit,saddle-shape,scarce,scarcely,secondary,separated,serrate,short-stalked,shorter,simple,single-celled,sinus,slightly,slit,small,smooth,somewhat,spur-like,stalk,stem,stone,strand,striate,tem,thecae,thickened,thickening,time,tooth,triangular,unequal,unit,upward,vary,vein,ventrifixed,verrucate,viscid,viscid-pubescen,wall,ympodial	abaxial,adaxial,arrangement,colour,flower,form,fruit,geminate,growth,height,history,inflorescence,life,na,number,ovary,pedicel,peduncle,plant,position,rachi,reproduction,saddle-shaped,shape,spacing,staman,surface,texture,width
715	wfo-0001031270	success	234	113	92	142	21	0.393	0.4-1.5,0.5-1,1-1.2,1-4,1/3,10-12,2-3,2-4,3-10,5-15,5-merous,6-50,9-10,abaxial,abaxially,acute,adaxial,anther,anthesi,apart,apex,base,bipinnatifid,bright,capitate,clavate,cm,conical,densely,depressed-spherical,diameter,elliptic,filament,flower,glabrous,glandular,green,growth,herb,heterostylous,inflorescence,lateral,leaf,leaf-opposed,length,like,live,lobed,long-styled,membranous,minutely,mixture,mm,obovate,ovoid,pale,pedicel,peduncle,petiole,pinnatifid,pitted,plant,prickly,pubescent,rachi,red,reniform,ripe,rounded,shallowly,shining,short-styled,simple,slender,slightly,sparsely,spherical,spreading,stellate,stem,stigma,style,surface,tan,thin,trichome,uniseriate,way,white,yellow,yellowish,½	+,.5,1,1-3,1.2-1.6,1.5,1.5-2,10,100,2-2.5,2-20,2-7,2.5-3,3-20,3-5,4-5,5,5-10,5-6,6-17,7-12,8,>,accrescent,adaxiall,along,alyx,arme,articulated,associated,bark,basal,beginning,berry,blade,brow,brown,c.,calyx,cell,celled,colored,connivent,consistently,curved,deeply,differentiated,difoliate,directed,distal,eed,ellipti,entire,equal,erect,few-rayed,free,frui,fruiting,geminat,gland,glandular-pubescent,heavily,infructescence,investing,later,leafy,lobe,lon,long,longer,loosely,lower,margin,midpoint,midvein,minute,multangulate,multiseriate,narrowly,new,nflorescence,occasionally,often,older,orolla,oung,outline,pair,papillo,per,pericarp,pore,poricidal,portion,prickle,primary,ray,reddish,reflexed,rest,ruit,scar,scattered,secondary,sessile,shallow,short-stalked,shrub,single,sinuate,size,small,stalk,staminat,straight,straw-colored,strongly,tall,tamen,tapering,terete,testal,thus,tightly,tip,tissue,truncate,tube,unit,upward,usually,vary,varying,vein,well,wice,wid,wide,wing,woody,ympodial	adaxially,arrangement,colour,corolla,form,fruit,height,history,life,na,number,ovary,perennial,position,reproduction,seed,shape,spacing,staman,texture,width
716	wfo-0001031283	success	52	66	21	31	45	0.404	-0.25,0.1-0.15,0.4-0.5,0.7,30-40,apex,base,brown,calyx,cell,cm,diameter,fruit,hair-like,obovate,outgrowth,pale,pubescent,shrub,surface,woody	.7-2.3,0.5-0.7,2.2-2.8,acute,appearance,eed,elongating,erect,fide,give,lateral,lo,lobe,long,markedly,mm,moore,narrowly,pleasant,silky,small,smelling,somewhat,sprawling,spreadin,tall,testa,thick,wall,wide,winged	abaxial,adaxial,anther,arrangement,bark,bud,center,colour,corolla,filament,flower,form,fruiting,growth,height,history,inflorescence,leaf,length,life,margin,na,new,number,ovary,pedicel,peduncle,petiole,plant,position,prickle,rachi,reproduction,scar,seed,shape,spacing,spreading,staman,stem,stigma,style,texture,trichome,width
717	wfo-0001031287	success	147	87	57	90	30	0.388	.5,0.5-1.5,0.9-1,1,1-5,1.5-2,2-2.5,3-5,4.5-5,6-7,abaxially,adaxially,anther,apex,base,bi-lobed,cm,corolla,dendritic,densely,divergently,elliptic,filament,fleshy,glabrous,globose,green,greenish-white,internodal,leaf,lobed,long,minutely,mm,nearly,ovary,ovoid-reniform,pale,papillose,pedicel,petiole,pitted,pubescent,shoot,short,shrub,simple,stigma,strongly,style,surface,tan,thick,trichome,tuft,white,x	1-1.2,1-1.3,1-1.5,1.5-5.5,3-4,4-5,4-6,5-14,6-10-flowered,acute,anthesi,apar,ape,attenuate,axil,bark,bearing,berry,branch,calyx,conical,connective,coriaceous,dark,deflexed,deltate,dia,difoliate,eaf,edicel,eed,ellipsoid,elongate,enlarged,erect,exserted,free,frui,fruiting,geminate,knob,lamina,later,lateral,lobe,lon,lower,main,many,margin,membranous,middle,nflorescence,occasionally,older,onto,pair,papillo,planar,plurifoliate,pointed,pore,poricidal,portion,red-papillose,reddish-brow,reflexed,rounded,ruit,scar,shaped,sinus,small,somewhat,spaced,stem,tear-drop,thin,tip,tub,tube,ud,unevenly,unit,vein,widest,winged,woody,ympodial,young	6-10,abaxial,adaxial,apart,arrangement,colour,diameter,flower,form,fruit,growth,height,history,inflorescence,length,life,na,number,peduncle,perennial,plant,position,rachi,reproduction,seed,shape,spacing,staman,texture,width
718	wfo-0001031300	success	219	95	72	147	23	0.329	0.2-0.4,0.2-0.5,0.3,0.5-0.9,0.5-18,0.7-0.9,0.8-1.5,1-2,1-4,1.5-3.5,2-6,2.5-3.2,5-merous,abaxially,acute,anther,apex,articulated,base,berry,brown-green,cell,chartaceous,cm,creeping,curved,diameter,dull,erect,filament,filiform,flattened-reniform,flower,fruit,glabrescent,glabrous,gray-green,lateral,leaf,length,lobed,maturity,membranous,mm,moderately,near,oblanceolate,orange,orange-brown,outline,pedicel,peduncle,petiole,pit,pubescent,raised,red,rounded,shrub,simple,small,smooth,sparsely,spherical,stellate,stellate-pubescent,style,surface,trichome,white,yellow,yellow-green	-2.2,-4,-5,-6,.5,/4,0-15,0-20,0-3,0-8,0.1,0.1-0.5,0.1-0.6,0.15-0.7,0.2-0.7,0.2-1,0.3-0.6,0.3-1.3,0.5-1.5,0.5-2,0.6-0.8,0.6-1,0.6-1.2,0.7-1.2,1-5,1.2-1.7,1.3-2,1/2-3/4,1/3-1/2,1/6-1/4,10-30,2-,2-3,2-4,2-5.5,2.2-2.3,2.2-2.7,3-,3-4,4,4.5-6,5-15,6-8,absent,also,alyx,apar,apart,apically,apparently,attenuate,ba,bark,blade,branched,brow,bulbous,calyx,caudat,concolorous,connivent,deltate,densely,difoliate,distance,drying,eaf,eed,elongating,equal,extending,eye,flattened,free,fruiting,geminat,geniculate,hair,herbaceous,highly,infructescence,lobe,lon,long,longer,lower,margin,mature,midpoint,midvein,minute,naked,nflorescence,oblong,obtuse,older,one,open,orange-green,orolla,oung,pair,pale,pendulous,per,perfec,pericarp,poricidal,porrect,portion,prickl,prickle,prickly,primary,rarely,ray,reduced,ruit,scar,sessile,side,spaced,spreading,stalk,stalked,stem,tamen,tapering,terete,tertiary,thin,time,tip,tube,uniradiate,unit,vary,vein,venation,visible,way,weakly,wide,wider,winged,yellow-orange,ympodial	abaxial,adaxial,arrangement,colour,corolla,form,growth,height,history,inflorescence,life,number,ovary,perennial,plant,reproduction,seed,shape,spacing,staman,stigma,texture,unknown
719	wfo-0001031310	success	203	92	68	135	24	0.335	1-10,1-3,1-6,1.5-4,15-40,3-10,4-10,4.5-4.8,abaxially,adaxially,anther,apex,blue,blue-purple,brown,brownish,cell,chartaceous,cm,condition,corolla,covering,diameter,drying,filament,flower,forked,fresh,fruit,glabrous,globose,green,greenish,hair-like,herb,lateral,leaf,light,membranous,minutely,mm,odd-pinnate,ovate,ovate-elliptic,ovoid,pale,pedicel,peduncle,petiole,pilose,plant,puberulent,pubescent,rachi,rotate,seed,simple,sometimes,sparsely,stigma,streak,style,terminal,testal,thick,wall,whitish,yellow	.5,0-3,0-4,0.5-3,1-2,1-5.5,2-3,2.5-5.5,2.5-8.5,4-12,5-6,5-7,5-merou,5.5-21,6-7,absent,acumen,acuminate,ag,along,alyx,apart,apparently,articulated,attenuate,axe,axillary,base,berry,blade,borne,broadly,bud,caly,ciliate,connivent,conspicuously,cuneate,decreasing,decurrent,digestion,distal,dorsally,eaf,edge,eed,elliptic,end,enzyme,erect-decumben,especially,exceeding,extremely,flat,folded,geminat,generally,glabrou,gradually,green-white,hair,half,high,homostylous,honeycomb-shaped,interjected,lanceolate,larger,leaflet,lengthening,less,like,living,lobe,long,lower,make,margin,midrib,mottled,mucilaginous,multicellular,narrowly,nflorescence,obtuse,orolla,ovate-lanceolate,pair,perfect,petiolule,plurifoliate,pointed,pore,poricidal,purple,removed,rosette-forming,ruit,seudostipule,shortly,singly,size,slightly,slit,small,somewhat,spaced,specimen,stamen,ste,stem,stolo,straight,subellipsoi,subrosette-forming,subtending,tall,tamen,tem,throughout,tip,tissue,toward,tri-,tube,tuber,typically,unit,unwinged,usually,vary,wet,white,x,ympodial	abaxial,adaxial,arrangement,colour,form,growth,height,history,inflorescence,length,life,na,number,ovary,perennial,position,reproduction,shape,spacing,staman,subellipsoid,surface,texture,width
720	wfo-0001031316	success	207	96	71	136	25	0.343	-2,/3,0.3-1,0.5-2,0.8-1.8,0.9-1.3,1-5,1.5-2,2-3,3-8,5-10,5-8,5-merous,6-20,abaxial,abaxially,acuminate,acute,adaxial,anther,apex,base,berry,blue-mauve,bright,cm,cream,dark,diameter,dull,erect,filament,flattened-reniform,flower,fruit,glabrescent,glabrous,green,lateral,leaf,length,lobed,marking,maturity,membranous,mm,moderately,obtuse,orange,orange-brown,ovate,pale,pedicel,peduncle,petiole,purple,red-brown,shrub,simple,sparsely,spherical,stellate,stellate-pubescent,style,surface,terminal,way,white-green,yellow,yellow-green,young	.1,0.05-0.1,0.05-0.15,0.1-0.2,0.4-0.6,0.4-0.8,0.6-1,0.8-1.2,1.2-2.1,1.3-3.5,1.5-,1.5-3.5,1.5-5,1/3-1/2,1/3-2/3,2-20,2-4,2.5-8,3-10,3.5-3.8,3.8-5,4,4-7,4-9,5-15,5-6,8-11,8-12,8-25,almost,alyx,ame,apar,apically,apparently,articulated,bark,becoming,blade,branched,broad,c.,calyx,colored,concolorous,connivent,contrast,curved,densely,difoliate,discolorous,drying,eaf,eed,elongating,entire,eye,fifth,foliaceou,four,free,fruiting,geminat,glabrou,gray,hair,held,herbaceous,infructescence,inward,lobe,long,long-acuminat,longer,lower,lowermost,margin,mature,midpoint,minute,multangulate,naked,narrow-deltate,nflorescence,older,one,open,orolla,oung,pair,pendulous,per,perfec,pericarp,poricidal,porrect,portion,primary,ray,red-brow,reflexed,ruit,scar,sessile,slender,smooth,sometimes,spaced,spreading,stalk,stalked,stellate-pubescen,stem,strongly,tamen,tapering,terete,tertiary,time,tip,trichome,tube,unarme,unarmed,unequal,unit,usually,variously,vary,vein,venation,visible,white,whitish,wide,ympodial	apart,arrangement,colour,corolla,form,growth,height,history,inflorescence,life,na,number,ovary,perennial,plant,position,rachi,reproduction,seed,shape,spacing,staman,stigma,texture,width
721	wfo-0001031333	success	194	89	63	131	26	0.325	0.1-0.5,1-1.5,1-4,1.2-2,1.5-2,2.5-3,3-4,30-40,7-10,7-9,?,anther,anthesi,apart,apex,berry,bilobed,broadly,brown,capitate,cm,densely,diameter,elliptic,filament,flattened,flower,glabrous,globose,golden,green,growth,immature,inflorescence,matte,minutely,mm,narrowly,nodding,ovate,pedicel,peduncle,pentagonal,petiole,pitted,pubescent,pubescent-papillate,reniform,simple,somewhat,sparsely,stellate,stigma,style,surface,terminal,thin,triangular,vine,white,woody,x,yellow	+,.5,0.5,1-5,1.5,1.5-1.7,1/2,2,2-3,2.7-7,3/4,5-7,5-8,5-merou,50,<,>,abaxially,acuminate,acute,adaxiall,adaxially,adjacent,ag,almost,alyx,appearing,ark,articulated,base,branche,branched,calyx,cell,clustered,collection,composed,conical,crea,cupped,denser,eaf,eed,ellipsoidal,entire,exserted,free,fruting,glabrescen,glabrescent,greenish,half,high,ilament,lamina,leaving,lengthening,less,like,lobe,lobed,long,lower,m.,many,margin,membranous,mere,minute,near,new,nflorescence,occasionally,older,orolla,outline,pair,pale,papillat,peg,penden,per,perfect,pericarp,planar,plurifoliat,pore,poricidal,portion,primary,quadrate,rest,rhachi,ruit,scar,sinus,slightly,slit,small,soon,splitting,ste,stem,striped,strongly,tangled,tem,testal,thickened,time,tip,trailing,trichome,truncate,tube,twining,ud,undersurface,undulation,unequal,unevenly,uniseriate,unit,upper,vary,vein,venation,way,whitish,yellowish,ympodial	5-merous,abaxial,adaxial,arrangement,colour,corolla,form,fruit,height,history,leaf,length,life,na,number,ovary,plant,position,rachi,reproduction,seed,shape,spacing,staman,texture,width
722	wfo-0001031333	success	194	89	64	130	25	0.33	0.1-0.5,1-1.5,1-4,1.5-2,2.5-3,3-4,30-40,7-10,7-9,?,acuminate,acute,almost,anther,apex,berry,bilobed,broadly,brown,capitate,cm,corolla,densely,diameter,elliptic,filament,flattened,flower,glabrous,globose,golden,green,growth,immature,inflorescence,lobed,matte,membranous,minutely,mm,narrowly,nodding,ovate,pedicel,peduncle,petiole,pitted,pubescent,pubescent-papillate,reniform,rotate-stellate,simple,somewhat,sparsely,stellate,stigma,style,surface,terminal,thin,triangular,vine,white,woody	+,.5,0.5,1-5,1-5-2,1.5,1.5-1.7,1/2,2,2-3,2.7-7,3,3/4,5-7,5-8,5-merou,50,<,>,abaxially,adaxiall,adaxially,adjacent,ag,alyx,anthesi,apart,appearing,articulated,bark,base,branche,branched,calyx,cell,clustered,composed,conical,cream,cupped,denser,eaf,eed,ellipsoid,entire,exserted,free,fruiting,glabrescen,glabrescent,greenish,half,high,ilament,lamina,leaving,lengthening,less,like,lobe,long,lower,m.,many,margin,mere,minute,near,new,nflorescence,occasionally,older,orolla,outline,pair,pale,papillat,peg,penden,per,perfect,pericarp,planar,plurifoliat,pore,poricidal,portion,primary,quadrate,rest,rhachi,ruit,scar,sinus,slightly,slit,small,soon,spaced,splitting,stem,striped,strongly,tangled,testal,thickened,time,tip,trailing,trichome,truncate,tub,tube,twinin,ud,undersurface,undulation,unequal,unevenly,uniseriate,unit,upper,vary,vein,venation,way,whitish,wide,yellowish,ympodial	abaxial,adaxial,arrangement,colour,form,fruit,height,history,leaf,length,life,na,number,ovary,perennial,plant,position,rachi,reproduction,seed,shape,spacing,staman,texture,width
723	wfo-0001031359	success	166	79	51	115	28	0.307	.25,0.5-6,1-4,1.2-1.6,1.2-2.5,1.3-1.6,3-3.5,6-7,anther,apart,apex,beneath,berry,bi-lobed,cm,corolla,curled,dull,elliptic,filament,flattened-reniform,glabrous,globose,green,leaf,lobed,membraneous,mm,narrowly,nearly,opposite,ovary,pedicel,petiole,pitted,plant,round,shrub,simple,stigma,style,surface,tan,tapering,trichome,tuft,undulate,uniseriate,white,yellow,yellow-orange	.02,.5,/4,0.5-1,0.75-1,1.1-1.6,1.5-2,1.6-2.8,1.9-2.3,12-21,2.5-3,3.6-8.8,5-30-flowered,5-7,5-angled,5.3-7.5,acuminate,angle,anthesi,apiculate,appearing,attenuate,axil,ba,bark,base,beginning,broadly,brown,calyx,dark,deflexed,dia,differing,difoliate,distal,dried,eaf,edicel,eed,evenly,extending,free,fruiting,geminat,incrassate,inflorescenc,internodal,interpetalar,lamina,lateral,live,lobe,lon,long,lower,main,major,margin,middle,minor,minutely,near,nflorescence,obovoid,occasionally,often,older,one,originating,outline,pair,paler,papillae,papillo,papillose,pit,planar,pore,poricidal,portion,reflexed,ridged,ripe,ruit,rusty,scar,shaped,shiny,sinus,size,slender,slightly,somewhat,spaced,specimen,stem,straight,strongly,tall,tear-drop,tip,triangular,tub,tube,ud,unit,vein,way,white-lenticellat,widest,woody,x,ympodial,young	5-30,abaxial,adaxial,arrangement,colour,diameter,flower,form,fruit,growth,height,history,inflorescence,length,life,na,number,peduncle,perennial,position,rachi,reproduction,seed,shape,spacing,staman,texture,width
724	wfo-0001031362	success	138	80	53	85	27	0.384	.2,.5,1-1.1,1-3,1-4,2-2.5,3-6,?,anther,base,closely,cm,corolla,densely,filament,flattened-reniform,glabrous,globose,incrassate,internodal,lanceolate,leaf,lobed,margin,minutely,mm,nearly,nodding,opposite,orange-red,ovary,pale,papillose,pedicel,petiole,pitted,pubescent,pubesent,red,shiny,shrub,simple,slender,small-capitate,spaced,sparsely,stigma,style,subshrub,surface,tan,thin,white	.3,0.4-0.5,0.5-1,0.7-1,1-1.5,1-3-flowered,1.5-2,3-4,abaxially,acute,adaxially,along,anthesi,apex,appearance,attenuate,bark,berry,branch,brown,bushy,calyx,cell,conical,dendritic,denser,dia,eaf,edicel,eed,ellipsoid,erect,exceeding,exserted,flattened,free,fruiting,giving,golden,golden-brow,inflorescenc,lamina,lateral,like,lobe,lon,long,long-triangular,lower,main,middle,nflorescence,older,outline,overlappin,packed,pair,papillo,pericarp,planar,plurifoliat,pore,poricidal,portion,rectangular,rest,rounded,ruit,scar,shaped,somewhat,stem,straight,tear-drop,tip,trichome,tube,ud,unit,vein,widest,woody,x,ympodial,young	abaxial,adaxial,arrangement,center,colour,diameter,flower,form,fruit,growth,height,inflorescence,length,na,number,overlapping,peduncle,plant,plurifoliate,position,rachi,reproduction,seed,shape,spacing,staman,texture
725	wfo-0001031363	success	198	78	55	143	23	0.278	1-2.2,1.1-1.6,1.5-4,10-11.5,3-7,4.5-7.5,5-10,6-13,7-12,adaxially,andromonoecious,anther,apex,articulated,base,broadly,chartaceous,cm,densely,diameter,erect,extra-axillary,flower,fruit,glabrous,globose,green,inflorescence,leaf,length,lobed,mm,moderately,obtuse,ovate,pale,pedicel,peduncle,perennial,petiole,plant,pseudo-racemose,purple,rhizomatous,shallowly,shrub,simple,sparsely,stellate,stellate-pubescent,style,surface,unbranched,weakly,yellow	%,.3,.5,0-15,0-3,0-30,0-6,0.3-0.5,0.3-0.6,0.3-0.7,0.4-0.5,0.4-0.8,0.5-0.8,0.5-0.9,0.5-1,0.7-1.5,0.9-1.6,1-2,1-5,1-6,1-locular,1.1-1.4,1.6-2.1,10-12,13-25,2-3,2-foliate,2.3-2.5,2.5-7.5,3-4,3-5,3.5-5.5,3.5-6,30,4-7,4-8,5-6,5-7,5-8,5-merou,6-8,6.5-11,6.5-8.5,80-120,abaxially,absen,absent,acicular,across,acute,adaxiall,adult,alyx,apart,attenuate,axe,ba,bark,blade,branch,branche,brown,calyx,corky,cross-section,cylindrica,decimetre,deltate,directed,distall,distributed,dm,eaf,eed,eglandular,exocarp,finger,fruiting,functional,furrowed,geminat,gland-tipped,hair,half,heterostylous,incomplete,index,juicy,juvenile,lamina,lateral,less,lobe,lobing,long,longer,lower,margin,mature,mesocarp,midpoint,midvein,minute,moist,nflorescence,oblique,orolla,pair,part,per,placenta,pore,porrect,present,prickle,ray,ruit,semi-circula,septum,sessile,short,side,spaced,stalks-0.1,stellae,straight,tal,tamen,tem,thick,throughout,time,transparent,tube,unarme,unarmed,unit,upper,vary,vein,wide,x,ympodial	5-merous,abaxial,adaxial,arrangement,colour,corolla,filament,form,growth,height,history,life,na,number,ovary,position,reproduction,seed,shape,spacing,staman,stigma,texture
726	wfo-0001031372	success	192	95	68	124	27	0.354	0,1,1-2,10-14,2-5,2-7,2.5-4.5,3,5-10,7-10,abaxially,adaxially,anther,apart,apex,articulated,base,broadly,brown,central,closely,cm,coarsely,dark,densely,diameter,elliptic,extra-axillary,filament,flattened,flower,fruit,glabrous,globose,green,leaf-opposed,length,light,lighter,lilac,minutely,mm,obtuse,ovate,pedicel,peduncle,perennial,petiole,pitted,prickly,pubescent,rachi,several,simple,spaced,sparsely,star,stellate,stellate-pubescent,stigma,style,thin-textured,ultimately,unbranched,white,woolly,x,yellow	-1.5,0-15,0.05-0.2,0.2-0.8,0.4-0.6,1.5,1/4-1/3,10,10-12,10-30,2-2.5,2-foliate,2.5,25-30,4-5,5-20,6-9,7,8-10,8-15,abaxiall,accrescent,acute,acute-,adaxiall,along,armed,axe,ba,blade,blunt-tipped,broad-based,calyx,capitat,completely,compressed,concealing,connivent,covering,cylindrical,decurrent,deltoid,directed,distal,distally,eaf,eed,entirely,enveloping,female-sterile,foliaceous,fruiting,geminat,glabrou,hair,interwoven,lanceolate,large,lateral,laterally,lobe,long,longer,lower,m.,main,margin,midpoint,midrib,minute,mostly,much,multiseriate,nflorescence,often,onto,orolla,ovate-lanceolate,perfect,pore,present,prickle,probably,ray,reaching,recurved,reddish,repand,round-tipped,ruit,scattered,short,short-styled,shorter,side,similar,soft-wooded,somewhat,spreading,stalk,ste,stellae,stellate-woolly,stelliform,stem,stipitate,tal,tamen,tem,termination,time,tube,unarmed,unit,vary,vein,weakly,well-developed,whitish,wide,widely,winged,ympodial,young	abaxial,adaxial,arrangement,capitate,colour,corolla,form,growth,height,history,inflorescence,leaf,life,na,number,ovary,plant,position,reproduction,seed,shape,spacing,staman,surface,tall,texture,width
727	wfo-0001031389	success	242	98	77	165	21	0.318	0-0.5,0-1,0-2,0.25-0.75mm,0.4-1.8,0.5-1,0.8-2.5,1-1.5,1-5,1.5-2.5,4-5.5,5.5-8,8-15,acute,almost,andromonoecious,anther,apex,articulated,base,chartaceous,cm,dark,densely,diameter,erect,extra-axillary,filament,flower,fruit,glabrous,globose,green,hair,inflorescence,lanceolate,leaf,length,lilac,minutely,mm,obtuse,ovate,pale,pedicel,peduncle,perennial,perfect,petiole,pitted,plant,pseudo-racemose,pseudo-umbellate,purple,rachi,red,reniform,reticulate,reticulately,rhizomatous,rotate-stellate,scattered,shrub,simple,sometimes,sparsely,stellate,stellate-pubescent,stigma,style,surface,tip,weakly,white,x,yellow,yellowish	%,0-0.1,0-0.4,0-0.6,0-10,0-3,0.05-0.1,0.25-0.4,0.25-0.5,0.3-0.5,0.3-0.6,0.3-0.8,0.4-0.6,0.5-1.5,0.5-3,0.6-0.7,0.65-1,0.9-4.5,1-2,1-3,1-4,1-locular,1.3-2.4,1.5-3,1.5-4,1.5-5,1.8-3.5,1.9-2.2,11-16,14-18,14-30,2-6,2-foliate,2.5-13,20-60,4-5,4-7,4-8,5-8,5-merou,6-10,6-12,6-7,6-9,7-8,abaxially,absen,absent,accrescent,acicular,across,adaxially,adult,alyx,apart,apparen,axe,ba,becoming,blade,branch,branche,brown,calyx,capitat,confined,connivent,cuneate,cylindrical,decimetre,deltate,directed,distall,distally,distributed,dm,eaf,eed,eglandular,entire,exocarp,finger,first,fruiting,functional,geminat,gland-tipped,half,heterostylous,homo-,incomplete,interpetalar,juicy,juvenile,lamina,lateral,less,lobe,lobed,long,longer,loosely,lower,margin,markedly,mature,mesocarp,mid-point,midpoint,midrib,midvein,minute,moderate,narrowly,nflorescence,oblique,often,orolla,pair,part,per,placenta,plump,pore,porrect,present,prickle,ray,reddish,rostrate,ruit,septum,sessile,shallowly,short,solitary,somewhat,spaced,sparse,stalk,stellae,straight,succulent,summit,tal,tamen,tem,thick,thicker,thicknes,throughout,tightly,time,tissu,tissue,triangular,tube,unarme,unarmed,unbranched,unit,upper,vary,wide,ympodial	5-merous,abaxial,adaxial,arrangement,capitate,colour,corolla,form,growth,height,history,life,number,ovary,position,reproduction,seed,shape,spacing,staman,texture
728	wfo-0001031394	success	217	87	51	166	36	0.235	3,abaxially,acute,alternate,anther,apex,apparently,cm,curved,diameter,eventually,extra-axillary,filament,finely,flattened,flower,fruit,glabrous,globose,length,light,mm,ovate,pedicel,peduncle,petiole,pilose,pitted,plant,pubescent,purple,rachi,red,short,slightly,sometimes,stellate,stigma,stipitate-glandular,straight,style,subreniform,subshrub,tan,taprooted,thin-textured,unbranched,white,x,yellow,yellow-orange	-celled,-rayed,0.2–0.4,0.3,0.3–1.5,0.5,0.5–1,0.6–1.6,0.8,1,1.1–1.6,1.2–3.2,1.4–2.1,1.7–4.5,1/2,1/3,1–,1–1.5,1–2,1–3,1–4,2,2-foliat,2.2–2.5,2.5–3,2–3,2–3-celled,2–3.2,2–4,3.7–7.6,33–80,3–4,3–5,3–6,4,4–8,5,5–8,64,6–11,6–8,9–13,=,?,accrescent,acicular,adaxially,additional,almost,apart,appearing,armed,articulated,axe,ba,basal,base,beginning,blade,bottom,branch,branched,broadly,bulbous,calyx,caudate,crenulate,cylindrical,densely,directed,distal,distall,eaf,eed,enlarging,even,fertile,free,fruiting,glabrou,gland-tippe,gland-tipped,glandular-pilosulose,glandular-pubescent,hair,halfway,hyaline,investing,lanceolate,leafy,least,less,lobe,lon,long,longest,lower,main,male,many,margin,maturity,midpoint,midrib,minute,n,narrowly,nflorescence,numerous,one,orolla,overtopped,per,pore,prickle,pubescence,quite,reaching,recurved,reflexed,rounded,ruit,scattered,sessile,shorter,side,similar,simple,single-celled,small,smaller,somewhat,spaced,sparse,spreadin,staminate,stellae,stem,sterile,stout,subcordate,tall,taman,tem,terminal,thick,thickened,time,tip,tooth,triangular,truncat,tube,unit,usually,variable,vary,vein,wide,ympodial,±,–1.5,–2,–3,–5,–6	0.2-0.4,0.3-1.5,1-3,1-4,1.2-3.2,1.4-2.1,1.7-4.5,2-4,3.7-7.6,4-8,5-8,abaxial,adaxial,arrangement,colour,corolla,form,growth,height,history,inflorescence,leaf,life,na,number,ovary,position,reproduction,seed,shape,spacing,staman,surface,texture,truncate,width
729	wfo-0001031400	success	161	76	53	108	23	0.329	0.25-0.8,0.7-6,1-4,1.2-2,1.5-5,10-11,4-17,4-6.5,7-28,abaxial,apex,branched,cm,corolla,cyme,dark,deeply,diameter,dichasial,dichasially,distal,ebracteate,filament,flower,globose,green,green-white,half,herbaceous,leaf,linear,linear-lanceolate,mm,monochasial,mucilaginous,odd-pinnate,ovoid,pedicel,peduncle,perennial,petiole,plant,puberulent,rachi,seed,stellate,stigma,style,subglabrous,tone,violet,white,yellow	-3,0.4-1.7,0.6-1.8,0.8-1.1,1,1-,2,2-3,2-5,2-9,3-6-foliat,4-,4-13,4-7,5-12.5,6-23,7-25,abaxially,abruptly,absen,acumen,acute,adaxially,apical,apically,apiculate,articulate,base,calyx,cell,connate,covering,cuneate,decurrent,dehiscent,digestion,diminishing,dorsally,eaf,edge,eed,emoval,enzyme,exceeding,flat,folded,forked,forming,generally,globo,hair-like,honeycomb,interjected,introrse,lateral,leaflet,living,lobe,lon,long,lower,lunat,make,maturing,nflorescence,nther,oblique,oblong,occasionally,often,orolla,pair,pattern,perfect,plan,poricidally,proximal,reveal,ruit,sessile,seudostipule,short,side,size,slit,specimen,stamen,straight,stripe,structure,tal,tem,terminal,testal,thick,throughout,tip,toward,trilobe,tuber-bearing,typically,unit,vary,wall,wide,without,ympodial,¼	adaxial,anther,arrangement,colour,form,fruit,growth,height,history,inflorescence,length,life,na,number,ovary,position,reproduction,shape,spacing,staman,surface,texture,width
730	wfo-0001031401	success	182	89	67	115	22	0.368	0.6-1.2,1-6,1.5-2,2-2.4,2-5,2.5-4,3.5-4,7-9,8-10,abaxial,abaxially,acute,adaxial,anther,apex,appearing,bi-lobed,black,cm,corolla,dendritic,densely,diameter,elliptic,filament,flattened,flower,fruit,globose,golden,growth,lateral,leaf,lenticular,lobed,minutely,mm,narrowly,occasionally,ovary,pedicel,pericarp,petiole,pitted,pubescent,purplish-black,pyramidal,reddish-brown,rounded,roundish,shiny,shrub,small,sometimes,stigma,strongly,style,surface,tapering,terminal,thin,tree,tree-like,trichome,violet,white,winged	0.5,0.8-1.2,1,1-1.4,1-1.5,1.1-3,1/2,3,3/4,5,5-7,5-9,adaxially,age,along,anthesi,apical,attenuate,axi,bark,basal,base,becoming,berry,blade,branch,branching,brown,calyx,clearly,conical,dark,deciduous,deflexed,deltoid,denser,dichasial,differentiated,drying,eaf,ecuador,ecuadorian,edicel,eed,ew,exserted,finely,fork,free,fruiting,glabrous,golden-yellow,impressed,inserted,less,lobe,long,long-triangular,lower,m.,matted,mesophyll,monochasia,near,new,nflorescence,noddin,nodding,node,often,older,outline,overtopping,pair,papillo,per,planar,plurifoliate,pore,poricidal,portion,prominently,puberulent,pubescen,raised,ruit,scar,secondary,shoot,short,sleev,slit-like,somewhat,sparsely,specimen,stamen,ste,stem,tall,time,tip,tub,tube,ud,unit,usually,vein,visible,way,wide,woody,x,yellow,ympodial,young	arrangement,colour,form,height,history,inflorescence,length,life,na,number,peduncle,perennial,plant,position,rachi,reproduction,seed,shape,spacing,staman,texture,width
731	wfo-0001031402	success	200	78	56	144	22	0.28	0-0.2,0-0.3,0.2-0.4,0.5-1,0.5-1.3,1-3,1.5-2,10-38,2-2.5,3-5.5,7.5-8.5,acute,andromonoecious,anther,apex,articulated,base,chartaceous,cm,contiguous,diameter,filament,flower,fruit,glabrous,globose,green,herbaceous,inflorescence,leaf,leaf-opposed,length,linear,mm,moderately,nearly,ovate,ovoid,pedicel,peduncle,petiole,plant,pseudo-umbellate,purple,rachi,resprouter,rotate-stellate,simple,single-flowered,sparsely,stellate-pubescent,stigma,style,unknown,x,yellow	%,0-3,0.3-0.6,0.3-1.1,0.4-1.2,0.5-0.7,0.5-2.6,0.6-1.2,0.7-1.4,0.8-2.5,0.8-3,1,1-15,1-2,1-4,1-5,1.5-2.5,10-15,10-18,14-18,2-3,2-4,2-6,2-8,2-foliate,2.2-12,3-15,3-4,3-5,4-7,4-8,5-40,5-merou,6-9,7-15,8-10,abaxially,absen,absent,abundant,accrescent,acicular,across,adaxiall,adaxially,adult,alyx,apart,armed,axe,ba,blade,branche,calyx,capitat,color,confined,connivent,cuneate,cylindrical,deeply,deltate,densely,directed,distall,distributed,dm,dult,eaf,eed,eglandular,entire,erect,finger,fruiting,functional,geminate,glabrou,gland-tipped,hair,half,heterostylous,index,interpetalar,lamina,lateral,lobe,lobed,lobing,lon,long,longer,lower,margin,mature,midpoint,midrib,midvein,minute,narrowly,nflorescence,oblique,obtuse,orolla,part,per,pore,porrect,possibly,present,prickle,projecting,ray,ripe,ruit,sessile,shallowly,short,shorter,side,spaced,sprawling,stage,stellae,stem,straight,strongly,tal,tamen,thick,throughout,time,tissue,tube,unarmed,unbranched,unit,uvenile,vary,vein,weakly,wide,winged,ympodial	abaxial,adaxial,arrangement,capitate,colour,corolla,form,growth,height,history,life,number,ovary,perennial,position,reproduction,seed,shape,spacing,staman,surface,texture
732	wfo-0001031480	success	237	86	69	168	17	0.291	/3,0.5-2,0.8-1,1-1.5,1-2,1-3,1.8-3,2-,2-6,3-10,3.5-7,5-merous,6-30,6-8,abaxial,adaxial,andromonoecious,anther,apart,base,branched,bright,cell,cm,densely,diameter,dull,ellipsoid,entire,filament,flattened-reniform,flower,fruit,glabrescent,glabrous,leaf,length,lobed,margin,mauve,minutely,mm,orange-brown,outline,ovate,pale,pedicel,peduncle,petiole,pit,plant,purple,raised,red,reticulate,scandent,shallowly,shrub,small,smooth,spherical,stellate,stellate-pubescent,style,surface,thick-chartaceous,way,weakly,yellow	-0.25,-2,0,0-0.5,0-1,0-2,0-30,0-5,0.1,0.1-0.3,0.1-0.4,0.15-0.3,0.2-0.35,0.4,0.4-0.8,0.5-,0.6-0.8,0.7,0.8,1-1.3,1-4,1.5-2.2,1.7-2.2,1/2,1/3,1/4,1/6-1/5,2-2.7,2-3,2-5,3,3-6,3-7,4-5,4-6,5-8,6-13,7-8,8-12,abaxially,acuminat,acute,alyx,apar,apex,apically,apparently,articulated,ba,bark,berry,blade,branching,broad-deltate,calyx,cream,cuneate,curved,dark,deltate,difoliate,discolorous,distal,distance,drying,eaf,eed,elongate,elongating,equal,erect,extending,eye,faint,flattened,free,fruiting,geminat,glandular,green,hair,hermaphrodite,heterostylous,inconspicuous,infructescence,lateral,lobe,long,long-styled,longer,lower,lowermost,marking,mature,maturity,midpoint,midvein,moderately,naked,near,nflorescence,obtuse,often,older,one,open,orolla,oung,pair,pendulous,per,pericarp,persistent,poricidal,porrect,portion,prickle,prickly,primary,pubescent,ray,red-brow,red-brown,red-green,red-yellow-green,reduced,rounded,ruit,scar,sessile,short-styled,shorter,side,simple,slender,slightly,somewhat,spaced,sparsely,spreading,stalk,stalked,staminat,stem,straight,tamen,tapering,terete,terminal,tertiary,time,tip,trichome,truncate,tube,unarme,unarmed,unit,upper,variously,vary,vein,venation,visible,wide,woody,ympodial,young	0.5,colour,corolla,form,growth,height,inflorescence,na,number,ovary,reproduction,seed,shape,spacing,staman,stigma,texture
733	wfo-0001031482	success	275	105	81	194	24	0.295	-150,-16,-18,.5-5,0.2-0.3,0.5-1.5,0.6-1.8,0.7-1.3,1-4.5,1.2-1.5,2.5-10,2.5-4,4-13,4-5,4-6,8,abaxially,adaxially,anther,apart,becoming,blue,brown,cm,continued,corolla,deltoid,densely,diameter,due,elliptic,elongate,farinose,filament,flower,fruit,grayish,green,growth,honeycombed,lanceolate,lateral,leaf,length,mm,moderately,mostly,oblong-orbicular,pale,pedicel,peduncle,perfect,petiole,possibly,pubescent,rachi,reniform,reticulate-punctate,ripe,rotate-stellate,scabridulous,shrub,simple,small,somewhat,stellate,stem,stigma,style,subcapitate,subconical,subglobose,suborbicular,subspherical,terminal,tomentose,tree,velutinous,x,yellow,yellowish	-0.06,-0.2,-0.4,-0.5,-0.6,-1.4,-5,-5.3,-5.5,-6,.04-0.1,.04-0.35,.04-0.5,.06-1,.2-1.6,.5-0.7,.5-3.5,/20-,0-0.2,0-0.3,0-0.4,0-0.6,0-0.7,0.02-0.03,0.02-0.04,0.02-0.06,0.03-0.04,0.03-0.3,0.04-0.3,0.04-0.4,0.04-0.5,0.04-0.6,0.04-1.4,0.3-0.5,1,1.2-3,1.3-4,1.4-2.2,1.6-2.8,1.9-2.5,1/10-1/4,1/2-2/3,2-3.3,2-3.5,2-4.6,2-4.7,2.5-4.5,3.5-4.8,3.7-8,3/4,4-7,4.5,5-7,5-80,5-merou,6-11,6-16,9-13,accrescent,acuminate,acute,adaxiall,ag,along,alyx,anthesi,ape,apex,apical-lateral,apparently,appressed,articulated,attenuate,axe,axillary,ba,bark,base,berry,beyond,blade,blunt-tipped,branch,branched,bud,calyx,commonly,decurrent,dehiscing,directed,eaf,echinoid,eed,ellipti,entire,evident,exserted,extend,few-rayed,free,fruiting,glabrescent,glabrous,granular-tomentose,hair,high,immature,inserted,interpetalar,introrse,irregular,lacking,large,later,line,lobe,lobed,long,long-stalked,longer,longitudinal,lower,m.,main,margin,midvein,minute,mixed,multangulate,multiseriate,narrowly,nearly,nflorescence,oblong,obtuse,occasionally,often,older,orolla,ovate,overlapping,persistent,plurifoliate,pore,porrect-stellate,present,prominent,pubescence,rather,ray,relatively,ribbed,rounded,ruit,runk,sessile,short-,short-stalked,side,slender,slightly,slit,sometimes,spaced,sparsely,splitting,stalk,stamen,stelliform,subcampanulate,sulcate,suture,tamen,terete,testa,thick,thin,time,tissue,toward,tube,unarme,unarmed,unevenly,unit,usually,vary,vein,way,weakly,white,wide,ympodial,young	0.5-3.5,15-80,abaxial,adaxial,arrangement,colour,form,height,history,inflorescence,life,na,number,ovary,perennial,plant,position,reproduction,seed,shape,spacing,staman,surface,texture
734	wfo-0001031483	success	154	74	47	107	27	0.305	.5,/2,0.5-2,1-2,2-3,almost,anther,apart,apex,base,clavate,cm,corolla,dry,filament,filiform,flower,fresh,glabrous,green,indistinct,leaf,linear,lobed,minutely,mm,oblanceolate,obovate,opposite,ovary,ovoid-reniform,pale,papillose,pedicel,petiole,shape,shrub,slender,slightly,stigma,style,subshrub,tan,tapering,turbinate,way,white	0,0.5,1,1.1-2.5,1.2-1.4,1.7-5.5,1/3,11-20.5,2-2.5,2.5-3.2,3-4,3-8-flowered,6-10,7-10,across,acuminate,acute,anew,anthesi,attenuate,ba,bearing,beginning,beneath,berry,blade,ca,caly,calyx,continuous,cork,corky,decurrent,deflexed,deltoid,dia,difoliate,distal,eaf,edicel,eed,end,evenly,exserted,free,fruiting,fusiform,geminat,indistinc,internode,larger,lateral,lea,lenticellate,less,lobe,long,lower,main,major,markedly,minor,nflorescence,oblong,obovoid,often,orbiculate,pair,paler,papillo,per,planar,pointed,pore,poricidal,portion,prominent,quite,raised,rounded,ruit,scar,shaped,short,short-triangular,simple,somewhat,soon,spaced,stem,straight,strongly,tall,tear-drop,third,tip,tube,ud,unit,variable,vein,widest,wing,winged,woody,x,ympodial	3-8,abaxial,adaxial,arrangement,colour,diameter,form,fruit,growth,height,history,inflorescence,length,life,na,number,peduncle,plant,position,rachi,reproduction,seed,spacing,staman,surface,texture,width
735	wfo-0001031486	success	166	100	75	91	25	0.452	0.2-0.7,1-4,1.5-4,1.8-3.3,11-37,3-26,3.4-10,3.5-6.5,5-10,abaxially,adaxially,almost,apex,articulate,branched,cell,cm,commonly,corolla,covering,cyme,darker,deep,diameter,dichasial,dichasially,distal,ebracteate,elliptic,filament,flower,globose,green,green-white,hair-like,half,herbaceous,lateral,leaf,less,light,lightly,mm,monochasial,odd-pinnate,ovate,ovoid,pedicel,peduncle,pentagonal,perennial,petiole,plant,proximal,puberulent,pubescent,pure,purple,rotate,seed,sometimes,spot,stigma,strigose,stripe,style,testal,thick,throughout,tinged,tip,wall,white,yellow,¼	0-1.,0-4.5,0.9-1.7,1-2.2,1-3,1.5-6,2-3,2-3.5,2-6,2.5-3.2,2.8-6,3-6-foliat,3.5-8,5-16,7.5-22,9-37,abruptly,acumen,acuminate,acute,apical,apically,base,calyx,connate,cordate,cuneate,decurrent,dehiscent,digestion,diminishing,dorsally,eaf,edge,eed,emoval,enzyme,exceeding,flat,folded,forked,generally,globo,highly,honeycomb,interjected,introrse,leaflet,living,lobe,lon,long,long-attenuate,lower,lunat,make,maturing,mucilaginous,nflorescence,nther,oblique,obovate,often,orolla,pair,pattern,perfect,petiolule,plan,poricidally,reveal,ruit,seudostipule,short,size,slit,specimen,stamen,straight,tal,tem,terminal,throughou,toward,tuber-bearing,typically,unit,usually,vary,wide,ympodial	abaxial,adaxial,anther,arrangement,colour,form,fruit,growth,height,history,inflorescence,length,life,na,number,ovary,position,rachi,reproduction,shape,spacing,staman,surface,texture,width
736	wfo-0001031492	success	175	85	62	113	23	0.354	0.5,0.7-1.3,0.9-1.1,1.5-1.8,10-15,2-10,3-5,4-4.5,6-8,abaxially,adaxially,anther,apex,attenuate,bi-lobed,cm,corolla,dark,decurrent,densely,diameter,drying,elliptic,filament,flattened,flower,fruit,glabrous,globose,growth,lateral,leaf,lenticular,lightly,lobed,medium,minutely,mm,narrowly,ovary,pedicel,pericarp,petiole,pitted,pubescent,purplish-black,pyramidal,reddish-brown,shiny,shrub,size,sometimes,sparsely,stigma,style,surface,tapering,terminal,thin,tree,violet,winged	.5,/4,08,1-1.3,1-1.5,1.3-2,1.5-2.5,2-3,2-5,20,3-4,4-10,8-11,8-9,absent,acuminate,acute,age,anthesi,apical,appearing,axe,ba,bark,basal,base,becoming,beneath,berry,bitter,branching,calyx,conical,dbh,deciduous,deltoid,dendritic,denser,distinguishable,dull,eaf,echinoid,edicel,eed,erect,ew,exserted,free,fruiting,golden,grey,inserted,juice,lamina,lobe,long,lower,m.,monochasia,nflorescence,nodding,occasionally,older,overtopping,pair,papillo,per,planar,plurifoliate,pore,poricidal,portion,predominantly,prominent,rather,remaining,ruit,scar,scarcely,scattered,secondary,shoot,short,sleeve,slightly,slit-like,somewhat,stamen,ste,stem,sticky,strongly,sunken,tall,time,tip,tree-like,trichome,tub,tube,ud,undersurface,unit,upper,upturned,vein,way,wide,woody,x,ympodial,young,younger	abaxial,adaxial,arrangement,colour,form,height,history,inflorescence,length,life,na,number,peduncle,plant,position,rachi,reproduction,seed,shape,spacing,staman,texture,width
737	wfo-0001031497	success	264	96	73	191	23	0.277	0.1-0.2,0.1-0.8,0.2-0.5,0.5-2.5,1-2,1.2-2,1.5-2.5,12-30,3-10,3-9,4.5-7,5-15,6-13,6-9,abaxially,actinomorphic,adaxially,anther,apart,apex,articulated,base,broadly,cm,deciduous,densely,diameter,erect,extra-axillary,filament,flower,fruit,globose,inflorescence,leaf,length,lenticular,light,margin,minutely,mm,orange,ovate,ovate-lanceolate,pedicel,peduncle,perennial,perfect,petiole,pitted,pubescent,purplish,rachi,red,reniform-ovate,simple,sometimes,spreading,stellate,stellate-pubescent,stigma,strongly,style,surface,tan,thickened,thin-textured,unbranched,weakly,white,x,yellow,zygomorphic	-1.4,-30,-35,-7,.1,.1-0.2,0.05-0.2,0.2-0.4,0.4-1,1,1.2-2.4,1.5-4,1/3,1/5-1/3,10-25,14-,15-,18-25,2-5,2-foliate,2.25-3,2.25-4.75,2.5-4,2.5-5,2.8-3.5,20-30,3-15,3-5,3-6,4-12,4-locular,4.5-9,5-8,7-12,acuminate,acute,along,ape,appearance,appearing,appressed,attenuate,axe,ba,berry,blade,broa,c.,calyx,campanulate,cast,cauline,clearly,close,closely,coarsely,compressed,connivent,curved,cylindrical,deeply,deltoid,dense,denser,depressed-deltoid,directed,distal,distall,distributed,downcurved,due,eaf,eed,entire,equaling,essentially,external,falcate,female-sterile,foliar,geminat,giving,glabrescent,glabrous,green,hair,high,incised,interlobal,intermixed,lanceolate,large,largely,larger,lateral,laterally,less,lignescent,lobe,lon,long,longer,lower,main,major,mature,maturity,midpoint,minute,nectary,never,nflorescence,numerous,oblique,obsolete,obtuse,occasionally,often,one,orolla,other,otherwise,oung,outer,outline,pair,per,persistent,pigmented,pore,presence,present,prickle,prickly,projecting,pubescence,purple,ray,readily,recurved,reduced,rigid,ring,ripe,ruit,scabrous,scattered,section,seldom,sessile,sharp-tipped,short,short-stalked,short-stipitate,side,similar,sinus,slightly,small,smaller,somewhat,spaced,species,stalk,stellae,stellate-puberulent,stem,subcapitat,summi,tamen,three,time,tip,toothlike,truncate,tube,two,type,unarmed,unit,unlobed,uppermost,upward,usually,vary,varyingly,vein,vestiture,wide,widely,ympodial	abaxial,adaxial,arrangement,colour,corolla,form,growth,height,history,life,na,number,ovary,plant,position,reproduction,seed,shape,spacing,staman,subcapitate,texture,width
738	wfo-0001031503	success	142	85	55	87	30	0.387	-10,-15,-30,-7,0.3-3,0.5-1,0.5-4,1-5,1-7,1.5-8,2-3,2.5-10,6-7,7-10,abaxially,angled,apart,apex,articulated,base,branched,chartaceous,cm,densely,diameter,elliptic,flower,forked,glabrous,globose,mm,moderately,orange,ovate,pedicel,peduncle,petiole,puberulent,pubescent,rachi,rarely,reddish,ripe,rugose-pubescent,shrub,simple,sparsely,stellate,stigma,style,truncate,unbranched,white,x,yellow	-25,-6,1-,1-2.5,1-3,1.5-2,1.5-3,1.5-7,1.7-3.5,10-19,3-15,3-4,3-5,3-6,5613,6-many-foliat,7-15,abruptly,absen,acuminate,acute,adaxially,aggregate,axe,ba,blade,calyx,cell,connivent,cuneate,curled,cylindrical,decurrent,deltate,directed,distall,distally,eaf,eed,eglandular,entire,except,fide,gland,hair,lanceolate,lobe,long,lower,margin,mostly,narrowed,narrowly,nflorescence,nther,obtuse,occasionally,often,orolla,perfect,pore,present,radiu,rounded,ruit,slightly,spaced,stalked,stone,subcapitat,subclavate,tal,tem,time,tip,toward,triangular,tube,unequal,uniseriate,unit,usually,vary,vein,venturi,wide,ympodial	abaxial,adaxial,anther,arrangement,colour,corolla,filament,form,fruit,growth,height,history,inflorescence,leaf,length,life,na,number,ovary,plant,position,reproduction,seed,shape,spacing,staman,subcapitate,surface,texture,width
739	wfo-0001031511	success	231	90	71	160	19	0.307	-12,-3.5,-5,0.5-1,0.5-5,0.7-2.1,0.8-2,1-1.5,1-2,10-25,2-6,2.5-3,4.5-7,5-9,7-11,andromonoecious,anther,articulated,base,black,brown,chartaceous,cm,conspicuously,contiguous,densely,diameter,discoid,ellipsoidal,erect,extra-axillary,filament,flower,forked,fruit,globose,green,inflorescence,length,light,lobed,minutely,mm,moderately,nearly,orange,ovate,pale,pedicel,peduncle,perennial,petiole,pitted,plant,pseudo-racemose,purple,rachi,rhizomatous,ripe,rotate,shallowly,shrub,stellate-pubescent,stigma,style,surface,tomentose,violet,white,x,yellow	%,-15,-7,0,0-0.3,0-1.1,0-2,0-3,0.1-0.2,0.3-0.5,0.3-0.8,0.3-1.7,0.4-0.7,0.5-0.7,0.5-0.9,0.6-1.5,1,1-3,1-7,1.1-1.6,1.7-2.4,1.8-2.6,10-12,10-18,15-25,17-25,2-3,2-4,2-locular,2.2-3,2.2-4.3,2.8-3.5,25-45,3-5,4-10,4.5-9,5-10,5-15,5-6,5-7,5-merou,6-8,6-9,7-8,8-15,9-15,9-20,abaxially,absen,absent,accrescent,acicular,across,acute,adaxiall,adaxially,alyx,ample,anvil-shape,apart,apex,armed,axe,ba,basal,bisexual,blade,broadly,calyx,connivent,cordate,cross-section,cuneate,cylindrical,deltate,dense,directed,distal,distall,dm,dult,eaf,eed,eglandular,entire,exocarp,finger,fruiting,functional,geminat,glabrous,gland-tipped,hair,half,heterostylous,hig,interpetalar,juicy,lamina,lanceolate,lateral,less,lobe,lon,long,longer,lower,male,margin,mature,mesocarp,mid-point,midpoint,midrib,midvein,minute,moist,nflorescence,oblique,obtuse,orolla,part,per,placenta,plurifoliate,pore,porrect,present,prickle,pubescent,ray,ruit,rusty,short,simple,somewhat,spaced,sparsely,stage,stalk,stalked,stellae,stem,straight,strongly,tamen,thick,throughout,time,tissue,triangular,tube,unbranched,unit,unknow,uvenile,vary,wid,wide,ympodial	abaxial,adaxial,colour,corolla,form,growth,height,history,leaf,life,number,ovary,position,reproduction,seed,shape,spacing,staman,texture
740	wfo-0001031512	success	199	94	70	129	24	0.352	-3,0.3-1,0.3-1.5,0.5-0.6,0.5-0.8,0.5-1.5,1-1.5,1-2,3-4,4-8,4.5-6,5-12,7-10,7-12,adaxially,andromonoecious,anther,base,black,brown,brownish-black,chartaceous,cm,cylindrical,densely,diameter,erect,extra-axillary,filament,flat,flower,fruit,glabrous,globose,grey,grey-green,inflorescence,lanceolate,length,lilac,long,minute,mm,moderately,pedicel,peduncle,perennial,petiole,plant,pseudo-racemose,purple,rachi,raised,rhizomatous,rotate-stellate,shrub,simple,slightly,stellate-pubescent,stigma,straight,style,surface,thick,though,tubercle,twisted,white,yellow,yellowish	%,0-10,0-3,0.05-0.1,0.1-0.2,0.15-0.2,0.15-0.25,0.15-0.3,0.2-0.3,0.3-0.5,0.5-1.8,0.8-1,0.9-1.5,1-2.5,1-3,1.5-3,12-15,12-16,13-15,13-16,15-25,2-6,2-foliate,3-5.1,3.8-5.7,4.5-7,5-7,5-merou,6-13,8-10,abaxially,absen,absent,abundant,accrescent,acute,adaxiall,alyx,and/or,apart,apex,articulated,axe,ba,blade,broad,broad-based,calyx,capitat,connivent,cuneate,decimetr,deltate,directed,distall,distinct,distributed,dr.,dult,eaf,eed,entire,finger,first,fruiting,functional,geminat,gland-tipped,green,hair,half,heterostylous,interpetalar,lamina,later,lateral,less,lobe,longer,loosely,lower,marbled,margin,mature,mesocarp,mid-point,midpoint,nflorescence,oblique,obtuse,orolla,part,per,pore,porrect,present,prickle,pubescent,ray,rounded,ruit,scarcely,sessile,short,smooth,sometimes,spaced,stage,stellae,stellate,stem,strongly,tal,tamen,throughout,time,tissue,tube,unarmed,unbranched,undulate,unit,unknow,uvenile,vary,weakly,wide,x,ympodial	abaxial,adaxial,arrangement,artificially,capitate,colour,corolla,form,growth,height,history,leaf,life,na,number,ovary,position,reproduction,seed,shape,spacing,staman,tall,texture
741	wfo-0001031586	success	167	79	51	116	28	0.305	-2,0.1-1,0.5-1,1-1.2,1-1.5,1-2,1.4-2.5,2,5-6,acute,anther,apart,apex,base,bright,capitate,cm,conical,corolla,cream-colored,elliptic,filament,flower,glabrous,green,greenish,inflorescence,leaf,lobed,mm,nearly,opposite,ovary,pale,paler,pedicel,petiole,ridged,shiny,shrub,simple,somewhat,stigma,style,surface,tapering,truncate,white,x,yellow,yellowish	.25,0.5-0.8,1,1.3-5,1.5-2,2-2.5,3-11,5-10,7-10-flowered,abrupt,absent,anthesi,apparently,appearing,attenuate,bark,becoming,beneath,borne,branch,broadly,bud,calyx,campanulate,closer,completely,cucullate,deflexed,deltate,dia,differing,difoliate,distance,drying,eaf,edicel,eed,ellipsoid,exerted,exfoliatin,fleshy,free,fresh,geminate,globose,gree,inflorescenc,know,known,later,lateral,leave,lobe,long,lower,main,major,margin,material,may,minor,minutely,mucro,near,new,nflorescence,notched,occasionally,older,olive,one,onto,open,overtopping,pair,papillate,papillose,planar,pore,poricidal,portion,present,prominent,raised,remaining,rounded,ruit,scar,shap,shaped,shin,size,slender,small,sometimes,soon,spaced,sparsely,stem,straight,swollen,tall,tear-drop,thick,thickened,tip,trichome,trunk,tube,ud,uniseriate,unit,vein,widely,ympodial,young	7-10,abaxial,adaxial,alternate,arrangement,colour,diameter,form,fruit,growth,height,history,length,life,na,number,peduncle,perennial,plant,position,rachi,reproduction,seed,shape,spacing,staman,texture,width
742	wfo-0001031587	success	142	79	44	98	35	0.31	0.8-1,1-1.5,1.5-2,1.7-2,2,2-2.5,5,6-7,anther,apex,bark,bi-lobed,calyx,cm,corolla,dendritic,elliptic-ovoid,evenly,filament,glabrous,globose,inflorescence,leaf,lobed,mm,ovary,pale,pedicel,petiole,pubescent,reddish-grey,scar,shape,soft,spaced,stem,stigma,style,surface,tree,trichome,white,winged,x	.5,10-15,12-16,17-30,2-9-celled,2/3,3-4,6-8,7-9,abaxially,acute,adaxially,along,anthesi,apart,attenuate,axi,base,broadly,clavate,closely,cone,conical,decurrent,deflexed,deltate,densely,denser,dia,differing,drying,eaf,edicel,eed,elliptic,erect,exserted,fide,fleshy,free,furcate,golden-red,included,irregular,know,known,lamina,later,lateral,like,lobe,long,loose,lower,lowered,main,major,middle,minor,minutely,mostly,oblique,ocasionally,occasional,older,overlappin,pair,papillate,papillo,parallel,perpendicular,persisten,pore,poricidal,portion,rarely,rect,rest,ruit,shaped,simple,size,somewhat,steinbach,tall,tear-drop,thick,thickened,tip,tub,tube,ud,uniseriate,vein,verrucose,way,widest,young	1,abaxial,adaxial,arrangement,bud,cell,center,colour,diameter,flower,form,fruit,fruiting,growth,height,history,length,life,margin,na,new,number,peduncle,perennial,persistent,plant,position,prickle,rachi,reproduction,seed,spacing,staman,texture,width
743	wfo-0001031589	success	222	89	66	156	23	0.297	0.1-0.5,0.2-0.5,0.4,0.5-1,0.55-0.7,0.9-1.3,1,1-1.8,1/3-1/4,2.8-4,5-merous,acute,anther,apex,articulated,base,berry,bright,brown-green,cell,chartaceous,cm,densely,diameter,dull,elliptic,erect,filament,flattened-reniform,flower,fruit,glabrescent,glabrous,gray-green,lateral,leaf,length,lobed,long-obovate,mauve,membranous,mm,orange-brown,outline,pedicel,petiole,pit,plant,raised,rounded,scandent,shiny,shrub,simple,small,smooth,sparsely,spherical,stellate,stellate-pubescent,style,surface,way,white,yellow,yellow-green	-0.5,-15,-6,-6.5,.5,/6,0,0-1,0-10,0-3,0-30,0.1,0.15-0.3,0.2-0.4,0.2-3,0.6-1.2,0.7,0.8-2.3,0.9-1.6,1-5,1.2-1.5,1.5-5,1.7-2.5,1.8-2.9,1/3,1/3-1/2,10-30,2-,2-10,2-3.5,2.5-4.5,2.5-6,3-4,3-5,3/4,4-6.5,4/5,5-8,6-8,8-14,8-30,abaxially,alyx,ame,apart,apically,apparently,attenuate,bark,blade,broadly,brow,c.,calyx,caudat,concolorous,connivent,cream,dark,deltate,density,difoliate,discolorous,distance,drying,eed,elongating,equal,extending,eye,free,fruiting,geminat,green,higher,infructescence,lengt,lobe,lon,long,longer,lower,margin,marking,mature,maturity,midpoint,midvein,moderately,multangulate,naked,narrow,narrow-cuneate,nflorescence,oblong,obovate,occasionally,often,older,orange-green,orolla,oung,pair,pale,part,pendulous,per,perfec,pericarp,poricidal,porrect,portion,prickl,prickle,prickly,primary,ray,reflexed,ruit,sessile,shorter,side,solitary,sometimes,somewhat,spaced,spreading,stalk,stalked,stem,stout,straight,subentire,subsessile,tamen,tapering,terete,tertiary,time,tip,trichome,tube,unit,upper,vary,vein,venation,visible,weakly,whole,wide,winged,woody,yellow-orange,ympodial,young	abaxial,adaxial,arrangement,colour,corolla,form,growth,height,history,inflorescence,life,na,number,ovary,peduncle,rachi,reproduction,seed,shape,spacing,staman,stigma,texture
744	wfo-0001031609	success	154	90	63	91	27	0.409	0-30,0.4-3,0.5-3,1-10,1-6,10-25,2-,2-3,3-5,3-9-lobed,4-6,abaxially,adaxially,apex,around,base,brownish,campanulate,cm,contiguous,dia,diameter,dilated,distally,flattened,fleshy,flower,forked,fruit,glabrous,globose,green,inflorescence,leaf,margin,mm,nearly,obconical,obovate,orange,papillose,pedicel,peduncle,petiole,pinnately,puberulent,rachi,reticulate,ripe,shrub,simple,small,stellate,stigma,strongly,style,succulent,tree,truncate,unbranched,unlobed,x,yellow	.5,/4,0.5-1,1.3-3,1.5-2,1.5-3,2,2.5-4,20-25,3-24,3-foliat,4,4-5,4.5-60,5-25,5/6,8-20,absen,absent,acute,aggregate,ape,apiculate,articulated,axe,barely,beyond,bilobe,blade,branch,brow,calyx,cell,connective,connivent,conspicuous,cuneate,dark,deltate,directed,divided,eaf,eed,ellipsoidal,elliptic,elliptic-ovate,emerging,entire,equal,exceeding,exserted,glabrou,laterally,leaving,lobe,lobed,long,lower,midrib,minutely,nflorescence,nther,obtuse,occasionally,orolla,pedicellar,point,pore,radiu,rounded,ruit,scar,shallowly,sinus,stamen,stone,succulen,tal,tem,thecae,time,tip,tomento,triangular,tube,two,ud,unit,vary,wide,ympodial	abaxial,adaxial,anther,arrangement,bilobed,colour,corolla,filament,form,growth,height,history,length,life,na,number,ovary,plant,position,reproduction,seed,shape,spacing,staman,surface,texture,width
745	wfo-0001031615	success	154	81	53	101	28	0.344	0.8-1,0.9-1.1,1-1.6,1.3-1.8,1.5-5,5-6,anther,apex,base,bilobed,brown,calyx,capitate,cm,corolla,decurrent,elliptic,filament,flattened-reniform,fruit,glabrous,globose,green,inflorescence,leaf,lobe,lobed,minutely,mm,nearly,opposite,ovary,papillose,pedicel,petiole,pitted,shrub,slender,small,stigma,style,subumbellate,surface,tapering,tip,tree,trichome,tube,tuft,unicellular,uniseriate,white,winged	.5,0,0.5,0.5-1,1.5,11-15.5,2-3,2-4.2,3.8-6.1,4-6.5,5-20-flowered,6-8,8-10,acuminate,acute,anthesi,arising,attenuate,axil,ba,bark,becoming,berry,caly,closely,dark,dark-papillo,deep,deflexed,deltoid,dia,differing,difoliate,distal,eaf,edicel,eed,expanded,exserted,free,fruiting,furcate,geminat,glandular,impressed,incrassate,interpetalar,lamina,lateral,less,lon,long,lower,main,major,margin,maroo,middle,minor,minute,nflorescence,occasionally,older,one,overlappin,packed,pair,paler,papillae,per,pore,poricidal,portion,prominent,reflexed,ruit,scar,scarcely,shaped,shiny,simple,sinus,size,slightly,somewhat,stem,straight,tall,tear-drop,terminal,thickened,thin,ud,unit,urceolate,vein,widest,woody,x,ympodial,young	5-20,abaxial,adaxial,arrangement,colour,dark-papillose,diameter,flower,form,growth,height,history,length,life,na,number,peduncle,perennial,plant,position,rachi,reproduction,seed,shape,spacing,staman,texture,width
746	wfo-0001031618	success	184	109	88	96	21	0.478	-2,0-3,1-1.5,2-3,3-4,5,acute,anther,apex,axil,base,branch,calyx,capitate,cell,clonal,cm,corolla,cuneate,cyme,darker,discoidal,ellipsoid,elliptic,equal,except,exerted,facetted,filament,finely,floral,glabrous,glandular,green,greyish,growing,habit,hair,lanceolate,lasting,lavender-purple,leaf,less,long,marbled,maturity,mauve,minute,mm,narrowly,obovoid,often,ovary,ovoid,pale,pedicel,peduncle,petiole,pinatisect,point,purple,reddish-brown,reticulate,rhachi,ripe,rotate,rounded,rugose,scorpioid,several,shrub,simple,soft-wooded,somewhat,stem,stigma,stone,stripe,strongly,succulent,surface,tapering,terete,tinged,unequal,variable,year,young	0.5-1.5,1-7,1.5-2,1.5-3.5,10-18,10-lobed,13,2-2.5,3,3-8,4-5,40-60,5-12,90-110,acuman,almost,also,anthesi,appearance,appearing,aspect,becoming,berry,beyond,blunt,bluntly,broadly,c.,cluster,column,conical,covering,cut,developed,dia,eaf,eed,emarginate,enlarged,erect,extending,fleshy,flower,fork,forked,frui,general,giving,greatly,gree,half,interacuminal,lengthening,lobe,lobed,lon,loosely,lower,may,mid-vein,midrib,nflorescence,oblong,occasional,occur,ovate-lanceolate,pal,pedicellate,petal,plurifoliat,pore,poricidal,rarely,ruit,sessile,shallowly,side,single,sinus,slit,sometimes,specimen,stout,styl,tip,tissue,triangular,tub,ud,unit,vigorous,way,well,x,ympodial,younger	arrangement,bud,colour,diameter,form,fruit,growth,height,history,inflorescence,length,life,plant,plurifoliate,position,reproduction,seed,shape,style,texture,tube
747	wfo-0001031646	success	171	87	59	112	28	0.345	.2,1-10,1-6,1.2-2.5,15-25,18-38,2-10,2.5-10,20,4-5,7-8,8-15,abaxially,adaxially,anther,apart,apex,base,blue,branched,brown,chartaceous,cm,darker,densely,diameter,ellipsoidal,filament,flattened,flower,fruit,glabrous,globose,green,highly,immature,leaf,light,maroon,mature,mm,pedicel,peduncle,petiole,pubescent,rachi,red,rotate-pentagonal,rugulose,scandent,shrub,smooth,stigma,style,surface,vine,violet,x,yellow	-7,-pinnate,.5,0.2-0.8,0.5-2,0.8-1.5,1-1.8,1.5-3.5,1.5-4,1962,2-2.5,2-3,3.5-4,4-18,4-20,4-8,4-foliate,5,5-6,5-7,5-7.5,5-merou,absen,absent,accrescent,acuminate,acut,acute,aggregate,alyx,apical,apparently,articulated,axe,ba,basally,berry,blade,calyx,cell,ciliat,climbing,connivent,correll,covered,cuneate,cylindrical,decreasing,directed,distall,eaf,eed,elliptic,elliptic-lanceolate,entire,equal,fide,fruiting,geminat,glandular,hair,high,homostylous,hyaline,interjected,lateral,leaflet,lobe,long,lower,margin,multicellular,nflorescence,oblique,obliquely,oblong,obtuse,orolla,ovate-lanceolat,ovate-lanceolate,part,perfect,petiolule,pore,present,pubescen,pubescence,rounded,ruit,seudostipule,shortly,simple,size,slightly,small,spaced,spreading,stem,stone,stout,tamen,tawny,tem,tip,toward,tree,truncat,tube,uniseriate,unit,vary,ympodial	abaxial,adaxial,arrangement,colour,corolla,form,growth,height,history,inflorescence,length,life,na,number,ovary,perennial,pinnate,plant,position,reproduction,seed,shape,spacing,staman,texture,truncate,unknown,width
748	wfo-0001031651	success	201	75	60	141	15	0.299	.7,0.3-0.8,0.3-1.5,0.6-1,0.7-1,1-1.7,1-4,1.2-2,4-6,5-merous,abaxial,absent,adaxial,anther,apart,berry,branched,cell,chartaceous,cm,densely,diameter,dull,elliptic,filament,filiform,flattened-reniform,flower,fruit,herb,leaf,length,lobed,maturity,mm,orange-brown,outline,ovate,pedicel,peduncle,petiole,pit,poricidal,prickly,purple,raised,red,shrub,small,smooth,spherical,stellate,stellate-pubescent,style,surface,tip,unarmed,weakly,white,yellow	-2,-3,-3.5,.1,.6,/3,/5,0-20,0.1,0.1-0.15,0.1-0.2,0.1-0.25,0.15-0.2,0.2-0.5,0.3-0.5,0.6-1.3,1,1-2,1.2-3,1.3-1.6,1.5-2,1/5,1/6-1/4,2-10,2-3,2-3.5,2/3-3/,3-5,4-5,4.5-7,abaxially,acuminat,acute,alyx,ame,apar,apex,apically,apparently,articulated,bark,base,blade,brown,c.,calyx,concolorous,cordate,curved,dark,deltate,difoliate,discolorous,drying,eaf,eed,elongating,entire,equal,erect,eye,faint,free,fruiting,geminat,glabrescent,glabrous,gra,gray,herbaceous,infructescence,lanceolate,lateral,lobe,long,longer,lower,margin,mature,midpoint,naked,nflorescence,oblong,obtuse,older,one,open,orolla,oung,pair,pendulous,per,perfec,pericarp,persistent,porrect,portion,prickl,prickle,primary,ray,red-green,reflexed,rounded,ruit,scandent,scar,shorter,simple,sometimes,spaced,spreading,stalk,stalked,stem,straight,subentire,subsessile,tamen,tapering,terete,terminal,tertiary,thick,thick-stalked,time,toward,trichome,tube,unarme,unit,upper,variously,vary,vein,venation,visible,way,wide,yellow-green,ympodial	colour,corolla,form,growth,height,inflorescence,ovary,plant,reproduction,seed,shape,spacing,staman,stigma,texture
749	wfo-0001031654	success	191	85	63	128	22	0.33	0.5-0.75,0.5-2,0.5-3.5,1-2,1-4,1.5-2.0,2-3,3-10,4-6,abaxial,acute,adaxial,anther,apex,brown,chartaceous,cm,cream,cylindrical,dark,diameter,extra-axillary,filament,flower,fruit,glabrous,globose,green,immature,leaf,leaf-opposed,lobed,many,mature,mm,moderately,netlike,ovate,pedicel,peduncle,petiole,pit,pubescent,rachi,raised,red,reniform,ridge,scandent,separated,shrub,simple,small,sparsely,stellate,stigma,style,surface,unbranched,white,whitish,x,yellow	0.5,0.5-1,0.5-1.5,1,1-.,1-1.5,1-3,1.5-2,1.5-3,1/3-1/2,10-20,2-5,2-6,2-8,2-ranked,3,3-6,4-16,4-7,5-8,5-merou,8-15,abaxially,absent,accrescent,adaxiall,adaxially,alyx,apar,apical,apparently,armed,attenuate,axe,base,berry,beyond,blade,bud,calyx,connivent,contiguous,cordate,cut,cylindrica,decurrent,densely,difoliate,directed,discolorous,eaf,eed,either,em,equa,exserted,flattened,frui,fruiting,geminate,glabrou,hair,interpetaler,introrsel,lacking,less,like,lobe,long,lower,m.,major,margin,midpoint,midrib,midvein,multicellular,multiseriate,narrowly,nearly,nflorescence,obscure,obtuse,occasional,occasionally,often,onto,orolla,pair,parallel,per,perfect,perpendicular,pore,porrect-stellate,prickle,ray,recurved,ruit,rusty,secondary,side,sinus,slightly,spaced,spine,spreading,stalk,stamen,ste,stem,straight,tamen,tan,tapering,thin-skinned,tissue,triangular,tube,unarmed,unicellular,unit,usually,vary,vein,way,wide,ympodial	5-merous,arrangement,colour,corolla,form,growth,height,history,inflorescence,length,life,na,number,ovary,plant,position,reproduction,seed,shape,spacing,staman,texture
750	wfo-0001031656	success	154	64	40	114	24	0.26	.5,1-2,1-2.5,1.2-1.5,1.5-2,1.5-5,3-3.5,5-ribbed,6-8,anther,apex,bright,capitate,closely,cm,corolla,ellipsoid,elliptic,filament,flower,fruit,glabrous,globose,green,leaf,lobed,mm,opposite,ovary,ovate,pedicel,petiole,plant,shrub,spaced,stigma,strongly,style,surface,white	/4,0.5,0.5-1,1-1.5,10-20,2.5-3.5,3-5,4-9,5-7,acuminate,acute,also,anthesi,arising,ba,bark,base,berry,calyx,cork,densely,dia,differing,difoliate,directly,drying,eaf,edicel,eed,enclosing,erect,extremely,fleshy,free,fruiting,geminat,greyish,hooded,known,lateral,live,lobe,lon,long,long-acuminate,lower,main,major,margin,matte,mature,middle,minor,minute,minutely,nflorescence,node,oblique,often,older,one,pair,pale,paler,papillo,papillose,peelin,persistent,planar,pore,poricidal,portion,prominent,proximal,rather,red-papillose,reddish,reflexed,rib,ridged,rounded,ruit,scar,sessile,shaped,shiny,size,slightly,somewhat,specimen,stem,straight,swollen,tall,tear-drop,terminal,thick,thickened,tip,top,transversely,tube,ud,unit,upper,vein,visible,way,wide,widest,woody,x,ympodial,young	abaxial,adaxial,arrangement,colour,diameter,form,growth,height,history,inflorescence,length,life,na,number,peduncle,position,rachi,reproduction,seed,shape,spacing,staman,texture,width
751	wfo-0001031667	success	153	86	61	92	25	0.399	0.6-1,1-1.5,1-4,1.4-3,12-35,2-3,3-13,5-15,5-9,8-13,apex,articulate,branched,cell,cm,corolla,covering,cyme,dark,diameter,dichasial,dichasially,distal,ebracteate,elliptic-lanceolate,filament,flower,forked,globose,green,green-white,hair-like,half,herbaceous,lanceolate,lateral,leaf,mm,monochasial,odd-pinnate,ovoid,pedicel,peduncle,perennial,petiole,pilose,plant,proximal,seed,spot,stellate,stigma,stripe,style,testal,thick,throughout,wall,white,yellow,¼	0.6-1.5,1.5-2,10-13,2-5,2-6,2.5-5,3-5,3-6-foliat,3-8,4-1.,6-10,8-15,abaxially,abruptly,acumen,acuminate,acute,adaxially,apical,apically,apiculate,base,calyx,caudate,connate,cordate,cuneate,dehiscent,digestion,diminishing,dorsally,eaf,edge,eed,emoval,enzyme,exceeding,flat,folded,generally,globo,honeycomb,interjected,introrse,irregularly,leaflet,living,lobe,lobed,lon,long,lower,lunat,make,maturing,mucilaginous,nflorescence,nther,oblique,oblong,often,orolla,pair,pattern,perfect,petiolate,petiolule,plan,poricidally,reveal,rounded,ruit,sessile,seudostipule,short,size,slit,specimen,stamen,straight,tal,tem,terminal,toward,tuber-bearing,typically,unit,vary,whit,wide,without,ympodial	abaxial,adaxial,anther,arrangement,colour,form,fruit,growth,height,history,inflorescence,length,life,na,number,ovary,position,rachi,reproduction,shape,spacing,staman,surface,texture,width
752	wfo-0001031672	success	157	82	54	103	28	0.344	0.3-0.5,0.5-1.5,1,1-10,1-5,1.5-2,1.5-5,10-20,15-50,2-12,4.5-5,6,apart,apex,articulated,base,chartaceous,cm,densely,diameter,flattened,flower,fruit,glabrous,glandular-puberulent,globose,green,greenish-brown,leaf,membranaceous,mm,moderately,near,ovate,ovoid,pedicel,peduncle,petiole,pilose,puberulent,rachi,simple,sparsely,stellate,stigma,style,subcoriaceous,tree,truncate,unbranched,white,whitish,x,yellow	0,0-2,0.5,0.5-1,1-,1-1.5,1-2,1.5-2.5,1.5-3.5,15-20,2-28,3-4-foliat,3/4,4,4-34,4/5,5-6,9-lobed,abaxially,absent,acuminate,acute,adaxially,aggregate,ape,apiculate,aublet,axe,basal,beyond,blade,calyx,cell,ciliat,connective,cordate,cylindrical,directed,distally,divided,eaf,eed,entire,exceeding,exserted,fide,fleshy,hair,lanceolate,leaving,lobe,lobed,lon,long,lower,margin,mature,midrib,narrowly,nflorescence,nther,obtuse,occasionally,often,one,orolla,pedicellar,perfect,pilo,pinnately,pore,presen,present,pubescent,purple,radiu,remant,represented,rounded,ruit,shorter,sinus,slightly,small,spaced,stamen,stone,tal,tem,thecae,time,tip,toward,triangular,truncat,tube,ud,unit,unlobed,vary,wide,yello,ympodial	abaxial,adaxial,anther,arrangement,colour,corolla,filament,form,growth,height,history,inflorescence,length,life,na,number,ovary,perennial,plant,position,reproduction,seed,shape,spacing,staman,surface,texture,width
753	wfo-0001031684	success	161	99	72	89	27	0.447	.25,/4,0.4-1.5,0.5-0.7,0.5-0.8,0.5-1,0.7-1,0.75-1,1-1.2,1-5,3-30,acute,along,anther,apex,base,beneath,calyx,clavate,cm,corolla,decurrent,densely,dia,difoliate,elliptic,filament,filiform,flower,geminate,glabrous,globose,green,inflorescence,internodal,leaf,like,lobed,long,minutely,mm,occasionally,opposite,ovary,ovoid-reniform,pale,papillose,pedicel,petiole,pitted,pubescent,rest,shrub,slender,slightly,small,sparsely,stigma,style,surface,tan,tapering,tree,trichome,tube,unifoliate,uniseriate,vein,way,white,winged,x	.5,.75,0.1,10-100,2,2-9,3-3.5,4-17,5-7,acuminate,anthesi,apar,bark,bearing,berry,black,borne,branched,causing,curly,deflexed,denser,differing,drying,eaf,edicel,eed,elongated,except,expanded,exserted,extremely,free,fruiting,gre,greatly,irregularly,lateral,less,lobe,lon,long-triangular,lower,main,major,middle,midrib,minor,nflorescence,obconic,older,one,pair,papillo,persistently,planar,pore,poricidal,portion,present,previously,pulled,raised,reflexe,reflexed,ruit,scar,shaped,short,single,siz,size,soon,spaced,stem,straight,tall,tear-drop,time,tip,tipped,ud,unevenly,unit,varying,widely,widest,ympodial,young	abaxial,adaxial,apart,arrangement,colour,diameter,form,fruit,growth,height,history,length,life,na,number,peduncle,perennial,plant,position,rachi,reproduction,seed,shape,spacing,staman,texture,width
754	wfo-0001031690	success	140	77	43	97	34	0.307	1.2-2.0,1/2-2/3,2-5,2.5-3.5,4-9,7-10,anther,apex,blade,blue,broadly,brown,cm,dark,depressed-spherical,dm,dry,foveolate,glabrous,green,herb,internodal,length,long,maturity,minutely,mm,ovate,pedicel,perennial,petiole,prickly,reflexed,reniform,shape,slightly,splitting,spreading,stellate,stipitate-glandular,violet,violet-tinged,zygomorphic	.5,2-3,2-8,2.7-3.6,2/3,6-9-flowere,8-40,accrescent,acro,acute,along,always,alyx,anthesi,apically,arcuate,base,bearing,beneath,berry,calyx,campanulate,cauline,completely,corky,covered,da,developing,difoliate,divided,eaf,eed,eglandular,emerging,erect,exceeded,geminat,glabrate,hair,invested,lanceolate,least,linear,lobe,lon,main,nflorescence,numerous,obtuse,often,orolla,per,persistent,pinnatifid,prickle,rarely,rhizome,root,rounded,ruit,scattered,separated,sessile,short,slende,slender,somewhat,space,stellae,stem,strait,tall,tamen,tapering,terete,thrice,throughout,tightly,tigma,tub,tube,twice,tyle,ultimate,unexpande,uniseriate,unit,usually,variable,vary,vein,viscid-glandular,widely,yearly,yellow,ympodial,young	6-9-flowered,abaxial,adaxial,arrangement,colour,corolla,diameter,filament,flower,form,fruit,growth,height,history,inflorescence,leaf,life,na,number,ovary,peduncle,plant,position,rachi,reproduction,seed,spacing,staman,stigma,style,surface,texture,unexpanded,width
755	wfo-0001031695	success	185	95	66	119	29	0.357	0.5-1,1-9,1.5-8,10-35,2-3,20-30,3-10,3-17,3-7,5-7,6-10,6-20,abaxially,abruptly,acuminate,adaxially,also,apart,apex,articulated,base,branched,campanulate,chartaceous,cm,dark,deep,densely,diameter,ellipsoidal,flattened,flower,fruit,glabrous,glandular-puberulent,green,greenish,immature,lavender,leaf,mm,moderately,mottled,occasionally,ovate,pedicel,peduncle,petiole,pilose,pilose-hirsute,puberulent,pubescent,purple,purplish,rachi,shrub,simple,sparsely,stigma,stripe,style,subcoriaceous,tree,unbranched,x,yellow	0.5-2,1,1-2,1-3,1.5-2,1/2,1/3,10-,10-15,15-20,2-4,2-5,2.5-5,3-,3-19,30-40,4-10,4-5,4-6,4-foliat,5,5-20,6-8,7-,?,acute,aggregate,ape,apically,apiculate,axe,basal,beyond,blade,broadened,calyx,capitat,cell,color,connective,connivent,cordate,cylindrical,d,dilated,directed,divided,eaf,eed,eglandular,eglandular-pilose,entire,exceeding,exserted,fleshy,glabrate,glabrescent,hair,hard,lanceolate,lateral,laterally,leaving,lilac,lobe,lobed,lon,long,lower,margin,midrib,narrowly,nflorescence,nther,oblique,oblong,obtuse,often,orolla,ovoid,pedicellar,perfect,pilo,pilose-hirsut,pore,presen,present,puberulent-pubescent,radiu,remnant,ripe,rounded,ruit,shorter,sinus,slight,slightly,small,sometimes,somewhat,spaced,stamen,stone,swelling,tal,tem,thecae,time,tip,tomento,triangular,tube,unequal,unit,unknown,unlobed,vary,wide,ympodial	abaxial,adaxial,anther,arrangement,capitate,colour,corolla,filament,form,growth,height,history,inflorescence,length,life,na,number,ovary,perennial,plant,position,reproduction,seed,shape,spacing,staman,surface,texture,width
756	wfo-0001031697	success	185	76	41	144	35	0.222	0.4,1.2,?,abaxially,anther,apex,attenuate,cm,diameter,except,filament,flower,foveolate,fruit,glabrous,globose,herbaceous,linear,mm,ovate-lanceolate,pedicel,peduncle,petiole,pilose,plant,pubescent,purple,shallowly,simple,sparsely,stellate,stigma,style,subreniform,subshrub,thin-textured,tip,unbranched,white,yellow,yellow-brown	-celled,.4,.5,.6,.7,.8,0.1,0.3,0.5,0.6–1.0,0.8,1,1.2–2.5,1.4,1.5–7,10-celled,15,15–60,1–1.6,1–2,2-celled,2-foliate,2.2,2–3,2–4,3,3.5,3–4,3–8,4,4-rayed,4.5,4–5,5,6–13,accrescent,acute,adaxially,apparently,around,axe,base,blade,branch,calyx,completely,consistently,cordate,covering,cylindrical,densely,directed,distall,divergent,eaf,eed,entire,especially,face,fertile,few-celled,flattened,flowering,free,frui,fruiting,geminat,glabrou,gland-tippe,gland-tipped,hair,hilum,hyaline,indentation,lacking,less,lobe,lon,long,longer,longest,lower,lowermost,lowest,major,many,margin,midpoint,minute,mixed,mostly,nflorescence,non-glandular,often,orolla,ovate,part,per,pigment,pore,prickle,pubescence,raised,ruit,scattered,sessile,several-celled,sharp,shiny,short,shorter,similar,single,size,slender,small,smaller,somewhat,ste,stellae,stem,straight,tall,tamen,taproo,tem,terminal,thick,time,truncat,tube,tuberculate,ultimate,unarme,unarmed,unit,upper,vary,varying,vein,wide,x,ympodial,–3	1.2-2.5,1.7,15-60,2,2-3,3-4,3-8,6-13,abaxial,adaxial,arrangement,colour,corolla,form,growth,height,history,inflorescence,leaf,length,life,na,number,ovary,position,rachi,reproduction,seed,shape,spacing,staman,surface,texture,truncate,width
757	wfo-0001031698	success	58	38	20	38	18	0.345	2-2.5,2.5,base,cm,elliptic,flattened,glabrous,incrassate,leaf,margin,minutely,mm,paler,pitted,reddish-brown,reniform,repandly,rugose,shrub,surface	'',2.5-3,4-4.5,``,ape,bark,branch,decurrent,deflexed,dia,difoliate,dull,eaf,eed,fide,fruiting,geminat,green,long,maguire,older,otherwise,pale,papillae,pedicel,persistin,stem,stout,strongly,tall,unit,wing,winged,woody,x,yellowish,ympodial,young	1,abaxial,adaxial,apex,colour,diameter,form,fruit,growth,height,length,na,peduncle,plant,reproduction,seed,shape,texture
758	wfo-0001031707	success	178	98	72	106	26	0.404	.5,/4,1-1.3,1.5-6,16-20,2-4,2-6,24,4-5,6-7,abaxially,adaxially,almost,along,anther,apex,apically,axillary,base,brown,capitate,climbing,cm,conical,corolla,dense,densely,diameter,erect,filament,flattened,flower,glabrous,globose,green,greenish,high,leaf,leaflet,like,lobed,mm,ovary,pair,pedicel,per,petiole,pink,pinnate,plant,pointed,pubescent,reddish,rest,round,scattered,simple,slightly,smooth,sparsely,stigma,style,surface,ternate,trichome,uniseriate,vein,vine,way,white,woody,x	-3,0.5-1,1-1.2,1-1.5,1-3,1.2-1.8,1.2-2,1.5-1.7,1.5-2,1/3,2,2-10,2-3,3,4-6,5-10-celled,8-12,80-140,9-15,absent,acuminate,acute,anthesi,apical,attenuate,axil,basal,basiscopically,bearing,berry,c.,calyx,cateniform,cell,clavat,conspicuously,cucullate,distal,distinct,drying,eaf,edicel,eed,elliptic,endrophilum,enlarged,epidermal,exserted,flap-like,flat,fleshy,four-lobed,free,fruiting,horizonta,inflorescenc,lanceolate,lateral,less,lobe,lon,long,lower,margin,minutely,narrower,narrowly,nflorescence,oblique,obovate,occasionally,open,papillate,penden,petiolule,planar,poricidal,portion,primary,quadrate,quite,raised,regular,ruit,sagittate,scar,smaller,somewhat,spaced,stout,strongly,tem,terminal,thickening,time,tip,tub,tube,type,ud,unifoliat,unit,usually,white-lenticellate,widely,ympodial	abaxial,adaxial,arrangement,clavate,colour,form,fruit,growth,height,history,horizontal,inflorescence,length,life,na,number,peduncle,position,rachi,reproduction,seed,shape,spacing,staman,texture,width
759	wfo-0001031714	success	201	111	87	114	24	0.433	-6,-8,0.2-0.5,0.5,1,1-1.4,1-2,1-3,1.5-2.4,2-3,2-3.5,4-merous,6-8.5,7,abaxial,absent,anther,apex,bark,base,berry,bright,broadly,calyx,capitate,cell,closely,cm,conical,corolla,cup-shaped,densely,diameter,ellipsoid,elliptic,entire,filament,flattened,flower,fruiting,glabrous,globose,greyish,growth,inflorescence,leaf,less,lobed,margin,minutely,mm,narrowly,nearly,new,often,orbicular,ovary,pale,pedicel,peduncle,petiole,pitted,prickle,pubescent,rarely,red,reniform,scar,shallowly,shoot,short,shrub,simple,spaced,sparsely,stellate,stem,stigma,stout,straight,style,surface,terminal,thin,trichome,white,yellow	-3.5,.25,0.15-0.3,0.3-0.5,0.4-,0.5-,0.5-0.6,0.5-0.8,0.7-2.2,0.8-1.2,1-4,1.5-2,2,2-4,3-3.5,3-4,3-6,6,7-10,7-8,<,?,abaxially,adaxially,anthesi,appearing,arising,armed,articulated,axi,basal,broad,broad-based,caly,dense,eaf,eed,elongate,enlarged,equal,erect,especially,exserted,extending,foliose,free,frui,irregular,juicy,leafy,lengthening,like,lobe,lon,long,longer,lower,markedly,membranous,midpoint,midrib,mixture,nflorescence,numerous,oblique,obvious,occasionally,older,pair,papillo,per,perfect,pericarp,planar,plate,plurifoliat,pore,poricidal,portion,prickly,primary,pubescence,ray,rectangular,ripe,rounded,ruit,sessile,short-stalked,shorter,sinuate,size,slightly,slit,smaller,sometimes,spreading,stalked,strongly,tapered,testal,tiny,tip,truncate,tube,ud,unarmed,unit,upper,usually,vein,woody,x,ympodial	adaxial,arrangement,bud,center,colour,form,fruit,height,history,length,life,na,number,perennial,plant,position,rachi,reproduction,seed,shape,spacing,staman,texture,width
760	wfo-0001031721	success	208	88	64	144	24	0.308	0-5,0.2-0.5,0.3-1.1,0.4-2.2,1-1.5,1-3,1.5,2-4,5-20,5-7,8.5-12.5,andromonoecious,anther,apex,articulated,base,black,brown,chartaceous,cm,cylindrical,dark,densely,diameter,elliptic,extra-axillary,filament,flattened,flower,fruit,glabrous,globose,green,herbaceous,inflorescence,lavender,leaf-opposed,length,minutely,mm,obtuse,ovate,pale,pedicel,peduncle,petiole,plant,purple,rachi,resprouter,reticulate,simple,sparsely,stellate,stellate-pubescent,stigma,streak,style,surface,unbranched,weakly,white,yellow,yellowish-green	%,.1,0-0.1,0-1,0-3,0.1-0.2,0.1-0.5,0.25-0.4,0.25-0.5,0.4-0.6,0.4-0.7,0.4-1.6,0.6-1.1,0.6-1.2,0.7-1.2,0.7-1.3,0.8-1.3,1,1-20,1-3.5,1.1-3.2,1.2-1.7,11-30,2.2-3.2,2.5-3,2.7-3.5,3-10,3-4.5,3-7,3-foliate,4-5,4-7,4-locular,5-11,5-merou,6-15,6-9,7-10,7-8,7-9,8-15,8-20,abaxially,absen,absent,accrescent,acicular,across,adaxiall,adaxially,alyx,anvil-shape,apart,axe,ba,blade,calyx,capitat,confined,connivent,cross-section,cuneate,curved,d.,deltate,directed,distall,distributed,dult,eaf,eed,eglandular,entire,erect,exocarp,finger,fruiting,functional,geminat,gland-tipped,grey,hair,half,heterostylous,hig,juicy,lamina,lanceolate,lateral,less,lobe,long,longer,lower,margin,mature,mesocarp,mid-point,midpoint,midrib,midvein,minute,moderately,moist,nflorescence,oblique,orolla,part,per,placenta,pore,porrect,possibly,present,prickle,pseudo-racemose,ray,ruit,semi-circular,sessile,short,solitary,somewhat,spaced,stage,stalk,stalked,stellae,stem,straight,tamen,thick,throughout,time,tube,unarme,unarmed,unit,uvenile,vary,wide,x,yellowish,ympodial	5-merous,abaxial,adaxial,arrangement,capitate,colour,corolla,form,growth,height,history,leaf,life,na,number,ovary,perennial,position,reproduction,seed,shape,spacing,staman,texture
761	wfo-0001031723	success	228	94	72	156	22	0.316	-1.5,-5,0.4-,0.4-1,0.6-1,0.7-1,1-,1-2.5,1-3,1-5,1.2-2,10-30,15-45,2-,4-11,4-6,abaxial,abaxially,adaxial,anther,apart,apex,berry,brown,chartaceous,cm,dark,diameter,dull,erect,evenly,filament,finely,flattened-reniform,flower,fruit,green,lateral,leaf,length,lobed,marking,maturity,mauve,mm,moderately,orange-brown,ovate,pale,pedicel,peduncle,petiole,recurved,red,rounded,shrub,simple,smooth,sometimes,sparsely,spherical,stellate,stellate-pubescent,style,surface,terminal,weakly,white,whitish,yellow,yellow-green,young	-1/2,-15,-16,-2,-6,-6.5,-8,-merous,0,0.05-0.2,0.1-0.2,0.1-0.3,0.1-0.5,0.15,0.2-1,0.4,0.4-0.9,0.55-0.9,0.8-1.5,1-2,1.5-,1.5-10,1.5-2.5,1/3-1/2,1/4-1/3,1/6-,2-3.5,2-5.5,2-7,2.5-4.5,2.5-5,2/3,2/3-3/4,3-10,3-15,4-,4-10,4-20,4-5,5-40,5-9,8-20,acuminate,acut,acute,alyx,ame,apar,apically,apparently,articulated,ba,bark,base,blade,branched,branching,brow,c.,calyx,conical,connivent,cuneate,curved,deltate,densely,discolorous,drying,eaf,eed,elongated,elongating,entire,equal,eye,filiform,free,fruiting,gently,glabrescent,glabrous,gland,gland-tipped,glandular,gray,hair,herbaceous,inflated,infructescence,lobe,long,longer,lower,margin,mature,midpoint,minute,multangulate,naked,narrow-deltate,near,nflorescence,obtuse,older,one,open,orange,orolla,oung,pair,per,perfec,pericarp,perpendicular,plurifoliat,poricidal,porrect,portion,prickle,prickly,primary,ray,reflexed,ruit,scar,secondary,sessile,spaced,spreading,stalk,stalked,stem,straight,strongly,subentire,tamen,tapering,terete,tertiary,time,tip,trichome,tube,unarme,unarmed,unit,usually,variously,vary,vein,venation,visible,way,wide,woody,ympodial	arrangement,colour,corolla,form,growth,height,history,inflorescence,life,number,ovary,perennial,plant,position,reproduction,seed,shape,spacing,staman,stigma,texture,unknown
762	wfo-0001031729	success	161	86	58	103	28	0.36	-2,0.5-1,0.6-,1-2,1-2.5,1.5-2,2-2.5,2-3,2.5-5,3-4,5-6,5-7,50,abruptly,acuminate,anther,apex,branched,cm,conical,corolla,darker,diameter,elliptic,filament,flattened,flower,fruit,glabrous,globose,green,greenish,lobed,long,minutely,mm,mottling,obovate,occasionally,ovary,ovate-reniform,pale,papillose,pedicel,peduncle,petiole,pink,purplish,reddish,shrub,smooth,stigma,stripe,surface,tan,time,white,x	-0.5,-45,..,0.5,0.5-4,1-1.5,1.0-1.3,1.5,10-20,11-30,12-13,2.5-,3-celled,3.5-4,4.1-16,5-,8-9,along,anthesi,apicula,apiculate-deltate,attenuate,base,beneath,branc,branch,brittle,brow,c.,calyx,cell,cucullate,curve,dark,deltate,dry,drying,eaf,edicel,eed,elongate,erec,flattened-capitat,fruiting,glandular,gradually,later,less,lobe,lower,markedly,membranous,middle,minute,narrowly,nearly,never,nflorescence,noddin,open,outer,outline,pair,papillae,papillate,per,pericarp,planar,plurifoliat,point,pointed,primary,quadrate,regularly,ruit,scar,scattered,short,single,single-stemmed,sinuate,small,somewhat,stem,striate,testa,thin,thing,tip,toward,triangular,trichome,tube,tuft,ud,unit,usually,vein,wall,wand-like,widening,ympodial,young	abaxial,adaxial,arrangement,colour,flattened-capitate,form,growth,height,history,inflorescence,leaf,length,life,na,number,perennial,plant,plurifoliate,position,rachi,reproduction,seed,shape,spacing,staman,style,texture,width
763	wfo-0001031738	success	231	89	69	162	20	0.299	-6,-merous,0.7-1,0.7-1.1,1-1.5,1-4,1.5-4,15-40,2.3-3,4-6,4-8,5,6-15,abaxial,acute,adaxial,andromonoecious,anther,apart,apex,apparently,berry,cell,chartaceous,cm,dark,densely,diameter,dull,evenly,filament,flattened-reniform,flower,fruit,glabrous,gray,green,lateral,leaf,length,lobed,mm,orange,orange-brown,outline,ovate,pale,pedicel,peduncle,petiole,pit,plant,raised,shrub,simple,small,smooth,spherical,stellate,stellate-pubescent,style,surface,terminal,tree,weakly,white,yellow,yellow-green,yellowish	-15,-5,.5,0,0-2,0-3,0.1-0.25,0.2-0.3,0.25-0.8,0.3-1,0.9-2.1,1-1.8,1-3,1.4-1.7,1.5-,1/,1/2-2/3,1/3,1/3-2/3,1/4-1/3,1/6-1/4,10-15,2-,2-4,20-200,3-4,3-6,3-7,3.5-3.8,3.5-4.5,4,4-10,4-5,5-8,7-12,7-12.5,8-10,8-18,abaxially,acuminat,adaxially,almost,always,alyx,apar,apically,articulated,auriculate,bark,base,blade,branched,calyx,connivent,cordate,curved,deltate,discolorous,distal,distance,drying,eaf,eed,elongating,equal,erect,extending,flattened,free,frequently,fruiting,glabrescent,held,hermaphrodite,heterostylous,infructescence,inside,lobe,lobing,long,long-styled,longer,lower,lowermost,margin,mature,maturity,midpoint,midvein,multangulate,narrow-deltate,nflorescence,oblong,obovate,often,older,one,open,orolla,oung,pair,per,pericarp,plurifoliat,poorly,poricidal,porrect,portion,prickl,prickle,prickly,primary,prominent,pubescent,ray,reflexed,resin,rounded,ruit,scar,secondary,sessile,short-styled,shorter,side,sometimes,spaced,sparsely,spreading,stalk,stalked,staminat,stem,sticky,stout,straight,strongly,tamen,tapering,terete,tertiary,time,tip,trichome,truncate,tube,unarmed,unit,upper,usually,variously,vary,vein,venation,visible,way,white-brow,wide,woody,yellow-orange,ympodial,young	arrangement,colour,corolla,form,growth,height,history,inflorescence,life,na,number,ovary,perennial,reproduction,seed,shape,spacing,staman,stigma,texture
764	wfo-0001031752	success	172	100	72	100	28	0.419	-10,-100,-44,-47,-6,0.5-1,1-1.5,1-3,1-4,1.5-10.5,1.5-3.5,15-25,15-40,2-2.5,2-5,3.5-15,5-6,5-8,acuminate,acute,apex,articulated,base,chartaceous,cm,darker,densely,diameter,ellipsoidal,elliptic,flattened,flower,fruit,fusiform,glabrescent,glabrous,green,immature,light,membranaceous,mm,moderately,near,oblong,older,ovate,pedicel,peduncle,petiole,pink,puberulent,pubescent,purplish,rachi,ripe,rugose,shrub,simple,small,sparsely,stellate,stigma,stripe,style,subcoriaceous,tree,truncate,unbranched,white,x,yellow,young	-3,-pubescent,0.5-1.5,1,1-,1-2,1.5-2,1.5-2.5,1.5-3,2-3,20-35,3-11.5,3-4,3-4-foliat,3-7,3.5-5,5-23,8-15,9-16,abaxially,adaxially,aggregate,apart,ape,apiculate,axe,basal,beyond,blade,calyx,cell,ciliat,ciliate,connective,connivent,cuneate,cylindrical,deltate,directed,distally,eaf,eed,entire,equal,exceeding,exserted,fleshy,glabrate,gland,glandular-puberulen,glandular-puberulent,lanceolate,leaving,less,linear,lobe,lon,long,lower,margin,narrowly,nearly,nflorescence,nther,obtuse,often,olde,orolla,ovoid,pedicellar,perfect,pore,presen,present,purpl,radiu,remnant,rounded,ruit,slightly,spaced,stalked,stamen,stone,subcordate,swelling,tal,tem,thecae,time,tip,tomentose,triangular,truncat,tube,ud,unit,vary,wide,ympodial	abaxial,adaxial,anther,arrangement,colour,corolla,filament,form,growth,height,history,inflorescence,leaf,length,life,na,number,ovary,plant,position,reproduction,seed,shape,spacing,staman,surface,texture,width
765	wfo-0001031756	success	186	81	60	126	21	0.323	-5,.5,/2,0-2,0-5,0.4-1.6,0.5-1,0.8-1,1-3,1-4,1.5-2,1.5-3.5,5-merous,abaxially,anther,apart,apex,articulated,base,berry,cm,color,densely,diameter,erect,evenly,filament,finely,flattened-reniform,flower,fruit,glabrous,green,known,leaf,lobed,long,mature,mauve,mm,moderately,orange-brown,ovate,pale,pedicel,peduncle,petiole,pitted,scandent,shoot,short,shrub,spherical,stellate-pubescent,style,surface,terminal,way,white,young	-1,.1,.8,0,0.02-0.2,0.1,0.15-0.25,0.2,0.5-1.3,0.6-1.2,0.6-1.6,0.7-1.7,00,1-1.8,1-2,1.8-2.5,1/2,1/3,10,2-6,3-15,3-5,3-7,4-5,4.5,6-9,7-10,9-14,accrescent,acut,alyx,apar,apically,apparently,bark,blade,branched,broad-deltate,calyx,chartaceous,concolorous,conical,connivent,cordate,curved,deltate,drying,eaf,eed,elongating,enclosing,entire,equal,eye,free,fruiting,fully,glabrescent,glabrou,gray,herbaceous,inflated,infructescence,invested,lobe,longer,lower,margin,midpoint,naked,nflorescence,older,one,open,orolla,oung,pair,pendulous,per,perfec,pericarp,perpendicular,plurifoliat,poricidal,porrect,portion,prickl,prickle,prickly,primary,ray,red-brown,rounded,ruit,scar,sessile,shorter,simple,slender,small,smooth,spaced,sparsely,spreading,stalk,stalked,stellate,stem,straight,tamen,tapering,terete,time,tip,trichome,truncate,tube,unarmed,unit,variously,vary,vein,visible,wide,yellow-green,ympodial	abaxial,corolla,form,growth,height,inflorescence,length,na,number,ovary,plant,position,rachi,reproduction,seed,shape,spacing,staman,stigma,texture,width
766	wfo-0001031761	success	207	86	66	141	20	0.319	.5,0-12,0.3-2.8,0.5-0.7,0.7-1.3,0.9-2,1,1-4,1-8,1/2,1/2-2/3,2-3.5,3.2-3.5,5-merous,abaxially,acute,anther,apart,apex,articulated,base,berry,branched,cell,cm,densely,diameter,dull,erect,filament,flattened-reniform,flower,fruit,glabrous,leaf,length,lobed,long,lower,maturity,mauve,mm,orange,orange-brown,outline,ovate,pedicel,peduncle,petiole,pit,purple,raised,red,red-green,rounded,scandent,shrub,small,smooth,spherical,stellate,stellate-pubescent,style,surface,way,yellow	-12,-20,-3/,-6.5,-7,.4,0,0-0.4,0-10,0-15,0-25,0-4,0-5,0.2-0.4,0.3,0.3-0.4,0.5,0.5-1.5,0.6-1.2,0.7-1.6,0.75-1.7,1-3,1.5,1.5-4.2,1.5-6,1.8-2.3,1/3,1/3-2/3,1/4-1/3,2,2-4,2-8,2.5-3.1,2.5-5.5,3-15,3-5,4-6,4-7,7-9,acicular,acut,alyx,ame,apar,apically,apparently,bark,blade,brow,c.,calyx,concolorous,connivent,cordate,curved,deltate,difoliate,discolorous,distance,drying,eaf,eed,elongating,equal,extending,faint,flattened,free,fruiting,fully,geminat,gray-green,infructescence,lateral,lobe,longer,margin,mature,midpoint,midvein,moderately,narrow-oblong,nflorescence,older,one,open,opening,orolla,oung,pair,pale,per,perfec,pericarp,perpendicular,poricidal,porrect,portion,prickle,prickly,primary,ray,recurved,scar,sessile,shallow,side,simple,slender,sometimes,spaced,sparsely,spreading,stalk,stalked,stem,straight,tamen,tapering,terete,tertiary,thick-chartaceous,time,tip,trichome,tube,uit,unarme,unarmed,unit,upper,variously,vary,vein,venation,visible,weakly,wide,woody,yellow-green,ympodial	-3/4,abaxial,adaxial,colour,corolla,form,growth,height,inflorescence,na,number,ovary,plant,reproduction,seed,shape,spacing,staman,stigma,texture
767	wfo-0001031786	success	209	88	65	144	23	0.311	0.2-2.5,0.5-1.5,0.7-1,0.7-1.6,1-4,1.2-1.6,1.5-2.5,2-3,2-8,6-8,abaxially,acute,anther,apex,articulated,base,cell,chartaceous,cm,dark,deep,densely,diameter,elliptic,erect,evenly,filament,flattened-reniform,flower,fruit,glabrescent,glabrous,green,herb,lateral,leaf,length,lobed,mauve,membranous,mm,orange,outline,ovate,pale,pedicel,peduncle,petiole,pit,raised,red,red-brown,shiny,shrub,small,smooth,sparsely,spherical,stellate-pubescent,stigma,style,surface,white,yellow-orange,young	-5,.4,.5,/2,/3,0,0-2,0-20,0-3,0-5,0.1,0.1-0.4,0.2-0.3,0.25-0.5,0.7-4,0.8,0.8-1.2,1,1-2,1-3,1-6,1.5-1.9,1/3-1/2,2-13,2-7,2.5-3.5,3-4,3-5.5,4-5,5-7,5-merous,8-12,acut,almost,alyx,ame,apar,apart,apically,apparently,bark,becoming,berry,blade,branched,c.,calyx,clavat,concolorous,connivent,cuneate,curved,deltate,distance,drying,eaf,eed,elongating,equal,extending,eye,filiform,flattened,free,fruiting,gray,gray-brow,herbaceous,inconspicuous,infructescence,lobe,lon,long,longer,lower,margin,mature,maturity,midpoint,midvein,minute,naked,nflorescence,obtuse,older,one,open,orange-brown,orolla,oung,pair,pendulous,per,perfec,pericarp,plurifoliat,poricidal,porrect,portion,prickl,prickle,prickly,primary,ray,reflexed,rounded,ruit,scandent,scar,sessile,shorter,side,simple,slightly,sometimes,spaced,spreading,stalk,stalked,stellate,stem,straight,tamen,tapering,terete,tertiary,thick,time,tip,trichome,truncate,tube,unarmed,unit,variously,vary,vein,venation,visible,way,weakly,wide,woody,ympodial	abaxial,adaxial,clavate,colour,corolla,form,growth,height,history,inflorescence,life,number,ovary,perennial,plant,position,reproduction,seed,shape,spacing,staman,texture,unknown
768	wfo-0001031791	success	288	101	76	212	25	0.264	.3,.5,.9,0.5–1.0,0.7,2.0–11.0,2.8–3.3,3,3.0–3.5,33–54,6.2–8.5,8.0–11.0,alveolate,anther,apex,area,central,chartaceous,cm,corolla,developed,diameter,dry,erect,extra-axillary,filament,flattened-reniform,flattened-suborbicular,flower,fruit,glabrous,globose,green,immature,inflorescence,interpetalar,lanceolate,lateral,lavender,leaf,length,margin,material,maturing,mm,moderately,nearly,orange-red,oval,pedicel,peduncle,petiole,poorly,preserved,pubescent,shiny,shrub,simple,small,smooth,stellate,stigma,straight,style,subcoriaceous,surface,thrice-branched,tissue,tree,triangular,twice,well,white,yellow,yellow-tan,×	.08,.2,.4,0.04,0.2,0.3–0.5,0.3–0.6,0.3–0.7,0.4–0.6,0.5,0.5–0.6,0.7–0.8,0.7–1.0,1.1–1.4,1.3–1.8,1.5,1.5–1.9,1.5–2.3,1.5–3.0,1.6,1.6–2.2,1.7–2.3,1.8,1.9–2.2,1/3,11–14,11–15,13.0–30.0,15.0,2.0–2.5,2.6–3.4,2/3,3.0,4.6–5.4,4.9,4.9–7.4,5-merou,6.0,6.0–14.0,7.0–9.0,7–10,7–8,8–12,9.0–16.0,abaxially,across,acute,adaxiall,adaxially,adnate,alyx,anthesi,apical,apiculate,apparently,appearing,appressed,around,articulated,attachment,attenuate,axe,ba,backward,base,berry,blade,branch,broad,broad-based,brochidodromous,bud,calyx,capitat,channeled,congested,connivent,cordate,curved,dehiscence,densely,dentate,development,difoliate,distally,distinct,dorsally,drying,eaf,eed,either,emerging,endocarp,entir,entire,especially,fertile,filiform,first,flexed,fork,free,frui,geminat,glabrescent,glandular,gradually,hair,homostylous,inclined,increasing,internode,intersepalar,juic,juvenile,lamina,large,largest,light,like,line,lobe,lon,long,longer,lower,m.,major,mature,membranaceous,middle,midpoint,midrib,midvein,minor,minute,multangulate,nflorescence,notched,numerous,oblique,obscured,often,one,orolla,oung,ovoid,particularly,persisting,point,pore,porrect,porrect-stellate,portion,potentially,prickle,project,raised,ray,rigid,ripe,rounded,row,rugose,ruit,scarcely,scattered,sessile,short,shorter,side,single,sinus,slender,slightly,smaller,sometimes,somewhat,sparsely,splitting,stamen,stellae,stellate-pubescen,stem,stipe,stipitate,suture,tamen,tardily,time,tip,totally,translucent,truncate,tube,two,ud,unarmed,undulate,various,vary,vein,wavy,weakly,wide,yellow-brown,ympodia,young,±90°at,±equal,±glabrous,±laterally	5-merous,abaxial,adaxial,arrangement,capitate,colour,form,growth,height,history,life,na,number,ovary,perennial,plant,position,rachi,reproduction,seed,shape,spacing,staman,texture,width
769	wfo-0001031793	success	188	91	66	122	25	0.351	-4,.5,1-2,1-8,1.5-4,10-15,15-20,2-3,40,5-merous,abundant,acuminate,aging,almost,anther,apex,articulated,base,black,branched,broadly,brown,brownish,capitate,cm,densely,diameter,elliptic,evident,extra-axillary,ferrugineous,filament,flattened,flower,forked,fruit,globose,inflorescence,interpetalar,leaf,long,minutely,mm,mucilaginous,orange-yellow,orbicular-ovate,pedicel,peduncle,petiole,rachi,reddish,scarcely,shrub,simple,small,stellate,stellate-pubescent,stigma,style,surface,tissue,tree,unbranched,white,yellow,yellow-brown	0,1,1-1.5,1-3,1.5-2,1/3,1/4,1/5,13-20,2-5,20,26,3-4,3-8,3/4,4,7,8-11,absent,accrescent,acumen,acute,adult,alyx,apparently,armed,aspect,axe,ba,berry,bilobe,blade,branche,broad,calyx,central,chartaceous,cuneate,cut,difoliate,distal,eaf,eed,elongatin,erec,erect,extreme,fruiting,geminat,general,glandular,hair,homostylou,larger,linear,lobe,lobing,lon,lower,main,many,margin,maturing,midpoint,midrib,mostly,nflorescence,oblique,oblong-lanceolate,obtuse,often,older,orolla,ovate,per,perfect,pore,porocidal,porrect,prickle,principal,pubescent,reduced,reticulation,rounded,ruit,rusty,scattered,sessile,shallow,side,similar,single,sinus,size,smaller,sparsely,stellate-pubescen,stem,stipitate,stout,tall,tamen,tem,testa,thickened,tip,triangular,triangular-acuminat,trichome,tube,unarmed,unit,upward,usually,uvenile,vary,way,well-developed,woody,x,ympodial	abaxial,adaxial,arrangement,bilobed,colour,corolla,form,growth,height,history,homostylous,length,life,na,number,ovary,plant,position,reproduction,seed,shape,spacing,staman,texture,width
770	wfo-0001031795	success	234	92	71	163	21	0.303	0.5-2,1-1.2,1-3,1.5-2,1.5-4,10-12,2-6,2/3,3,5-merous,50,6-8,abaxial,acuminate,acute,adaxial,anther,apex,base,berry,capitate,cm,conical,densely,diameter,elliptic,filament,flattened,flower,globose,grayish,green,growth,irregularly,lateral,leaf,leaf-opposed,live,lobed,long,matte,minutely,mm,occasionally,ovate,pale,pedicel,peduncle,petiole,pitted,plant,pubescent,reniform,ripe,shape,shiny,shrub,slender,slightly,smooth,spaced,stellate-pubescent,stigma,style,surface,tan,thin,way,white,yellowish,½	..,.2,.5,0.5,0.5-1,1,1-1.3,1-4,1/3,10,100,2-2.5,2.5-3,3-4,4-,4-5,4-6,5,5-12,5-40+,5.5-,7-9,9-17,<,>,abaxially,absent,adaxiall,alf,almost,along,always,alyx,anthesi,apar,armed,around,articulated,bark,blade,branched,broad-based,broadly,brownish,c.,calyx,caudate,cell,clearly,connivent,curved,dark,deeply,denser,differing,difoliate,directed,discolorous,distally,dry,eaf,eed,entire,equal,evenly,free,fruiting,geminat,geminate,glabrescent,glabrous,gland-tipped,glandular,gra,infructescence,lamina,like,lobe,lon,long-stalked,longer,lower,major,many-branched,margin,membranous,midpoint,midrib,midvein,minor,mixture,much,multangulate,multiseriate,never,new,nflorescence,oblique,often,older,orolla,oung,outline,pair,papillat,pendant,per,perfec,pericarp,persistent,pore,poricidal,porrect,portion,prickle,prickly,primary,ray,reduced,reflexed,ruit,scar,scattered,sessile,shallowly,short,short-,short-stalked,simple,sinuate,size,somewhat,sparsely,spreading,stalk,stellate,stem,straigh,tamen,tapering,terete,testal,thicker,time,tip,toward,triangular,trichome,truncate,tube,unarme,unarmed,unicellular,unit,upward,usually,vary,vein,visible,wide,woody,ympodial,young	apart,colour,corolla,form,fruit,height,hermaphroditic,history,inflorescence,length,life,na,number,ovary,perennial,position,reproduction,seed,spacing,staman,texture
771	wfo-0001031829	success	138	64	39	99	25	0.283	.25,0.7-1,1-2,1.3-1.5,1.5-2,2-4,4-4.5,adaxial,anther,apex,capitate,cm,corolla,elliptic,filament,globose,green,growth,inflorescence,leaf,lobed,minutely,mm,opposite,ovary,papillose,pedicel,petiole,pubescent,shrub,simple,sparsely,stigma,style,surface,tapering,waxy,white,x	.5,0.5-2.1,1,1.5-2.5,1.5-3.5,1.5-4.5,3-5-flowered,3/4,4-8.5,7-10,abaxially,absent,acute,adaxially,along,anthesi,ape,apiculae,bae,bark,base,berry,branched,broadly,calyx,conical,crystalline,deflexed,densely,denser,dia,differing,difoliate,drying,eaf,edicel,eed,epidermi,erect,exserted,free,fruiting,geminat,glabrat,glabrous,greenish-brown,immature,known,large-celled,lateral,leathery,like,lobe,lon,long,lower,main,major,margin,minor,minute,nflorescence,occasionally,often,older,overlappin,packed,pair,papillo,planar,pore,poricidal,portion,quadrate,revolute,ruit,scar,shaped,size,soft,somewhat,stem,tall,tear-drop,thick,tip,trichome,tub,tube,tuft,ud,uniseriate,unit,vein,way,woody,yellowish,ympodial,young	3-5,abaxial,arrangement,colour,diameter,flower,form,fruit,height,history,length,life,na,number,peduncle,plant,position,rachi,reproduction,seed,shape,spacing,staman,texture,width
772	wfo-0001031832	success	232	107	83	149	24	0.358	0.1-0.3,0.2-1.5,0.3-0.8,0.3-3,0.7-1.5,0.7-2,1-12,1.2-1.6,2-3.6,2-6,3-6.5,4-20,5-21,9,abaxially,acuminate,adaxially,anther,apart,apex,becoming,brown,bullate,chartaceous,cm,conical,continued,corolla,dark,deltoid,diameter,due,filament,flower,fruit,glabrescent,globose,granular-tomentose,green,greenish,growth,honeycombed,lanceolate,lateral,leaf,length,mm,mostly,oblanceolate,obovoid,orbicular,pale,pedicel,peduncle,petiole,pitted,probably,pubescent,rachi,reniform,reticulate-punctate,ripe,rotate-stellate,rough,scabrous,shrub,simple,soon,sparingly,stellate-pubescent,stem,stigma,style,suborbicular,surface,terminal,tree,violet,white,x,yellow,yellowish,young	-8,.5-1,/50-1/10,0-150,0.2-0.6,0.7-1.6,0.8-1.2,1.1-2.4,1.2-2,1.2-2.5,1.3-4.2,1.5-4,1.7-4,1.8-4,1/2-3/4,14,2-4,2.5-6.5,2.8-4.8,3-7,3.5-7,4-7,5.5-10,7-10,8-25,accrescent,acute,ag,anthesi,apical-lateral,apice,apparently,articulated,attenuate,axe,axillary,ba,bark,basal,base,berry,blade,blister,blunt-tipped,branch,branched,brownish,bud,calyx,capitat,closely,connate,decurrent,dehiscing,directed,eaf,eed,entire,evident,exserted,extend,ferrugineous,few-rayed,fleshy,forming,free,fruiting,glabrescen,glabrous,hair,half,high,indument,inserted,introrse,lackin,large,line,lobe,lobed,long,long-,longer,longitudinal,lower,m.,main,margin,midvein,minute,mixed,multangulate,nearly,nflorescence,oblong,obtuse,occasionally,older,orolla,ovate,partly,perfect,persistent,plurifoliate,pore,porrect-stellat,porrect-stellate,pubescence,rather,ray,relatively,ruit,runk,sessile,short-,short-stalked,side,slit,smooth,sometimes,somewhat,spaced,sparse,splitting,stamen,stipitate-glandular,subcampanulate,suture,swelling,tamen,terete,testa,thick,thick-stalked,time,toward,translucent,tube,unarme,unarmed,unit,usually,vary,vein,way,weakly,whitish,wide,ympodial	20-150,abaxial,adaxial,arrangement,capitate,colour,form,height,history,inflorescence,life,na,number,ovary,perennial,plant,position,reproduction,seed,shape,spacing,sparing,staman,texture
773	wfo-0001031834	success	150	74	46	104	28	0.307	0.5,0.5-1,0.5-3,0.5-3.5,0.6-1.4,0.8-1,1.5,1.6-2,6-7,acuminate,anther,apex,cm,corolla,few-flowered,filament,flattened-reniform,fruit,glabrous,globose,green,greenish-yellow,leaf,less,lobed,minutely,mm,opposite,ovary,ovate,pale,papillose,pedicel,petiole,pitted,scabrous,shrub,simple,stigma,style,surface,tan,tapering,white,x,yellow	.5,0.8-1.3,0.9-1.4,1,1.5-4,1.9-6.5,2.9-7,2/3,6.5-14,accrescent,across,acute,anthesi,apar,apically,apiculate,appear,attenuate,base,berry,bi-cellular,borne,calyx,campanulate,covered,deciduou,deciduous,decurrent,deflexed,deltoid,depression,dia,difoliate,eaf,edicel,eed,expanded,eye,free,fruiting,geminat,glabrou,hook,hooked,incrassate,lamina,larger,leaving,like,lobe,lon,long,lower,major,margin,markedly,middle,minor,minute,mound-like,multicellular,naked,nflorescence,often,papillo,persistent,planar,pore,poricidal,portion,proximal,pubescent,ruit,scar,shaped,short,slender,slightly,small,soon,spaced,sparsely,speck,stem,straight,tall,tear-drop,tip,trichome,tube,tufted,ud,unevenly,uni-,uniseriate,unit,upper,usually,vein,way,widest,woody,ympodial,young	abaxial,adaxial,apart,arrangement,colour,diameter,flower,form,growth,height,history,inflorescence,length,life,na,number,peduncle,perennial,plant,position,rachi,reproduction,seed,shape,spacing,staman,texture,width
774	wfo-0001031839	success	138	96	58	80	38	0.42	1-1.4,1.2-1.5,1/3-2/3,2.5-3.5,7-10,8-15,across,anther,apically,armed,beneath,berry,blade,blue,blue-tinged,broadly,brown,calyx,cm,dark,deltoid,developing,extended,foveolate,fully,glabrous,green,herb,internodal,invested,lenticular,lobe,long,minutely,mm,olivaceous,otherwise,ovary,ovate,pale,perennial,petiole,pinnatifid,smooth,spherical,stellate-pentagonal,stellate-pubescent,stellate-tomentose,tawny,tightly,tube,twice,velvety-tomentose,weakly,white,whitish,yellow,zygomorphic	.5,1,2/3,3-7,4-8,6-15,8-14-rayed,9-12,9-13-flowere,accrescent,along,alyx,annually,anthesi,arcuate,base,becoming,bristly,broad,campanulate,cauline,confluent,da,dark-based,densely,density,dia,difoliate,divided,dry,eaf,eed,emerging,erect,externall,geminat,ligneous,linear-lanceolate,lon,long-stalked,long-stipitate,main,maturity,nearly,nflorescence,often,orolla,persisting,prickle,prickly,pubescent,purple,root,rounded,ruit,several,short,slende,somewhat,splitting,spreading,stella,stellae,stellate-tomento,stem,stipitate,subulate,tamen,throughout,tigma,tub,tyle,ultimate,unexpande,unit,usually,varying,vein,year,ympodial	9-13-flowered,abaxial,adaxial,apex,arrangement,colour,corolla,diameter,externally,filament,flower,form,fruit,growth,height,history,inflorescence,leaf,length,life,na,number,pedicel,peduncle,plant,position,rachi,reproduction,seed,shape,spacing,staman,stigma,style,surface,texture,unexpanded,width
775	wfo-0001031842	success	161	104	76	85	28	0.472	.4,.5,0.1-0.5,0.5-2,0.6-1,0.7-1,1,1-1.8,2-10,2.5-3,3-8,3/4,4.5-6,acute,anther,apart,apex,base,beneath,bi-lobed,brown,calyx,capitate,cm,corolla,cup-shaped,dark,deeply,dia,dry,elliptic,filament,flattened-reniform,glabrous,globose,green,later,lateral,leaf,leaf-opposed,lobed,long,minutely,mm,near,new,often,opposite,ovary,overtopping,papillose,pedicel,petiole,pitted,shiny,shoot,shrub,simple,slender,specimen,stigma,strongly,style,surface,tapering,terminal,tree,trichome,tube,tuft,uniseriate,way,white,woody,x,yellowish	.1,.75,0.5-1,1-1.5,1-3.5,1.5-2,10-12,10-20,10-30-flowered,2-3,2.5-6,7-9,9-15,anthesi,attenuate,axil,ba,bark,bearing,beginning,berry,cusp,decurrent,deflexed,densely,differing,difoliate,eaf,edicel,eed,ellipsoid,exserte,exsertion,free,fruiting,geminat,incrassate,inflorescenc,irregularly,lobe,lon,lower,main,major,margin,middle,minor,nflorescence,older,one,onto,pair,pale,paler,papillo,pore,poricidal,portion,prominent,pubescent,quadrate,reddish,reddish-resinous,reflexed,ruit,scar,shaped,size,somewhat,soon,spaced,sparsely,stem,straight,tall,tear-drop,time,tip,ud,unit,vein,widest,yellowish-whit,ympodial,young	10-30,abaxial,adaxial,arrangement,colour,diameter,flower,form,fruit,growth,height,history,inflorescence,length,life,na,number,peduncle,plant,position,rachi,reproduction,seed,shape,spacing,staman,texture,width
776	wfo-0001031843	success	245	93	73	172	20	0.298	.5,0-4,0.6-1.2,1-7,1.2-2,1.2-2.2,1.5-2,3-4,3-7,5-12,6-9,acuminate,almost,anther,apex,apically,base,berry,black,branch,brown,capitate,caudate,cm,conical,corolla,dark,deeply,diameter,dilated,discoid,distributed,drying,dull,evenly,filament,finely,flower,glabrous,green,honeycomb,largely,leaf,length,liana,lobed,long,main,mm,oblong,obovate,orange-brown,orange-yellow,pattern,pedicel,peduncle,petiole,pitted,pubescent,rachi,reddish,seed,shrub,side,slender,sparsely,spheroidal,stigma,style,surface,terminal,violet,x	.2,.3,.6,0.2-2,0.4-0.5,0.5-1,0.5-1.5,0.7-1.2,0.7-2,0.8-2,1-2,1.5,1.8-2.5,1/6-1/4,1mm,2-3,2-4,2.5,4-12,45-60°,5-10,abaxially,accrescent,adaxially,age,along,always,alyx,anthesi,apar,apice,apparently,appressed,around,articulated,attenuate,bark,basal,becoming,branched,branching,broadly,calyx,canaliculate,clearly,collapsing,completely,cupular,curved,cuspidate,delineated,deltoid,dendritic,density,detaching,discolorous,domatia,eaf,eed,ellipsoi,entire,equal,erect,even,eye,fertilisation,fine,flat,flexuous,forming,free,fruiting,hand,inner,leave,len,lengthening,lignified,like,lobe,longitudinally,loop,looping,lower,m.,margin,midvein,much,multiseriate,naked,network,never,nflorescence,nther,oblique,obscure,older,opening,orange,orolla,outline,ovate,pair,papillo,part,partly,pendulous,perfec,pericarp,pit,plurifoliat,pore,poricidal,portion,present,primary,prominent,pronounced,protruding,raised,rarely,recurve,red,reveal,ribbed,ridged,rounded,ruit,scar,see,shallowly,shiny,shortly,simple,sinus,slightly,small,smaller,smooth,sometimes,soon,spreading,stem,straight,strongly,stump,surfac,tearing,tertiary,thick-chartaceous,thickened,thin,tip,trichome,tube,tuft,twice,ud,unarmed,unit,variable,vary,vein,venation,visible,weakly,white,wide,wider,without,ympodial,young	abaxial,adaxial,arrangement,colour,form,fruit,growth,height,inflorescence,na,number,ovary,papillose,plant,position,reproduction,shape,spacing,staman,texture
777	wfo-0001031852	success	155	82	55	100	27	0.355	0.1-1,1-4,1-4.2,1-9,1.4-3,12-35,3-9,4-6,7-,9-11,acuminate,acute,apex,articulate,branched,cm,conical,corolla,cyme,diameter,dichasial,dichasially,distal,ebracteate,elliptic-lanceolate,filament,flower,green,green-white,half,herbaceous,lanceolate,leaf,light,mm,monochasial,mucilaginous,odd-pinnate,ovoid,pedicel,peduncle,perennial,petiole,plant,proximal,pubescent,rachi,seed,stellate,stigma,style,throughout,white,yellow,¼	-8,0.5-1.3,0.5-3,1-,1.3-2.5,1.5-3,2-3,2-5.5,2.6-9.5,3-4,3-6-foliat,3.5-10,4-,4-10,4-5,5-15,abaxially,abruptly,absen,acumen,adaxially,apical,apically,apiculate,attenuate,base,calyx,cell,connate,covering,decurrent,dehiscent,digestion,diminishing,dorsally,eaf,edge,eed,elliptic,emoval,enzyme,exceeding,flat,folded,forked,generally,globo,hair-like,honeycomb,interjected,introrse,lateral,leaflet,living,lobe,lon,long,lower,lunat,make,maturing,nflorescence,nther,oblique,oblong,often,orolla,ovate-elliptic,pair,pattern,perfect,plan,poricidally,reveal,ruit,sessile,seudostipule,short,shortly,size,slit,specimen,stamen,straight,tal,tem,terminal,testal,thick,throughou,toward,tuber-bearing,typically,unit,vary,wall,white-crea,wide,without,ympodial	abaxial,adaxial,anther,arrangement,colour,form,fruit,globose,growth,height,history,inflorescence,length,life,na,number,ovary,position,reproduction,shape,spacing,staman,stem,surface,texture,white-cream,width
778	wfo-0001031864	success	140	82	53	87	29	0.379	.2,.25,.5,0.5-13.5,0.5-4,1-1.2,1-1.8,1-2,15-60,2-3,2.5-6,3-3.5,3-pinnate,5-15,abaxially,adaxially,anther,apex,cm,dense,diameter,emarginate,extra-axillary,filament,flower,fruit,glabrous,herbaceous,lenticular,mm,near,ovoid-deltoid,pedicel,peduncle,petiole,pubescence,pubescent,rachi,rotate,rounded,short,slender,stigma,style,surface,tip,trichome,truncate,unbranched,unknown,vine,violet,x	0.2-0.5,0.4-3,0.6-3.5,0.6-4,0.7-0.8,0.8-1,1-3,1-5,1-6.5,1.2-1.5,1.5,1.5-10,1.5-2.5,2,5-9,5-merous,7.5-8,accrescent,acuminate,acute,alyx,apar,apical,apiculate,axe,base,berry,blade,c.,calyx,capitat,chartaceous,ciliate,clavate,color,cuneate,deltoid,densely,eaf,eed,entire,fine,flattened,fleshy,fruiting,glabrou,hair,lateral,leaflet,like,lobe,lon,long,lower,m.,margin,middle,minutely,moderately,nflorescence,nternode,oblique,orolla,papillose,perfec,petiolule,plurifoliat,pointed,pubescenc,ruit,sand-punctate,scattered,slightly,spaced,sparsely,stem,tamen,tem,terrestria,tube,typical,unit,vary,vein,wide-diameter,widely,ympodial	abaxial,adaxial,apart,arrangement,capitate,colour,corolla,form,growth,height,history,inflorescence,leaf,length,life,na,number,ovary,perfect,plant,position,reproduction,seed,shape,spacing,staman,terrestrial,texture,width
779	wfo-0001031864	success	148	82	56	92	26	0.378	.2,.25,.5,0.5-13.5,0.5-4,1-1.2,1-1.8,1-2,1-3,15-60,2-3,2.5-6,3-3.5,3-pinnate,5-15,7.5-8,abaxially,adaxially,anther,apart,apex,blue-purple,ciliate,cm,color,dense,diameter,entire,extra-axillary,filament,fleshy,flower,fruit,glabrous,herb,lenticular,margin,mm,pedicel,peduncle,pubescence,pubescent,rachi,rotate,short,slender,somewhat,stigma,style,surface,terrestrial,trailing,unbranched,unknown,x,yellow	0.4-3,0.6-3.5,0.6-4,1-5,1-6.5,1.2-1.5,1.5,1.5-2.5,2,3-5-celled,5-9,5-merou,absent,accrescent,acuminate,acute,ag,alyx,apical,apiculate,apparently,articulated,axe,ba,basally,base,blade,calyx,capitat,center,clavate,connivent,cordate,cuneate,deltoid,densely,directed,distally,eaf,eed,emarginate,equal,etiole,fine,fruiting,geminat,hair,interjected,large,lateral,leaflet,lobe,long,longitudinal,lower,m.,minutely,near,nflorescence,node,oblique,oblong,opening,orolla,papillose,perfect,petiolule,plurifoliate,pore,pubescenc,rooting,rounded,scattered,simple,slightly,slit,spaced,sparsely,tamen,tem,thick,tip,truncate,tube,uniseriate,unit,vary,weakly,widely,wiry,woody,ympodial	abaxial,adaxial,arrangement,capitate,corolla,form,growth,height,history,inflorescence,leaf,length,life,na,number,ovary,petiole,plant,position,reproduction,seed,shape,spacing,staman,texture,width
780	wfo-0001031871	success	185	97	71	114	26	0.384	0.4-2,0.6-1.2,1-2,1.5-11,14-22,3-10,3-5,3.5-4,33-40,6-7,6.5-20.5,abaxially,acute,adaxially,anther,apex,axillary,brownish,bud,cell,chartaceous,clavate,cm,condition,corolla,covering,dark,deep,diameter,dot,drying,elliptic,filament,flower,forked,fresh,fruit,glabrous,globose,green,greenish,hair,hair-like,herb,lateral,medium,mm,odd-pinnate,ovate,ovoid,pedicel,peduncle,petiole,plant,ripe,rotate,rounded,seed,short,stigma,style,subglabrous,subtending,terminal,testal,thick,tiny,wall,white,whitish,yellow	1.4-2.1,1.5-2,1.5-2.1,1.6-2.7,2-3,2-4,2.9-6,3-4,36-44,4-6,4-7,5-merou,5.4-12.3,6-12,7-9,7.5-23,acumen,adaxiall,ag,alyx,apart,apparently,articulated,asymmetric,attenuate,axe,base,basiscopic,berry,blade,capitat,connivent,digestion,distal,dorsally,eaf,edge,eed,end,enzyme,erec,exceeding,flat,folded,geminat,generally,glabrou,green-white,hal,half,high,homostylous,honeycomb-shaped,interjected,lanceolate,leaflet,lengthening,linear,living,lobe,long,lower,make,mottled,mucilaginous,narrowly,nflorescence,one,orbicular,orolla,pair,perfect,petiolulate,placed,plurifoliate,pore,poricidal,pubescent,purple,removed,round,ruit,sessile,seudostipule,side,size,slit,sometimes,spaced,specimen,stamen,stolo,straight,subequal,subglabrou,symmetric,tall,tamen,tem,throughout,tip,tissue,tri-,tube,tuber,typically,unit,usually,vary,wet,wide,winged,x,ympodial	abaxial,adaxial,arrangement,capitate,colour,form,growth,height,history,inflorescence,leaf,length,life,number,ovary,perennial,position,rachi,reproduction,shape,spacing,staman,surface,texture,unknown,width
781	wfo-0001031874	success	197	102	76	121	26	0.386	-1.2,-7,0.2,0.2–0.8,0.5-1,0.5-1.5,0.5–0.9,1-4,1.2,1.8–2.3,2-4,2-5,3–5,4.5-6,7–8,9–11,abaxially,adaxially,anther,apart,apex,base,bilobed,blue,broadly,chartaceous,ciliate,cm,diameter,elliptic,especially,extra-axillary,filament,flattened-reniform,flower,fruit,fully,glabrous,globose,green,herb,hermaphroditic,least,length,light,lobe,minutely,mm,near,nearly,numerous,orange,ovate,pedicel,peduncle,petiole,pitted,rachi,recurved,red,ripe,rotate-stellate,simple,slightly,sometimes,sparsely,stigma,style,surface,tip,violet,white,white-puberulent,x,yellow,young	-1.5,-3.5,-4,.5-1.2,0.4,0.6-1,1.2-1.8,1.3–1.4,1.4–1.5,1.5-,1.8,1/10,1/3,1/5,2,2-3,2-3.5,2-foliate,2–2.5,2–9-branched,3-8,3-lobed,3.5–11,5,5-merou,6–7,accrescent,acute,adaxiall,always,alyx,angulate,articulated,asymmetrically,axe,ba,barely,berr,bi-lobed,bifurcation,blade,branch,broad,calyx,capitat,completely,connivent,contact,covering,cylindrical,decumbent,dehiscent,downward,eaf,eed,erect,even,fruiting,geminat,generally,hair,hold,juic,lanceolate,lateral,level,line,lobed,long,long-attenuate,longitudinall,lower,lowermost,main,margin,mesocarp,midrib,nflorescence,node,oblong,obtuse,often,one,orolla,ovate-triangular,partially,passing,petiol,pore,prostrate,puberulent,pubescent,rarely,rooting,ruit,several,short,side,soil,somewhat,spaced,spreading,stem,swollen,tall,tamen,tem,terete,terminal,time,triangular,tube,unit,usually,vary,vein,way,well,wide,winged,ympodial	abaxial,adaxial,arrangement,capitate,colour,corolla,form,growth,height,history,inflorescence,leaf,life,na,number,ovary,perennial,plant,position,reproduction,seed,shape,spacing,staman,texture,width
782	wfo-0001031876	success	140	72	42	98	30	0.3	.1,.5,0.5,1-1.6,1.5-2.2,anther,apex,base,bright,closely,cm,corolla,cup-like,elliptic,filament,flower,glabrous,globose,green,greenish-yellow,leaf,less,lightly,lobed,mm,nearly,oblanceolate,oblique,opposite,ovary,papillose,pedicel,petiole,shrub,simple,spaced,stigma,style,tapering,white,winged,yellow	0-flowered,0.8-1,1,1-1.5,1-4,27-35,3,5,9-15,?,across,acute,anthesi,apiculate,arc,arising,ba,bark,bearing,beneath,berry,calyx,convergence,corky,decurrent,dia,differing,eaf,edicel,eed,erect,family,free,fruiting,glabrou,granular,immature,irregularity,known,lateral,lenticellat,lobe,long,long-acuminate,lower,main,major,margin,melastomataceae,member,middle,minute,minutely,nflorescence,often,otherwise,overlappin,pair,parallel,perpendicular,persistent,point,pore,poricidal,portion,present,primary,prominent,raised,recurved,reflexed,resemble,ruit,running,scar,secondary,shaped,slender,slightly,stem,straight,styl,tall,tear-drop,time,tip,tube,ud,unifoliat,unit,vein,venation,wide,widest,woody,x,ympodial,young	0,abaxial,adaxial,arrangement,colour,diameter,form,fruit,growth,height,history,inflorescence,length,life,na,number,overlapping,peduncle,perennial,plant,position,rachi,reproduction,seed,shape,spacing,staman,surface,texture,unifoliate
783	wfo-0001031877	success	216	113	90	126	23	0.417	0.3-1,0.3-1.2,0.6-1.2,1-1.5,1-3,1-4,1.5-1.9,2,3-6,3.5-4,6-8,abaxially,adaxially,anther,apex,basally,base,bright,brown,capitate,cell,clavate,cm,corolla,deltate,diameter,ellipsoid,exposed,filament,flattened,flower,fruit,furcate,glabrous,globose,growth,hastate,irregularly,lateral,line,linear,lobed,long,mature,minutely,mm,nearly,occasionally,outline,pedicel,peduncle,petiole,pitted,plant,plump,prominently,pubescent,purple,red,reddish,reniform,ripe,scrambler,seed,semi-woody,shiny,silky,simple,slender,slightly,sometimes,somewhat,spaced,sparsely,stellate,stigma,style,surface,terminal,testal,thin,tinged,triangular,trichome,uniseriate,usually,vine,wall,white,x	+,.3,.5,0.2,0.3-,0.5,0.5-1,0.8-0.9,1,1-3.5,1.1-,1.5,1.5-2,1.8-5,2-,2.5,3-5,5-merou,6-10,abruptly,acuminate,acute,adaxiall,ag,along,alyx,angled,anthesi,apar,apparently,ark,articulated,ascending,basal,berry,calyx,conical,connivent,deep,deflexed,densely,distal,dried,eaf,eed,ellipsoidal,enlarged,entire,erect,especially,exserted,eye,fleshy,free,fruiting,green,greenish,ilament,impressed,internal,lamina,later,lengthening,like,lobe,long-acuminate,loosely,lower,margin,material,midvein,minute,new,nflorescence,often,older,orolla,pair,pale,papillate,papillo,parallel,part,per,perfect,pericarp,plurifoliat,pointing,pore,poricidal,portion,primary,pubescence,purplish,rectangular,reflexed,rest,rounded,ruit,scar,short,shorte,sinuate,sleeve,slit,spreadin,stem,strongly,subshru,tem,tip,truncate,tube,twinin,ud,uniformly,unit,upper,vary,vein,visible,weak,woody,yello,ympodial,young	abaxial,adaxial,apart,arrangement,colour,form,height,history,inflorescence,leaf,length,life,na,number,ovary,position,rachi,reproduction,shape,spacing,staman,texture,width
784	wfo-0001031880	success	180	113	95	85	18	0.528	.5,0.5-1,0.7-0.8,1,1-1.5,1.5,2.5-8,3-3.5,3-foliate,3-lobed,6-9,7-9,age,anther,anthesi,apart,berry,brown,calyx,capitate,cell,cm,conical,corolla,curved,dark,densely,diameter,ellipsoid,elliptic,enlarged,exerted,flattened,fleshy,flower,flush,fruit,fruiting,glabrous,glandular,globose,herb,inflorescence,internodal,lamina,leaf,lengthening,lobe,long,margin,markedly,mature,minutely,mm,nodding,orange,ovary,ovoid,papillose,pedicel,petiole,pitted,pore,poricidal,pubescent,rachi,red,reddish,reflexed,scar,shallowly,simple,slightly,slit,spreading,stem,stigma,straight,strongly,style,subshrub,surface,testal,thin,tip,triangular,trichome,uniseriate,upward,vein,wall,woody,x,yellow,–5	0.5-2,1-1.3,1-2,2,2-3,2-4,2-9,3-4-pluri-foliate,4,4-8,5,5-6,abaxially,acuminate,acute,adaxially,apex,basal,base,bearing,becoming,broadly,c.,ciliate,color,cordate,crenate,crowded,cup-shaped,eaf,edicel,eed,entire,erect,filament,free,gland,gland-tipped,green,growing,heteromorphic,hollow,horn,irregularly,less,lon,longest,lower,maturit,mid-length,middle,narrowly,near,nflorescence,ovate,pair,pale,papillo,peduncle,pericarp,plan,portion,primary,pubescen,purple,ruit,shortest,single,slender,sometimes,spaced,sparse,sparsely,terminal,toothed,truncate,tube,ud,unicellula,unit,unlobed,upper,widely,widest,ympodial	abaxial,adaxial,arrangement,bud,colour,form,growth,height,length,maturity,number,plant,position,seed,shape,spacing,texture,unicellular
785	wfo-0001031881	success	168	80	54	114	26	0.321	.5,0.5-0.7,1-1.3,1-1.5,1-7,1.2-6,1.5-2.5,3.5-4,3/4,5-6,anther,apex,base,beneath,brown,capitate,cm,corolla,dark,decurrent,densely,elliptic,filament,fruit,glabrous,globose,golden-puberulent,green,inflorescence,leaf,lightly,lobed,minutely,mm,obovate,opposite,ovary,ovoid-reniform,pedicel,petiole,pitted,pubescent,shape,shrub,small,sparsely,stigma,style,surface,tree,way,white,winged,x	0.1-0.5,0.2,0.2-0.6,0.4-1,0.5-1,1/3,10-12,10-30,2,2-9,3-19,7-14,absent,acute,along,anthesi,apar,apparent,attenuate,axil,ba,bark,branch,branched,broadly,bud,calyx,campanulate,constriction,deflexed,deltoid,dia,differing,difoliate,distal,dry,drying,eaf,edicel,eed,either,ellipsoid,erect,evenly,exserted,fleshy,free,fruiting,geminat,golden,golden-pubescent,greyish-brow,incrassate,inflorescenc,junction,lateral,like,lobe,lon,long,lower,main,major,margin,material,maturity,middle,midrib,minor,minute,nflorescence,occasionally,older,one,orbicular,pair,papillo,papillose,planar,pore,poricidal,portion,puberulen,puberulent,rest,rounded,ruit,scar,shaped,simple,size,slender,slightly,somewhat,soon,spaced,stem,straight,strong,tall,tapering,tear-drop,tip,trichome,tube,ud,uniseriate,unit,usually,vein,widest,woody,ympodial,young	abaxial,adaxial,apart,arrangement,colour,diameter,flower,form,growth,height,history,length,life,na,number,peduncle,perennial,plant,position,rachi,reproduction,seed,spacing,staman,texture,width
786	wfo-0001031886	success	169	74	50	119	24	0.296	-9,0.5-1,1-1.5,1-4,2-2.5,2-3,2-5,5-6,9-10,acuminate,anther,apex,axillary,bright,brown,capitate,cm,conical,corolla,diameter,elliptic,filament,flower,fruit,glabrous,green,greenish,lobed,minutely,mm,open-conical,ovary,ovoid-reniform,papillose,pedicel,petiole,pinnate,purple,rachi,rugose,seed,shape,shrub,simple,stigma,style,surface,white,woody,x	-1.2,-25,-4,.5,0,0.1,1.2-2.5,1.5-2,10-40,2,2-4,2.0-2.5,20-30,3-6,3.0,4,4-15,5-10,5-ridged,6-20,6-8,abaxially,abruptly,absent,adaxially,along,anthesi,anticlinal,arising,attenuate,axil,basal,base,beak,bearing,berry,broadly,bud,calyx,cell,clavat,commonly,completely,deltate,distinctly,dry,eaf,earl,edicel,eed,either,em,epidermal,equal,erec,exserted,fleshy,free,fruiting,half,irregular,lanceolate,lateral,le,leaflet,lobe,long,lower,margin,narrowed,near,nearly,nflorescence,noddin,node,oblique,occasionally,pair,papillae,papillate,per,petiolule,poricidal,portion,primary,projection,raised,reddish,reflexed,ripe,ruit,scar,scattered,similar,single,sinuous,smaller,smelling,somewhat,sparse,specimen,strongly,terminal,thickening,time,tip,triangular,trichome,tub,tube,ud,unifoliat,uniseriate,unit,usually,vein,wintergreen,without,ympodial	1,abaxial,adaxial,arrangement,colour,form,growth,height,history,inflorescence,leaf,length,life,na,nodding,number,peduncle,plant,position,reproduction,spacing,staman,texture,width
787	wfo-0001031895	success	160	92	67	93	25	0.419	1-1.5,1.5-3,2-2.5,2.5-3,3-10,3-8,3.5-6,4,5,6-7,anther,apex,base,beneath,berry,bluish,capitate,cm,completely,conical,corolla,dark,densely,diameter,elliptic,filament,fleshy,flower,glabrous,globose,green,growth,leaf-opposed,leafy,lobed,matte,minutely,mm,occasionally,once-branched,ovary,ovoid,pale,papillate,pedicel,peduncle,petiole,pitted,reniform,shiny,shoot,short,shrub,simple,stigma,stout,style,surface,tan,terminal,thin,tip,violet,way,white,x,¼-1/2	-1.5,0.5,0.5-1,0.5-2,1.5-2,1.5-6,3-4,4-5,4.5-16.5,5-6,5-8,6-9,acute,age,anthesi,apparently,articulating,attenuate,bark,blac,broadly,calyx,campanulate,cell,cup-shaped,deltate,drying,eaf,eed,ellipsoid,emarginated,enlarging,entire,erec,erect,exerted,exfoliating,expand,fragrant,free,fruiting,glabrou,immature,inflorescenc,intensely,irregular,leaving,lengthening,less,lobe,lower,margin,new,nflorescence,older,overlapping,pair,papillat,part,patch,peeling,peg,perfect,pericarp,planar,plurifoliat,pore,poricidal,portion,primary,reddish,revolute,ruit,scar,sinuate,slender,slightly,slit,small,somewhat,stem,straight,strongly,testal,thick,tree,tub,tube,ud,unit,vein,woody,ympodial	abaxial,adaxial,arrangement,colour,form,fruit,height,history,inflorescence,leaf,length,life,na,number,perennial,plant,position,rachi,reproduction,seed,shape,spacing,staman,texture,width
788	wfo-0001031896	success	196	98	74	122	24	0.378	0.5-1,0.5-2,1-1.5,1-10,1-2,1-3,10-20,10-20+,13,2-4.5,2-5,2-7,5,5-15,6-9,abaxially,acute,adaxially,anther,apart,apex,articulated,base,branched,brown,chartaceous,cm,contiguous,densely,diameter,elliptic,erect,extra-axillary,ferruginous,filament,flattened,flower,forked,fruit,glabrous,glandular-puberulent,globose,green,lanceolate,midvein,minutely,mm,moderately,nearly,orange,pedicel,peduncle,perfect,petiole,pitted,pubescent,rachi,shape,shrub,simple,small,spaced,sparsely,stellate,stellate-pubescent,stigma,style,surface,tree,unbranched,white,whitish,x,yellow	-1.5,0-1.2,0.1-0.6,0.3-0.5,0.3-0.7,0.3-0.8,0.3-1,0.4-0.8,1-1.2,1.5,15-20,2,2-2.5,2-3,3-30+,3-5,4-7,5-10,5-6,5-9,6-10,6-30+,7-10,9-18,accrescent,adaxiall,ample,apparently,armed,axe,ba,blade,broad-based,calyx,capitat,coarsely,connivent,conspicuously,covering,curved,cylindrical,denser,difoliate,directed,distall,eaf,eed,eglandular,entire,equal,ferruginous-pubescent,frequently,frui,fruiting,geminate,gland-tipped,glandular,hair,held,interpetalar,lateral,less,like,lobe,lon,long,long-acuminate,long-stalked,longer,lower,margin,midpoint,midrib,mixed,mostly,multangulate,nflorescence,oblique,occasional,occasionally,often,orolla,pinnatifid,pore,porrect,prickle,pubescence,ray,recurved,rounded,ruit,sessile,short,shorter,size,slightly,sometimes,stalk,stalked,ste,stellae,stem,straight,subcordate,tal,tamen,tapered,tem,time,tip,tissue,toothed,truncate,tube,unarmed,uniform,unit,uprigh,vary,vein,wide,ympodial	abaxial,adaxial,arrangement,capitate,colour,corolla,form,growth,height,history,inflorescence,leaf,length,life,na,number,ovary,plant,position,reproduction,seed,spacing,staman,texture
789	wfo-0001031897	success	264	103	84	180	19	0.318	.5,0.1-0.5,1-2,1.3-2,1.7-3,2-4,5-6,6-9,abaxial,adaxial,almost,along,anther,apex,apically,base,berry,black,brachyblast,branch,brown,cell,chartaceous,clavate,clustered,cm,conical,coriaceous,corolla,dark,diameter,dilated,distributed,dry,drying,dull,elliptic,enlarged,epiphyte,evenly,except,filament,flower,fruit,glabrous,green,inside,lanceolate,lateral,leaf,like,lobed,mauve,midvein,mm,obconical,oblong,orange-brown,outside,ovoid,papillose,pedicel,peduncle,petiole,plant,pubescent,reddish,ridged,short,shrub,slender,smooth,sometimes,sparsely,stigma,style,surface,terminal,thick,thin,weakly,white,x,young	.1,.8,0-1,0.15,0.2-0.4,0.4-1.1,0.5-1,0.5-3,0.6,0.8-1.5,0°,1,1-1.5,1-2.5,1.1,1.5,1.5-8,13,2/3,4-5,462.,8,abaxially,absent,accrescent,acute,adaxially,age,alyx,anthesi,apar,apparently,appearing,appendage,arising,aristate,articulated,attenuate,axillary,bark,bendy,boiteau,branched,calyx,clearly,concolorous,condensed,connate,covering,cuneate,curved,datum,dehiscing,delineated,dendritic,dense,densely,developed,developing,development,divided,domatia,dorsal,dorsifixed,eaf,earliest,ed,entire,equal,erect,even,extending,eye,faint,filiform,fine,foliaceous,free,fruiting,grey,hair,immature,indistinc,inner,known,lamina,larger,least,lengthening,light,linear,lobe,long,longitudinal,longitudinally,looped,lower,m.,main,margi,margin,membranous,minute,minutely,multicellular,multiseriate,naked,never,nflorescence,nther,oblon,obtuse,occasional,occasionally,one,orange,orolla,ovate,overlapping,pair,part,partly,pendulous,perfec,pericarp,persisting,plurifoliat,pointed,pore,poricidal,portion,primary,prominent,pronounced,protruding,raised,rarely,reach,revolute,ribbed,ridge,ruit,scar,secondary,see,seen,shoot,side,simple,sinus,slightly,smaller,smoot,sparse,stem,stump,subulate,sunk,tearing,terete,tertiary,tip,toward,trichome,tube,ud,unarmed,unbranched,unicellular,unit,usually,vary,vein,venation,visible,well-developed,wide,winged,wrinkle,ympodial	arrangement,colour,form,growth,height,inflorescence,length,na,number,ovary,position,rachi,reproduction,seed,shape,spacing,staman,texture,width
790	wfo-0001031908	success	213	103	79	134	24	0.371	0-22,0-25,0.4-1.4,1-10,1-2,10-35,2-6,3-8,5-11,9-13,abaxially,adaxially,anther,apex,axillary,band,blue,broadly,brownish,bud,cell,cm,condition,corolla,covering,dark,densely,diameter,drying,dull,elliptic,elliptic-lanceolate,filament,flower,forked,fresh,fruit,glabrous,globose,green,greenish,hair-like,herb,lateral,leaf,lilac,medium,minutely,mm,nearly,odd-pinnate,ovate,ovoid,pedicel,peduncle,petiole,pink,plant,puberulent,pubescent,purple,red-purple,rotate,rotate-pentagonal,seed,shiny,spot,stigma,style,subtending,surface,terminal,testal,thick,tinged,wall,white,whitish,yellow	0-45,0-9,1-4,1-5.5,1-8,1.5-5.5,3-5,3.5-9,4-25,5,5-13,5-19,5-merou,7,8-22,absent-10,acumen,acuminate,acute,ag,almost,along,alyx,apart,apparently,approximately,articulated,ascending,attenuate,auriculate,axe,base,berry,blade,capitat,chartaceous,ciliate,color,connivent,cordate,cuneate,decreasing,decumbent,digestion,distal,dorsally,eaf,edge,eed,enzyme,erect,especially,exceeding,falcate,flat,folded,geminat,generally,glabrou,green-white,hair,half,homostylous,honeycomb-shaped,interjected,lanceolate,leaflet,lengthening,like,living,lobe,long,lower,make,margin,membranous,middle,midrib,mottle,mucilaginous,nflorescence,oblique,often,orolla,pair,papillose,perfect,petiolulate,plurifoliate,pore,poricidal,prominent,prostrat,rarely,removed,ripe,rounded,ruit,secondary,semi-elliptic,semi-erect,sessile,seudostipule,short,shortly,size,slightly,slit,spaced,specimen,stamen,star,ste,stem,stippled,straight,tall,tamen,tem,thir,throughout,tip,tri-,truncate,tube,uniform,unit,unwinged,usually,vary,wet,wing,x,ympodial	abaxial,adaxial,arrangement,capitate,colour,form,growth,height,history,inflorescence,length,life,na,number,ovary,perennial,position,rachi,reproduction,shape,spacing,staman,texture,width
791	wfo-0001032157	success	136	70	42	94	28	0.309	.5,0.6-1,0.75-1,1-3,2-3,7-9,acute,anther,apart,apex,bi-lobed,cm,corolla,crystalline,elliptic,filament,glabrous,globose,golden,green,leaf,lobed,minutely,mm,opposite,ovary,ovoid-reniform,paler,pedicel,petiole,pitted,plant,rounded,shrub,simple,stigma,style,surface,tapering,white,x,yellowish	.75,0.25,0.5-1,1.9-2.2,2-5,2.2,3-6,5-15-flowered,5-8,5-9,9-17,anthesi,bark,base,becoming,beginning,beneath,berry,caly,calyx,completely,decurrent,deflexed,deltoid,dia,differing,difoliate,dry,eaf,edicel,eed,evenly,exserted,free,frui,fruiting,geminat,glabrou,incrassate,inflorescenc,lateral,less,live,living,lobe,lon,long,longitudinal,lower,main,major,margin,middle,minor,nearly,nflorescence,obscure,older,one,pair,papillo,papillose,peeling,persistent,pore,poricidal,portion,raised,reddish,reflexed,ruit,scar,shaped,shiny,size,slender,slightly,soon,spaced,stem,straight,strip,tall,tear-drop,tip,translucen,tube,ud,unit,vein,widest,woody,ympodial,young	5-15,abaxial,adaxial,arrangement,colour,diameter,flower,form,fruit,growth,height,history,inflorescence,length,life,na,number,peduncle,perennial,position,rachi,reproduction,seed,shape,spacing,staman,texture,width
792	wfo-0001032161	success	146	84	56	90	28	0.384	.5,0.4-1.2,0.8-1,1-3,1.2-1.3,2-7,2.5-3,adaxially,anther,apex,area,base,closely,cm,corolla,densely,drying,elliptic,filament,filiform,glabrous,globose,green,inflorescence,internodal,leaf,lobed,merely,minutely,mm,mustard,nearly,opposite,ovary,ovoid-reniform,pale,papillose,pedicel,pericarp,petiole,pitted,plant,pubescent,shrub,simple,spaced,sparsely,stigma,style,sulcate,surface,tan,thin,white,yellow,yellowish	0.5-1,0.7-4,0.75-1,1-1.5,1-11,1.4-2,2-8-flowered,3.5-4,?,abaxially,acute,adaxiall,anthesi,apical,ba,bark,beneath,berry,branched,brownish-blac,calyx,color,conical,coriaceous,dark,deflexed,delicate,deltate,dendritic,dia,difoliate,eaf,edicel,eed,ellipsoid,exserted,free,fruiting,giving,golden,hanging,lamina,later,like,lobe,long,lower,many,margin,middle,minute,nflorescence,obovate,occasionally,older,overlappin,persistent,plurifoliate,pore,poricidal,portion,projection,quadrate,reflexed,rest,revolute,ruit,scar,shaped,shiny,shoot,short,stem,strongly,styl,tall,tear-drop,tip,trichome,tub,tube,ud,uniseriate,unit,usually,vein,widest,x,ympodial,young	2-8,abaxial,adaxial,arrangement,colour,diameter,flower,form,fruit,growth,height,history,length,life,na,number,overlapping,peduncle,perennial,position,rachi,reproduction,seed,shape,spacing,staman,texture,width
793	wfo-0001032165	success	197	72	48	149	24	0.244	0.25-0.5,1-1.2,1-2,1.5-4,2.5-3.5,3-6,5-6,5-7,abaxial,acute,adaxial,anther,apex,brown,capitate,closely,cm,corolla,dark,dull,elliptic,erect,filament,glabrous,globose,green,inflorescence,leaf,lobed,minutely,mm,obovate,ovary,ovoid-reniform,pedicel,petiole,pitted,plant,puberulent,shape,simple,spaced,stigma,style,surface,terminal,tree,white	.25,.5,0.1,0.1-0.3,0.3-1,0.75-1,1-1.5,10-25,2-2.5,3-4,3.5-8.5,4-6,5-15,5-30-flowered,5-9.5,8-9,along,anthesi,apparent,appearing,ba,bark,base,beginning,beneath,berry,broadly,bud,calyx,center,continued,cucullate,cup-shaped,deciduous,decurrent,deltoid,densely,denser,dia,differing,difoliate,distal,dry,due,eaf,edged,edicel,eed,ellipsoid,end,entire,even,expansion,exserted,exsertion,free,fruiting,geminat,golden,golden-puberulent,golden-pubescent,greyish-brown,immature,inflorescenc,later,lateral,less,like,live,lobe,lon,long,lower,main,major,margin,markedly,medial,middle,midrib,minor,minute,near,nearly,nflorescence,node,occasionally,older,once-furcate,one,onto,opposite,orbicular,overlapping,pair,pale,paler,papillo,papillose,planar,pore,poricidal,portion,presence,prominent,purplish,rather,rest,ridge,ripe,rounded,ruit,scar,shaepd,single,size,slender,slightly,slow,small,smoot,specimen,stem,stout,straight,stripe,strongly,swollen,tall,tapering,tear-drop,thickened,time,tinged,tip,trichome,tub,tube,ud,uniseriate,unit,vein,widest,winged,woody,x,yellowish,ympodial,young	5-30,arrangement,colour,diameter,flower,form,fruit,growth,height,history,length,life,na,number,peduncle,perennial,position,rachi,reproduction,seed,spacing,staman,texture,width
794	wfo-0001032167	success	163	82	59	104	23	0.362	0.5-1,0.5-2.5,1-2,1-2.5,1-5,12-20,2-7,2-foliate,4-6,5-15,7-10,absent,anther,apex,brown,cell,chartaceous,cm,diameter,dm,drying,elliptic,elliptic-ovoid,filament,flower,forming,fruit,glabrous,globose,growth,herb,immature,maturing,membranaceous,mm,moderately,nearly,netlike,pedicel,peduncle,petiole,projection,pubescent,purple,rachi,raised,rotate,seed,semitransparent,sparsely,staman,stigma,style,surface,twisted,wall,white,x,yellow	.5,0.5-1.5,0.75-3,1,1-2-celled,1-3,1-7,1.5,10-20,10-35,2-4,3-6,3-7,4-10,abaxially,abundant,acute,adaxiall,adaxially,along,appressed,axe,base,berry,blade,calyx,ciliate,closely,common,connected,cordate,curved,decurrent,dehiscing,dense,densely,denser,eaf,eed,emarginat,entire,explosively,few-,flat,flattened,frui,geminat,geniculate,growt,hair,held,interpetalar,larger,linear-lanceolate,lobe,long,longer,lower,lowermost,lying,many-branched,margin,maturit,mesocarp,near,new,nfloresence,notch,oblong,obtuse,often,older,one-celled,orolla,per,placenta,pressure,pubescen,rounded,ruit,shorter,slightly,small,smaller,sometimes,stamen,straight,tal,tamen,tem,tissue,triangular,tube,two-celled,unbranched,unit,upper,usually,vary,vein,watery,wid,woody,ympodial	abaxial,adaxial,arrangement,colour,corolla,form,height,history,inflorescence,leaf,length,life,na,number,ovary,perennial,plant,position,reproduction,shape,spacing,texture,width
795	wfo-0001032176	success	177	77	51	126	26	0.288	.5,0.5-0.7,0.8-6,1-10,1.5-2.5,100,3-4,6,6-10,7,anther,apart,apex,axillary,base,cm,conical,corolla,densely,diameter,elliptic,filament,filiform,flower,green,greenish,grey-brown,greyish,herb,leaf,lobed,long,minutely,mm,nearly,obtuse,ovary,ovoid-reniform,pale,papillose,pedicel,petiole,pinnate,pubescent,rachi,rounded,seed,sparsely,stigma,style,white	0,0.42,0.5,0.5-0.75,0.5-1,0.8-1,1-1.2,1.5-1.6,1.5-6,1/2,2-3,2.5-10,3-15,3-3.5,3-7,5-6-celled,adaxially,adhering,along,anthesi,apical,arising,attaining,attenuate,axil,basal,beak,becoming,berry,branched,calyx,capitat,cateniform,cell,containing,copiously,creeping,cucullate,denser,drying,eaf,edicel,eed,ellipsoid,epidermal,equal,especially,exserted,fallen,free,fruiting,glabrous,globose,hangin,inflorescenc,lateral,leaflet,lengt,lengthening,like,lobe,log,long-papillose,lower,margin,minute,nflorescence,nodding,node,obovate,occasionally,often,onto,open,pair,per,petiolule,pore,poricidal,portion,projection,quadrate,reflexed,rest,rooting,ruit,scar,separate,simple,single,sinuous,size,slightly,slit,smaller,somewhat,soon,spaced,stem,strait,strongly,tem,terminal,thickening,tightly,time,tip,tree,trichome,truncate,trunk,tub,tube,ud,ultimate,unevenly,unifoliat,uniseriate,unit,vein,wall,whit,winged,without,x,ympodial	abaxial,adaxial,arrangement,capitate,colour,form,fruit,growth,height,history,inflorescence,length,life,na,number,peduncle,perennial,plant,position,reproduction,shape,spacing,staman,surface,texture,width
796	wfo-0001032183	success	162	79	53	109	26	0.327	0.3-0.6,0.7-1.4,1-3,3.5-4.5,5-9,5.5-7,7-9,absent,adaxially,anther,apex,articulated,base,chartaceous,cm,contiguous,densely,diameter,erect,extra-axillary,flower,fruit,glabrous,gland-tipped,globose,green,hair,inflorescence,lanceolate,length,mm,nearly,ovate,pale,pedicel,peduncle,perennial,petiole,pubescent,purple,rachi,red,rhizomatous,rotate-stellate,sessile,short,shrub,simple,stellate-pubescent,stigma,style,white,yellow	%,0-0.1,0-1.5,0.1-0.2,0.2-0.8,0.25-0.4,0.4-0.5,0.4-0.6,0.4-0.8,0.4-4,0.5-1,0.5-1.5,0.6-0.9,0.9-1,1-2,1.1-2.3,1.5-1.9,16-23,2-foliate,2.4-2.7,2.7-3.6,4-,4-6,4.5-7,5-merou,7-12,7-8,8-9,abaxially,absen,accrescent,across,acute,adaxiall,alyx,apart,axe,ba,blade,calyx,capitat,confined,cuneate,cylindrical,directed,distall,distally,distributed,eaf,eed,eglandular,elliptic,entire,exceeding,finger,fruiting,geminat,glaberous,grey,homostylous,juicy,lamina,lateral,lobe,long,lower,margin,markedly,mature,mesocarp,mid-point,midpoint,midrib,minute,nflorescence,oblique,obtuse,orolla,part,per,perfect,pore,porrect,prickle,pseudo-umbellate,ray,ruit,solitary,spaced,sparsely,stalk,stellae,succulen,tal,tamen,tem,thick,thicker,throughout,time,tube,unarme,unarmed,unbranched,unit,vary,wide,x,ympodial	abaxial,adaxial,arrangement,capitate,colour,corolla,filament,form,growth,height,history,leaf,life,na,number,ovary,plant,position,reproduction,seed,shape,spacing,staman,surface,texture,width
797	wfo-0001032187	success	139	94	63	76	31	0.453	-11,-4.2,-9,0.5,0.5-,0.5–1,0.6–1.3,1.1–3.2,1.8–2,2–9,3.1–3.5,5-merous,5–7,7–11,acuminate,acute,anther,apex,appressed,aromatic,berry,brown,brownish,cm,corolla,cyme,dull,eglandular,elliptic,erect,filament,flowered,forked,glabrescent,globose,green,hair,herb,leaf,light,mature,mm,obovate,occasionally,ovate,pedicel,peduncle,persistent,petiole,plant,purple,rarely,simple,soft,stage,stellate,style,sub-glabrous,texture,tinged,yellow,yellowish,±	-2.1,-4,-5,0.1–1.4,1.3–1.8,1.6–2.1,1.8–2.8,100,1–1.7,22,24.6–26.3,3–3.2,3–4,9,adherent,alyx,angular,ape,base,blade,branch,broadly,changing,consisting,dark,di-foliate,dia,eaf,eed,entire,equal,fully,geminat,granule,hite,hooked,hydrated,lobe,long,lower,many,margin,marked,nflorescence,numerous,penden,pentagonal,per,perfec,petiolate,pollen,predominantly,presen,protruding,ridge,ruit,running,sclerotic,short,small,sometimes,sparse,spreading,stem,straight,tooth,triangular,truncate,unit,well,widest,wing,ympodial,±1,µm,×	abaxial,adaxial,arrangement,colour,diameter,flower,form,fruit,growth,height,history,inflorescence,length,life,na,number,ovary,pendent,perennial,perfect,position,rachi,reproduction,seed,shape,spacing,staman,stigma,surface,white,width
798	wfo-0001032190	success	230	98	73	157	25	0.317	-1,-3.4,0-0.6,0.2-0.3,0.4-1.5,0.5-3,0.6-1.5,1-1.5,1-6,1.8-3,2-6,3-21,4-5,5-22,abaxially,acuminate,adaxially,anther,apart,apex,appressed-tomentose,articulated,attenuate,base,becoming,brown,bud,cm,conical,corolla,deltoid,diameter,ellipsoid,filament,flower,fruit,glabrous,globose,green,growth,honeycombed,lanceolate,lateral,leaf,length,mm,mostly,ovate,pedicel,peduncle,petiole,pubescent,rachi,reniform,reticulate-punctate,ripe,rotate-stellate,scabridulous,scabrous,shrub,simple,small,stigma,style,suborbicular,terminal,tree,truncate,white,whitish,x,yellow,yellowish	-6,.5-6,/100-1/20,0-80,0.7-1.1,0.8-1.1,1-1.7,1.2-2.1,1.2-3,1.3-5,1.5-3.5,1.5-4,1.6-4.4,1.9-4.5,1/2-3/4,10,2.5-10,2.5-4.3,2.7-6.8,3.5-8,4-6,4.5-7,6-11,6x,7-11,7-28,absent,accrescent,acute,ag,along,anthesi,apical-lateral,apparently,axe,axillary,ba,bark,berry,blade,blunt-tipped,branch,branched,calyx,campanulate,chartaceous,closely,coarse-stalked,continued,coriaceous,decurrent,dehiscing,densely,due,eaf,eed,elliptic,entire,evident,exserted,extend,few-rayed,fleshy,free,fruiting,glabrescent,glabrou,granular-pubescent,hair,high,hirsute,inserted,introrse,large,line,lobe,lobed,long,long-,long-attenuate,long-stalked,longitudinal,lower,m.,magnification,main,margin,midvein,minute,mixed,moderately,multangulat,multangulate,multiseriate-stalked,near,nearly,nflorescence,oblanceolate,oblong,obtuse,occasional,occasionally,older,openly,orolla,ovat,overlapping,pale,partly,perfect,plurifoliate,pore,porrect-stellat,porrect-stellate,present,rarely,rather,relatively,ruit,runk,sessile,short-,short-stalked,side,slit,somewhat,spaced,sparse,sparsely,stamen,stelliform,stem,stipitate-glandular,strongly,subcapitat,subcoriaceous,suture,tamen,terete,testa,thick,thin-stalked,time,tomentose,touching,toward,tube,unarme,unarmed,unit,usually,vary,vein,way,wide,ympodial,young	20-80,abaxial,adaxial,arrangement,colour,form,height,history,inflorescence,life,na,number,ovary,perennial,plant,position,reproduction,seed,shape,spacing,staman,subcapitate,surface,texture,width
799	wfo-0001032206	success	216	90	65	151	25	0.301	-20,0.8–1.2,1.1–1.2,1.5–2.5,1/4–1/2,1–2.3,1–3,2.5–3.3,2–8,3.5–9,4.5–5.8,5-merous,5–6,6–15,acute,andromonoecious,anther,apart,apex,apparently,berry,cm,cream,dark,diameter,elliptic,filament,flattened-reniform,flower,fruit,glabrous,green,green-brown,lateral,leaf,length,lobed,long-styled,marking,maturity,mauve,midvein,mm,moderately,obtuse,orange-brown,pale,pedicel,peduncle,petiole,plant,purple,short-styled,shrub,smooth,sometimes,spherical,stellate,stellate-pubescent,style,surface,usually,white,yellow,young	-0.8,-2,-5,..,.2,.5,0,0.2,0.2–0.4,0.2–0.5,0.5–1,00–200,0–20,0–30,0–5,1,1.2–2.2,1.5–2,1/3,1/4–1/3,1/6,10–80,11–22,1–2,1–4,2.7–3.5,2–2.5,2–3,30–80,3–4,4–6,5–15,5–20,5–8,5–9,6–10,6–8,7–10,8–20,abaxially,accrescent,adaxially,alyx,apar,apically,approximately,armed,articulated,bark,base,blade,bluntly,branched,broad-deltate,brow,calyx,chartaceous,clearly,concolorous,connivent,covering,cuneate,curved,deltate,discolorous,distal,distance,drying,eaf,eed,equal,erect,extending,flattened,foliaceous,free,fruiting,functionally,gently,glabrescent,hermaphroditic,heterostylous,infructescence,lengt,lobe,lobing,long,longer,lowermost,mal,margin,mature,midpoint,nflorescence,often,older,one,open,orolla,ovate,ower,pair,pendent,pendulous,per,pericarp,plurifoliat,poricidal,porrect,portion,prickle,primary,rarely,ray,reflexed,scar,secondary,sessile,side,slender,spaced,sparsely,spreading,stalk,stalked,stem,stout,straight,tamen,tapering,tertiary,time,tip,toward,trichome,truncate,tube,uit,unarmed,ung,unit,variously,vary,vein,venation,visible,weakly,wide,woody,yellow-orange,ympodial	/,0.5–1.5,abaxial,adaxial,arrangement,colour,corolla,form,growth,height,history,inflorescence,life,na,number,ovary,perennial,position,reproduction,seed,shape,spacing,staman,stigma,texture
