	coreid	status	nwords_original	nwords_result	nwords_recovered	nwords_omitted	nwords_created	prop_recovered	common_words	original_only	result_only
0	wfo-0001025652	success	156	111	97	59	14	0.622	.3,.5,0.5-1,1,1-1.5,1.5-2,10-20,15-17,15-19,2-5,2-6,20-50,3-3.5,3-5,4,4-6,4-7,9-11,abruptly,acuminate,acute,anther,anthesi,apex,bark,base,bilobed,calyx,campanulate,cm,connate,corolla,decurrent,densely,elliptic,filament,fleshy,flower,furcate,glabrate,glabrous,green,greyish,growth,lateral,leaf,lobed,main,matte,minor,minutely,mm,narrowing,nearly,new,occasionally,opposite,ovary,ovoid-reniform,pair,pale,paler,papillose,parallel,pedicel,petiole,pinkish-grey,pitted,planar,plant,pore,poricidal,red-papillose,shape,shaped,shiny,shrub,simple,size,small,stem,stigma,strongly,style,surface,tan,tear-drop,tightly,tip,tree,tube,vein,white,wing,winged,x,young	2-3,3-5-flowered,appearing,blade,broad,closed,closely,completely,dia,differing,difoliate,dry,eaf,edicel,eed,emerge,envelope,free,fruit,geminat,greyi,growing,irregular,like,live,lobe,lon,long,lower,major,margin,middle,minute,nflorescence,older,one,onto,overlappin,ovoid,papillae,papillo,portion,rather,ry,scar,soon,spaced,specimen,straight,tall,tapering,tear,thick,thicker,ud,unit,wider,widest,ympodial	abaxial,adaxial,colour,connective,form,height,inflorescence,length,number,position,seed,texture,venation,width
1	wfo-0001025657	success	239	124	100	139	24	0.418	0.1-0.4,0.5-2.5,1-1.1,1-1.3,1-3,1.2-1.5,2-10,2-3.5,2/3,25-60,3-6,5-14,5-16,6-12,6-8,7-27,7-9,7-9.5,8.3-12,abaxially,accrescent,acute,anthesi,apart,apex,base,bluish,branch,branched,brown,bud,calyx,chartaceous,cm,conical,cordate,corolla,dark,deltoid,densely,diameter,dried,elliptic,entire,flower,fruit,fruiting,granular,green,hair,lanate-pubescent,lateral,leaf,length,long,main,margin,midrib,mm,narrowly,nearly,oblong,orbicular,ovate,pale,parted,pedicel,peduncle,persistently,petiole,plurifoliate,rachi,reticulate-punctate,ripe,scented,shrub,side,simple,soft,somewhat,stellate,stellate-pubescent,strongly,subcampanulate,suborbicular,surface,tan,tomentose,tomentose-pubescent,tree,unarmed,unit,vein,velutinous-pubescent,way,white,x,yellow,yellowish,young	-2,/3,0.2-0.4,1-1.6,1.3-2,1.5-1.8,1.7-1.9,12x,2.2-5.5,2.5-9.3,2.7-4.3,3-4,3-4.8,3.2-6,4-4.4,4-4.5,4-7,6.5-10,8-10.5,adaxially,ag,also,anther,apparently,appearing,ark,around,articulated,ascending,axe,axillary,ba,berry,blade,blunt-tipped,broadly,capitat,central,closely,cylindrical,dendritic-multangulat,dendritic-multangulate,dense,directed,distally,due,eaf,earl,edge,eed,especially,evident,exerted,expanded,exserted,farinose,few-rayed,filament,fleshy,free,glabrous,glandula,glandular,half,inserted,lanceolate,lengthening,light,lobe,lobed,long-stalked,longitudinal,lower,m.,magnification,minutely,mixed,multangulate,nflorescence,obtuse,occasional,often,older,open,orolla,ovat,ovate-lanceolate,overlapping,part,partly,perfect,persistent,pore,poricidal,porrect-stellate,present,pseudo-terminal,pubescence,pubescent,ray,reportedly,ruit,semi-ovate,sessile,short,short-,short-stalked,slightly,slit,spaced,splitting,stamen,stem,stigma,stipitate-glandular,stipitate-multangulate,style,subcoriaceous,suture,tall,tamen,terete,thick-stalked,thickened,thin-stalked,time,tip,tomentum,transparent,tube,two-third,ud,unarme,upper,usually,vary,weakly,wide,ympodial	abaxial,adaxial,arming,arrangement,bark,branching,colour,form,growth,height,inflorescence,lanation,lobing,number,plant,scent,seed,shape,size,spacing,structure,sympodial,texture,type
2	wfo-0001025669	invalid_json	216	124	98	118	26	0.454	'',.5,0-7,0.1-0.3,1,1-2,1-2.2,1-4,1.3-4.2,1.4-2.5,13-35,2-3,2-4,2.2-6,2.4-7,3-5,3-7,4-6,9-24.5,``,abaxially,absent,adaxially,anther,base,blade,blue,broadly,brownish,chartaceous,clavate,cm,condition,corolla,diameter,drying,end,filament,flower,fresh,fruit,glabrous,globose,green,greenish,hair,herb,homostylous,interjected,lanceolate,lateral,leaflet,lengthening,long,membranous,minute,minutely,mm,moderately,monochasium,mottled,obovate,odd-pinnate,one,orbicular,ovoid,pair,pedicel,peduncle,placed,plant,pore,poricidal,puberulent,pubescent,purple,rarely,ripe,scale-like,seed,size,slightly,slit,sometimes,stem,stigma,streaked,style,subglabrous,terminal,tinged,tip,tuber,typically,white,whitish,wide,x	0-1,0-5,0.8-2.4,1-10,1-3,1.6-4.4,2,2.2-6.5,5-merou,absen,acumen,acuminate,acute,ag,along,alyx,apart,apex,apparently,articulation,axe,berry,capitat,cell,ciliate,clearly,connivent,contracted,covering,cuneate,decurrent,digestion,discussion,distal,distinct,dorsally,eaf,edge,eed,elliptic,enzyme,erec,especially,exceeding,except,extra,flat,flowered,folded,forming,geminat,glabrou,greatly,green-white,hair-like,half,highly,honeycomb-shaped,larger,like,living,lobe,lower,make,margin,midrib,mucilaginous,multicellular,near,nflorescence,oblique,obtuse,often,orolla,ovate,perfect,petiole,petiolulate,petiolule,plurifoliate,proximal,reduced,removed,rosette,rotate,rounded,ruit,see,sessile,seudostipule,short,single,spaced,species,specimen,stamen,ste,stolo,straight,subequal,tall,tamen,tem,testal,thick,throughout,tri-,truncate,tube,unbranched,unequal,unit,unwinged,vary,wall,wet,yellow,ympodial	'extra,[,],age,arrangement,calyx,capitate,characteristic,colour,form,growth,height,inflorescence,leaf,length,ovary,placement,pseudostipule,shape,staman,stolon,texture,type,value,{,}
3	wfo-0001025697	success	181	143	115	66	28	0.635	-9,0-14,0.15-0.75,0.8-2,1-1.7,1-2,1-3,1.7-8.6,10-26,2-4,2-6,25-35,3-10,3-4,3-5,3-6,5.5-11.5,abaxially,acumen,acuminate,acute,adaxially,anther,apex,asymmetric,attenuate,base,basiscopic,blade,blue,brownish,cell,clavate,cm,condition,connivent,coriaceous,corolla,dark,decurrent,deep,diameter,digestion,distal,dorsally,drying,edge,elliptic,enzyme,filament,flat,flower,folded,forked,fresh,fruit,glabrescent,glabrous,globose,green,greenish,hair,half,herb,high,homostylous,honeycomb-shaped,interjected,lanceolate,lateral,leaf,leaflet,lengthening,light,lilac,lobe,medium,mm,odd-pinnate,ovate,ovoid,pair,pedicel,peduncle,pentagonal,perfect,petiole,plant,pore,poricidal,purple,rachi,removed,ripe,rotate,rounded,seed,sessile,short,side,slightly,slit,stigma,straight,stripe,style,terminal,testal,tip,tissue,tube,typically,wall,whitish,yellow	0.6-3.5,1.5-1.8,2-10.5,2-2.6,3.3-11,4-7.5,5-merou,6.5-13.5,adaxiall,ag,alyx,apart,apparently,articulated,axe,axillary,berry,bud,capitat,covering,decreasing,eaf,eed,erec,exceeding,geminat,generally,glabrou,green-white,hair-like,hal,linear,living,long,lower,make,mucilaginous,nflorescence,orbicular,orolla,petiolulate,plurifoliate,ruit,seudostipule,size,spaced,specimen,stamen,subequal,subglabrou,subtending,tall,tamen,tem,thick,throughout,toward,tri-,unit,unwinged,usually,vary,wet,wood,x,ympodial	abaxial,adaxial,age,arrangement,articulation,asymmetry,branching,calyx,capitate,colour,connivence,decurrency,form,growth,height,inflorescence,length,number,ovary,pseudostipule,shape,spacing,staman,stem,subglabrous,texture,type,woody
4	wfo-0001025699	success	181	123	107	74	16	0.591	.2,0.5,1,1-1.5,1-2,1-2.5,1-3,1.5-2,1/3,15-20,2,2-6,2cm,3-15,4-5,5-8,5-winged,8-9,absent,acute,almost,anther,anthesi,apart,apex,attenuate,bark,base,becoming,branching,brown,c.,calyx,capitate,cm,completely,conical,corolla,crystal,dark,darker,deltate,densely,dry,ellipsoid,elliptic,entire,exerted,filament,flower,fruiting,glabrous,globose,green,grey-brown,growth,immature,inflorescence,leaf,less,lobe,lobed,margin,markedly,midrib,minutely,mm,narrowly,new,nodding,older,ovary,pair,pale,papillose,pedicel,peduncle,petiole,poricidal,primary,red,reniform,reticulate-pitted,rounded,rounded-sagittate,sand,scar,simple,slightly,somewhat,stem,stigma,style,surface,tangled,time,tip,tree,trichome,tube,vein,way,white,white-spotted,x,young,Â½	.5,1.5,10,2-2.5,3-3.5,3-5.5,3-8,499,5.5-14,abaxially,adaxially,age,apparently,appearing,articulating,berry,campanulate,conspicuously,continuing,corrugate,cup-shaped,diameter,difoliate,dorsal,drying,eaf,eed,erect,face,fide,free,glabrou,included,inclusion,inflorescenc,irregularly,lanceolate,leaf-opposed,leafy,leaving,lengthening,lower,nflorescence,one,onto,oxalate,papillat,peg,penden,per,perfect,plurifoliate,pore,portion,reddish,ruit,shoot,short,slit,small,spaced,stearn,straight,strongly,thickened,triangular,ud,unit,wide,wing,winged,woody,yellow,ympodial	arrangement,articulation,bud,colour,corrugated,exertion,form,fruit,glabrousnes,length,papillate,seed,shape,size,spacing,texture
5	wfo-0001025700	success	189	112	90	99	22	0.476	0-16,0.30-2.0,0.5-2,0.7-2.7,0.8-2.6,1-3,1.5-2,10-40,10.5-12,2-7,2.5-4,3-8,3.5-10.5,4-5,5-15,5-20,5.3-17.5,5.5-18,5.5-8,9-31,abaxially,acumen,adaxially,anther,blade,brownish,cell,chartaceous,clavate,cm,condition,corolla,covering,diameter,dot,drying,filament,flower,forked,fresh,fruit,glabrescent,glabrous,globose,green,greenish,hair,hair-like,herb,homostylous,interjected,lanceolate,lateral,leaf,leaflet,lilac,lobe,long,medium,mm,narrowly,odd-pinnate,ovoid,pair,pentagonal,petiole,plant,pore,poricidal,purple,ripe,rotate-pentagonal,seed,short,size,sometimes,stigma,straight,style,terminal,testal,thick,tip,tube,unwinged,wall,white,whitish,winged,x	0.8-4,1-2,1.1-2.3,15-40,2-12,3-4,3.7-8.6,5-merou,acuman,acuminate,acute,ag,alyx,apex,apiculate,apparently,articulated,asymmetric,attenuate,axe,axillary,basal,base,basiscopic,berry,bud,capitat,connivent,considerably,decrease,decreasing,digestion,distal,dorsally,eaf,edge,eed,elliptic,enzyme,erec,exceeding,except,flat,folded,geminat,generally,glabrou,green-white,hal,half,high,honeycomb-shaped,larger,lengthening,light,linear,living,lower,make,mucilaginous,nflorescence,orbicular,orolla,ovate,par,pedicel,peduncle,perfect,petiolulate,plurifoliate,proximal,removed,rounded,ruit,sessile,seudostipule,side,slightly,slit,specimen,stamen,subequal,subglabrou,subtending,tall,tamen,tem,throughout,tissue,toward,tri-,typically,unit,usually,vary,wet,whose,yellow,ympodial	abaxial,adaxial,arrangement,branching,calyx,capitate,colour,form,growth,hairines,height,inflorescence,length,number,ovary,pseudostipule,shape,staman,stem,subglabrous,texture,winging
6	wfo-0001025704	success	248	110	91	157	19	0.367	-10,0,0.7-1,1.2-3,1/2-4/5,1/5,3-10,4-12,4.5-6.5,8-17,abaxial,abaxially,acute,adaxial,almost,anther,apex,auriculate,base,branched,calyx,chartaceous,cm,connivent,cordate,curved,densely,discolorous,drying,ellipsoid,elliptic,evenly,flattened,flattened-reniform,flower,fruit,fruiting,green,green-yellow,irregular,lateral,leaf,length,lobed,margin,maturity,mauve,mm,moderately,occasionally,often,orange,orange-brown,outline,ovate,pale,per,petiole,poricidal,prickle,prominent,rarely,red-green,reflexed,round,rounded,shape,shrub,small,sometimes,somewhat,spherical,stellate-pubescent,stem,straight,strongly,style,tapering,terminal,tip,tree,truncate,unbranched,upper,way,white,white-gray,yellow,yellow-green,yellowish,young	-2,-3,-5,/6,0-100,0-2,0-3.5,0-5,0.1,0.1-0.3,0.1-0.5,0.15-0.8,0.3-0.8,0.5-1.5,1,1-3.5,1-4,1-6,1.5-2,1.5-3.2,1.5-4.5,1.8-3.5,1/4-3/4,2,2-10,2-3,2-4.5,2-5,2-7,2.5-4.5,2.7-4,3-15,3-5,3-6,4-5,5-20,5-merous,6-12,6-15,8-12,8-15,age,alyx,andromonoecious,apar,apart,apically,apiculate,apparently,articulated,axe,ba,bark,berry,blade,broad-deltate,brow,cell,covering,deltate,development,diameter,distal,distance,eaf,eed,elongating,end,equal,erect,extending,filament,free,glabrescent,glabrous,gray,half,hermaphrodite,heterostylous,infructescence,less,lobe,lobing,long,long-styled,longer,lower,lowermost,mature,midpoint,midvein,multangulate,near,nflorescence,obtuse,older,one,open,orolla,oung,pair,pedicel,peduncle,pendulous,pericarp,pit,plant,plurifoliat,porrect,portion,prickl,prickly,primary,raised,ray,recurved,red-brown,retaining,ruit,scar,secondary,sessile,short-styled,shorter,side,slender,smooth,spaced,sparsely,spreading,stalk,stalked,staminat,stellate,stellate-pubescen,stout,surface,tamen,terete,tertiary,throughout,time,trichome,tube,unarmed,unit,variously,vary,vein,venation,visible,warty,wide,widening,woody,ympodial,Ã	50-100,branching,colour,corolla,form,growth,hair,inflorescence,na,number,orientation,ovary,position,present,seed,staman,texture,type,width
7	wfo-0001025729	success	177	107	90	87	17	0.508	.5,/4,0.25-0.5,0.7-1.2,1-1.5,1-5,1.1-1.5,1.75,2,4-5,4-8,9-17,abaxially,acute,adaxially,anther,anthesi,apex,apical,axil,bark,base,black,blackish,calyx,cm,corolla,cyathiform,deflexed,dia,diam,dirty,drying,elliptic,expanded,filament,flattened-reniform,fruiting,furcate,glabrous,globose,green,greenish-yellow,greyish-brown,lateral,leaf,like,live,lobed,long,main,mm,oblique,occasionally,opposite,ovary,pale,pedicel,petiole,pit,pitted,plant,pore,portion,ripening,rounded,shaped,shiny,short,simple,size,stem,stigma,stout,style,surface,tear-drop,tree,treelet,trichome,tube,tuft,uniseriate,usually,vein,way,white,woody,x,yellow	-20,1.2-1.8,1.5-2,2-3.5,20,3-6,5-50-flowered,6-8,7-8,abaxial,abrupt,along,apar,apiculate,appearing,basal,berry,branched,bright,bristly,bud,covered,covering,dark,deltoid,densely,denser,differing,difoliate,eaf,edicel,eed,enclosed,f,fleshy,free,geminat,gently,glabrou,growing,incrassate,lamina,lat,lobe,lon,lower,m.,mainly,major,margin,member,middle,minor,minute,minutely,nflorescence,often,older,one,overlapping,overtopping,pair,papillo,papillose,partially,poricidal,prominent,pubescent,quite,raised,reflexed,ruit,scar,sparsely,straight,tall,tapering,terminal,tip,touching,tub,ud,unit,widening,widest,ympodial,young	4-20,5-50,branching,colour,flower,form,fruit,growth,hair,height,inflorescence,length,number,position,seed,shape,texture
8	wfo-0001025749	success	217	86	65	152	21	0.3	0.2-1.5,0.3-1.5,0.8-0.9,1-13,2.5-6,5-20,abaxial,acute,adaxial,anther,apex,base,berry,branched,calyx,chartaceous,cm,cuneate,dark,densely,elongating,equal,flattened,flattened-reniform,flower,fruit,fruiting,glabrous,green-brown,lateral,leaf,length,lobed,margin,markedly,mauve,mm,moderately,narrow-deltate,orange-brown,orange-red,orbicular,ovate,pale,per,petiole,poricidal,prickle,rarely,red-brown,rounded,shrub,sometimes,sparsely,spherical,spreading,stellate-pubescent,straight,straw-yellow,style,tapering,tip,white,yellow-green,yellow-orange	-1,-12,.5,/5,0-10,0-3,0-5,0-6,0-8,0.1,0.1-0.2,0.1-0.3,0.1-0.4,0.2,0.4-0.7,0.5,0.5-0.8,0.5-0.9,0.5-1.3,0.5-3,0.6-4.5,1,1-10,1-2,1-3,1-6,1-8.5,1-9,1.5,1.5-2,1.5-2.5,1/4-1/3,1/5-1/2,2-10,2-2.5,2/3,3-20,3-5,4-8,5-,5-10,5-merous,6-8,abaxially,acuminat,adaxially,adnate,almost,alyx,apar,apart,apically,apparently,articulated,bark,blade,broad-deltate,concolorous,curved,diameter,difoliate,discolorous,distance,drying,dull,eaf,eed,erect,extending,filament,filiform,free,geminat,gently,glabrescent,gray,herbaceous,indistinct,infructescence,light,lobe,lon,long,long-ovate,longer,lower,magnification,mature,maturity,midpoint,midvein,narrow-ovate,nflorescence,oblong,obtuse,occasionally,older,one,open,orange-brow,orolla,oung,pair,pedicel,peduncle,pendulous,perfec,pericarp,porrect,portion,prickl,prickly,primary,procumbent,purple,ray,recurved,reduced,ruit,scar,sessile,shorter,side,smooth,spaced,stalk,stalked,stellate,stem,strongly,surface,tamen,terete,tertiary,time,toward,trichome,tube,unit,usually,variously,vary,vein,venation,visible,way,wide,without,yellow,yellowish,ympodial,Â½-2/	branching,colour,corolla,form,growth,height,heteromorphism,inflorescence,number,orientation,ovary,plant,pore,position,seed,shape,staman,symmetry,texture,type,zygomorphy
9	wfo-0001025754	success	164	108	79	85	29	0.482	-celled,.5,0.5-1,0.5-1.5,1-2,1-3,1.5,1.5-3,10-20,10-35,3-6,4,5-15,acuminate,acute,anther,apex,asymmetrical,base,berry,brown,center,chartaceous,ciliate,cm,cordate,cordiform,decumbent,decurrent,densely,dm,drying,edge,eglandular,entire,fine,flower,fruit,glabrous,globose,hair,herb,immature,leaf,lobe,margin,maturing,membranaceous,mm,moderately,much-branched,nearly,oblong,often,parallel,pedicel,per,petiole,pubescent,radiating,raised,ridge,rotate,running,semitransparent,shallow,slightly,solitary,sparsely,surface,triangular,truncate,tube,unbranched,upright,white,woody,x,yellow	0.1-0.2,1,1-3.5,1.5-4,2-4,2-5-celled,2-7,2-foliate,3-10,3-5,4-6,5-12,abaxially,absent,abundant,adaxiall,adaxially,along,axe,barely,beyond,blade,branch,calyx,connected,dehiscing,denser,diameter,dried,eaf,eed,emarginat,equal,erect,explosively,exserted,filament,flat,geminat,glandular,held,interpetalar,leaving,like,linear-lanceolate,long,lower,lying,main,material,maturit,mesocarp,mixed,nfloresence,notch,orolla,palmately,peduncle,penden,placenta,pressure,probably,pubescen,rachi,ruit,short,small,sometimes,stamen,stem,stigma,straight,style,swollen,tal,tamen,tem,tissue,unit,vary,vein,visible,watery,wid,ympodial	abaxial,adaxial,arrangement,articulation,bract,branching,colour,corolla,emarginate,form,geminate,growth,height,inflorescence,length,number,pattern,pendent,placement,plant,position,prickle,scale,seed,shape,symmetry,texture,trichome,type
10	wfo-0001025760	success	210	131	106	104	25	0.505	-10,-6,/3,0-0.5,0.1,0.15-0.3,0.2-0.35,0.3-1,0.4-0.8,0.45-0.9,0.5-2,0.8-1.8,1-1.8,1-2,1-4,1.5,1/5,2-2.5,2.1-3.5,2.3-4,2.5-10,3,3.5-17,3.5-9,5-18,abaxial,adaxial,almost,anther,apparently,articulated,bark,base,berry,black,calyx,chartaceous,cm,connivent,cream,cuneate,dark,diameter,dull,flattened-reniform,flower,fruit,fruiting,glabrescent,glabrous,green,hair,herb,leaf,length,lobe,lobed,long,margin,marking,maturity,membranous,midpoint,mm,moderately,orange,orange-brown,pale,pedicel,peduncle,per,petiole,poricidal,porrect,ray,red-brown,rounded,sessile,shape,shorter,shrub,side,sometimes,spherical,spreading,stalked,stellate-pubescent,stem,style,subentire,surface,tapering,terete,tip,trichome,unarmed,unbranched,upper,variously,way,weakly,white,wide,yellow,yellow-green,young	-12,-3,-5,.5,0-100,0.1-0.2,0.5-1.5,0.7-2.5,1,1-,1.5-2.5,1.5-4.5,1.5-5,1/4,1/4-1/2,1/4-1/3,2-3,2.5-8,2/3,3-6,5-10-merous,8-10,abaxially,acut,acute,alyx,annual,apar,apex,apically,blade,broad-deltate,brow,concolorous,cultivar,curved,deltate,difoliate,discolorous,distance,drying,eaf,eed,elliptic,elongating,equal,erect,extending,filament,free,geminat,geminate,gently,infructescence,lateral,lengt,longer,lower,mature,midvein,minute,nflorescence,often,older,one,open,orolla,oung,ovate,pair,pendulous,perennial,perfec,pericarp,portion,primary,recurved,reflexe,ruit,scar,simple,slender,smooth,spaced,stalk,stellate,stellate-pubescen,stout,straight,tamen,tertiary,thick-stalked,time,tube,unarme,unit,usually,various,vary,vein,venation,visible,woody,ympodial	20-100,8-12,armament,arming,articulation,branching,brown,colour,corolla,form,growth,height,inflorescence,number,ovary,perfect,plant,position,reflexed,seed,staman,symmetry,texture,type,width
11	wfo-0001025782	success	200	88	59	141	29	0.295	0.4-0.6,0.55-0.75,0.9-1.3,1.2-6,4-4.5,5-20,5-merous,abaxial,adaxial,andromonoecious,anther,base,berry,calyx,chartaceous,cm,cuneate,curved,dull,elliptic,elongating,equal,evenly,filament,flattened-reniform,flower,fruit,fruiting,gently,glabrous,green,hair,lateral,leaf,length,lobed,long,lower,margin,membranous,mm,orange-brown,pedicel,per,petiole,poricidal,prickle,shrub,sparsely,spherical,stellate-pubescent,stem,style,surface,tapering,trichome,unbranched,white,yellow	-2,.5,0-10,0-5,0.1-0.15,0.1-0.2,0.1-0.25,0.3-1,0.5-1,1,1-1.7,1-2,1-2.5,1-4,1.3-1.6,1.5-3,1/4-1/2,1/4-1/3,1/6,10-13,2-10,2-2.5,2-3,2-5,2-7,2.5-3.5,2/3-3/4,20,3-4,3-5,4,4.5-9,5-6.5,5-8,5.5-6,6-14,6-8,abaxially,acuminat,acuminate,also,alyx,apar,apart,apex,apically,apparently,articulated,bark,blade,brown,climbing,concolorous,conical,connivent,deltate,densely,diameter,difoliate,discolorous,distal,distance,drying,eaf,eed,elongated,extending,flattened,free,geminat,geminate,glabrescent,green-brown,hermaphrodite,heterostylous,infructescence,lengt,less,lobe,long-styled,longer,lowermost,mature,maturity,midpoint,midvein,minute,moderately,nflorescence,occasionally,older,one,open,orolla,oung,pair,peduncle,pendulous,pericarp,plant,porrect,portion,prickl,prickly,primary,ray,red-brow,reduced,ruit,scar,sessile,short-styled,shorter,side,simple,smooth,spaced,spreading,staminat,stellate,stout,straight,tamen,terete,tertiary,time,tip,toward,tube,unit,vary,vein,venation,visible,way,weakly,wide,woody,yellow-green,ympodial,young	articulation,bract,branching,breeding,colour,corolla,form,glabrousnes,growth,heteromorphism,inflorescence,insertion,na,needle-like,number,odour,orientation,ovary,placement,pore,position,seed,shape,staman,symmetry,system,texture,type,zygomorphy
12	wfo-0001025783	invalid_json	179	135	100	79	35	0.559	.5,0.5,0.5-1,0.5-1.5,0.8-3.5,1-1.2,1-1.5,1-3,1.8-2,2,2-3+,2-5,2-6.5,5,7-10,<,abaxially,acute,anther,anthesi,apart,apex,base,branching,brown,bud,c.,calyx,cluster,cm,coriaceous,corolla,dendritic,diameter,ellipsoid,elliptic,entire,expanded,exserted,flattened,fleshy,flexuous,flower,fruiting,glabrous,globose,greyish,growth,inserted,known,lateral,less,lobed,long,margin,minutely,mm,narrowly,new,number,obtuse,pale,pedicel,peduncle,petiole,pitted,pubescent,purple,reniform,revolute,ripe,sagittate,scar,shiny,shoot,short,shrub,simple,sleeve,slightly,sometimes,somewhat,sparse,sparsely,stellate,stem,strongly,surface,suture,terminal,thin,time,trichome,truncate,type,uniseriate,vine,violet,way,within	3-4,5-merou,abaxiall,adaxiall,adaxially,along,alyx,ape,ark,articulated,axil,berry,branched,cell,completely,confined,conical,densely,eaf,eed,erect,exposed,filiform,free,glabrou,green,groove,hromosome,ilament,keeled,lax,lobe,long/tall,lower,mature,midrib,midvein,minute,mmm,near,nflorescence,nodding,obscured,occasionally,older,orolla,outlin,pair,penden,pentagonal,perfect,pericarp,plurifoliat,point,portion,possibly,primary,ruit,scarious,see,spaced,stigma,style,testal,transparent,triangular,tube,tuft,twinin,ud,unit,upper,vary,vein,weak,wide,woody,yellowish,ympodial	'',3,[,``,abaxial,adaxial,arrangement,articulation,bark,characteristic,chromosome,colour,dense,exsertion,filament,form,fruit,glabrousnes,height,inflorescence,leaf,length,ovary,plant,position,seed,shape,spacing,texture,thicknes,value,width,ye,{,}
13	wfo-0001025788	success	158	118	87	71	31	0.551	0.5-2,1-4,1-5,1.8-2.7,1.8-3.9,10-24,14-48,15-30,2-10,2-13,2-3,2-5,2.8-9.5,4-5.5,4.5-10.1,4.5-12.5,5-8,6.2-12.5,8-38,acute,apical,apically,blue,branched,calyx,cm,conical,connate,corolla,cyme,deep,dehiscent,diameter,dichasial,dichasially,distal,dorsally,edge,filament,finely,flat,flower,folded,green,hair-like,herbaceous,interjected,introrse,lateral,leaf,leaflet,lobe,long-attenuate,maturing,medium,mm,monochasial,mucilaginous,obtuse,odd-pinnate,often,ovoid,pedicel,peduncle,perennial,perfect,petiole,plant,poricidally,proximal,pubescent,purple,rotate,seed,short,slit,stigma,straight,style,terminal,throughout,tip,tuber-bearing,unit,wall,yellow,Â¼	-8,0-6,2m,3-,3-6-foliat,4-3.,6-7,abaxiall,abaxially,acumen,acuminate,adaxially,apex,articulate,attenuate,base,cell,covering,cuneate,digestion,diminishing,eaf,ebracteate,eed,elliptical,emoval,enzyme,exceeding,forked,generally,globo,gradually,green-white,half,honeycomb,living,lon,long,lower,lunat,make,narrowly,nflorescence,nther,oblique,orolla,ovate,pair,pattern,petiolule,plan,reveal,rounded,ruit,sessile,seudostipule,size,specimen,stamen,subequal,subsessile,tal,tem,testal,thick,throughou,toward,typically,vary,wide,ympodial	3-6-foliate,4-31,anther,arrangement,articulation,bract,branching,colour,ebbrate,form,fruit,globose,growth,height,inflorescence,length,lunate,modification,number,ovary,perfection,presence,present,pseudostipule,shape,stem,structure,sympodial,texture,wet,width
14	wfo-0001025792	success	203	126	106	97	20	0.522	0.4-0.7,1-2,1-3,2-11,2-3,2.5-3.5,2.5-4,3-4,3-5,3.5-6,4-12,4-6,5,5-10,5-6,5-9,7-10,7.5-8,8-10,9-12,abaxially,acumen,adaxially,anther,auriculate,blade,blue-mauve,blue-purple,brownish,cell,chartaceous,cm,condition,corolla,dark,densely,diameter,digestion,dorsally,drying,edge,elliptic,enzyme,filament,flat,flower,folded,forked,fresh,fruit,glabrous,globose,green,greenish,hair,half,herb,homostylous,honeycomb-shaped,interjected,lanceolate,lateral,leaflet,lengthening,like,lobe,long,mauve,membranous,minute,minutely,mm,narrowly,odd-pinnate,ovoid,pair,papillose,petiole,plant,pore,poricidal,proximal,puberulent,pubescent,purple,removed,ripe,rotate-pentagonal,seed,size,slit,stem,stigma,straight,streak,style,terminal,testal,tinged,tip,tube,wall,white,whitish,x,yellow	1-10,1-4,10-15,2-3.5,21-28,4.5-7,5-merou,acuminate,acute,ag,along,alyx,apart,apex,apparently,articulated,articulation,axe,axillary,base,basiscopic,berry,broadly,bud,capitat,ciliate,connivent,covering,decurrent,developing,distal,distinct,distinctly,eaf,eed,especially,exceeding,except,geminat,generally,glabrou,greatly,green-white,hair-like,hal,high,indistinct,living,lower,make,margin,midrib,mottle,mucilaginous,narrow,nflorescence,oblique,often,onto,orolla,pedicel,peduncle,perfect,petiolulate,plurifoliate,rachi,reduced,rounded,ruit,semi-erec,semi-rosette,sessile,seudostipule,short,shortly,side,slightly,spaced,specimen,stamen,ste,sub-rosette,subequal,subtending,tall,tamen,tem,thick,throughout,tri-,unit,usually,vary,wet,wing,ympodial,young	5-merous,age,arrangement,branching,calyx,capitate,colour,form,glabrousnes,growth,height,inflorescence,leaf,length,ovary,pseudostipule,shape,staman,texture,type
15	wfo-0001025804	success	155	142	121	34	21	0.781	.25,.5,0.5-1,1-1.5,1-3,1.2-1.5,1.4-1.7,1.5-2,11-20,16-35,2-2.5,2.5-4,3-4.5,3.5-12,4-10,6-8,7-10,?,abaxially,acute,adaxially,age,anther,anthesi,apex,apiculate,attenuate,bark,base,berry,bilobed,branched,calyx,clavate,cm,conical,corolla,covered,cream,cucullate,dark,decurrent,densely,dia,ellipsoid,elliptic,erect,exserted,filament,flattened,fleshy,fruiting,glabrous,glandular,globose,green,incrassate,internodal,lateral,leaf,lengthening,light,lobe,lobed,long,main,major,many,margin,mere,middle,minor,minute,minutely,mm,nearly,obovate,occasionally,often,onto,opposite,ovary,pair,paler,papillae,papillate,papillose,pedicel,pitted,planar,pore,poricidal,projection,red,reddish-brown,regularly,reniform,rim,scar,sessile,shrub,size,slit,somewhat,spaced,stem,stigma,strongly,style,surface,thick,time,tip,tube,vein,white,whitish-green,widest,winged,x,young	10-20,5,apar,ape,ba,c.,deflexed,differing,difoliate,drying,eaf,edicel,eed,flower,free,geminat,later,lower,near,nflorescence,older,papillat,plurifoliate,portion,red-papillose,reddish-brow,ruit,tall,tub,ud,unit,wing,woody,ympodial	apart,branching,bud,colour,diameter,exsertion,form,fruit,growth,height,inflorescence,length,mature,part,plant,position,seed,shape,state,thicknes,ye
16	wfo-0001025813	invalid_json	197	102	77	120	25	0.391	'',0-2,1.2-4.5,1.3-7,1.5-1.8,1.5-6.5,15-30,2-5,3-3.5,3-4,3-5,3-6,3-7,5-18.5,5-6,``,abaxially,absent,adaxially,anther,base,blade,blue,borne,brownish,chartaceous,cm,condition,corolla,dark,densely,diameter,drying,end,flower,fresh,fruit,globose,green,greenish,hair,herb,homostylous,interjected,lanceolate,lateral,leaflet,light,long,membranous,minute,mm,monochasium,odd-pinnate,ovoid,pair,pedicel,peduncle,pilose,pore,poricidal,pubescent,rarely,seed,singly,size,stem,strongly,style,terminal,tip,tuber,typically,violet,white,whitish,x	0.7-1.7,1-1.5,1-10,1-2,1-4,1.5-2,2-3,2-4,5-merou,6-7,acumen,acuminate,acute,ag,along,alyx,apart,apex,apparently,articulated,axe,berry,broadly,cell,ciliate,connivent,contracted,covering,cuneate,decreasing,decurrent,digestion,discussion,distal,distinct,dorsally,eaf,edge,eed,elliptic,enzyme,especially,exceeding,extra,filament,flat,folded,geminat,glabrou,glabrous,green-white,hair-like,half,highly,honeycomb-shaped,larger,lengthening,like,living,lobe,longer,lower,make,margin,midrib,minutely,mucilaginous,near,nflorescence,obtuse,often,orbicular,orolla,ovate,ovoi,perfect,petiole,petiolulate,plant,plurifoliate,puberulent,rachi,removed,rosette-formin,rotate,ruit,see,sessile,seudostipule,short,single-flowered,slit,sometimes,spaced,species,specimen,stamen,ste,stigma,stolo,straight,suborbicular,tamen,tem,testal,thick,thir,throughout,toward,tri-,tube,unforked,unit,unwinged,vary,vein,wall,wet,yellow,ympodial	'extra,[,],arrangement,calyx,characteristic,colour,form,formation,growth,inflorescence,leaf,length,presence,pseudostipule,pubescence,rosette,rosette-forming,shape,stolon,texture,type,value,{,}
17	wfo-0001025825	success	187	107	84	103	23	0.449	0-0.21,0.4-1,0.5-10.4,0.9-2,1-2,1-3,1-5.5,10-24,10.5-26,14-85,2-3.7,22-86,3-10,3-5,3.7-6.5,4-8,4-9,5-7,6-10,6.6-14,anther,berry,blade,brownish,clavate,cm,condition,coriaceous,corolla,dark,diameter,drying,elliptic,filament,flower,forked,fresh,fruit,glabrescent,glabrous,green,greenish,hair,herb,homostylous,interjected,lanceolate,lateral,leaf,leaflet,light,lilac,lobe,medium,mm,mucilaginous,odd-pinnate,ovate,ovoid,pair,pedicel,peduncle,pentagonal,petiole,plant,pore,poricidal,rotate-pentagonal,seed,shiny,short,size,stigma,straight,streak,style,terminal,tip,tube,wet,white,whitish,wing,x	0.4-3,0.5-0.8,0.7-2.2,0.9-4,1.1-1.4,2-5,3-8.5,5-10,5-merou,abaxially,acumen,acuminate,acute,adaxiall,adaxially,ag,alyx,apart,apex,apparently,articulated,asymmetric,attenuate,axe,axillary,back,base,basiscopic,bud,capitat,cell,connivent,covering,cuneate,decreasing,decurrent,digestion,distal,dorsally,eaf,edge,eed,enzyme,erec,exceeding,flat,folded,geminat,generally,glabrou,green-white,hair-like,hal,half,high,honeycomb-shaped,increasing,lengthening,living,long,lower,make,middle,nflorescence,orbicular,orolla,perfect,petiolulate,plurifoliate,rachi,removed,rounded,ruit,sessile,seudostipule,side,slightly,slit,smaller,spaced,specimen,stamen,subequal,subglabrou,subtending,tall,tamen,tem,testal,thick,throughout,tissue,toward,tri-,unit,unwinged,usually,vary,wall,wide,winged,yellow,ympodial	abaxial,adaxial,arrangement,branching,calyx,capitate,colour,form,growth,height,inflorescence,length,number,ovary,pseudostipule,shape,staman,stem,subglabrous,symmetry,texture,type,width
18	wfo-0001025838	success	217	150	129	88	21	0.594	.5,0.5-1,0.7-2,1-1.2,1-1.5,1.5-1.7,1.5-3.5,1.5-5,2-5,2/3,20-40,4-15,4.5-5.5,6.5-7,acuminate,anther,apart,apex,appearing,articulated,attenuate,base,berry,black,branch,branched,brown,capitate,cell,clavate,clustered,cm,connivent,corolla,dark,dendritic,dense,densely,diameter,disintegrating,ellipsoidal,elliptic,entire,filament,flattened,fleshy,flower,fruit,fruiting,glabrous,globose,greenish,growth,hairy,inflorescence,inserted,irregularly,lanceolate,lateral,leaf,lengthening,like,lobed,loosely,lower,many,margin,membranous,minutely,mm,mostly,narrowly,often,onto,ovoid,pale,pedicel,peduncle,per,perfect,petiole,pitted,platform,pointed,pore,poricidal,pubescent,purple,reddish,reniform,revolute,ripe,scar,seed,shiny,short,shrub,simple,sleeve,slightly,slit,small,sometimes,spaced,sparsely,square,stellate,stem,stigma,style,surface,terminal,testal,time,tinged,tip,tree,trichome,tuft,turbinate,uniseriate,upper,wall,way,white,winged,x,yellow,Â¾	-20,0.5,1.2-5,1.5-2,1.5-2.5,1.8-2,10-15,10-60,2-2.5,2.5-3,3.5-,5,5-merou,6-15,abruptly,adaxial,adaxially,ag,along,alyx,anthesi,apiculate,archin,ark,axil,basall,broad,calyx,cucullate,cup-shaped,decurrent,denser,drying,eaf,eed,erect,exserted,extending,free,glabrescent,ilament,insertion,keeled,lamina,less,lobe,long,m.,midrib,minute,narrowing,never,new,nflorescence,nodding,occasionally,older,orolla,pair,papillat,papillo,pericarp,plurifoliat,point,portion,primary,quadrate,ruit,shin,sinus,slender,spreading,strongly,tall,tem,thi,thin,tube,twinin,ud,unit,vary,vein,weight,wing,woody,yellowish,ympodial	5-merous,age,arching,articulation,bark,basally,branching,bud,colour,form,hair,height,length,number,ovary,pattern,plant,position,shape,texture,type
19	wfo-0001025845	success	180	135	111	69	24	0.617	.5,0.3-0.5,0.4-1.5,0.5-11,0.5-2.5,1-1.8,1-4.5,1.5,1.5-13,1.5-2,1.5-2.5,1.5-7,2,2-15,2-3,2-5-lobed,2.5-4,3,3-13,3-4,4-5,4-6,5-6,6-6.5,6-9,acuminate,acute,along,anther,apart,apex,apiculate,articulated,base,branch,brown,calyx,chartaceous,cm,corolla,cuneate,cylindrical,dark,deltate,diameter,directed,distally,ellipsoidal,entire,extra-axillary,filament,flattened,fork,fruit,glabrous,green,greenish,herb,leaf,light,lobe,lobed,located,longitudinal,margin,membranaceous,minutely,mm,narrowly,near,obtuse,often,orange,ovate,ovoid,patch,pedicel,peduncle,petiole,pinnately,pore,puberulent,purple,rachi,radiu,rotate-stellate,rugose-verrucate,sagittate,shrub,side,simple,small,sparsely,stigma,stripe,strongly,style,subcordate,tapered,tip,triangular,truncate,tube,unbranched,unlobed,vein,white,wide,x,yellow,yellowish	1,1-2,3-6,3-foliat,7-10,abaxially,abundantly,adaxial,adaxially,aggregate,around,ascending,axe,ba,blade,cell,channe,compressed,connivent,decurrent,diamete,distall,divided,eaf,eed,eglandular,elliptic,especially,flower,free,glabrou,inserted,lateral,laterally,long,lower,major,mesocarp,midrib,nearly,nflorescence,obovate,orolla,part,perfect,pubescent,rarely,rounded,ruit,sand-punctate,shorter,sinus,spaced,stone,tal,tamen,tem,terminal,thecae,thick,tightly,time,tomento,truncat,unit,vary,veiny,ympodial,youn	articulation,branching,colour,decurred,form,growth,hair,height,inflorescence,length,lobing,ovary,plant,position,seed,shape,size,spacing,stem,symmetry,texture,theca,thicknes,type
20	wfo-0001025850	success	197	88	73	124	15	0.371	.5,0.5,0.5-1,0.5-3,0.6-1,1.5,15-20,anther,articulated,base,berry,branched,brown,cm,corolla,densely,denser,diameter,divaricate,ellipsoid,elliptic,entire,filament,flattened,fleshy,flower,glabrous,glandular,globose,green,growth,inflorescence,lobed,many,margin,membranous,mm,narrowly,nearly,node,openly,orange,pale,papillate-puberulent,pedicel,peduncle,per,perfect,petiole,pinnatifid,pore,poricidal,pubescent,reddish,reniform,rhomboid,scattered,shallowly,shrub,simple,sleeve,slightly,small,stem,surface,tan,time,tip,trichome,uniseriate,vine,white,x	-5,-7,.8,0.5-,1,1-1.5,1-3,1-celled,1.5-5,2,2-12,2-6.5,3-4,30,4-5,5-7,5-merou,6-7,abaxial,acute,ag,along,alyx,anthesi,apar,apex,apparently,ark,axi,basal,broadly,calyx,capitate,cell,connivent,cupped,cyathiform,deciduous,deflexed,deltate,divided,drying,eaf,eed,elongate,em,erect,exserted,extending,free,fruiting,geminat,glabrou,gland,half,halfway,ilament,irregularly,lamina,later,lateral,lax,leaving,lengthening,less,lobe,long,loosely,lower,midrib,minute,minutely,new,nflorescence,nodding,occasionally,often,older,orolla,outline,pair,papillo,peg,pitted,planar,plurifoliate,portion,primary,puberulen,ripe,rounded,ruit,scar,shiny,sinuate,sinus,slender,slit,sometimes,soon,spaced,splitting,spreadin,spreading,stellate,stigma,strongly,style,surfac,terminal,testal,thin,tiny,truncate,tube,twinin,ud,unit,vary,vein,woody,yellow,ympodial,young	articulation,bark,branching,colour,density,form,fruit,glabrousnes,leaf,length,number,seed,shape,texture,type
21	wfo-0001025872	success	160	99	83	77	16	0.519	.5,0.25-0.5,0.6-1,1,1-1.3,1-1.5,1-2,1.2-1.5,1.2-1.6,1.7-3,10-25-flowered,2-2.5,2-5,2/3,3.5-4,4-4.5,4.5-13,6-10,6-8,acute,anther,apex,base,becoming,blade,branched,broadly,brownish,calyx,capitate,cm,coriaceous,corolla,cup-shaped,dark,dia,dry,elliptic,filament,flattened-reniform,fleshy,flower,fruiting,glabrous,globose,green,greenish-tan,later,lateral,leaf,live,lobed,long,main,margin,material,mm,narrowly,occasionally,opposite,ovary,pair,pedicel,petiole,plant,pore,revolute,rounded,several,shaped,shrub,stigma,style,tapering,tear-drop,terminal,thick,time,tube,vein,way,white,x	.1,0.5,0.5-1,along,anthesi,apart,apically,auriculate,ba,bark,beginning,beneath,berry,bright,crinkled,crowded,decurrent,deeply,deflexed,dense,densely,eaf,edicel,eed,exserted,flattened,free,glandular-resinous,grayish-brow,incrassate,inflorescenc,irregularly,junction,lobe,lon,lower,midrib,minutely,nflorescence,often,older,onto,paler,papillae,papillo,papillose,pitted,planar,plurifoliat,poricidal,portion,prominent,pubescent,red-papillose,rounded-triangular,ruit,scar,simple,somewhat,soon,spaced,specimen,stem,straight,surface,tall,thickened,tip,trichome,tub,ud,uniseriate,unit,visible,woody,ympodial,young	branching,colour,diameter,form,fruit,growth,height,inflorescence,length,number,pattern,position,seed,shape,size,texture
22	wfo-0001025893	success	157	79	63	94	16	0.401	.5,0.5-1.5,1-1.2,1-1.5,1-4,1.5-1.7,1.5-2,2-2.5,2-3,3-5,5-6,along,anther,attenuate,base,beneath,berry,bi-lobed,branched,broadly,calyx,capitate,cm,corolla,cup-shaped,dia,elliptic,filament,flower,fruit,fruiting,glabrous,globose,golden-puberulent,internodal,leaf,lobe,lobed,long,minutely,mm,narrowly,nearly,obovate,occasionally,opposite,ovary,ovoid-reniform,pedicel,petiole,pitted,pore,shaped,shrub,sometimes,stigma,style,surface,tear-drop,tube,vein,white,x	.25,.4,0.8-1,1-2.5,11-20,6-10,accrescent,anthesi,apex,bank,barely,bark,bearing,beginning,blade,brownish-green,closely,decurrent,deflexed,deltoid,densely,difoliate,dry,eaf,early,eed,ellipsoid,erect,even,exserted,faintly,free,geminate,glabrate,gravelly,green,greyish,growing,impressed,inflorescenc,lateral,lon,long-acuminate,longitudinally,lower,main,many,margin,material,middle,nflorescence,older,overlapping,pair,pale,papillo,papillose,planar,plurifoliat,poricidal,portion,puberulent,red-papillose,reflexed,river,rocky,ruit,sandy,scar,slender,slightly,spaced,specimen,stem,straight,stream,striat,tall,tapering,thickened,time,tip,trichome,ud,unicellular,unit,usually,visible,widest,winged,woody,yellowish,ympodial,young	branching,colour,diameter,form,growth,height,inflorescence,length,number,plant,position,seed,shape,size,texture,type
23	wfo-0001025896	success	146	116	91	55	25	0.623	-3,-30,0.5,0.5-2,1-1.5,1-25,1-3,1-6.5,1-8,1.5-2,1.5-9,10-15,2-2.5,2.5-14,2.5-5,4,4-5,4-6,5-15,6-10,7-,7743,abaxial,acosta,acuminate,angled,apart,apex,base,brownish,calyx,chartaceous,cm,constricted,cuneate,cylindrical,deltate,densely,diameter,eglandular,elliptic-ovate,entire,flower,forked,fruit,glabrous,gland,globose,greenish,hair,inflated,lobe,margin,membranaceous,mm,moderately,nearly,obtuse,occasionally,orange,ovate,pale,pedicel,peduncle,petiole,pore,present,pubescent,purple,rachi,radiu,red,ripe,rotate-stellate,rugose,short-stalked,shrub,simple,smooth,solÃ­,stem,stigma,style,subcordate,triangular-subulate,tube,unbranched,unit,white,x,yellow	.5-2.5,10-25,2-14,4-12,4-23,5-7,6-13,abaxially,absen,acute,adaxiall,adaxially,aggregate,also,articulated,axe,ba,blade,branched,cell,connivent,dendritically,directed,distall,eaf,eed,especially,like,long,lower,many-foliat,near,nflorescence,nther,often,orolla,perfect,puberulent,pubescen,ruit,spaced,sparsely,stalked,stone,surface,tal,tem,time,tip,triangular-ovate,truncat,vary,vein,wide,ympodial	adaxial,anther,articulation,branching,colour,corolla,dendritic,direction,distally,form,growth,height,inflorescence,leaf,length,many-foliate,ovary,plant,seed,shape,spacing,sympodial,texture,truncate,type
24	wfo-0001025902	invalid_json	211	163	135	76	28	0.64	.2,.5,/2,0.1-0.5,0.5-2.5,1-1.5,1.2-1.5,1.5,1/3,11-15,1983,4,4-5,40,5-6,8-15,>,abaxially,absent,acute,adaxially,aid,along,anther,anthesi,apex,articulated,attenuate,axi,bark,base,becoming,beginning,berry,black,branched,branching,cabrera,cell,circular,clavate,cm,completely,corolla,densely,diameter,dull,ellipsoid,entire,fide,filament,flattened-reniform,flower,fruiting,glabrous,globose,green,growth,inflorescence,lateral,leaf,leaf-opposed,leaving,length,lengthening,less,lobed,low,lower,margin,markedly,mature,minute,minutely,mm,new,occasionally,often,ovary,pale,papillose,pedicel,peduncle,peg,pendant,per,perfect,petiole,pitted,pore,poricidal,pubescent,ridged,rotate-stellate,rounded,scattered,scrambling,simple,sleeve,slender,slit,small,sometimes,soon,sparsely,spreading,stem,stigma,strongly,style,surface,tangled,tapering,terminal,testal,time,tip,trichome,twining,ultimate,uniseriate,usually,vegetation,vine,violet,water,way,weight,whitish,wing,woody,x,yellow,yellowish,Â½	0.5-2,1-1.2,1.5-2,1.5-3,2-6,2.5-4,3-10,4-13,4-6,5-merou,8-10,8-9,accompanied,ag,always,alyx,apar,ark,berr,branch,broadly,c.,calyx,chartaceous,climbin,conical,connivent,deciduou,deltate,eaf,eed,either,except,exfoliatin,exserted,fleshy,free,geminat,ilament,lanceolate,linear,lobe,long,loosely,midvei,nflorescence,obscured,older,one,orolla,pair,papillat,pericarp,planar,plurifoliate,portion,primary,prominent,revolute,ruit,scar,semi-aquati,semi-circular,shallow,somewhat,spaced,tem,thin,tube,ud,unit,vary,vein,weak,widely,ympodial	'',5-merous,[,``,age,bud,characteristic,climbing,colour,deciduous,exfoliating,form,fruit,midvein,number,orientation,papillate,placement,position,prickle,seed,semi-aquatic,shape,texture,type,value,{,}
25	wfo-0001025906	success	188	105	86	102	19	0.457	0-14,0.1-2,0.20-0.60,1.1-2,1.6-12.4,16-51,2-4.4,2-6,2.6-5.2,3-10,4-10,4-12,4-7,5-6,5-7,5.2-9,8-16,8.5-12.5,anther,blade,blue,brownish,cell,clavate,cm,condition,coriaceous,corolla,covering,dark,diameter,drying,flower,forked,fresh,fruit,glabrous,globose,green,greenish,hair,hair-like,herb,homostylous,interjected,lanceolate,lateral,leaf,leaflet,light,lilac,linear,long,mm,odd-pinnate,ovoid,pair,pedicel,peduncle,pentagonal,petiole,plant,pore,poricidal,pubescent,purple,rotate,seed,shiny,short,size,sparsely,stigma,straight,stripe,style,sub-glabrous,subglabrous,terminal,testal,thick,tip,wall,white,whitish,width	0.15-0.6,0.2-0.6,1-2,1-3,1-6,1.8-4.8,3-5,4-5,5-merou,abaxially,acumen,acute,adaxiall,adaxially,ag,alyx,apart,apex,apparently,articulated,axe,axillary,base,berry,bud,capitat,connivent,cuneate,decreasing,decurrency,decurrent,delimited,digestion,diminishing,distal,dorsally,eaf,edge,eed,enzyme,erec,exceeding,falcate,filament,first,flat,folded,geminat,generally,glabrou,green-white,hal,half,high,honeycomb-shaped,lengthening,living,lobe,lower,make,mucilaginous,next,nflorescence,obtuse,orolla,perfect,plurifoliate,rachi,removed,ripe,ruit,second,sessile,seudostipule,slightly,slit,smaller,spaced,specimen,stamen,subequal,subglabrou,subtending,tall,tamen,tem,third,throughout,toward,tri-,tube,typically,unit,unwinged,usually,vary,well,wet,wood,x,yellow,ympodial	abaxial,adaxial,arrangement,branching,calyx,capitate,colour,form,growth,height,inflorescence,length,number,ovary,pseudostipule,shape,stem,symmetry,texture
26	wfo-0001025907	success	148	91	74	74	17	0.5	.05,0,0.8-1.8,1,1-1.2,1-2.3,1-3,1-5,1.5-2,1.5-2.2,10-15,12-45,2,2-3.5,2-8,3-,4-5,5-15,acuminate,acute,anther,apex,attenuate,axillary,base,beak,berry,c,cell,cm,conical,densely,diameter,elliptic,epidermal,filament,flattened,fruit,fruiting,glabrous,globose,green,growth,highly,irregular,lobed,long,minutely,mm,obovate,ovary,ovoid-reniform,pair,pedicel,per,petiole,plant,poricidal,primary,pubescent,red-papillate,round,rugose,seed,shrub,simple,sinuous,size,stigma,style,surface,tip,vein,x	-4,.5,.5-1,0-60,2/3,3-4,3/2,absent,along,anthesi,anthesis5-7,anticlinal,appearing,axil,bearing,breaking,brown,calyx,clavat,conspicuously,deciduous,eaf,edicel,eed,erec,flower,free,greenish,included,iquito,isolated,lamina,lobe,lon,lower,margin,near,nearly,new,nflorescence,occasionally,open,papillate,papillose,population,portion,projection,raised,reflexed,remaining,ruit,scar,scattered,single-stemmed,slender,soon,sparsely,tal,tem,thickening,time,trichome,truncate,tub,tube,ud,unifoliat,uniseriate,unit,variable,white,white-lenticellate,without,ympodial	5-7,branching,bud,clavate,colour,form,height,inflorescence,leaf,length,number,position,shape,stem,texture,type,venation
27	wfo-0001026203	success	197	96	77	120	19	0.391	0-39,0.06-0.86,0.38-11.3,0.4-3,0.5-2.3,0.7-2.6,1-13,1-2,1-4,1-9,1.2-5.5,2-10,2-4.9,2-8.5,2.2-13.3,3-10,3-11,3.2-22,3.2-23,7-47,anther,blade,blue,clavate,cm,coriaceous,corolla,dark,deep,diameter,filament,flower,forked,fruit,glabrescent,glabrous,globose,green,greenish,hair,herb,homostylous,interjected,lanceolate,lateral,leaf,leaflet,light,lilac,long,medium,mm,moniliform,odd-pinnate,ovoid,pair,pedicel,peduncle,pentagonal,petiole,plant,pore,poricidal,rotate,seed,short,size,stigma,straight,style,subglabrous,terminal,tip,tuber,whitish,wide,x	0-7,0.3-11,0.3-6,0.5-3.2,1-5,1.1-7.9,2-43,2-5,3-5,5-merou,abaxially,acumen,acuminate,acute,adaxially,ag,along,alyx,apart,apex,apparently,arranged,articulated,asymmetric,attenuate,axe,axillary,base,basiscopic,bead,berry,brownish,bud,capitat,cell,condition,connivent,covering,decreasing,decurrent,digestion,distal,dorsally,drying,eaf,edge,eed,elliptic,enzyme,erect,exceeding,flat,folded,fresh,geminat,generally,glabrescen,glabrou,green-white,hair-like,hal,half,high,honeycomb-shaped,lengthening,like,linear,living,lobe,lower,make,middle,mucilaginous,multiple,necklace,nflorescence,orbicular,orolla,ovate,perfect,plurifoliate,rachi,removed,ripe,rosett,rounded,ruit,sessile,seudostipule,side,slightly,slit,sometimes,spaced,specimen,stamen,stolon,stripe,subequal,subtending,tall,tamen,tem,testal,thick,throughout,tissue,toward,tri-,tube,typically,unit,unwinged,usually,vary,wall,wet,white,yellow,ympodial	abaxial,adaxial,arrangement,branching,calyx,capitate,colour,form,growth,height,inflorescence,length,ovary,pseudostipule,shape,staman,stem,symmetry,texture
28	wfo-0001026208	success	214	92	72	142	20	0.336	-5,0,0-20,0.6-0.8,0.7-2,0.8-1.3,1-5,2.5-5,3.5-5,5-22,abaxial,adaxial,anther,apex,base,berry,branched,bright,calyx,chartaceous,cm,connivent,cuneate,dark,densely,dull,equal,evenly,flattened-reniform,flower,fruit,fruiting,glabrous,green,lateral,leaf,length,lobed,margin,maturity,mauve,membranous,mm,moderately,orange,orange-brown,pale,pedicel,per,petiole,poricidal,prickle,prickly,red,rounded,shrub,sometimes,sparsely,spherical,stellate,stellate-pubescent,stem,style,tapering,terminal,tip,toward,trichome,unarmed,white,yellow,young	-1/2,-10,-3,.5,/3,0-4,0-5,0-8,0.1,0.1-0.2,0.1-0.25,0.1-0.3,0.5-0.8,0.5-1.2,0.6-0.9,0.8-1.5,1-2,1-4,1.5,1.5-2.5,1.8-2.3,1.8-2.5,1/3,1/4-1/3,1/4-1/6,11-25,2,2-20,2-3,2-4,2.5-6,3-30,3-5,3-6,3/,4-7,4-9,5,5-,5-17,5-merous,6-22,6-8,abaxially,acuminate,acut,acute,alyx,apar,apart,apically,apparently,articulated,bark,becoming,blade,broad-deltate,brown,conical,curved,deltate,diameter,difoliate,discolorous,distance,drying,eaf,eed,elliptic,elongated,elongating,erect,extending,filament,flattened,free,geminat,geminate,glabrescent,gray-greenish,green-brown,infructescence,lobe,long,longer,lower,mature,midpoint,midvein,nflorescence,older,one,open,orolla,oung,ovate,pair,peduncle,pendulous,perfec,pericarp,porrect,portion,primary,pubescent,ray,recurved,red-brow,ruit,scar,sessile,shorter,side,slender,smooth,somewhat,spaced,spreading,stalk,stalked,stout,straight,straw-yellow,subentire,surface,tamen,terete,tertiary,time,tube,unarme,unit,usually,variously,vary,vein,venation,visible,way,wide,woody,ympodial	branching,colour,corolla,form,growth,hair,height,heteromorphism,inflorescence,number,ovary,plant,position,presence,present,seed,shape,staman,texture,type
29	wfo-0001026215	success	150	141	113	37	28	0.753	-3,.05,.5,0,1-3,1.5,1.5-2,1.5-2.2,13-35,15-2,18-20,2-3,2-3.5,2-4,3/4,4-15,4-5,7-8,absent,along,anther,anthesi,anticlinal,apex,axillary,base,beak,brown,calyx,cell,clavate,cm,completely,conical,conspicuously,corolla,densely,diameter,elliptic,enlarged,entire,epidermal,erect,exserted,filament,flattened-round,flower,fruit,fruiting,glabrous,globose,green,greenish,herb,highly,horizontal,internode,irregular,kink,length,lobe,lobed,long,marked,markedly,minutely,mm,nearly,nodding,occasionally,often,ovary,ovoid-reniform,pair,papillae,papillate,pedicel,per,petiole,poricidal,portion,primary,projection,purple,raised,red-papillose,reflexed,rugose,scar,seed,shrub,simple,sinuous,stem,stigma,strongly,style,surface,thickening,time,tip,tube,unit,usually,vein,way,white,white-lenticellate,white-pubescent,wing,winged,without,x	0.05,0.5-1,1,2,abaxially,abruptly,acuminate,ape,axil,berry,bifi,broadly,continually,deltate,eaf,edicel,eed,free,less,lower,narrowing,nflorescence,noddin,onto,papillat,rounded,ruit,shortsympodial,single-stemmed,small,ste,tal,tem,tub,ud,unifoliat,wide	abaxial,bifid,bud,colour,exsertion,form,glabrousnes,growth,height,inflorescence,leaf,lenticellate,lobing,number,orientation,plant,pore,position,pubescence,reflexion,shape,short,size,sympodial,tall,type,unifoliate,width
30	wfo-0001026229	success	299	94	72	227	22	0.241	35,5,abaxial,adaxial,anther,apex,articulated,base,berry,black,branching,brown,calyx,cm,corolla,cyme,dark,densely,drying,elliptic,flattened,flower,fruit,glabrous,globose,golden,green,growth,hair,hirsute,hispid,immature,inflorescence,internodal,lanceolate,lateral,leaf,lobed,long,mature,membranaceous,mm,moderately,narrow-ovate,narrowly,oblong,ovate-elliptic,pale,pedicel,per,petiole,pink,pore,poricidal,porrect-stellate,purple,purplish,reniform,shiny,shrub,simple,stellate,stem,subopposite,terminal,trichome,type,unbranched,upper,white,wide,Â¾	0.1â1.47,0.2â0.8,0.35,0.3â0.9,0.3â1.2,0.4,0.8â1.2,0.8â2,0.9,0.9â4.3,1,1-celled,1.2â4.8,1.3â1.5,1.3â1.7,1.4,1.7â11.8,1.7â2.3,1.8,1.8â5.5,1.9â2.5,1/3,13,1â1.4,1â2,1â4,2,2.3â3.4,2.8â4,2â3,2â3-celled,2â4-celled,3,3â4,3â5,4.5â6.5,4â6,5-merou,5â9,6â15,6â7,6â8,8.6â12,8â10,9â31,abaxially,accrescent,acuminate,acute,adaxiall,adaxially,ag,almost,also,always,alyx,anthesi,ark,associated,asymmetric,attenuate-caudate,axe,ba,barely,beneath,blade,branch,broadly,broken,camptodromous,capitate,celled,central,changing,clavate,commentary,commonly,completely,concentrated,connivent,cordate,covered,creating,cuneate,cylindrical,deltoid,develope,developed,diameter,differing,directed,discolorous,diÂ­,dried,eaf,eed,eglandular,ellipsoidal,elongated,entire,even,faces,few-rayed,found,free,frequently,fresh,fully,geminate,glabrescent,gland,glandular,glandular-capitate,head,hyaline,ilament,impressed,included,insertion,introrsely,involute,irregular,lamina,larger,less,like,lobe,long-stalked,longer,longitudinal,lower,mainly,margin,material,maturit,midpoint,midri,midvein,minute,mixed,much,multangulate,multangulate-stellate,multiseriate,near,nearly,new,nflorescence,often,old,older,one,open,opening,orientation,orolla,other,oung,ovate,pair,paired,papillose,peduncle,pedunculate,perfect,pit,plurifoliate,point,poorly,portion,primary,pubescent,ra,rachi,raised,rarely,ray,remnant,revolute,rounded,ruit,secondary,see,sessile,shin,short-,short-stalked,shorter,size,slightly,slit,small,smaller,solitary,sometimes,somewhat,sparsely,spread,spreadin,spreading,stalk,stigma,strongly,style,subsessile,supported,surfac,surface,three,tree,trifoliate,tube,tuft,ud,unequal,unit,usually,vary,vein,venation,vestiture,visible,weakly,whitish-green,yellow,yellowish-white,ympodial	0.3-1.2,1.3-1.5,1.8-5.5,1.9-2.5,2.8-4,6-15,9-31,arrangement,articulation,colour,form,height,length,number,pattern,plant,position,scale,seed,shape,texture,width
31	wfo-0001026230	success	144	115	93	51	22	0.646	.25,.5,0.3-1.5,0.75-1,0.9-2,1-4,1.8-2.3,1.9-4.1,12.6-20.8,2-4,2-5,3-4,4.6-9.3,5-10,5-20-flowered,acuminate,acute,anther,apart,apex,apiculate,area,bark,base,beginning,beneath,broadly,bud,calyx,clavate,cm,cordate,corolla,difoliate,distal,elliptic,evenly,except,filament,fruit,fruiting,geminate,glabrous,globose,green,grey,large,leaf,lobe,lobed,long,long-acuminate,major,minor,minutely,mm,nearly,obtuse,older,opposite,orbicular,ovary,ovoid,pair,papillose,pedicel,petiole,pore,raised,rounded,rusty-papillose,scar,shaped,shrub,slightly,small,spaced,stem,stigma,straight,strongly,style,surface,tear-drop,tip,tree,unit,unknown,vein,white,winged,x,young	.8,0.5-3,1-1.4,1-1.5,1.1-1.8,anisomorphic,anisophyllou,anthesi,appears,back,berry,clu,completely,coroll,deflexed,deltoid,dia,eaf,edicel,eed,enclosing,erect,free,immature,inflorescenc,lateral,lon,long-triangular,lower,main,margin,middle,nflorescence,pointed,poricidal,portion,reflexed,ruit,simple,sinus,slender,tall,tapering,thickened,tube,ud,umbonate,white-lenticellat,widest,woody,ympodial	anisophyllous,club,colour,diameter,flower,form,growth,hair,height,inflorescence,information,length,na,plant,position,seed,shape,size,structure,sympodial,texture,white-lenticellate
32	wfo-0001026233	success	165	114	94	71	20	0.57	-1,-1.9,-3.8,-5.5,-50,-8.1,.25,.75,0.7-0.8,0.8-1.55,1-,1.1,1.2-2.7,1.5,1/2,2,2-,2.4-3.5,2/3,3.5-4.5,5-30,6,accrescent,acute,annular,anther,apex,basal,base,bearing,berry,broadly,calyx,campanulate,capitate,cm,coat,conspicuous,curved,cylindrical,densely,diameter,dimorphic,ellipsoidal,elliptic,embryo,entire,few-,filament,fruiting,glabrous,globose,hair,herb,herbaceous,investing,leaf,less,lilac,lobe,lobed,longitudinally,margin,mm,moderately,narrowly,near,non-glandular,ovate,ovule,pale,partially,petiole,pinnatisect,pore,poricidal,protuberance,pubescent,ridged,scarcely,seed,simple,sparsely,stigma,style,subglobose,tip,trans-ovoidal,trichome,tube,tuberculate,winged,x,yellow	0.3,0.5,0.7-,0.8-1.3,0.8-4,1,2.1,2.3-7,2.6,3.2-3.7,3.2-4.7,4-,5-6.2,abundant,ag,annual,antrorse,articulated,ascending,cuneate-attenuate,difoliat,eaf,eed,evident,hig,interlobular,lamina,larger,long,longitudinal,lower,membrane,minutely,multicellular,obtuse,occasionally,opening,orolla,other,outer,papery-scarious,pinnatipartite,portion,present,pubescen,ree,reticulate,rounded,ruit,seede,serrate,shorter,slender,slightly,slit,small,smaller,striate,strongly,styl,surface,tem,unequal,unifoliate,uniseriate,unit,vary,venatio,verrucose,wider,ympodial	0.7-1.3,4-6.2,colour,corolla,dimorphism,form,fruit,growth,height,length,number,ovary,plant,ridging,seeded,shape,size,stem,texture,type
33	wfo-0001026241	success	220	108	81	139	27	0.368	10-20,109,5,abaxially,adaxially,anther,appearing,appears,base,berry,black,branching,brown,calyx,capitate,cell,cm,conical,cordate,corolla,covered,cup,densely,depressed-globose,dry,et,fruit,fruiting,galiano,glandular-pubescent,globose,herb,inflorescence,internodal,leaf,lobed,mm,near,open,orangish,outline,ovary,ovate,ovoid,papillate,pedicel,peduncle,per,perennial,petiole,pinnatifid,pitted,pubescent,pulp,rachi,remain,reniform,seed,shallowly,sinuate,slightly,somewhat,stellate,stem,stigma,style,subshrub,succulent,sulcate,surface,taproot,ternate,testa,thick,thickened,triangular,tuberculate,way,white,woody,x	.2,.3,.5,0.1â0.15,0.2â,0.3â,0.3â0.4,0.3â0.6,0.3â1,0.5,0.5â0.7,0.5â0.8,0.5â1,0.7â1.1,1-,1-celled,1.2â1.5,1.2â2,1.5â1.7,1.5â2.5,1.5â3.5,1.9â2.1,1/3â1/2,1â,1â1.1,1â1.4,1â1.5,1â2,2-flowered,2.5â3,2â2.1,2â3,3,3-,30â50,3â3.1,4-,4.5â5,5-celled,5-merous,6,always,anthesi,apex,apical,articulated,attenuate,ba,basal,basiscopically,beak,brittle,broader,campanulate,center,connecting,curved,curving,darker,decurrent,deflexe,dehiscing,deltate,denser,dia,difoliate,discrete,drying,dwarf,eaf,eglandular,elliptic,enclosed,entire,equal,erect,erose,extended,filament,flower,foliat,foliose,free,geminate,glabrous,gland,glandular,intially,irregularly,larger,lateral,leaflet,like,lobe,lon,long,longitudinal,main,margin,midvein,mixture,much,nflorescence,oblique,one,onto,papillat,perfect,pericarp,pore,portion,prolonged,pubescen,robust,ruit,shiny,simple,slit,small,smaller,sometimes,spatulate,stamen,stout,strongly,terminal,tip,tissue,trichome,truncate,tube,ud,uniseriate,unit,usually,vein,wide,wing,ympodial	0.1-0.15,0.5-0.7,1-1.1,1-2,1.2-1.5,1/3-1/2,2-2.1,2.5-3,4.5-5,arrangement,articulation,bud,colour,form,growth,hair,history,length,life,number,pattern,position,root,shape,staman,texture,type
34	wfo-0001026242	success	210	75	56	154	19	0.267	0.4-2,0.5-0.7,0.55-0.9,0.7-1.3,1-2.5,1.5-3,1.5-4,10-20,2.5-4.5,6.5-8,acute,anther,apex,base,berry,bright,calyx,cm,cuneate,deltate,diameter,dull,evenly,flattened-reniform,flower,fruit,fruiting,glandular,green,hair,lateral,leaf,length,lobed,margin,membranous,minute,mm,orange-brown,pedicel,per,petiole,prickle,red,red-brown,shrub,spherical,stellate-pubescent,stem,style,tapering,venation,visible,white,yellow,young	-0.9,-1.5,-2,-5,-6,/4,0,0-2,0.05-0.2,0.1,0.3-0.5,0.35-,0.4-0.5,0.4-0.55,0.5,0.5-1,0.7,1-1.5,1-3,1.2-2,1/2,1/5-1/3,1/6-1/4,10-,2-2.5,2-5,2.5-2.8,3-6.5,30-80,4-10,4-13,4-5-merous,4.5-5.5,5-,5-18,5-7,7-17,8-20,abaxial,abaxially,acut,almost,alyx,ame,apar,apart,apically,apparently,articulated,bark,blade,branched,broad-deltate,c.,concolorous,connivent,curved,densely,difoliate,distance,drying,eaf,eed,elliptic,elongating,equal,erect,extending,eye,filament,filiform,flattened,free,geminat,glabrescent,glabrou,glabrous,green-gra,infructescence,irregularly,largely,lobe,long,longer,lower,mature,maturity,midpoint,midvein,moderately,multangulate,naked,narrow-deltate,nflorescence,obtuse,occasionally,older,one,open,orolla,oung,pair,pale,pale-brown,peduncle,perfec,pericarp,poricidal,porrect,portion,prickl,prickly,primary,ray,recurved,reflexed,rounded,ruit,scar,sessile,shorte,shorter,side,simple,smooth,sometimes,spaced,sparsely,spreading,stalk,stalked,stellate,straight,subentire,surface,tamen,terete,tertiary,time,tip,trichome,tube,unarme,unarmed,unit,upper,variously,vary,vein,way,weakly,wide,woody,ympodial	0.35-0.9,20,branching,colour,corolla,form,growth,height,inflorescence,number,ovary,plant,presence,present,seed,shape,staman,texture,type
35	wfo-0001026259	success	233	136	123	110	13	0.528	.8,0.3â1.2,0.4â0.6,0.5â0.6,0404,1.0â1.2,1.0â3.3,1.2â8.4,1.4â4.0,1.5,11â22,1â3-celled,2-ridged,2â17,3.0â3.4,35â45,6,8â11,?,abaxially,affected,age,anther,anthesi,apex,appressed,base,becoming,berry,branching,broadly,brown,calyx,cell,central,cm,concave-reniform,congested,conical-ellipsoid,corolla,cream-coloured,cylindrical,decurrent,diameter,ellipsoid,entire,especially,et,filament,fleshy,fruit,fruiting,glabrous,globose,green,green-orange,herb,inflorescence,knapp,leaf,length,lengthening,lilac,margin,membranous,minutely,mm,much,narrowly,nearly,node,occasionally,often,once-branched,ovary,ovate-lanceolate,papillate,pathogen,pedicel,peduncle,per,petiole,plant,pore,poricidal,pubescent,purple,purple-black,purple-coloured,rarely,recurving,ripe,rounded,shiny,short,shrub,simple,slightly,slit,smooth,somewhat,sparsely,spreading,star,stellate,stem,stigma,stone,straight,style,tightly,tinged,tip,translucent,trichome,turning,uniseriate,white,winged,woody,yellow,yellow-green,young	.1,.7,0.1â0.2,0.2â0.4,0.5,0.7â0.9,0â2,1,1-celled,1.5â2.0,12â24,1m,1â2,1â2-celled,2/3,2â3-celled,4â5,5-merous,5â14,5â7-celled,7â10,abaxial,acuminate,acute,adaxial,adaxially,apar,arising,beyond,branch,branched,close,coloured,cone,dehiscing,deltate,densely,difoliate,drop,eaf,eed,elongating,end,exerted,flower,free,geminat,gradually,growt,halfway,hilum,individual,internodal,larger,lateral,leave,less,like,live,lobe,lobed,lon,long,longer,lower,lowermost,narrower,near,nflorescence,one,outline,pair,pale,pentagonal,perfect,pericarp,portion,positioned,primary,rachi,reduced,reflexed,relatively,remaining,ruit,scar,shorter,similar,sometimes,spaced,splitting,stout,strongly,sub-laterally,surface,tall,tapering,tem,testal,thick,together,toward,tube,two,ud,unit,vein,wide,ympodial,â15	bud,colour,form,growth,hair,height,number,pattern,ridging,seed,shape,texture,width
36	wfo-0001026267	success	162	115	93	69	22	0.574	.25,.5,0.1-1,0.6-1.7,0.7-1.1,1-1.2,1-1.5,1-2.6,1-4,1.5-2,1.5-2.3,2.5-3,3-15,3.2-8.6,5-7,acuminate,acute,anther,anthesi,apex,attenuate,bark,base,blackish,body,bright,calyx,closely,cm,corolla,crateriform,cuneate,dia,difoliate,drying,filament,flattened-reniform,fruiting,glabrous,globose,green,greenish-white,incrassate,larger,leaf,lobed,long,margin,minor,minutely,mm,narrowly,nearly,occasionally,opposite,ovary,ovate,overlapping,papillose,pedicel,petiole,pitted,pitting,pore,pubescent,ripening,rough,scar,scattered,shaped,shrub,size,slender,slightly,small,spaced,stem,stigma,straight,style,surface,tapering,tear-drop,tip,tree,trichome,tube,uniseriate,unit,white,winged,x,yellow-green	0.5-1,20-30-flowered,3-6.1,4-8,8-10,8.5-15,axil,ba,beginning,beneath,berry,broadly,decurrent,deflexed,densely,depressed,differing,distally,distinct,eaf,edicel,eed,except,exerted,free,geminat,greyish-green,hard,inflorescenc,lateral,lavender,lobe,lon,longinflorescence,lower,main,major,maturity,middle,often,older,one,pair,pale,papillo,poricidal,portion,quickly,raised,reflexed,remaining,ruit,scarious,simple,softening,soon,sparsely,tall,tan,tinge,triangular,tuft,ud,vein,widest,wing,woody,ympodial,young	20-30,bud,colour,diameter,flower,form,fruit,geminate,growth,height,inflorescence,length,number,plant,position,pubescence,seed,shape,spacing,structure,sympodial,texture
37	wfo-0001026279	success	248	132	99	149	33	0.399	-2.9,-34.3,0.8-2.3,0.9-1.8,1-10,1-3.5,11.5-19.7,3.1-4.2,accrescent,acuminate,anther,apex,appressed,articulated,attenuate,base,berry,black,blunt-tipped,branch,branched,brown,bud,calyx,chartaceous,cm,completely,corolla,covering,cuneate,dark,deltoid,dendritic-echinoid,drying,echinoid,elliptic,entire,enveloping,filament,fleshy,fruit,fruiting,glabrescent,globose,granular,grayish,grayish-green,green,hair,immature,lanceolate,lavender,leaf,length,lilac,many,margin,mature,minute,mm,multangulate,narrowly,oblong,obovate,orbicular,pale,pedicel,peduncle,petiole,plant,pore,poricidal,porrect-stellate,rachi,reticulate-punctate,rounded,scabridulous,scabrous,sessile,short,shrub,simple,slowly,somewhat,stellate,stem,suborbicular,surface,time,tip,tomentose-pubescent,tree,unarmed,unwinged,white,whitish,yellowish,yellowish-tan,young	-11.4,-4,-5.9,/14-1/8,0.2-0.4,0.25-0.4,0.9-1,1-1.4,1.1-1.6,1.1-1.9,1.5-1.8,1.5-3,1.7-2.3,1.9-3,1.9-3.2,1/2,14-27,2.4-3.2,2.5-3.2,2.6-4.8,2/3,3-4,3.1-3.6,3.4-5.2,3.5-7.8,3.8-5.1,4-7.5,5-200,5-8,8,8-11,8.5-10.5,9-22,abaxially,acute,adaxiall,adaxially,ag,anthesi,apart,apparently,appearing,ark,around,axe,axillary,ba,blade,capitate,closely,conical,cylindrical,dendritic-echinoi,dense,diameter,directed,distally,due,eaf,earl,echinoi,edge,eed,elongated,equal,evident,exerted,expanded,farinose,few-rayed,flower,free,glabrescen,glabrous,half,inserted,lateral,lengthening,lobe,lobed,long,long-stalked,longer,longitudinal,longitudinall,lower,m.,main,midrib,mixed,multangulate-pubescent,multiseriate,nflorescence,occasional,occasionally,often,older,open,orolla,ovate-lanceolate,overlapping,partly,perfect,plurifoliate,present,prominent,pseudo-terminal,pubescence,ruit,scattered,secondary,semi-ovate,short-,short-decurrent,short-stalked,side,slightly,slit,spaced,splitting,stalk,stamen,stigma,style,subcampanulate,subcoriaceous,subsessile,sulcate,suture,tall,tamen,tertiary,thickened,thin,thin-stalked,tomentose,tube,ud,unarme,unit,upper,usually,vary,vein,way,wide,x,yellow,ympodial	abaxial,adaxial,arrangement,articulation,bark,bract,branching,colour,connective,form,growth,height,inflated,inflorescence,insertion,marking,modification,na,odour,position,prickle,pseudoterminally,scale,seed,shape,smell,spot,symmetry,texture,trichome,type,vegetative,zygomorphy
38	wfo-0001026299	success	239	127	103	136	24	0.431	0.1-0.2,0.1-0.25,0.1-0.4,0.2-0.25,0.25-0.5,0.3-0.4,0.4-0.5,0.5,0.5-0.6,0.5-1,0.5-2.5,0.8-0.9,0.8-1,0.9-1,1,1-1.4,1.1-1.7,1.2-1.6,1.5-2.3,1.8-2,2-locular,2.2-3.2,2.5-7,6-20,7-12,acute,almost,angled,anther,apex,apical,appendage,axi,base,bract,broadly,brown,calyx,capitate,cm,column,conical,corolla,crenate-serrate,dark,densely,diameter,distal,elliptic,entire,filament,fruit,fruiting,glabrous,glandular,globose,green,hair-like,half,herb,imparipinnate,inflorescence,interrupted,irregularly,leaf,leaflet,less,lobe,lobed,long,margin,middle,minute,minutely,mm,obovate,outgrowth,ovary,pale,pedicel,peduncle,pentagonal,perennial,petiole,pseudostipule,pubescent,regularly,short,simple,sparsely,staminal,stem,sterile,stigma,stripe,style,toward,trichome,truncate,variously,velvety,wide,yellow	--,-0.8,-1,-10,-2.5,-3.5,-5,.5,0-8,0.1-0.5,0.15-0.2,0.2-1,0.4-2,0.5-0.7,0.6-2,0.7-3.5,1-celled,1.2-5,1.5-,2-4,2-6,2-foliate,2.5,25,3-,3.5-10,5,5-15,5-20,abaxially,absent,abundant,acroscopically,adaxially,along,anthesi,appearance,approximately,articulated,basal,basiscopically,beneath,berr,bracteate,cell,change,chota,could,crenat,decurrent,developed,diamete,eaf,ebracteate,edicel,eed,eglandular,erect,exserted,flower,give,gree,hal,head,interjected,intermixed,internode,investing,jequetepeque,lacking,lanceolate,larger,lateral,like,lon,long-acuminate,longer,loosely,lower,maraÃ±Ã³n,maturity,mixture,multicellular,narrowly,nearly,nflorescence,node,oblique,occasionally,often,pair,patent,petiolule,population,present,primary,prostrate,pubescence,purple,rachi,reflexed,rest,ruit,scarcely,scattered,secondary,sessile,silky,size,sparse,spreading,stout,straight,surface,tall,tem,terminal,tertiary,testa,thick,tip,tube,ud,unicellular,uniseriate,unit,usually,valley,vein,wall,way,weak-walled,white,winged,woody,ympodial	1.5-10,3-15,abaxial,adaxial,angle,arrangement,articulation,branching,bud,colour,form,growth,hair,height,history,length,life,plant,seed,shape,texture,thicknes,type,width
39	wfo-0001026305	success	135	83	66	69	17	0.489	.25,/4,0.2-1,0.5-2,0.6-1,0.7-1,1-1.5,1.3-1.5,2-2.5,5-7,abaxial,abaxially,acute,adaxially,anther,anthesi,apex,area,attenuate,base,berry,calyx,cm,congested,conical,corolla,dendritic,densely,elliptic,filament,fruiting,glabrous,globose,green,greenish-white,leaf,leaf-opposed,lobed,long,minute,minutely,mm,ovary,ovoid-reniform,papillose,pedicel,petiole,pitted,pore,pubescent,rounded,shaped,shining,shrub,simple,sparsely,stigma,style,surface,tear-drop,tip,trichome,tube,unifoliate,way,x	0.25-0.5,2-6-flowered,2.5-3,3-8.5,4-4.5,6-9,7-16,7-9,along,apical,ba,bark,beige-tan,closely,dark,deflexed,deltate,dia,difoliate,drying,eaf,edicel,eed,exserted,free,geminat,glabrate,interlocking,knob-like,lamina,lateral,like,lobe,lon,lower,main,margin,middle,midrib,nflorescence,occasionally,older,overlappin,pair,pale,planar,poricidal,portion,projection,reddish-brow,ruit,scar,scattered,slender,spaced,stem,strongly,styl,tall,tan,tub,ud,unit,vein,visible,widest,woody,ympodial,young	arrangement,branching,colour,diameter,form,fruit,growth,hair,height,inflorescence,length,plant,position,seed,shape,texture,type
40	wfo-0001026307	success	193	145	123	70	22	0.637	.3,.5,.6,.8,0.2â1.5,0.4,0.5â0.6,0.5â0.7,0.5â5.0,0.6,0.8â0.9,0.8â2,0.8â5,1.0â1.2,1.0â2.0,1.0â2.4,1.0â2.5,2.0,2.0â3.5,2.6â13,2/3,3.0â4.0,3.5â7.0,35â45,3â8-celled,4â5.7,abaxial,acute,acute-acuminate,adaxial,age,angled,anther,apex,appressed,articulated,base,berry,black,broadly,calyx,cell,central,clavate,cm,corolla,cuneate,cylindrical,decurrent,densely,diameter,ellipsoid,end,entire,eye,filament,flattened-reniform,fruit,fruiting,glabrous,glandular,globose,green,growth,herb,hilum,internodal,lateral,length,lengthening,lobe,lobed,long,margin,minutely,mm,narrower,narrowing,ovary,ovate,paler,pedicel,peduncle,per,petiole,pore,poricidal,positioned,pubescent,purple,purple-yellow,reflexed,ripe,scar,shallowly,shape,shrub,simple,slightly,slit,sparsely,stellate,stem,stigma,stone,style,sub-laterally,surface,tinged,tip,toward,translucent,trichome,tube,turning,undulate,unequal,uniseriate,variable,white,wide,yellow,yellow-green	.0â1.2,.5â4.0,0.2â0.5,1.0â1.5,1â3-celled,1â6-celled,2.0â3.0,3â8,5-merous,5â7,8â12,9,abaxially,adaxially,anthesi,apar,becoming,beyond,cone,difoliate,eaf,eed,exerted,facing,flower,free,geminat,gradually,later,like,longer,lower,membranous,middle,new,nflorescence,one,outline,pair,papillat,pentagonal,perfect,portion,primary,recurved,reflexe,restricted,ruit,shallow,shorter,side,spaced,spreading,ste,straight,strongly,tal,tem,testal,three,triangular,two,ud,unevenly,unit,upper,vein,vigorous,weak-stemmed,ympodial	angle,apart,articulation,branching,bud,colour,form,glandularity,height,inflorescence,leaf,lobing,number,papillate,plant,position,pubescence,seed,size,spacing,type,width
41	wfo-0001026317	success	169	107	90	79	17	0.533	.5,/4,0.25-1,0.3-1.2,0.5,0.5-0.6,0.7-0.9,1-1.2,10-12,2-2.5,2-4,2.5-10,4-5,6-8,6x,acuminate,acute,anther,anthesi,apex,approximately,attenuate,bark,base,berry,branched,bright,brown,capitate,closely,cm,conical,corolla,dark,dendritic,densely,diameter,distally,elliptic,entire,filament,flattened,fruiting,glabrous,globose,growth,inflorescence,less,lobed,many,margin,mm,narrowly,new,orange,ovary,packed,pair,pale,pedicel,peduncle,per,petiole,planar,pore,poricidal,primary,pubescence,pubescent,red,reflexed,reniform,scar,shiny,shrub,simple,slightly,sparsely,stem,stigma,style,time,tip,trichome,uniseriate,vein,way,white,x,yellowish	0.5-0.8,0.5-1,0.6-,0.8-1,1-1.5,1-5.7,2-,3,3-3.5,3-foliate,3.5-15,50-200,?,abaxially,absent,adaxially,age,apart,apically,calyx,clonal,correlated,deltate,dense,drying,eaf,eed,em,erec,erect,essentially,exerted,extremely,flower,found,free,geminat,halfwa,internodal,lamina,lengthening,like,lobe,longer,lower,maturity,minutely,nflorescence,nodding,occasionally,often,papillat,papillate,perfect,pericarp,pitted,plane,plant,population,portion,pubescen,pulp,rachi,ruit,slit,sticky,straight,surface,swollen,terminal,thin,toward,triangular,tube,ud,unit,variable,woody,ympodial	abaxial,adaxial,arrangement,branching,bud,colour,exertion,form,fruit,halfway,leaf,length,number,seed,shape,texture,type
42	wfo-0001026335	success	157	98	79	78	19	0.503	.5,0.25-0.5,0.5-1,0.6-1,1-2,1.5-2,10-20,10-30,2,2-3,2-4,2-7.5,3-18,4-5,5-15,5-7,abaxially,acuminate,adaxially,anther,apex,base,branched,calyx,chartaceous,cm,cuneate,curved,cylindrical,densely,diameter,directed,distally,elliptic,elliptic-ovate,entire,flattened,flower,forked,fruit,glabrescent,glabrous,globose,green,hair,large,leaf,longitudinal,margin,mm,moderately,multangulate,oblong,opening,pedicel,peduncle,petiole,pore,probably,pubescent,rachi,reticulate,ripe,rounded,sessile,shrub,simple,slit,stellate,stem,stigma,straight,style,surface,unripe,white,whitish,x,yellowish	.5-3.5,0.1-0.3,0.8-1.3,1,1-1.5,1-3,1-4,1.5-4,3-5,5-,7-8,accrescent,acute,adaxiall,ag,apart,apparently,articulated,axe,ba,blade,capitat,connivent,covering,deltate,dense,eaf,eed,equal,erect,especially,filament,frui,fruiting,geminate,glandula,glandular,held,lanceolate,leaf-opposed,like,lobe,long,lower,many-foliate,midpoint,much,nflorescence,often,orolla,paired,perfect,pubescence,ray,ruit,scattered,slightly,smaller,sometimes,spaced,ste,stellate-pubescent,subtending,tal,tamen,tem,time,tip,toward,tube,unit,uprigh,usually,vary,vein,wide,yellow,ympodial	age,branching,capitate,colour,corolla,form,growth,height,inflorescence,length,number,ovary,plant,seed,shape,size,staman,texture,type
43	wfo-0001026343	success	221	95	73	148	22	0.33	.5,0-10,0-2,0-40,0.05-0.5,2-5,2-8,2.5-8,5-10,7-12,abaxial,acute,adaxial,anther,apex,base,berry,branched,broadly,calyx,chartaceous,cm,cream,cuneate,dark,densely,dull,elliptic,elongating,equal,flattened-reniform,flower,fruit,fruiting,glabrescent,green,lateral,leaf,length,lobed,long,lower,margin,marking,maturity,mauve,mm,orange,orange-brown,pale,per,petiole,poricidal,porrect,prickle,purple,rounded,sessile,shrub,small,sparsely,spherical,stalked,stellate,stellate-pubescent,stem,surface,tapering,tip,tree,trichome,yellow,young	-1,-1.5,-15,-3.5,-4,-7,/2,/5,0,0-4,0-5,0.05-0.2,0.1-0.2,0.15,0.2,0.2-0.3,0.2-0.7,0.3,0.45-1,0.5,0.5-1.5,0.8-1.5,1-2,1-3,1-4,1.3-1.7,1.5-2,1.5-2.5,1.8-2.2,1.8-3,1/,1/3,1/4-2/3,1/5,10-30,2-3,2-3.2,2-4,2-6,2.2-3.2,3-4,3-5,3.5-4.5,5-merous,5.5-9,6-9,7-14,7-8,7-9,abaxially,acuminat,alyx,andromonoecious,apar,apart,apically,apparently,articulated,bark,blade,brow,concolorous,connivent,curved,deltate,diameter,distal,distance,drying,eed,erect,extending,faint,filament,flattened,free,glabrous,green-brown,hermaphrodite,heterostylous,infructescence,less,lobe,lobing,lon,long-styled,longer,lowermost,mature,midpoint,midvein,moderately,multangulate,narrow-deltate,nflorescence,obtuse,older,one,open,orolla,oung,ovate,pair,pedicel,peduncle,pendulous,pericarp,plant,plurifoliat,portion,prickl,prickly,primary,ray,reddish,reduced,reflexed,ruit,scar,secondary,short-styled,side,smooth,sometimes,spaced,spreading,stalk,staminat,stout,style,tamen,terete,tertiary,time,tube,unarmed,unit,upper,variously,vary,vein,venation,visible,way,weakly,wide,woody,ympodial	branching,colour,corolla,form,growth,hair,heteromorphism,inflorescence,na,needle-like,number,orientation,placement,position,seed,shape,staman,symmetry,texture,type,width,zygomorphy
44	wfo-0001026352	success	209	102	93	116	9	0.445	0.5,0.5-0.8,0.5-1.5,0.5-3,0.9-1,1-10,10+,2,4-4.5,<,?,abaxially,acuminate,acute,anther,antrorsely,apart,apex,articulated,articulation,axi,base,berry,blue,branching,broadly,calyx,chartaceous,cm,cordate,corolla,curved,deltate,densely,diameter,ellipsoid,entire,evenly,filament,flattened,fruiting,globose,green,growth,inflorescence,irregularly,lamina,leaving,length,like,lobe,lobed,long,many,margin,membranous,mm,narrowly,near,nearly,outline,ovate,pale,papillate,pedicel,peduncle,peg,per,petiole,pink,pubescent,reniform,revolute,scar,shallowly,simple,sleeve,small,spaced,stellate,stem,time,trichome,truncate,tube,uniseriate,vein,vine,violet,weak,white,woody,yellowish	.3,.5,0.5-1,0.6-,0.7-2,1-,1-1.5,1-2-celled,1.2-1.7,1.5,1.5-2,1.5-4.6,12-60,2-3-celled,3-15,3.5-9,5-6,5-merou,6-7,7-9,adaxiall,ag,almost,alyx,angle,anthesi,apparently,appearance,arising,bark,basal,bending,branch,brown,capitate-truncate,cell,conical,deciduous,denser,discolorous,eaf,eed,eventually,expanded,exserted,few-celled,flower,free,giving,glabrous,greenish,half,heigh,herbarium,ilament,immature,impressed,inflorescenc,junction,large,largest,leafy,leave,lengthening,lower,mature,minutely,new,nflorescence,older,orolla,pair,papillo,perfect,pericarp,plurifoliat,point,pore,poricidal,portion,primary,principal,rachi,reflexed,rest,right,ruit,seen,shiny,shoot,short,slit,sparser,specimen,spreadin,spreading,stigma,straw-colored,strongly,style,surface,tem,terminal,thin,third,tip,tub,tuberculate,ud,unit,unspecified,upper,vary,wide,widest,ympodial	colour,form,fruit,hair,leaf,number,seed,shape,texture
45	wfo-0001026352	success	214	120	110	104	10	0.514	.5,0.5,0.5-0.8,0.5-1.5,0.5-3,0.9-1,1-1.5,1-10,10+,2,4-4.5,5-6,<,?,abaxially,acuminate,acute,adaxially,anther,antrorsely,apart,apex,articulated,articulation,axi,basal,base,berry,blue,branch,branching,capitate-truncate,chartaceous,cm,connivent,cordate,corolla,curved,densely,diameter,ellipsoid,entire,evenly,filament,flattened-reniform,form,fruiting,glabrous,globose,green,growth,half,inflorescence,irregularly,lamina,leaf,leaving,length,lengthening,like,lobed,long,many,margin,membranous,minutely,mm,narrowly,near,nearly,outline,pale,papillate,pedicel,peduncle,peg,per,petiole,pink,pore,poricidal,principal,pubescent,revolute,scar,shallowly,shiny,simple,sleeve,slit,small,spaced,stellate,stem,stigma,style,surface,time,tip,trichome,truncate,twining,uniseriate,vein,vine,violet,weak,white,x,yellowish	.3,0.5-1,0.6-,0.7-2,1-,1-2-celled,1.2-1.7,1.5,1.5-2,1.5-4.6,12-60,2-3-celled,3-15,3.5-9,5-merou,6-7,7-9,ag,almost,alyx,angle,anthesi,apparently,appearance,arising,ark,bending,broadly,brown,calyx,cell,conical,deciduous,deltate,denser,discolorous,eaf,eed,eventually,expanded,exserted,few-celled,flower,free,geminat,giving,greenish,heigh,herbarium,ilament,immature,impressed,inflorescenc,junction,large,largest,leafy,lobe,lower,mature,new,nflorescence,older,orolla,ovate,pair,papillo,perfect,pericarp,plurifoliate,point,portion,primary,rachi,reflexed,rest,right,ruit,seen,shoot,short,sparser,speciman,specimen,spreadin,spreading,straw-colored,strongly,tem,terminal,thin,third,tub,tube,tuberculate,ud,unit,unspecified,upper,vary,widest,woody,yellow,ympodial	age,colour,fruit,hair,number,ovary,papillose,seed,shape,texture
46	wfo-0001026379	success	219	183	160	59	23	0.731	-4.5,0.2-0.38,0.2-0.4,0.7-1,0.7-2.5,0.8-1.2,1-1.7,1-10,1-2,1-3.7,1.3-2.1,1.5-2.3,1.7-4.9,1.8-2.6,1.8-3.2,1.9-3.4,1/2,13,2-2.8,2-7,2.6-3.7,2/3,4-5,4.1-7,5.3-10.2,50-450,8-13,8-15,8.3-10,9-14,abaxially,acute,adaxially,along,anther,apart,apex,around,attenuate,bark,basal,base,blunt-tipped,branch,branched,brown,calyx,chartaceous,cm,conical,corolla,cylindrical,dark,dendritic-echinoid,densely,diameter,directed,distal,distally,dried,echinoid,echinoid-pubescent,edge,ellipsoid,entire,evident,farinose,few-rayed,filament,finely,flower,free,fruit,glabrous,globose,granular,gray-brown,grayish,growth,hair,inserted,large,lateral,leaf,length,lengthening,line,lobe,long-attenuate,main,many,margin,midrib,minute,minutely,mm,mostly,multangulate,multangulate-pubescent,nearly,oblong,obovate,obtuse,ovate,ovate-lanceolate,pale,partly,pedicel,peduncle,persistently,petiole,pitted,plant,pore,poricidal,porrect-stellate,rachi,reniform,rich,scabrous,scattered,semi-ovate,sessile,short-stalked,shrub,side,simple,size,slit,small,sometimes,somewhat,sparse,stellate,stellate-,stellate-pubescent,stellate-tomentose,stelliform,stigma,style,suture,terete,testa,time,tip,tomentose-pubescent,translucent,tree,tube,upper,usually,vein,velutinous-pubescent,vestigial,violet,whitish,whitish-brown,x,yellow,young	0.9-1.2,1.8-5,2.4-5.1,2.9-4,3-11,3/4,6-10.6,8-29,accrescent,adaxiall,ag,anthesi,apparently,articulated,axillary,ba,berry,blade,capitat,closely,completely,covering,eaf,echinoi,eed,enveloping,fleshy,fruiting,hig,included,lacking,lobed,long,lower,m.,mature,multangulat,nflorescence,often,older,orolla,perfect,plurifoliate,present,pubescen,rather,recent,ruit,runk,spaced,stem,tamen,thin,ud,uneven,unit,vary,way,ympodial	age,arrangement,branching,bud,capitate,colour,direction,farinosenes,form,glabrousnes,height,inflorescence,insertion,number,ovary,pubescent,seed,shape,spacing,staman,texture,trunk,type
47	wfo-0001026400	success	187	131	109	78	22	0.583	0.2-0.8,0.4-1,0.5-1.2,0.7-1.1,1-10,1-2,1.3-2.6,10-18,10-28,12-27,13-30,2-8,2.4-5.9,3.4-4.8,3.5-5.9,30-55,4-7,5-7,6-13,6-15,6.5-20,8-12,9-13,acumen,anther,blade,blue,brownish,cell,clavate,cm,condition,coriaceous,corolla,dark,deep,diameter,digestion,distal,dorsally,drying,edge,elliptic,enzyme,filament,finely,flat,flower,folded,forked,fresh,fruit,glabrescent,glabrous,globose,green,greenish,hair,half,herb,high,homostylous,honeycomb-shaped,interjected,lanceolate,lateral,leaf,leaflet,lengthening,light,lilac,linear,lobe,mm,moderately,odd-pinnate,ovate,ovoid,pair,pedicel,peduncle,pentagonal,petiole,plant,pore,poricidal,puberulent,pubescent,purple,removed,ripe,seed,semi-stellate,short,simple,size,slit,stigma,straight,stripe,style,terminal,testal,tip,tube,wall,white,whitish,x	0.5-1,1.7-2.2,2-6,3-6,5-merou,abaxially,acuminate,acute,adaxiall,adaxially,ag,alyx,apart,apex,apparently,articulated,asymmetric,attenuate,axe,axillary,base,basiscopic,berry,bud,capitat,connivent,covering,decreasing,decurrent,eaf,eed,erec,exceeding,geminat,generally,glabrou,gree,green-white,hair-like,hal,living,long,lower,make,mucilaginous,nflorescence,orbicular,orolla,perfect,petiolulate,plurifoliate,rounded,ruit,sessile,seudostipule,side,slightly,spaced,specimen,stamen,subequal,subtending,tall,tamen,tem,thick,throughout,tissue,toward,tri-,typically,unit,unwinged,usually,vary,wet,yellow,ympodial	abaxial,adaxial,age,arrangement,articulation,branching,calyx,capitate,colour,form,growth,height,inflorescence,length,ovary,pseudostipule,shape,spacing,staman,stem,symmetry,texture
48	wfo-0001026406	success	219	83	63	156	20	0.288	.2,00-200,1/4-1/3,5-8,6.5-7,abaxial,acute,adaxial,anther,apex,base,berry,branched,calyx,chartaceous,connivent,cordate,cream,dark,densely,dirty-whitish,elongating,equal,flattened-reniform,flower,fruit,fruiting,green,herb,lateral,leaf,length,lobed,long-styled,margin,marking,mature,maturity,mauve,midvein,mm,obtuse,ovate,pale,per,petiole,poricidal,prickle,purple,red-brown,reflexed,short-styled,shrub,spherical,stellate-pubescent,stem,tapering,terminal,tip,velvety,white,yellow,young	-1,.5,0,0-3,0-30,0-5,0.3,0.3-0.5,0.3-0.7,0.4-0.8,0.4-0.9,0.5,0.5-1.5,0.5-2.5,0.8,1,1-2,1.3-1.5,1.5-2,1.5-5,1.8-2.4,1/,1/3,1/4,1/4-1/2,10-30,12-19,2-2.7,2-3,2-6,2.5-8,2.9-3.2,20-60,3-10.5,3-4,3.2-3.8,30-60,5,5-25,5-50,5-6,5-7,5-merous,6-12,6-15,7-10,7-8,7-9,9-15,abaxially,adaxially,alyx,ame,andromonoecious,apar,apart,apically,apparently,articulated,bark,blade,broad-deltate,c.,cm,conical,curved,deltate,diameter,discolorous,distal,distance,drying,eaf,eed,elongated,erect,extending,filament,flattened,foliaceous,free,fully,gently,glabrous,hermaphrodite,heterostylous,infructescence,least,lobe,lon,long,longer,lower,lowermost,midpoint,moderately,nflorescence,oblong,older,one,open,opening,orange-brown,orolla,oung,pair,pedicel,peduncle,pendent,pendulous,pericarp,plant,plurifoliat,porrect,portion,prickl,prickly,primary,ray,rounded,ruit,scar,sessile,side,smooth,sometimes,spaced,sparsely,spreading,stalk,stalked,staminat,stellate,stout,straight,style,surface,tamen,terete,tertiary,time,trichome,tube,unit,upper,variously,vary,vein,venation,visible,way,weakly,wide,woody,yellow-brow,ympodial	branching,broad-based,colour,corolla,form,growth,heteromorphism,inflorescence,needle-like,number,orientation,placement,position,seed,shape,staman,symmetry,texture,type,zygomorphy
49	wfo-0001026407	success	221	155	132	89	23	0.597	.5,/3,0.5,0.5-0.6,0.5-1,0.5-2,1,1-1.2,1-10,1.2-1.5,1.3,20-30,3.5,4-5,7-8,abaxially,acute,adaxially,anther,apart,apex,articulated,axi,basal,base,becoming,berry,black,branched,broadly,brown,brownish,capitate,chartaceous,cm,congested,connivent,corolla,deep,dendritic,densely,diameter,ellipsoid,elliptic,entire,erect,filament,flattened-reniform,fleshy,flower,free,fruiting,glabrous,globose,golden,golden-pubescent,growth,inflorescence,internodal,irregularly,lateral,lax,leaving,lengthening,like,lobed,long,loosely,lower,many,margin,markedly,membranous,minutely,mixture,mm,narrowly,new,numerous,oblique,obscured,occasionally,outline,pale,papillate,pedicel,peduncle,peg,per,perfect,petiole,pitted,pore,poricidal,portion,pubescence,pubescent,purple,purplish,reddish,revolute,ripe,scar,shiny,short,shrub,simple,sleeve,slightly,slit,small,spaced,stellate,stem,stiff,stigma,style,surface,terminal,testal,time,tip,trichome,truncate,tube,upper,vine,violet,way,woody,x,yellow	+,-11,-6,0.9-3,1.5-1.7,1.5-2,1.5-7,2-2.5,2.5-3,20-40,3.5-5.5,5,5-10,5-7,5-merou,7-10,ag,aid,along,always,alyx,anthesi,appearing,area,ark,around,beneath,berr,blunt,branch,calyx,cell,clear,climbin,conical,deltate,dense,denser,discolorous,eaf,eed,evenly,exserted,geminat,glabrescen,glabrou,ilament,interpetalar,lamina,leafy,lobe,midvein,near,nflorescence,often,older,open,orolla,pair,paler,papillat,pedice,pentagonal,pericarp,persistent,planar,plurifoliate,primary,pubescenc,ruit,sinus,sparsely,sparser,spreading,stout,strongly,tangled,tem,thin,transition,twining,ud,undulate,unit,usually,vary,vein,weak,ympodial	5-merous,age,arrangement,articulation,bark,branching,bud,colour,discoloration,form,fruit,glabrescent,hair,leaf,length,number,ovary,position,seed,shape,texture,type,ye
50	wfo-0001026424	success	138	69	55	83	14	0.399	0.75-1.5,1-1.5,1-10,1-2,1.5-2,10-15,12-60,15,15-30,3-11,3-4,acuminate,acute,anthesi,apex,base,blush-violet,broadly,calyx,campanulate,cell,cm,corolla,cuneate,cyme,ellipsoid,elliptic,facetted,glandular,hair,lanceolate,lanceolate-elliptic,leaf,line,lobe,lobed,long,minute,mm,oblique,obovate,pedicel,petiole,pinnatisect,raised,rarely,rotate-stellate,rounded,scorpioid,shrub,simple,stem,stone,triangular,x	-25,-3.5,-4,1,1-,10,2,637/1,8-,acuman,acumen,age,angular,aspect,axil,ba,becoming,blunt,bluntly,broad,clonal,close,common,conspicuous,cut,dia,distinct,downard,eaf,erect,exceeding,except,exerted,facing,floral,flower,fork,forked,general,glabrous,gree,growing,interacuminal,lacking,larger,lasting,lavender,lon,lower,midvein,nflorescence,often,part,pedicellate,peduncle,plurifoliat,point,rachi,rh,second,several,shallowly,short,sinus,slightly,soft-wooded,soon,straggly,time,tip,tissue,toward,tub,ud,unit,unwinged,usually,violet,within,woody,year,ympodial,young	1-3.5,8-25,angularity,bud,colour,diameter,form,growth,inflorescence,length,number,shape,size,type
51	wfo-0001026440	success	181	158	132	49	26	0.729	0-15,1-5,1.1-1.5,1.3-1.7,1.5-2.1,1/2,1/2-2/3,2-2.8,2-4,2.9-4.4,3-7,3-8,3/4,5-7,7-14,9,abaxially,accrescent,acute,adaxially,along,anther,apex,appressed,articulated,bark,basal,base,berry,blunt-tipped,bract-like,branch,branched,broadly,brown,calyx,chartaceous,closely,cm,conical,corolla,dendritic-echinoid,dense,diameter,dichotomy,directed,distal,distally,echinoid,elliptic,entire,filament,first,fleshy,flower,fruiting,globose,granular,green,greenish-yellow,hair,large,leaf,length,lengthening,lobe,long-attenuate,many,margin,minute,minutely,mm,mostly,multangulate,multangulate-pubescent,nearly,oblong,obovate,obovoid-oblong,obscure,obtuse,often,openly,ovate,pair,pale,pedicel,peduncle,perfect,persistently,petiole,pitted,pore,porrect-stellate,reniform,ripe,scabrous,semi-ovate,sessile,short-acuminate,short-stalked,shrub,simple,size,slit,small,somewhat,spaced,sparse,stellate,stellate-pubescent,stigma,style,suture,terete,testa,time,tomentose,tomentose-pubescent,tomentum,translucent,tree,truncate,tube,turning,uneven,usually,way,white,x,yellow,young	1.1-1.4,1.8-4.5,1.9-3.7,14-30,3-5,3.9-6.5,4-12,adaxiall,ag,always,anthesi,apparently,axillary,ba,blade,branche,capitat,developed,eaf,echinoi,eed,free,high,included,inserted,lobed,long,lower,m.,multangulat,nflorescence,older,orolla,plurifoliate,poricidal,pubescen,rather,ruit,runk,sometimes,stem,tamen,thick,thin,tip,ud,unit,vary,ympodial	age,articulation,bract,branching,bud,capitate,colour,form,fruit,growth,height,inflorescence,insertion,lobing,ovary,pattern,plant,pubescent,seed,shape,spacing,staman,texture,thicknes,trunk,type
52	wfo-0001026441	success	197	133	111	86	22	0.563	0-2,0.3-0.7,1-1.5,1-2,1.5-2.5,10,10-14,2-2.5,2-8,3-5,4-6,4-8,4-8.5,5,5-10.5,7-20,7-8,9-14,abaxially,adaxially,anther,base,berry,blade,brownish,cell,chartaceous,ciliate,cm,condition,conical,corolla,covering,decreasing,diameter,drying,elliptic-lanceolate,end,especially,filament,flower,forked,fresh,fruit,glabrous,gradually,green,green-white,greenish,hair,hair-like,herb,homostylous,interjected,lanceolate,lateral,leaf,leaflet,lengthening,light,like,lobe,long,make,margin,minute,minutely,mm,mottled,mucilaginous,odd-pinnate,one,orbicular,ovate,ovoid,pair,pale,petiole,placed,plant,pore,poricidal,puberulent,pubescent,purple,ripe,rotate,seed,size,slit,sparsely,stem,stigma,style,subequal,subsessile,terminal,testal,thick,throughout,tip,toward,tube,tuber,typically,usually,violet,wall,wet,whitish,x	.5,0.4-3,0.5-1.5,0.8,1-10,1.5-2,15-20,2-5.5,4.5-6.5,5-merou,6-15,absent,acumen,acuminate,ag,alyx,apart,apex,apparently,articulated,attenuate,axe,axillary,bud,capitat,connivent,digestion,distal,dorsally,eaf,edge,eed,enzyme,equal,erec,exceeding,flat,folded,fourt,geminat,generally,glabrou,half,honeycomb-shaped,internal,larger,living,lower,middle,narrow,nflorescence,obtuse,orolla,pedicel,peduncle,perfect,petiolule,plurifoliate,removed,rounded,ruit,secondary,semierect,seudostipule,short,slightly,spaced,specimen,stamen,star,ste,stolo,straight,subtending,symmetrical,tall,tamen,tem,tri-,unit,vary,white,wide,wing,yellow,ympodial	5-merous,age,arrangement,branching,calyx,capitate,ciliation,colour,form,growth,height,inflorescence,length,number,ovary,placement,pseudostipule,shape,stolon,texture,type,width
53	wfo-0001026460	success	131	108	86	45	22	0.656	.1,.5,0.5-1.5,1-1.5,1.5-2,1/2,10-15,13.5-21,2-2.5,2.5-3,4.5-5,5,6-7,6-9,7-9,8-10,abaxially,acute-acuminate,adaxially,anther,anthesi,apex,axi,base,berry,branched,calyx,capitate,closely,cm,completely,conical,corolla,dia,distal,elliptic,filament,filiform,floccose,flower,fruiting,glabrous,globose,green,inflorescence,leaf,less,lobe,lobed,long,long-exserted,middle,minutely,mm,nearly,older,opposite,ovary,ovoid-reniform,pair,papillose,pedicel,pitted,pore,puberulent,reddish,scar,shaped,shrub,simple,spaced,stem,stigma,style,subshrub,surface,tapering,tear-drop,trichome,tube,vein,white,widest,x,yellow,young	513,acut,becoming,brown,dark,deflexed,deltate,do,drying,eaf,edicel,eed,erect,fide,free,frui,greenish,inflorescenc,internodal,like,lower,major,membraneous,nflorescence,often,pale,papillo,poricidal,portion,reddish-brow,reflexed,ruit,santo,slightly,somewhat,soon,tall,tiny,tip,tub,ud,unifoliat,unit,woody,ympodial	acute,branching,bud,colour,diameter,exsertion,form,fruit,growth,height,length,number,part,plant,position,reddish-brown,seed,shape,size,spacing,texture,type
54	wfo-0001026489	success	153	90	64	89	26	0.418	.3,0.05-0.1,0.25-0.5,0.8-1.3,1-1.5,1.5-5,2-5,2.5-4,2/3,5-6,acute,along,anther,anthesi,area,axil,base,berry,branched,brown,calyx,cm,corolla,dark,deflexed,densely,elliptic,erect,filament,flattened-reniform,fruiting,glabrous,globose,green,leaf,lobed,long,margin,minutely,mm,opposite,ovary,papillose,pedicel,petiole,pitted,pore,poricidal,pubescent,shaped,shrub,simple,stigma,style,tear-drop,tip,trichome,tube,uniseriate,vein,way,white,widened,woody	0.5,0.5-0.75,0.5-1,0.5-2,0.6-1.4,0.8-1.2,0.8-3.7,1.3-3,2-3,2-4,2-8-flowered,2.5-13,8-13,apex,appearing,ba,bark,beneath,broadly,closely,cup-shaped,deltoid,dia,differing,difoliate,dry,eaf,edicel,eed,exserted,extending,flattened,fleshy,free,geminat,gra,incrassate,lamina,later,lateral,lobe,lon,lower,main,major,middle,minor,nflorescence,occasionally,often,older,one,overlappin,pair,paler,papillo,parallel,perpendicular,planar,portion,prominent,red-papillose,rhachi,ruit,scar,shiny,size,slender,somewhat,soon,spaced,specimen,stem,straight,strongly,surface,tall,tapering,terminal,thickened,tub,ud,unit,usually,whitish,widest,x,ympodial,young	abaxial,articulation,bract,branching,colour,diameter,form,fruit,growth,hair,height,inflorescence,insertion,length,marking,na,odour,paired,plant,position,seed,shape,spot,symmetry,texture,type
55	wfo-0001026490	success	272	149	127	145	22	0.467	0.1â0.2,0.1â2.5,0.2â1,0.4â0.8,0.5â1.5,0.8â1.5,1â1.2,1â8,2â6,3â4.5,5â7,7-pinnate,acute,along,anther,anthesi,apex,around,articulated,axillary,base,branched,chartaceous,climbing,cm,connivent,corolla,crisped,cylindrical,darker,densely,directed,distally,ellipsoidal,elliptic,equal,extra-axillary,flat,flattened,flower,fruit,glabrous,green,ground,immature,incurved,inflorescence,large,latrorse-introrse,leaf,leaflet,length,lenticular,lobe,long,longitudinal,lower,main,margin,mature,middle,midvein,mm,moderately,mottled,near,node,oblique,obliquely,oblong,obtuse,obtusely,one,opening,orange,ovate,papillose,pedicel,pentagonal,per,petiole,pointed,pore,present,pseudostipule,pubescence,pubescent,radial,reflexed,rounded,seed,shape,shoot,short,simple,slightly,slit,smooth,sometimes,sparsely,spur,stem,stigma,striation,striping,strongly,style,surface,tawny,teardrop-shaped,terminal,tip,transparent,trichome,truncate,vegetation,vine,violet,white,wide,wing,woody,yellow,yellowish-tan,Â½,Ã,â4.5	.5,0.2â1.5,0.3â3.5,0.5â1,0.5â3.5,0.5â8,0.7â3,0.8â12,1.2â8,1.5,1.5â2,1.5â3.5,1.5â5,1.8â2.2,1.9,10â20,1â15,1â2.5,1â3,2,2.5â3.5,2â2.5,2â4,2â8,3,3â4.2,3â5,3â5-pinnate,3â8,4.6,4â4.5,4â5,5-merous,6,7,7â15,=,[,],abaxially,absent,accrescent,acuminate,adaxially,ag,alyx,apart,apical,apicall,apparently,axe,ba,becoming,blade,bract,bracteate,broadly,brown,calyx,capitat,cauline,ciliate,commonly,completely,contiguously,cordate,covered,decreasing,diameter,distal,eaf,eed,eglandular,entire,exceeding,expanded,filament,free,fruiting,fused,geminat,interjected,irregularly,lacking,lateral,light,lobed,lowermost,lunate,markedly,match,mean,mean=,medium,minute,multicellular,nearly,nflorescence,obliqu,oblon,occasionally,orolla,ovate-lanceolate,pair,part,peduncle,perfec,perfect,petiolule,plurifoliate,pubescen,punctate,pur,rachi,reniform,resulting,revolute,rooting,ruit,sand,seudostipule,shorter,similar,size,slender,smaller,somewhat,spaced,stamen,tamen,tem,thickened,toward,trailing,trichomessympodial,tube,typically,unbranched,undulate,unit,vary,youn,â4,â8,â9.5	abaxial,adaxial,age,arrangement,articulation,branching,capitate,colour,form,growth,hair,heteromorphism,number,ovary,placement,position,prickle,staman,texture,type,width,young
56	wfo-0001026491	invalid_json	165	149	115	50	34	0.697	.5,1,1-2,1.5-2,1.5-2.5,1.5-3.5,1.7,10-50,2-3,2-4,2-celled,2.5-3.5,3,3-pinnate,5-6,5-8,6-8,7-8,abaxially,absent,acuminate,acute,adaxially,anther,apex,appressed,articulated,averaging,base,bent,berry,blade,bract,branched,branching,broadly,cellular-papillose,cellular-pilose,central,cm,conspicuously,cuneate,deciduous,deep,deltoid,diameter,directed,elliptic-lanceolate,entire,flower,glistening,globose,green,hair,highly,homostylous,inflorescence,interjected,lanceolate,leaf,leaflet,less,light,lobe,long,margin,middle,minutely,mm,near,oblong-elliptic,obtuse,often,ovate,ovate-elliptic,ovoid,pale,pedicel,peduncle,perfect,petiole,pilose,pore,poricidal,porrect-incurved,present,pubescent,purple,readily,rotate-pentagonal,rotate-substellate,rounded,row,sharp,shortly,shrub,simple,small,spotted,stigma,strigose,strongly,subacute,suborbicular-ovate,surface,tawny,tip,tube,uniseriate,usually,ventral,white,whitish,x,yellow	1977,5-merou,abaxiall,alyx,anderson,apparently,axe,ba,bayonet,capitat,connivent,crinkly,densely,distall,eaf,eed,equal,filament,first,geminat,greatly,growing,lateral,lower,lunulat,mean,nflorescence,orolla,plurifoliate,point,rachi,rarely,reduced,ruit,scandent,seudostipule,similar,slender,straight,strigo,strong,tal,tamen,tem,terminal,tightly,tyle,unit,upright,ympodial	'','bayonet,5-merous,[,],``,articulation,calyx,capitate,characteristic,colour,corolla,distally,form,fruit,growth,height,length,lunulate,number,pilosity,plant,pseudostipule,seed,shape,size,staman,stem,style,texture,type,value,{,}
57	wfo-0001026501	success	195	68	50	145	18	0.256	.35,.5,0,0.27-0.7,0.5-0.6,0.5-1,0.6-1,0.9-2.2,1-2,1-2.5,1.8-2.2,2.8-3,3.5-4,4-5,?,anther,berry,brown-green,calyx,chartaceous,cm,densely,diameter,entire,flower,fruit,fruiting,green,leaf,length,lobed,margin,mauve,mm,moderately,pale,pedicel,per,petiole,prickly,shrub,simple,spherical,spreading,stellate-pubescent,stem,tapering,terminal,white,yellow-green	-1.7,-3,.1,.6,.7,/3,0-1,0-2,0.05-0.3,0.1,0.2-1.8,0.5,0.5-0.9,0.6-1.1,0.6-2,1,1/2-2/3,1/4,1/6-1/2,2-10,2.5-4,3-4,3-5,3-9,4-7,5-merous,6-9,7-9,abaxially,acicular,acute,almost,alyx,apar,apart,apex,apically,apparently,articulated,bark,base,becoming,blade,borne,branched,brown,color,concolorous,cuneate,curved,deltate,discolorous,drying,dull,eaf,eed,elliptic,elongated,elongating,equal,erect,eye,filament,filiform,filiform-acuminat,flattened,flattened-reniform,free,glabrou,glabrous,gray,infructescence,known,light,lobe,long,longer,lower,mature,midpoint,naked,nflorescence,often,older,one,open,orange-brown,orbicular,orolla,oung,ovate,pair,peduncle,pendulous,perfec,pericarp,plurifoliat,poricidal,porrect,portion,prickl,prickle,primary,ray,reddish,rounded,ruit,scandent,scar,sessile,shoot,short,shorter,slender,small,smooth,sometimes,somewhat,spaced,sparsely,stalk,stalked,stellate,straight,style,subsessile,surface,tamen,terete,time,tip,trichome,tube,unarme,unarmed,unit,upper,variously,vary,vein,visible,way,wide,yellow,ympodial	colour,corolla,form,growth,hair,height,inflorescence,number,plant,position,scale,seed,shape,staman,texture,type,width,young
58	wfo-0001026513	success	138	101	72	66	29	0.522	.1,/3,0.8-2,1-1.5,1-3,2-2.2,2-5,3-5,4-5,7-9,8-16,acute,anther,apex,area,bark,base,closely,cm,corolla,decurrent,elliptic,filament,flower,fruit,fruiting,glabrous,globose,green,known,lanceolate,lateral,leaf,less,lobed,long,long-styled,main,mature,mm,opposite,ovary,pair,pale,papillose,pedicel,petiole,plant,pore,scar,shaped,short-styled,shrub,slender,small,spaced,stem,stigma,style,tear-drop,tip,treelet,trichome,tube,undersurface,uniseriate,unit,vein,venation,way,white,young	.25,.3,.75,3-6-flowered,6-8,anthesi,apiculate,ba,berry,broadly,caly,calyx,completely,darkish,deflexed,delicate,deltoid,dia,differentiated,dry,eaf,edicel,eed,erect,except,exserted,free,gre,hirsute,immature,leave,live,lobe,longer,lower,middle,minute,minutely,much,nflorescence,obscure,older,overlappin,poricidal,portion,prominent,raised,reflexed,rest,ruit,shiny,simple,somewhat,soon,specimen,straight,styl,surface,tall,ud,unifoliat,wide,widest,woody,x,ympodial	0.25,0.75,1,3,3-6,bud,colour,diameter,form,grey,growth,hair,height,inflorescence,information,length,number,overlapping,position,seed,shape,spacing,structure,symmetry,sympodial,texture,type,unifoliate,width
59	wfo-0001026529	success	219	118	102	117	16	0.466	0-25,0.3-1,1-10,1-2,1.1-2.5,1.5-2.5,1.5-4,10-28,11-14,12-22,3-12,3-5,3-6,3-9.5,5-15,5-17,5-9,6-20,abaxially,adaxially,anther,blue,brownish,cell,chartaceous,clavate,cm,condition,corolla,covering,creamy,dark,deep,diameter,distal,drying,elliptic,faintly,filament,flower,forked,fresh,fruit,glabrous,glandular,globose,greatly,green,greenish,hair,hair-like,half,herb,interjected,lanceolate,lateral,leaflet,length,light,like,lilac,long,medium,membranous,mm,moderately,non-glandular,odd-pinnate,ovate,ovoid,pair,pedicel,peduncle,pentagonal,plant,pore,poricidal,pubescent,pure,rarely,ripe,seed,shape,short,size,slightly,stem,stigma,straight,style,substellate,terminal,testal,thick,tip,trichome,varying,wall,white,whitish,x,yellowish	0.5-4.5,1,1-3,1-4.5,10,120-210,2,2-5,2-7.5,20-60,4-8,5-merou,50-70,600-950,?,acumen,acuminate,acute,ag,along,alyx,apart,apex,apparently,articulated,attenuate,axe,axillary,base,berry,blade,broadly,bud,capitat,ciliate,connivent,cordate,densely,digestion,dorsally,dot,eaf,edge,eed,enzyme,erec,especially,exceeding,except,flat,folded,geminat,generally,glabrou,gland,gree,green-white,hal,head,homostylous,honeycomb-shaped,lengthening,living,lobe,longer,lower,lunate,make,margin,midrib,minutely,mucilaginous,narrowly,nflorescence,oblique,often,orbicular,orolla,perfect,petiole,petiolulate,petiolule,plurifoliate,proximal,puberulent,reduced,removed,rounded,ruit,scattered,sessile,seudostipule,slit,spaced,specimen,stamen,ste,subequal,subsessile,subtending,tall,tamen,tem,tetralobulate,throughout,tri-,tube,typically,unit,unwinged,usually,vary,wet,wide,wing,yellow,ympodial	arrangement,articulation,branching,capitate,colour,form,glabrousnes,growth,height,inflorescence,leaf,ovary,pseudostipule,spacing,staman,texture
60	wfo-0001026534	success	150	132	107	43	25	0.713	0.5-1,1-2.5,1-3,1.5-6,1.5-9,10-20,10-50,15-50,2-2.5,2-7,2-8,2.5-15,3-10,3-25,3-4,3-5,3.5-4,4-10,5-6,6-35,7-40,abaxially,absent,acuminate,acute,adaxially,apart,apex,apiculate,auriculate,basal,base,beyond,branched,bright,calyx,chartaceous,cm,connective,connivent,cordate,cylindrical,darker,deltate,densely,diameter,directed,distally,eglandular,ellipsoidal,entire,equal,flattened,fleshy,flower,fruit,glabrous,glandular,hair,lanceolate,leaving,lobe,long,longitudinal,m.,margin,mm,moderately,narrowly,obtuse,often,orange,ovate,ovoid,pale,pedicel,pedicellar,peduncle,petiole,pinkish,pore,puberulent,pubescent,purple,rachi,radiu,red,remnant,shorter,simple,slightly,stamen,stellate,stigma,stripe,style,subcoriaceous,thecae,tip,tree,triangular,truncate,unbranched,vein,white,x,yellow	-1.5,1-2,10-15,2-3,2.5-4,3-,4-foliat,4.5-5,7-12,aggregate,ape,articulated,axe,blade,cell,eaf,eed,exserted,lemon-yello,lon,lower,nflorescence,nther,orolla,perfect,presen,puberulen,ruit,small,spaced,sparsely,stone,tal,tem,time,tomento,truncat,tube,ud,unit,vary,wide,ympodial	anther,articulation,branching,bud,colour,corolla,direction,exsertion,form,growth,height,inflorescence,leaf,lemon-yellow,length,ovary,plant,seed,shape,size,spacing,stem,texture,theca,type
61	wfo-0001026535	success	248	178	151	97	27	0.609	.5,.8,0.15,0.2,0.7-1.5,1,1-2,1.2-2,1.3,1.5-3,1/2-2/3,1/3,2-5,2.5,3-5,3.5-4,4-15,5-7,7-8,abaxial,abaxially,accrescent,acute,adaxially,age,almost,along,anther,anthesi,apically,apparently,around,bark,base,becoming,berry,black,brachyblast,branch,branched,branching,broadly,brown,calyx,chartaceous,clavate,clustered,cm,conical,corolla,cuneate,cup,cupular,dark,deltoid,dendritic,dendritic-pubescent,dense,developed,developing,diameter,dilated,distributed,dorsal,dry,drying,elliptic,elongated,entire,evenly,filament,fine,flat,flexuous,flower,forming,fruit,fruiting,glabrous,green-brown,known,leaf,length,liana,like,lobe,lobed,long,loose,lower,main,margin,membranous,midvein,minute,minutely,mm,network,number,oblong,obovate,older,orange-brown,ovate,ovoid,pair,partly,pedicel,peduncle,pericarp,petiole,plant,pointed,pore,poricidal,primary,prominent,pubescent,rachi,raised,rarely,ray,ridged,shrub,side,slightly,smooth,sparsely,stem,stigma,style,surface,terete,terminal,tertiary,thin,tip,trichome,truncate,unarmed,uneven,vein,venation,violet,visible,white,widely,wider,x,yellowish,young	.1,.2,.4,0-0.5,0.1-0.2,0.2-0.3,0.2-1.5,0.5-1,1-3,1-5,1.5-2,2-3,3,3-4.5,5-10,5Â°,absent,alternate,alyx,apar,apex,area,articulated,clearly,concolorous,condensed,curved,deeply,delineate,delineated,detaching,discolorous,divided,domatia,eaf,eed,ellipsoi,equal,except,eye,fertilisation,free,frui,increasing,inside,leave,lengthening,linear,lon,loop,m.,marginal,mostly,much,naked,nflorescence,nther,obscure,orolla,outside,papillo,pendulous,perfec,plurifoliat,portion,protruding,reaching,rounded,ruit,scar,secondary,see,short,simple,sinus,slender,smaller,soon,spaced,spreading,stump,tearing,tissue,toward,translucent,tube,tufted,two,ud,unevenly,unit,unlignified,vary,weakly,wide,ympodial,youngest	-0.5,0.1,1.5,45Â°,accrescence,angle,arming,arrangement,articulation,breeding,bud,colour,ellipsoid,form,growth,inflorescence,ovary,papillose,pattern,perfect,position,presence,seed,shape,system,texture,type
62	wfo-0001026604	success	192	112	99	93	13	0.516	.4,.5,.75,0,0.8-0.9,1.1-1.3,1.2-1.7,1.5-9,2-2.5,2.3-3.5,4-4.5,5,50-100,acuminate,age,along,anther,apex,articulated,articulation,bark,base,berry,branching,brown,c.,calyx,capitate,cm,conical,cordate,corolla,dark,densely,diameter,distal,ellipsoid,entire,filament,flattened,flower,fruit,fruiting,glabrous,globose,growth,inflated,lengthening,liana,lobed,margin,midrib,minute,minutely,mm,narrowly,new,nodding,oblique,ovary,ovate,ovoid,pale,papillose,pedicel,peduncle,per,petiole,pitted,pore,poricidal,pubescent,purple,quarter,red,reddish,reniform,ripe,shape,shrub,simple,slit,somewhat,stellate,stem,stigma,style,surface,time,tip,trichome,truncate,tube,uniseriate,vining,violet,way,woody,x	0.1,0.4-0.6,0.8-1,1-1.2,1.5-2,10-30,2-2.3,3-3.5,3-5,3.5-4,4.5-7,5-7,<,?,absent,aid,always,anthesi,apart,appearing,atop,basal,brow,cell,clearly,climbing,comical,cucullate,cupped,deflexed,differentiated,distinct,drying,due,eaf,eed,elongate,expanding,exserted,flexuous,free,later,leaf-opposed,leaving,lobe,lower,mere,nflorescence,occasionally,older,outline,overall,pair,papillo,part,particularly,peg,perfect,pericarp,planar,plurifoliat,poin,point,portion,primary,receptacle-like,rim,ruit,scar,series,shiny,sinuate,slender,slightly,spaced,stout,strongly,structure,support,swolle,terminal,testal,thin,tub,twisting,ud,undulation,unit,upper,vein,widely,ympodial,Â½	arrangement,bud,colour,form,hair,inflorescence,leaf,length,number,seed,symmetry,texture,type
63	wfo-0001026607	success	204	104	87	117	17	0.426	0-3,0-4,0.1-0.3,0.5-5.8,0.8-3.4,0.8-4.5,0.8-5,1-2,1-8,1.5-4,10-30,2-10,2-2.5,2.4-5.8,2.5-3.8,2.7-19,4-10,4-6,5,5.8-19.8,6-10,abaxially,absent,adaxially,anther,blade,brownish,chartaceous,clavate,cm,coarse,condition,corolla,deep,diameter,drying,filament,finely,flower,forked,fresh,fruit,glabrous,globose,green,greenish,hair,herb,interjected,lanceolate,lateral,leaf,leaflet,like,long,medium,membranous,minute,mm,moderately,odd-pinnate,ovoid,pair,pedicel,peduncle,pentagonal,perfect,petiole,plant,pore,poricidal,puberulent,pubescent,rachi,rarely,ripe,seed,simple,size,stem,stigma,style,terminal,tip,violet,whitish,x	0.3-1.8,1-10,1-3.8,1-5,2-3,3-8,5-merou,acumen,acute,ag,along,alyx,apart,apex,apparently,articulated,attenuate,axe,axillary,base,basiscopic,berry,bud,capitat,cell,ciliate,clearly,connivent,covering,decreasing,decurrent,digestion,distal,dorsally,dot,eaf,edge,eed,elliptic,enzyme,especially,exceeding,flat,folded,forming,geminat,generally,glabrou,greatly,gree,green-white,hair-like,hal,half,high,homostylous,honeycomb,larger,lengthening,living,lobe,lower,make,margin,marked,midrib,minutely,much,mucilaginous,nflorescence,obtuse,often,orbicular,orolla,ovate,petiolulate,plurifoliate,present,removed,rosette,rounded,ruit,scattered,semierec,sessile,seudostipule,shaped,short,side,slit,sometimes,spaced,specimen,stamen,ste,straight,subtending,tall,tamen,tem,testal,thick,throughout,toward,tri-,tube,typically,unit,unwinged,usually,vary,wall,wet,white,without,yellow,ympodial	arrangement,branching,calyx,capitate,colour,form,growth,height,inflorescence,length,number,ovary,pseudostipule,shape,staman,texture,type
64	wfo-0001026613	success	159	120	94	65	26	0.591	1-10,1-2,1.5-4,11-19.5,2-7.5,2.3-8,2.5-2.8,3-5,4.5-8.5,5,5-6,5-7,5.5-7,6-12,6.2-9.5,8-18,8.5-10,8.5-9,9.5-13.5,abaxially,acumen,adaxially,along,anther,berry,blade,borne,chartaceous,cm,conical,connivent,corolla,densely,diameter,dorsally,edge,especially,filament,flat,flower,folded,forked,fruit,glabrous,green,hair,half,herb,immature,lanceolate,lateral,leaf,leaflet,lengthening,like,long,margin,mature,membranous,middle,midrib,minute,minutely,mm,mottled,odd-pinnate,ovate,pedicel,peduncle,perfect,petiole,plant,pore,poricidal,proximal,puberulent,pubescent,purple,rotate-pentagonal,singly,size,slit,stem,stigma,style,terminal,tip,tube,tuber,typically,unknown,unwinged,x,yellow	0.5-1,0.6,3-10,4-5,5-merou,6-8,absent,acuminate,ag,alyx,apart,apex,apparently,articulated,attenuate,axe,axillary,base,bud,capitat,ciliate,cordate,decreasing,distal,eaf,eed,end,erec,geminat,generally,greatly,hal,homostylous,interjected,larger,lobe,lower,m-1.2,nflorescence,orolla,pair,petiolule,plurifoliate,pubescen,ruit,secondary,semierect,seudostipule,spaced,sparsely,ste,stolo,subequal,subtending,symmetrical,tall,tamen,tem,toward,tri-,unit,unknow,usually,vary,ympodial	0.6-1.2,age,arrangement,articulation,branching,capitate,ciliation,colour,connivence,form,growth,height,inflorescence,length,number,ovary,presence,present,pseudostipule,pubescence,seed,shape,spacing,texture,type,width
65	wfo-0001026614	success	200	142	121	79	21	0.605	.8,0.2â0.3,0.4-0.7,0.5,0.5â2,1.3-1.8,11-15,1â2,1â3,1â5,2.2,2.2-5.5,2.5,2.5â3,20â25,2â6.5,3â10,4-7,4.5â11,4.5â5.5,50,8â10,9â16,>,abaxially,acuminate,acute,adaxially,anther,apex,articulated,base,berry,black,broad-based,brown,calyx,campanulate,cm,commonly,dark,densely,denser,diameter,directed,distally,dried,entire,especially,evenly,filament,flattened-reniform,fleshy,flower,fruit,glabrescent,glabrous,gland-tipped,globose,hair,homostylous,internode,interpetalar,irregularly,leaf,linear,lobe,lobed,long,margin,minute,mm,mottled,nearly,often,orange,orange-red,ovate,ovoid,pair,pedicel,peduncle,per,petiole,pore,prickle,pubescence,pubescent,rachi,repand,ripe,rotate-pentagonal,rounded,scattered,sessile,shallowly,shrub,similar,simple,slightly,smaller,sometimes,somewhat,soon,sparsely,spreading,stellae,stellate,stellate-pubescent,stem,stigma,style,tapering,tissue,unarmed,weakly,white,x,yellow,yellowish,â5	0.2,1-,1.5â2,15â30,2â4,2â4-branched,3-foliate,3.2-5.2,5,5-merou,5.3-8.2,6.4-8.4,6â8,7.2-9.8,absent,across,adaxiall,alyx,apart,apparently,armed,axe,ba,blade,blunt-tipped,capitat,chartaceous,clavate,closely,concentrated,cylindrical,developed,eaf,eed,erect,expanded,extra-axillary,foveolate,fruiting,geminate,globo,golden,lanceolate-attenuate,lateral,less,lon,lower,midpoint,midvein,minutely,nflorescence,oblique,obtuse,orolla,ovate-lanceolate,perfect,rarely,ray,reflexed,ruit,shin,side,spaced,surface,tall,tamen,tem,time,tissu,tube,ud,unarme,usually,vary,vein,well,wide,ympodia,young	3â4-branched,5-merous,articulation,branching,bud,capitate,colour,corolla,form,growth,height,inflorescence,length,number,ovary,plant,seed,shape,shiny,size,type
66	wfo-0001026642	success	193	117	75	118	42	0.389	0.1,0.25,5,6,<,abaxial,abaxially,along,annual,anther,anthesi,apart,base,bipinnate,black,blade,blue,brown,calyx,cell,clavate,cm,dark,densely,denser,diameter,elliptic,filament,flattened,flower,fruit,glabrous,glandular,globose,green-purple,hair,herb,lavender,leaf,length,lilac,long,mm,multicellular,number,oblong,often,ovate,pale,pedicel,peduncle,pentagonal,perennial,pinnate,pitted,pore,present,pubescent,shallowly,simple,sparsely,stigma,stone,style,surface,time,tube,uniseriate,usually,vein,violet,white,woody,x,yellow	.05,.1,.8,0.1â0.3,0.2,0.4,0.4â2.2,0.5,0.5â,0.5â0.7,0.5â1.7,0.5â2.0,0.5â3.5,0.6,0.6â1.0,0.75â1.0,0.75â2.0,0.7â1.6,0.8â1.2,1.0,1.0â2.0,1.2â1.7,1.2â2.0,1.2â3.5,1.2â6.2,1.6â8.0,1.9â3.0,12â30,1â10,1â3,2.0â4.0,2.5â3.5,2.5â4.0,2.8â3.0,3.0â5.1,3â5,4.0â6.0,4â7,5.0â7.0,50â100,acute,adaxiall,adaxially,ag,apex,appressed,articulated,axe,axillary,ba,borne,branched,chartaceous,circular,connivent,cylindrical,decreasing,decumbent,divided,eaf,eed,either,equal,erect,fleshy,geminat,glabrescen,gland,half,indumentum,lobe,lon,longitudinal,lower,m.,moderately,narrow,nflorescence,obtuse,occasionally,opening,orolla,pair,perfect,petiole,pinnae,poricidal,primary,probably,rapidly,rounded,ruit,secondary,sessile,shoot,side,slit,sometimes,spaced,straight,subglabrous,tal,tamen,tem,tip,unicellular,unifoliate,unit,vary,wide,wing,ympodial,â1.2,â11.0,â2.0,â4.5,â6,â7	0.5-2.0,0.5-3.5,0.5-6.2,0.5-8.0,0.75-1.0,0.8-1.2,1-10,1-3,1.2-1.7,1.2-3.5,12-30,2.0-4.0,2.8-3.0,3.0-5.1,4-7,4.0-6.0,5.0-7.0,50-100,branching,colour,corolla,form,glabrousnes,glandularity,growth,height,history,inflorescence,life,ovary,plant,pubescence,seed,shape,size,spacing,staman,stem,type,venation,width,ye
67	wfo-0001026651	success	222	119	98	124	21	0.441	-celled,1.8,1â2,2.2â10,2.8,2â13,2â3,2â4,2â8,3,3â7,4,4â6,6â14,acuminate,acute,anther,antrorse,apex,appressed,arcuate,articulated,attenuate,base,beneath,berry,brochidodromous,brownish-green,calyx,chartaceous,ciliate,cyme,dark,decurrent,densely,drying,dull,entire,erect,exfoliating,flattened,flower,fruit,glabrescent,globose,green,hair,herb,introrsely,lanceolate,lateral,leaf,length,light,lobe,long,margin,membranaceous,mm,moderately,much-branched,narrowly-elliptic,oblong-ellipsoid,onto,ovate-reniform,pedicel,peduncle,pedunculate,per,perfect,petiole,plant,pore,pubescent,revolute,ripe,rounded,seed,shape,shrub,similar,simple,slightly,sometimes,stellate,stem,style,sub-opposite,surface,terminal,translucent,trichome,unbranched,undulate,uniseriate,venation,white,woody	0.2â1.3,0.35â2.6,0.9â3,1,2â11.5,2â3.3,2â4.5,3-plurifoliate,3â5,4â7.8,5-merou,6â10,8,abaxially,absent,accrescent,adaxiall,adaxially,along,alyx,anisophyllous,antror,antrorsely,apar,ark,asymmetric,axi,beyond,branch,broadly,brown,capitat,capitate,cell,circular,cm,connivent,cordate,cylindrical,decumbent,diameter,differing,directed,discolorous,eaf,eed,elliptic,emarginate,equal,exserted,eye,filament,flexuous,frui,geminate,geniculate,glabrou,glabrous,glandular,growt,head,highly,hilum,hollow,impressed,less,like,longitudinal,lower,lying,major,markedly,matte,midrib,minor,moderate,mostly,multicellular,naked,new,nflorescence,normally,obtuse,older,one,opening,orolla,ovate-deltate,ovate-lanceolate,parallel,poricidal,prominent,pubescence,reduce,region,ruit,secondary,shiny,single-celled,size,slit,small,smaller,spaced,stalk,stamen,stigma,straight,subapical,tall,tamen,tem,turning,unit,upper,usually,vary,vein,visible,wide,yellow,ympodial,young,Ã	5-merous,arrangement,articulation,bark,branching,colour,corolla,form,glabrousnes,growth,height,inflorescence,number,orientation,ovary,pattern,staman,symmetry,texture,type,ye
68	wfo-0001026656	success	211	100	80	131	20	0.379	0-4,0.4-6.5,0.9-13,1-1.8,1-10,1-2,1-3.8,1.1-8.1,2-6,2.5-17,20-60,4-10,4-13,4-8,5-35,5.5-27,9-11,anther,blade,blue,broadly,brownish,chartaceous,cm,condition,corolla,dark,densely,diameter,dot,drying,elliptic,filament,flower,forked,fresh,fruit,glabrous,globose,green,greenish,hair,herb,homostylous,interjected,lanceolate,lateral,leaflet,light,long,membranous,mm,moderately,narrowly,non-glandular,odd-pinnate,ovate,ovoid,pair,pedicel,peduncle,pentagonal,plant,pore,poricidal,pubescent,purple,rotate-pentagonal,scattered,seed,short,stem,style,subglabrous,terminal,tip,tuber,violet,white,whitish	0.3-3,0.3-4.2,0.7-10.5,1,1-4,1-5,1.5-7,10,2-8,5,5-18,5-merou,abaxially,absent,acumen,acuminate,acute,adaxially,ag,along,alyx,apart,apex,articulated,attenuate,base,bearing,borne,bud,capitate,cell,ciliate,clavat,connate,connivent,covering,cuneate,curved,decurrent,digestion,distal,dorsally,eaf,edge,eed,end,enzyme,erec,especially,exceeding,flat,folded,geminat,generally,glaucous,greatly,green-white,greenish-yellow,hair-like,half,honeycomb-shaped,larger,lengthening,like,living,lobe,lower,lunate,make,margin,middl,midvein,minutely,mottled,mucilaginous,nflorescence,oblique,occasionally,often,orolla,petiole,petiolulate,petiolule,plurifoliate,puberulent,pubescen,rachi,ranging,removed,ruit,scale-like,seudostipule,singly,slightly,slit,sometimes,somewhat,spaced,specimen,stamen,star,ste,stigma,stolo,straight,subequal,subtending,symmetrical,tall,tamen,tem,tertiary,testal,therefore,thick,throughout,tinged,tri-,truncate,tube,typically,unit,unwinged,vary,wall,wet,wide,wing,without,yellow,ympodial	arrangement,branching,calyx,colour,form,glabrousnes,growth,height,inflorescence,leaf,length,ovary,presence,present,pseudostipule,shape,staman,symmetry,texture,width
69	wfo-0001026663	success	251	114	92	159	22	0.367	-2.9,-8,0.2-0.6,0.4-2.2,0.9-1.5,1-3.2,1-5,1.2-2,1.6-2.3,2-12,2.1-2.6,2.9-5,2/3,31,4.5-5.7,4.7-25.9,abaxially,adaxially,anther,apex,attenuate,bark,base,becoming,berry,blunt-tipped,branch,branched,broadly,brown,bud,cm,conical,constricted,corolla,cylindrical,dark,diameter,drying,echinoid,elongated,entire,fleshy,fruit,globose,granular,green,greenish-brown,hair,immature,lanceolate,leaf,length,long,many,margin,mm,multangulate,obtuse,openly,ovate,pale,pedicel,peduncle,petiole,pore,poricidal,rachi,rich,scabrous,shrub,simple,slightly,small,stellate,stem,stigma,style,subglobose,time,tip,tomentose,tomentum,tree,tube,unarmed,upper,violet,white,whitish,x,young	-15,-9.7,.5-2.5,/25-1/15,/3,0-160,0.3-0.8,1,1-2.5,1.1,1.1-2.1,1.4-2.6,1.4-3.1,1.9-2.6,1/2,1/3,1/4-1/2,10-26,10.3-13.2,12-14,2.5-3.7,2.8-5.3,24-45,3-5,3.5-5,3.8-5.7,5-8,5.5-,5.5-8.8,7.5-9,8-17,accrescent,acuminate,acute,adaxiall,ag,along,angled,anthesi,apart,apparently,appressed,around,articulated,ascending,axe,axillary,blade,calyx,capitat,chartaceous,closely,completely,covering,densely,directed,distally,distributed,eaf,echinoi,echinoid-pubescent,edge,eed,enveloping,especially,evident,exserted,farinose,filament,flared,flower,free,fruiting,glabrescen,glabrescent,glabrous,granular-tomentose,grooved,inserted,lateral,lengthening,less,light,line,lined,lobe,lobed,long-stalke,long-stalked,longer,longitudinal,longitudinally,lower,m.,main,matur,midrib,midvein,minute,multangulate-pubescent,nearly,nflorescence,occasional,occuring,older,opening,orolla,ovate-lanceolat,ovate-lanceolate,perfect,persistent,plurifoliate,porrect-stellate,present,pseudo-terminal,pubescence,pubescent,rather,ray,ridged,robust,ruit,runk,sessile,short,short-stalked,side,slit,sometimes,somewhat,soon,spaced,sparsely,stalk,stalked,stamen,strongly,subcampanulate,subcoriaceous,subglabrous,suture,tall,tamen,tangled,terete,thick,thin,tomentose-pubescent,touching,ud,unarme,unit,usually,vary,vein,way,wide,yellow,ympodial	5.5-9,articulation,branching,capitate,colour,form,growth,height,inflorescence,ovary,pattern,plant,position,prickle,pseudoterminally,scale,seed,shape,texture,trichome,trunk,type
70	wfo-0001026686	success	196	114	93	103	21	0.474	.4,0.6-0.9,1-2,1.2-3.4,1.5-7,1.7-2.5,10-28,2.4-3.6,3-4,3.7-8,5,5-16.5,5-8,6.5-12.7,7-9,8-10,8-14,8-27,abaxially,adaxially,anther,berry,blade,brownish,cell,chartaceous,cm,condition,conical,corolla,densely,diameter,digestion,distal,dorsally,drying,edge,enzyme,filament,flat,flower,folded,forked,fresh,fruit,glabrous,green,greenish,hair,herb,honeycomb-shaped,interjected,lanceolate,lateral,leaf,leaflet,light,like,long,middle,minute,minutely,mm,mottled,odd-pinnate,ovoid,pedicel,peduncle,perfect,petiole,plant,pore,poricidal,puberulent,pubescent,purple,purple-violet,removed,ripe,rotate-stellate,seed,size,sparsely,stigma,style,terminal,testal,tip,tuber,wall,whitish,wide,x	0.2-0.5,1,1-10,1-2.5,1.2-3.6,2-10,2-9,2.5-8,3-5,4-6,5-merou,absent,acumen,acuminate,ag,along,alyx,apart,apex,apparently,articulated,axe,axillary,base,borne,bud,capitat,ciliate,connivent,covering,decreasing,eaf,eed,elliptic-lanceolate,end,equal,erec,especially,exceeding,geminat,generally,glabrou,gradually,green-white,hair-like,half,homostylous,larger,lengthening,living,lobe,lower,make,margin,midrib,mucilaginous,nflorescence,obtuse,often,orbicular,orolla,ovate,pair,petiolule,plurifoliate,pubescen,round,ruit,secondary,semierect,seudostipule,singly,slightly,slit,spaced,specimen,stamen,star,ste,stolo,straight,stripe,subequal,subsessile,subtending,symmetrical,tall,tamen,tem,thick,throughout,toward,tri-,tube,typically,unit,usually,vary,wet,white,wing,yellow,ympodial	arrangement,articulation,branching,capitate,colour,form,growth,height,inflorescence,length,number,ovary,presence,present,pseudostipule,shape,staman,stem,texture,type,Â¼
71	wfo-0001026696	invalid_json	139	129	91	48	38	0.655	0.3-4.5,0.8-7,0.9-7.2,1,1-1.3,1-4,1.3-2.1,2-17,3-17,3-3.5,3-6,3-8.5,4-16,5-35,9,abaxially,acute,adaxially,apex,apical,apically,base,branched,broadly,calyx,cell,cm,connate,corolla,covering,cuneate,cyme,decurrent,dehiscent,densely,diameter,dichasial,dichasially,distal,ebracteate,filament,flower,generally,globose,green,green-white,hair-like,half,herbaceous,introrse,lanceolate,lateral,light,linear,make,maturing,mm,monochasial,mucilaginous,obtuse,odd-pinnate,often,ovate,ovoid,pedicel,peduncle,perennial,perfect,petiole,plant,poricidally,proximal,pubescent,rounded,seed,short,simple,slit,stellate,stigma,straight,style,testal,thick,throughout,tuber-bearing,typically,unit,wall,white-cream,Â¼	1.5-3,2-3,3-6-foliat,acumen,apiculate,articulate,digestion,dorsally,eaf,edge,eed,emoval,entire,enzyme,exceeding,flat,folded,forked,globo,honeycomb,light-yello,living,lobe,lon,long,lower,lunat,margin,nflorescence,nther,oblong,orolla,pattern,plan,reveal,ruit,seudostipule,sinuate,specimen,stamen,tal,tem,throughou,vary,wide,without,yellow,ympodial	'','hair-like,3-6-foliate,[,],``,anther,arrangement,articulation,branching,characteristic,colour,form,fruit,growth,height,inflorescence,leaf,length,light-yellow,lunate,number,ovary,pore,position,pseudostipule,shape,stem,structure,sympodial,tall,texture,type,value,wet,width,{,}
72	wfo-0001026706	success	232	117	99	133	18	0.427	-6.1,0-240,0.2-0.5,0.6-2.2,1-5,1.5-3,12,4,4.5-5.5,6-8,6.1-,9.8-15.4,acute,anthesi,apex,appearing,attenuate,axillary,bark,base,becoming,berry,branch,branched,brown,bud,calyx,chartaceous,cm,coriaceous,corolla,crisped,cuneate,dark,dendritic-echinoid,dendritic-multangulate,diameter,entire,fleshy,flower,fruit,glabrate,globose,grayish,green,hair,herbarium,indument,lacking,leaf,length,lobe,long,long-stalked,margin,matted,mm,multangulate,nearly,oblong,obtuse,occasionally,ovate,ovate-elliptic,pale,pedicel,peduncle,persistent,petiole,plurifoliate,porrect-stellate,rachi,rather,reddish,reticulate-punctate,semi-ovate,short-,shrub,simple,slightly,small,softly,somewhat,specimen,subcampanulate,suborbicular,surface,tall,tomentose-pubescent,translucent,tree,unarmed,unit,velutinous,wavy,whitish,x,yellowish-tan,young	-3.1,-4.4,-5.5,.5,/14-1/6,0.2-0.3,0.8-1.2,0.8-1.5,0.8-2.8,0.9-1.9,0.9-2,1-2.2,1.1-4,1/2-2/3,10-15,14-32,2.2-3.3,2.3-3.8,2.5-3,2.7-4,2.9-6,2/3-3/4,3-4.6,3.1-3.8,3.6-5.7,4.2-12,5-6.5,5.3-6.4,6-10,7-16,8-14,abaxially,accrescent,adaxiall,adaxially,ag,anther,apart,apparently,around,articulated,axe,ba,blade,blunt-tipped,capitat,closely,completely,covering,cylindrical,densely,directed,distally,eaf,edge,eed,enveloping,exserted,farinose,filament,fourth,free,fruiting,furfuraceou,glabrous,golden,inserted,lackin,lanceolate,lateral,lengthening,lobed,longitudinal,lower,m.,main,many,midrib,minute,mixed,multangulat,nflorescence,obscured,often,older,orolla,ovate-lanceolate,perfect,pore,poricidal,pseudo-terminal,pubescence,pubescent,ruit,runk,sessile,short-stalked,side,slit,soon,spaced,sparsely,splitting,stalked,stamen,stellate,stem,stigma,strongly,style,subconical,subglobose,sulcate,suture,tamen,thin-walled,time,tip,tomentu,touching,transparent,tube,ud,unarme,unevenly,upper,vary,vein,way,white,wide,yellow,ympodial	abaxial,adaxial,colour,form,furfuraceous,growth,height,inflorescence,persistence,plant,pseudoterminally,seed,shape,structure,sympodial,texture,trunk,type
73	wfo-0001026707	success	196	129	107	89	22	0.546	-5,.5,/3,0,0.05,0.3-0.8,0.5-1,0.5-3,0.6-0.7,0.6-0.8,0.7-1,0.7-1.4,1-1.7,1.5-1.8,1.6-2,1/3,1/3-1/2,2-2.3,2.5-4,2.5-6,3-4,3-7,3-8,5-10,5-25,8-15,?,anther,apparently,articulated,bark,base,berry,blade,branched,calyx,chartaceous,clustered,cm,concolorous,connivent,diameter,discolorous,drying,entire,equal,erect,filament,flattened-reniform,flower,fruit,fruiting,fused,glabrescent,glabrous,gray,green,known,lateral,leaf,length,less,lobed,long,mauve,mm,moderately,narrow-deltate,orange-brown,pedicel,peduncle,per,petiole,poricidal,porrect-lepidote,prickle,prickly,ray,red-brown,sessile,shrub,simple,small,sometimes,spherical,stalked,stellate,stellate-pubescent,stem,straight,style,surface,tapering,terete,terminal,tip,tree,trichome,tube,unarmed,upper,variously,way,weakly,white,wide,yellow-green	-1/3,-3,.8,0-20,0.05-0.15,0.1-0.2,0.7-1.5,1-3,1-5,1/3-3/4,1/4-1/3,1/8-1/4,11-16,2-10,2-6,2.5-3,3-4.5,4,5-7,5-8,5-merous,abaxially,acute,alyx,apar,apart,apex,apically,attenuate,branche,broad-deltate,broadly,color,curved,cuspidat,decurrent,densely,eaf,eed,elongating,eye,foliaceous,free,gently,glabrou,inflated,infructescence,juvenil,lobe,longer,lower,margin,mature,midpoint,naked,narrow-oblong,nflorescence,obtuse,older,one,open,orolla,oung,perfec,pericarp,plurifoliat,porrect,portion,pubescent,reflexed,rounded,ruit,scar,shorter,slender,smooth,spaced,sparsely,spreading,stalk,stout,tamen,time,unit,vary,venation,visible,ympodial,Â¼	arrangement,articulation,branch,branching,colour,corolla,form,fusion,growth,hair,inflorescence,juvenile,number,ovary,position,seed,shape,staman,texture,type,width,young
74	wfo-0001026711	success	210	89	71	139	18	0.338	-5,0-25,0.3-1,0.5-1.5,0.7-,0.75-1,0.8-2.2,0.9-1.1,0.9-1.5,1.5-2.2,1.7-4,1/2-2/3,1/3,2-2.2,2-3.5,2-6,2.1-2.5,3.5-5.2,4.5-7,anther,base,berry,calyx,cm,connivent,densely,diameter,dull,equal,flattened-reniform,flower,fruit,fruiting,lateral,leaf,length,lobed,long,maturity,mauve,mm,occasionally,orange,orange-brown,pedicel,per,petiole,poricidal,prickle,prickly,purple,red,shrub,stellate,stellate-pubescent,stem,style,surface,tapering,terete,terminal,thick-chartaceous,tip,unarmed,uniform,upper,way,weakly,yellow,yellow-green,young	-15,-2,-6,-7,.2,.5,.8,0,0-0.2,0-4,0-6,0.1,0.15,0.2-0.3,0.7-0.9,0.7-1.4,0.8,1-,1-2,1-30,1.5-,1/,1/4,1/4-1/3,2-2.5,2-4,3-4,3-4.5,3-5,3-7,4-8,5-merous,7-8,abaxially,acicular,acuminat,acute,alyx,ame,apar,apart,apex,apically,apparently,articulated,bark,blade,branched,brow,c.,cell,concolorous,cuneate,curved,deltate,difoliate,discolorous,distance,drying,eaf,eed,elliptic,elongating,erect,evenly,extending,faint,filament,free,geminat,glabrous,green,infructescence,less,lobe,longer,lower,margin,mature,midpoint,midvein,moderately,narrow-deltate,nflorescence,obtuse,older,one,open,orolla,oung,outline,pair,pale,peduncle,pendulous,perfec,pericarp,perpendicular,pit,porrect,portion,prickl,primary,raised,ray,reduced,reflexed,rounded,ruit,scar,sessile,shallowly,shorter,side,slender,small,smooth,sometimes,somewhat,spaced,spherical,spreading,stalk,stalked,straight,tamen,tertiary,time,trichome,tube,unit,variously,vary,vein,venation,visible,wide,woody,ympodial	colour,corolla,form,growth,hair,height,heteromorphism,inflorescence,number,ovary,plant,position,seed,shape,staman,texture,type,width
75	wfo-0001026717	success	207	127	107	100	20	0.517	0.3-0.6,0.6-1.5,1-2,1-2.5,1.4-2.2,1.8-3,13-28,14-22,15-34,2.5-5.5,3-5,3-6,3.3-11,4-6,4-8,5,5-11,5-13.5,5.3-9,7-11,abaxially,adaxially,along,anther,berry,blade,borne,brownish,cell,chartaceous,ciliate,cm,condition,conical,corolla,covering,dark,diameter,drying,end,especially,filament,flower,forked,fresh,fruit,glabrous,green,green-white,greenish,hair,hair-like,herb,homostylous,interjected,lanceolate,lateral,leaf,leaflet,lengthening,light,like,long,make,margin,medium,membranous,midrib,minute,minutely,mm,mottled,mucilaginous,odd-pinnate,ovoid,pedicel,peduncle,pentagonal,plant,pore,poricidal,puberulent,pubescent,purple,ripe,rotate,seed,singly,size,slit,sparsely,stigma,straight,style,terminal,testal,thick,throughout,tip,tuber,typically,violet,wall,wet,whitish,wide,x	0.3-2.5,0.3-5,0.8,1-10,1-3,1.3-2.5,2.2-5,2.5-4.5,3-4,4-9,5-6,5-merou,acumen,acuminate,ag,alyx,apart,apex,apparently,articulated,attenuate,axe,axillary,base,bud,capitat,connivent,darker,decreasing,decurrent,digestion,distal,dorsally,eaf,edge,eed,elliptic,enzyme,equal,erec,exceeding,flat,folded,geminat,generally,glabrou,gradually,half,honeycomb-shaped,larger,living,lobe,lower,middle,narrow,nflorescence,obtuse,often,one-quarte,orbicular,orolla,ovate,pair,perfect,petiole,petiolule,plurifoliate,present,pubescen,removed,round,ruit,secondary,semierect,sessile,seudostipule,slightly,spaced,specimen,stamen,ste,stolo,stripe,subequal,subglabrous,subsessile,subtending,symmetrical,tall,tamen,tem,toward,tri-,tube,unit,usually,vary,wing,yellow,ympodial	age,arrangement,branching,capitate,colour,form,glabrousnes,growth,height,inflorescence,length,number,ovary,presence,pseudostipule,shape,stem,stolon,symmetry,texture
76	wfo-0001026725	success	166	128	108	58	20	0.651	.3,.5,/4,0.2,0.7-1.2,1-1.2,1-1.5,1-4.5,1-5,1.2-1.7,1.5,1.5-2,1.6-2,1/2,2,2.2-4,3.6-7.7,5-5.5,5-6,8-18.6,acute,anther,anthesi,apart,apex,attenuate,bark,base,beneath,black,bluish,brownish-papillose,calyx,capitate,cm,corolla,dark,dia,drying,ellipsoid,elliptic,extremely,filament,flattened-reniform,fruit,fruiting,glabrous,glandular-papillose,globose,green,greenish-white,incrassate,large,leaf,less,lobe,lobed,long,major,margin,middle,minor,minutely,mm,onto,open,opposite,ovary,ovate,ovoid,pale,paler,papillose,pedicel,petiole,pitted,pore,proximal,pubescent,reddish-brown,rounded,scar,shaped,short,shrub,size,slender,split,stem,stigma,stretching,style,subshrub,surface,tan,tapering,tear-drop,tip,trichome,tube,uniseriate,upper,way,white,widest,winged,x,young	3.5-4,5-20-flowered,8-9,accrescent,axil,becoming,berry,broadly,character,crackin,cup-shaped,deflexed,differing,difoliate,dry,eaf,edicel,eed,evenly,free,geminat,geographically,inflorescenc,interpetalar,lateral,lon,lower,main,margine,material,nflorescence,occasionally,often,older,one,pair,papillo,planar,poricidal,portion,prominent,reflexed,ruit,scarious,simple,sinus,slightly,spaced,straight,tall,triangular,tuft,ud,unit,varying,vein,woody,ympodial	5-20,bud,colour,cracking,diameter,flower,form,growth,height,inflorescence,length,number,plant,position,seed,shape,spacing,texture,type,width
77	wfo-0001026733	success	188	128	101	87	27	0.537	-2,-7,-8,0.3-0.5,0.3-2,0.5-1,1,1-1.5,1-7,1.5-14,4,4-5,4.5-5,5-8,abaxially,acute,acute-acuminate,aggregate,apex,articulated,basal,base,cell,chartaceous,cm,color,connective,connivent,cordate,curled,dense,densely,eglandular-pilose,eglandular-pubescent,ellipsoidal,elliptic-ovate,entire,equal,exceeding,flattened,forked,fruit,fusiform,glabrate,glabrous,gland-tipped,glandular-,glandular-puberulent,green,greyish,hair,hirsute,immature,lanceolate,leaving,lobe,long,longitudinal,margin,membranaceous,mm,moderately,narrowly,near,oblique,ovate,ovoid,pedicel,pedicellar,petiole,pilose,pore,pubescent-pilose,remnant,ripe,round,shining,shorter,simple,slightly,smooth,sometimes,stellate,stigma,stone,stripe,style,submarginally,thecae,tree,triangular,truncate,unbranched,unit,unknown,vein,villous,white,white-puberulent,x,yellowish	-1,-11,-13,-14,-15,-4,.5-3,0.5,0.5-2,0.5-4,1-2,1-3,1.5-2,1.5-2.5,10-20,15-,2-2.5,2-3,2-4,2-6,2.5-7.5,20-50,25-40,3-15,3-3.5,3-4-foliat,3-7,4-23,7-10,8-12,acuminate,adaxially,apart,ape,axe,beyond,blade,calyx,capitat,ciliat,cylindrical,deltate,dia,diameter,directed,distally,eaf,eed,eglandular-villous,especially,exserted,flower,glandula,glandular-tomentose,linear-triangular,lon,lower,midrib,nflorescence,nther,orolla,ovum,peduncle,perfect,present,pubescent,pubescent-pilo,rachi,radiu,ruit,small,spaced,sparsely,stamen,swelling,tal,tem,time,toward,tube,ud,unknow,usually,vary,wide,yellow,ympodial	3-4-foliate,abaxial,adaxial,anther,articulation,branching,bud,capitate,colour,corolla,form,growth,height,inflorescence,leaf,length,oval,ovary,plant,position,seed,shape,stem,structure,sympodial,texture,type
78	wfo-0001026734	success	266	83	65	201	18	0.244	3,abaxial,acuminate,adaxial,anther,apex,articulated,asymmetric,base,broadly,brown,calyx,chartaceous,congested,corolla,cuneate,cyme,densely,elliptic,entire,flattened,flower,fruit,glabrescent,glabrous,globose,green,growth,hair,immature,internodal,lanceolate,lateral,leaf,length,lobed,long-attenuate,margin,mature,maturity,membranaceous,mm,narrow,oblong,observed,obtuse,pale,pedicel,petiole,pore,poricidal,porrect-stellate,pubescent,purple,reniform,sessile,shape,short-stalked,shrub,simple,stellate,subopposite,trichome,unbranched,white	0.1,0.2,0.3,0.5,0.6,0.7â0.9,0.7â1,0.8â1,1,1.6â2,1.6â2.5,1.8â2.2,1.8â3,1/4,1â1.2,1â3,2.2â7,2.3â5,2.5â3,2â2.4,2â3,3.2â3.8,3â4,3â4-celled,3â8,4â6,4â7,4â8,4â9,5-merou,5â9,8,abaxially,absent,accrescent,acute,adaxiall,adaxially,ag,also,always,alyx,anthesi,apical,apice,archin,ark,associated,axi,barely,becoming,beneat,beneath,berry,blade,branch,branched,bright,caly,camptodromous,capitate,celled,central,clavate,closely,cm,commonly,connivent,covered,covering,cylindrical,dark,dense,denser,diameter,differing,directed,discolorous,distally,downward,dried,drying,due,eaf,eed,eglandular,emergent,erect,f.,fewer,flat,foliate,forked,found,free,frequently,geminate,glabrescen,glandular,gray,held,ilament,initially,introrsely,irregular,j,lamina,large,less,lobe,long,longer,longitudinal,lower,lying,material,maturit,midpoint,midri,minute,moderately,mostly,much,multiseriate,near,new,nflorescence,normally,obovate,often,old,older,one,one-celled,opening,orolla,other,oung,ovary,ovate,pair,paired,papillose,peduncle,perfect,pit,plane,pointing,porrect,portion,pubescence,purplish,rachi,raised,rarely,ray,rayed,reaching,rounded,ruit,scandent,secondary,shiny,shorter,size,slightly,slit,smaller,sometimes,spaced,sparse,sparsely,spread,spreading,stalk,stem,stigma,still,style,subsessile,surfac,surface,terminal,tube,tuft,ud,unequal,uniseriate,unit,upward,vary,vein,venation,vestiture,visible,whole,wide,yellow,yellowish,ympodial,Â¾	1.6-2,2-3,2.3-5,3-8,5-9,arrangement,articulation,colour,form,height,inflorescence,number,plant,position,seed,symmetry,texture,type
79	wfo-0001026740	success	171	116	91	80	25	0.532	0-10,0.5-1,1-2,1-4,1-5,2-3,2-4,2.5-27,5-8,6-10,abaxially,absent,acuminate,acute,adaxially,aggregate,also,apex,articulated,basal,base,branched,cell,cm,connective,connivent,cordate,curled,darker,densely,eglandular,ellipsoidal,elliptic,entire,equal,especially,exceeding,flattened,fruit,glabrous,glandular-puberulent,greenish,hair,immature,lanceolate,leaving,lobe,long,margin,mature,mm,moderately,near,nearly,obtuse,often,orange,ovate,ovoid,pedicel,pedicellar,petiole,pilose,pore,present,puberulent,purple,remnant,reticulate,scar,sessile,shorter,simple,slightly,small,stellate,stone,stripe,style,subcoriaceous,swelling,thecae,tree,truncate,unbranched,unit,white-puberulent,whitish,x,yellow,young	-17,-2,1-10,1-12,1-3,10-20,10-30,2.5-3,2.5-4.5,2.5-6,20-50,3-15,3-3.5,3-5,3-foliat,3.5-40,4-5,4.5-10,5-40,8-19,absen,acute-acuminate,apart,ape,apiculate,axe,beyond,blade,browni,calyx,ciliate,corky,cylindrical,deltate,diameter,directed,distally,eaf,eed,exserted,fleshy,flower,glabrate,lon,lower,narrowly,nflorescence,nther,oblong,orolla,peduncle,perfect,pilo,pubescent,rachi,radiu,rarely,ruit,sometimes,spaced,sparsely,stamen,stigma,tal,tems,time,tomentose,toward,triangular,truncat,tube,ud,unlobed,vary,vein,villous,violet,wide,woody,ympodial	3-foliate,anther,articulation,branching,brownish,bud,colour,corolla,form,growth,height,inflorescence,leaf,length,ovary,plant,position,seed,shape,stem,structure,sympodial,texture,type,unknown
80	wfo-0001026752	success	169	122	92	77	30	0.544	-25,-4,1,1-3,1-5,1-6,1.5-12,1.5-2.5,10-20,2,2-2.5,2.5-5,20-30,3-18,3-4,3-5,3.5-4,4-5,abruptly,acute,apart,apex,base,beyond,black,branched,campanulate,chartaceous,cm,connective,cordate,coriaceous,cuneate,cylindrical,densely,diameter,dilated,directed,distally,ellipsoidal,elliptic-oblong,elliptic-ovate,entire,finely,flattened,fleshy,forked,fruit,glabrous,globose,green,greenish-brown,hair,lanceolate,laterally,long,margin,mm,moderately,narrowly,near,obtuse,ovoid,pedicel,peduncle,petiole,pilose,pore,pubescent,pubescent-pilose,purplish,rachi,rarely,rather,short-acuminate,simple,slightly,somewhat,stamen,stellate,stigma,style,tree,triangular,truncate,unbranched,unit,violet,white,wide,x,yellow	-3,-50,0-,1-1.5,1-12,1-2,1.5-2,15-35,2-3,2-4,2.5-20,3,3-foliat,4-45,7-15,8-16,abaxially,absent,adaxially,aggregate,also,ape,apiculate,articulated,axe,basal,blade,calyx,capitat,cell,connivent,darker,deltate,eaf,eed,equal,exceeding,exserted,flower,immature,leaving,less,lobe,lon,lower,nearly,nflorescence,nther,orolla,papillose,pedicellar,perfect,pilo,possibly,presence,present,radiu,remnant,ripe,ruit,small,spaced,stone,stripe,tal,tem,thecae,time,tomento,tube,ud,unknow,vary,vein,whitish,yello,ympodial	3-foliate,abaxial,adaxial,anther,articulation,branching,bud,capitate,colour,corolla,exsertion,form,growth,height,inflorescence,leaf,length,ovary,plant,position,seed,shape,size,spacing,stem,structure,sympodial,texture,theca,type
81	wfo-0001026754	success	176	80	65	111	15	0.369	.5,0.5-1,0.9-1.1,2,5,5-lobed,abaxially,acute,anther,apex,articulated,asymmetric,base,berry,branched,broadly,cm,corolla,deeply,densely,diameter,ellipsoid,elliptic,entire,filament,flower,glabrous,globose,growth,inflorescence,later,lateral,leaf,lobed,lower,many,margin,membranous,mm,narrowly,oblique,pedicel,peduncle,perfect,petiole,pore,poricidal,pubescent,simple,sparsely,stellate-rotate,stem,surface,terminal,time,tip,truncate,twining,upper,vine,white,woody,x,yellow,yellowish	-6+,0.5,1,1-,1.5-3,1/2,10,198.,2-2.5,2-3,2-4,2.5-3.5,2/3,3-4-celled,30+,4-5,5-merou,5.5-9,7-9,9,9-11,adaxially,ag,along,alyx,anthesi,apar,apparently,ark,axi,basal,brow,cabrera,calyx,clavate,complete,conical,connivent,cucullat,dendritic,denser,distal,divided,eaf,ed,especially,exerted,extending,fide,free,half,halfway,ilament,irregularly,lamina,leaving,lengthening,like,lobe,long,loosely,mature,midvein,minute,minutely,mixture,mostly,new,nflorescence,older,orolla,outline,pair,papillo,peg,pinnate,planar,plurifoliat,portion,primary,puberulent,ruit,scandent,scar,seen,sleeve,slender,slit,small,sometimes,spaced,splitting,spreading,stigma,style,tangled,tem,transparent,trichome,tub,tube,twinin,ud,uniseriate,unit,vary,vein,way,weak,within,ympodial	5-merous,articulation,bark,branching,brown,bud,colour,form,fruit,hair,length,position,shape,texture,type
82	wfo-0001026756	success	147	79	60	87	19	0.408	0-7-1.2,0.5-1,0.5-3,1-1.5,1-2,1.5-1.7,1.5-10,1.5-2,1.5-3,1.8-3,3-4,3.5-8.5,5-10,5-5.5,6-16,acute,anther,apex,attenuate,bark,base,bilobed,broadly,calyx,cm,conical,corolla,dendritic,elliptic,filament,fruiting,globose,green,lax,leaf,lobed,mm,nearly,opposite,ovary,ovate,ovoid-reniform,pale,pedicel,petiole,pinkish-white,pore,pubescent,shape,shaped,shrub,stem,stigma,style,tear-drop,tree,trichome,tube,white,young	.25,.5,0.25-0.5,5-10-flowered,6-10,abaxial,abaxially,adaxially,along,anthesi,apiculate,ba,berry,brown,closely,corresponding,dark,deflexed,deltate,densely,denser,dia,differing,difoliate,distal,eaf,edicel,eed,erect,exserted,fleshy,free,geminat,glabrescent,glabrous,grayish-brow,hard,inflorescenc,irregular,lamina,lateral,like,lobe,long,lower,main,major,middle,minor,minutely,nflorescence,occasionally,older,overlappin,pair,papillo,perhaps,pericarp,pitted,planar,poricidal,portion,present,pubescence,rest,ruit,scar,simple,somewhat,soon,spaced,sparsely,strongly,surface,tall,thick,tip,tub,ud,unifoliate,uniseriate,unit,vein,wide,widest,woody,ympodial	0.25,0.5,colour,diameter,flower,form,fruit,grayish-brown,growth,height,inflorescence,length,number,plant,position,seed,texture,type,width
83	wfo-0001026777	success	168	90	76	92	14	0.452	.5,0.25-0.5,0.5-1.5,0.9-3,1-1.3,1-10,1-2,1-4,1.5-3,1.5-5,2-4,3-3.5,5-50-flowered,5-7,acute,anther,base,beneath,blue,branching,brown,calyx,capitate,cm,corolla,cup,decurrent,deflexed,dense,elliptic,fide,filament,filiform,flattened,flattened-reniform,fruiting,glabrous,globose,green,growth,leaf,lobed,long,matted,minor,minutely,mm,narrowly,nearly,occasionally,often,onto,opposite,ovary,papillose,pedicel,petiole,pore,pubescent,quite,russet,seed,shaped,shiny,shrub,size,slightly,stigma,style,tear-drop,trichome,tube,uniseriate,vellozo,white,x	.25,/3,0.5-1,0.5-5,1-1.5,1.2-1.8,2-4.5,2-5,4-8,5-14,acuminate,anthesi,apart,apex,apiculate,axil,ba,beginning,berry,body,campanulate,cell,dia,differing,difoliate,distal,eaf,edicel,eed,end,exserted,flexuous,free,geminat,glabrate,greyi,hyaline,incrassate,inflorescenc,irregularly,lateral,like,lobe,lon,lower,main,major,margin,middle,near,new,nflorescence,older,one,outline,overtopping,pair,papillo,pitted,planar,poricidal,portion,prominent,quadrate-deltoid,rest,ruit,scar,sinuate,smooth,somewhat,soon,spaced,sparsely,stem,straight,surface,tall,tapering,testa,thread-like,tip,tuft,ud,unit,vein,wall,way,widest,woody,yellowish,ympodial,young	colour,diameter,flower,form,fruit,hair,height,inflorescence,length,number,plant,position,shape,texture
84	wfo-0001026819	success	218	123	102	116	21	0.468	0-27,1-10,1-2,1.5-10,1.5-12,10-26,2-6,3-120,3-18,3-20,3-35,3-38,4-7,5-30,6-11,7,abaxially,absent,acuminate,acute,adaxially,anther,apex,base,blade,blue,broadly,brownish,chartaceous,cm,condition,corolla,dark,densely,diameter,distal,dorsally,dot,drying,edge,elliptic,filament,flat,flower,folded,fresh,fruit,glabrous,glaucous,globose,green,greenish,hair,herb,interjected,lanceolate,lateral,leaflet,light,like,long,lunate,membranous,middle,minutely,mm,moderately,mottled,narrowly,oblique,odd-pinnate,ovate,ovoid,pair,pedicel,peduncle,pentagonal,petiolule,plant,pore,poricidal,puberulent,pubescent,purple,rotate-pentagonal,scale-like,scattered,seed,slightly,somewhat,stem,stripe,style,subglabrous,symmetrical,terminal,tinged,tip,tuber,violet,white,whitish	0.3-4.7,0.5-1.5,1-2.3,1-5,1.2-36,1.5-3.0,1.5-3.3,1.5-3.5,1.6-3.5,10,2-5,2.5-5,4,4-10,5-merou,acumen,ag,along,alyx,apart,articulated,ascending,attenuate,bearing,borne,bud,capitate,cell,ciliate,clavat,connate,connivent,covering,cuneate,curved,decurrent,digestion,eaf,eed,end,enzyme,erec,especially,exceeding,forked,geminat,generally,glabrou,greatly,green-white,greenish-yellow,hair-like,half,homostylous,honeycomb-shaped,larger,lengthening,living,lobe,lower,make,margin,midvein,mucilaginous,nflorescence,non-glandular,often,orolla,pedice,petiole,plurifoliate,rachi,ranging,removed,ruit,seudostipule,short,singly,slit,sometimes,spaced,specimen,stamen,star,ste,stigma,stolo,straight,subequal,suborbicular,subrosette,subtending,tall,tamen,tem,tertiary,testal,therefore,thick,throughout,tri-,truncate,tube,typically,unit,unwinged,usually,vary,wall,wet,wide,wing,within,without,yellow,ympodial	abaxial,arrangement,articulation,colour,form,growth,height,inflorescence,leaf,length,number,ovary,position,presence,present,pseudostipule,shape,spacing,staman,texture,width
85	wfo-0001026821	success	204	118	95	109	23	0.466	.2,/3,0.3-1.2,0.3-2.5,0.4-1.5,0.7-1.8,0.8-1,1-1.5,1-2,1-5,1.5-2.5,10-15,2-3.5,2-celled,2.5-18,3-18,3-branched,4-4.5,5-12,5-20,5-34,anther,apically,appressed,auriculate,base,bayonet,berry,blade,broadly,brown,chartaceous,cm,cordate,dark,diameter,directed,distally,ellipsoidal,flattened,flower,forked,fruit,fused,gglobose,glabrous,green,hair,herb,incurved,large,length,light,lobe,long,longitudinal,many,mature,membranous,mm,obliquely,oblong,odd-pinnate,opening,paired,pale,pedicel,peduncle,per,perfect,petiole,pilose,pore,present,puberulent,pubescent,rachi,rarely,reniform,rounded,short,slender,slit,small,sparsely,stellate,stigma,stripe,style,subglabrous,substellate,unbranched,white,x,yellow	0-20,0.2-1.5,0.5-1.2,0.5-3.5,1-20,1-3,1.2-1.5,17,1977,2-15,2-6,3-11,3-6,3-7,3-celled,5-10,5-merou,abaxially,acuminate,acut,adaxial,adaxially,ag,alyx,anderson,angular,apart,apex,apical,apiculate,articulated,axe,ba,basal,bract,cell,ciliat,cuneate,deltate,distal,due,eaf,eed,elliptic,equal,especially,exceeding,filament,frequent,geminat,glabrou,gland-tipped,greatly,homostylous,interjected,interstaminal,lanceolate,lateral,leaf-opposed,leaflet,long-attenuate,lower,lowermost,margin,mean,membrane,minute,minutely,moderately,much,narrowly,nflorescence,oblique,obtuse,occasional,occasionally,one-celled,orolla,pair,petiolule,plurifoliate,pseudostipular,pubescen,reduced,remnant,ruit,scandent,seudostipule,slightly,smaller,somewhat,spaced,stamen,subtended,surface,tamen,tem,terminal,thickening,time,tri-,truncat,tube,unit,vary,wall,wide,winged,ympodial	10-20,age,arrangement,branching,calyx,colour,corolla,form,fusion,growth,inflorescence,leaf,number,ovary,pseudostipule,seed,shape,size,staman,stem,texture,truncate,type
86	wfo-0001026827	success	143	106	93	50	13	0.65	.5,/3,0.4-0.6,0.6-1,1-1.1,1-1.5,1-2,1-2.1,1.3-1.6,1.5-2,2-2.2,3-9,5-6,7-9,abaxially,acute,age,and/or,anther,anthesi,apart,apex,arachnoid,attenuate,base,branched,calyx,clavate,cm,conical,corolla,dendritic,densely,diameter,distally,drying,ellipsoid,especially,exerted,filament,glabrescent,glabrous,growth,inflorescence,internodal,lamina,lanceolate,leaf,lengthening,less,like,margin,minutely,mm,narrowly,new,nodding,oblanceolate,ovary,pair,paler,papillate,pedicel,petiole,plane,pore,poricidal,primary,pubescent,rachi,reddish,revolute,scar,shrub,simple,sinus,slit,sparsely,stem,stigma,stout,straight,strongly,style,surface,tip,trichome,tube,uniseriate,vein,way,white,x	0.2-0.5,0.5-2,1-,2-2.5,2-4,?,adaxiall,appearing,bark,branch,broadly,crowded,deciduou,deltate,dense,dry,eaf,erect,fleshy,flower,free,irregularly,know,known,lobe,lobed,lower,near,nflorescence,ot,papillat,peduncle,perfect,planar,plurifoliat,portion,slender,small,soon,surfac,terminal,thick,thickened,third,tub,ud,unit,upper,widest,ympodial	adaxially,bud,colour,distance,exertion,form,length,lobing,position,shape,texture,type,width
87	wfo-0001026830	invalid_json	198	136	109	89	27	0.551	0-10,0.3-1.3,0.4-1,0.5-1.0,0.9-1.9,1-2,1.4-4,1.5-4,2-4,2.5-5,3.5-8.5,4-10,4-14.5,4-7,4.4-14.5,4.5-17.5,5-11,6-13,7-18,abaxially,adaxially,anther,berry,blade,brown,brownish,cell,ciliate,clavate,cm,condition,connivent,coriaceous,corolla,covering,deep,diameter,drying,elliptic,filament,finely,flower,forked,fresh,fruit,glabrescent,glabrous,globose,green,green-white,greenish,hair,hair-like,herb,homostylous,interjected,lanceolate,lateral,leaf,leaflet,lengthening,light,lobe,make,margin,medium,mm,moderately,moniliform,mucilaginous,odd-pinnate,ovate,ovoid,pair,pentagonal,petiole,plant,pore,poricidal,puberulent,pubescent,purple,ripe,rotate,seed,short,simple,size,slit,stigma,straight,stripe,style,subglabrous,terminal,testal,thick,throughout,tip,tube,tuber,unwinged,wall,wet,white,whitish,x,yellow,yellowish	0.5-1.2,1-10,1-11,1.1-2.7,10-57,2-6,2.5-4.4,2.7-8,5-merou,acumen,acuminate,acute,adaxiall,ag,along,alyx,apart,apex,apparently,arranged,articulated,asymmetric,attenuate,axe,axillary,base,basiscopic,bead,bud,capitat,decreasing,digestion,distal,dorsally,eaf,edge,eed,enzyme,erec,exceeding,flat,folded,geminat,generally,glabrou,hal,half,high,honeycomb,like,linear,living,long,lower,multiple,necklace,nflorescence,orbicular,orolla,pedicel,peduncle,perfect,petiolulate,plurifoliate,removed,rounded,ruit,sessile,seudostipule,shaped,side,spaced,specimen,stamen,stolon,subequal,subglabrou,subtending,tall,tamen,tem,tissue,toward,tri-,typically,unit,usually,vary,ympodial	'',5-merous,[,``,age,arrangement,branching,calyx,capitate,characteristic,colour,form,growth,height,inflorescence,length,number,ovary,pseudostipule,shape,staman,stem,texture,type,value,{,}
88	wfo-0001026831	success	207	77	57	150	20	0.275	0-20,0-3,1-4,3-5,3-6,anther,berry,branched,bright,calyx,chartaceous,cream,dark,dull,elliptic,elongating,equal,flattened-reniform,flower,fruit,fruiting,green,lateral,leaf,length,lobed,long,lower,margin,marking,maturity,mauve,membranous,mm,moderately,orange,orange-brown,pale,per,petiole,poricidal,porrect,prickle,red-brown,shrub,spherical,stellate-pubescent,stem,subsessile,surface,tapering,tip,trichome,white,yellow,yellow-green,young	-0.25,-5,-6.5,-9,.5,/4,0-10,0-6,0.1,0.1-0.2,0.1-0.25,0.15-0.25,0.2-0.4,0.2-1,0.3-0.6,0.3-0.65,0.5-1.2,0.6,0.6-2,0.65-1,0.7-1.1,0.7-2,1-10,1-2,1-2.2,1-2.5,1-3,1-6,1.2-2,1.5-2.5,1/3,1/3-1/,1/3-2/3,1/5-1/4,2-2.5,2-3,2-4,2.3-2.9,2.5-4.5,3.5-10,5-merous,7-10,7-8,abaxially,acute,alyx,apar,apart,apex,apically,apparently,articulated,attenuate,bark,base,blade,broad-deltate,brow,caudat,cell,cm,concolorous,connivent,curved,deltate,densely,diameter,difoliate,distance,drying,eaf,eed,erect,extending,eye,filament,free,fully,geminat,glabrescent,glabrous,gray-brown,herbaceous,infructescence,less,lobe,longer,mature,midpoint,midvein,multangulate,naked,narrow-cuneate,nflorescence,oblong,occasionally,older,one,open,opening,orolla,oung,outline,ovate,pair,pedicel,peduncle,pendulous,perfec,pericarp,portion,prickl,prickly,primary,raised,ray,reduced,rounded,ruit,scandent,scar,sessile,shiny,shorter,side,slender,smooth,sometimes,spaced,sparsely,spreading,stalk,stellate,style,tamen,terete,tertiary,time,tube,unit,upper,usually,vary,vein,venation,visible,way,white-gray,wide,ympodial	branching,colour,corolla,form,growth,hair,heteromorphism,inflorescence,needle-like,number,orientation,placement,position,seed,shape,staman,symmetry,texture,type,zygomorphy
89	wfo-0001026841	success	139	75	57	82	18	0.41	0.25-0.3,0.5-0.75,0.5-1,0.6-1,0.75-1,0.8-1,0.8-3,1.5,1.5-2,2-2.5,3-6.5,3.5-5,4-8,6-8,9.2-18,acute,along,anther,base,beneath,bi-lobed,broadly,calyx,clavate,cm,conical,corolla,elliptic,filament,filiform,fruiting,glabrous,globose,green,inflorescence,leaf,lobed,mm,opposite,ovary,pedicel,petiole,pore,pubescent,shaped,shining,shrub,simple,sparsely,stigma,style,tear-drop,trichome,tube,uniseriate,vein,white	.25,.5,/4,0.05,0.25-0.5,0.5-2,5-8-flowered,7-9,anthesi,apart,apex,arch,axi,ba,bark,berry,coroll,curly-tipped,decurrent,deflexed,deltoid,dia,eaf,edicel,eed,ellipsoid,exsertion,free,glabrate,greyish-gree,hyaline,immature,joined,known,later,lateral,like,lobe,lon,long,lower,main,margin,middle,minutely,nflorescence,older,pair,paler,papillo,papillose,poricidal,portion,prominent,raised,reddish,reflexed,rest,ruit,scar,series,slender,slightly,spaced,stem,straight,tall,tapering,terminal,thickened,tip,ud,unevenly,unifoliat,unit,way,widest,winged,woody,x,ympodial,young	5-8,branching,colour,decurren,diameter,flower,form,fruit,growth,height,length,number,plant,position,shape,symmetry,texture,width
90	wfo-0001026849	success	180	91	77	103	14	0.428	0-10,0.5-1,1-1.5,1-2,1.5-2.5,11,2-3,38/2,5,637/2,7-8,acute,anther,apex,aster,axil,base,brown,calyx,capitate,cell,cm,colour,conical,corolla,cyme,discoidal,distinctly,expanded,facetted,filament,floral,fork,glandular,globular,green,grey-brown,growth,hair,inflorescence,lavender,leaf,lobe,long-cuneate,margin,minute,minutely,mm,oblong,oblong-lanceolate,ovary,pedicel,peduncle,petiole,pore,poricidal,reproducing,reticulate,rh,rhachi,rounded,sea,seed,short-lived,shrub,simple,slightly,stem,stigma,stone,style,surface,tip,unarmed,undulate,vegetatively,violet	-50,1,1-6,1.75-2,100-130,2,30-,40,5-10,80-,adherent,adult,amongst,appearing,aspect,australian,berry,composed,conspicuous,curved,cut,deflexed,developed,dia,distinct,eed,ellipsoid,emarginate,enlarge,entire,erect,exceeding,except,exerted,filled,flesh,flower,flowered,free,fruiting,general,glabrous,globose,granule,greater,gree,half,interacuminal,large,leave,lengthening,less,linear-lanceolate,little,lon,long,loosely,lower,mature,maturity,mid-vein,native,nflorescence,occasionally,often,pal,pale,pedicellate,petal,plurifoliat,preparation,pruinose,purple,rarely,relatively,rotate,ruit,ruiting,shallow,shed,sinus,slende,slit,soft-wooded,solanum,solitary,sometimes,somewhat,soon,stony,stout,thus,tissue,tub,tube,ud,unit,uvenile,way,well,x,ympodial,young	30-40-50,80-100-130,armament,diameter,form,fruit,history,length,life,number,position,reproduction,shape,type
91	wfo-0001026858	success	153	127	97	56	30	0.634	-30,0.5,0.8,0.8-1,1-10,1-11.5,1-4,1-5,1.3-1.5,1.5-4,2-2.5,2-3,2-4,2.5-3,3-4,4-24,4.5-10.5,6-10,6-18,6-7,abaxially,acumen,adaxially,apical,apically,branched,calyx,cell,cm,connate,corolla,covering,cyme,dehiscent,diameter,dichasial,dichasially,distal,exceeding,filament,flower,forked,glabrescent,glabrous,globose,green,green-white,hair-like,herbaceous,interjected,introrse,lateral,leaf,leaflet,light,lobe,long,make,maturing,minute,mm,monochasial,mucilaginous,mucronate,oblong,odd-pinnate,often,ovoid,pedicel,peduncle,perennial,perfect,petiole,plant,poricidally,proximal,seed,shiny,short,size,slit,stamen,stellate,stigma,straight,style,testal,thick,throughout,triangular,tuber-bearing,typically,unit,wall,wide,yellow,Â¼	-4,0-.,1-,3-,3-6-foliat,5-15,abruptly,acute,apex,articulate,base,cordate,cuneate,digestion,diminishing,dorsally,eaf,ebracteate,edge,eed,emoval,enzyme,flat,folded,generally,globo,half,honeycomb,living,lon,lower,lunat,nflorescence,nther,oblique,obtuse,orolla,ovate,ovate-lanceolate,pair,pattern,plan,reveal,rounded,ruit,seudostipule,slightly,specimen,tal,tem,throughou,toward,vary,white-crea,without,ympodial	0-2,3-15,3-6-foliate,anther,arrangement,articulation,bract,branching,colour,ebbrate,form,fruit,growth,height,inflorescence,length,lunate,number,ovary,pore,pseudostipule,shape,stem,structure,sympodial,texture,type,wet,white-cream,width
92	wfo-0001026895	success	166	96	80	86	16	0.482	0.5-1,0.5-1.2,0.5-1.5,0.5-2,0.8-1,1-1.5,1.4-2.1,2/3,4.5-5,abaxial,acute,anther,apex,apically,attenuate,base,berry,broad,broadly,brown,calyx,capitate,cm,conical,corolla,dark,deflexed,dendritic,drying,erect,filament,filiform,flattened,fruiting,glabrous,globose,green,incrassate,internodal,lamina,leaf,lobed,margin,mm,mustard,often,ovary,pale,pedicel,petiole,pointed,pore,pubescent,reddish,reniform,scattered,shape,shaped,shrub,shrublet,simple,small,somewhat,stigma,style,swollen,swollen-based,tan,tear-drop,thin,toothed,trichome,tube,type,uniseriate,way,white,woody,x,yellow	.5,0-0.5,1-5,1.5-2,2-2.3,2-2.5,2-3,2.5-3.2,3-12,5-6,5-8-flowered,adaxial,along,anthesi,apical,appearing,ba,bark,borne,campanulate,closely,contracted,deltoid,denser,dia,differing,difoliate,eaf,edicel,eed,ellipsoid,elliptic,elongate,free,geminat,glabrate,hard,lateral,like,lobe,lon,long,long-exserted,lower,main,major,middle,minor,minute,minutely,narrowly,nflorescence,obovate,older,overlappin,pair,papillo,pericarp,pitted,poricidal,portion,present,projection,reddish-brow,ruit,scar,shoot,short,side,size,soon,spaced,sparsely,stem,surface,tall,tip,tub,tuft,ud,unit,usually,vein,widest,ympodial,young	articulation,branching,colour,connective,form,fruit,growth,hair,height,inflorescence,length,plant,position,seed,stellate,texture
93	wfo-0001026905	success	204	89	61	143	28	0.299	.5,0-25,0.5-1.5,1-4,1/2-3/4,2.5-3.5,anther,attenuate,base,berry,branched,calyx,chartaceous,cm,connivent,dull,elongating,filament,flattened-reniform,flower,fruit,fruiting,glabrous,inflorescence,lateral,leaf,length,lobed,long,lower,margin,marking,mature,maturity,mauve,mm,oblong,orange,orange-brown,ovate,per,petiole,poricidal,prickle,prickly,red,rounded,shrub,sometimes,spherical,stellate-pubescent,stem,subentire,surface,tapering,tip,usually,way,weakly,white,yellow	-1.5,-10,-2,-2/3,-3,-4,.2,0,0-2,0-20,0.1,0.15,0.2-0.3,0.2-0.5,0.3-0.4,0.4,0.4-0.9,0.4-1,0.5-0.7,0.6-0.7,0.7-1.4,0.75-1.1,0.9-1.3,1,1-2,1-2.5,1-20,1-3.7,1-6,1.9-2.5,1/3,1/4,1/5-1/3,2-3,2.5-2.9,2/3-3/,3-5,3-8,5-6,5-merous,6-8,7-8,abaxially,acuminat,acute,alyx,ame,apar,apart,apex,apically,apparently,articulated,bark,blade,brow,c.,cell,cream,curved,dark,deltate,densely,diameter,difoliate,discolorous,distance,drying,eaf,eed,equal,erect,extending,eye,free,geminat,gray-green,green,infructescence,lobe,longer,midpoint,midvein,moderately,naked,older,one,open,orolla,oung,outline,pair,pale,pedicel,peduncle,pendulous,perfec,pericarp,pit,porrect,portion,prickl,primary,raised,ray,reduced,ruit,scar,sessile,shallowly,shorter,side,slender,small,smooth,somewhat,spaced,sparsely,spreading,stalk,stalked,stellate,straight,style,tamen,terete,tertiary,time,trichome,tube,unarmed,unit,upper,variously,vary,vein,venation,visible,wide,woody,yellow-green,ympodial,young	abaxial,adaxial,appressed,bract,branching,colour,connective,corolla,form,growth,hair,heteromorphism,inflated,modification,na,number,odour,orientation,placement,pore,position,seed,shape,spot,staman,symmetry,texture,type
94	wfo-0001026923	success	177	113	94	83	19	0.531	.1-0.3,.5,0.25-0.5,0.5-1,0.6-0.8,0.8-1,1,1-7,1.5-4,2,2-2.5,2-6,3-5,4-18,5-10,5-15,5-6,5-9,abaxially,acuminate,adaxially,anther,apex,articulated,base,black,branched,brown,calyx,chartaceous,cm,cuneate,cylindrical,densely,diameter,directed,distally,elliptic,elliptic-ovate,entire,flattened,flower,forked,fruit,glabrescent,glabrous,globose,green,hair,intermediate,large,leaf,light,like,longitudinal,margin,mm,moderately,multangulate,oblong,opening,pedicel,peduncle,peltate,petiole,pore,possibly,pubescent,purple,rachi,red,ripening,rounded,rugulose,scale,sessile,shrub,simple,slit,small,sparsely,stellate,stem,stigma,strongly,style,surface,tree,trichome,white,whitish,x,yellow,yellowish	-5,0-5,0.5,1-1.5,1-3,1-4,1.5-2,10,2-3,20-50,3-4,4-5-,absent,accrescent,acute,adaxiall,ag,apart,apparently,axe,ba,blade,capitat,center,connivent,covering,curved,deltate,denser,eaf,eed,eglandular,equal,erect,filament,frui,fruiting,fused,geminate,gland-tippe,glandular,held,lanceolate,lateral,leaf-opposed,lobe,long,lower,many-foliate,midpoint,midvein,much,nearly,nflorescence,orange,orolla,paired,perfect,pubescence,ray,relatively,ruit,short,slightly,smaller,sometimes,somewhat,spaced,ste,straight,subtending,tal,tamen,tem,time,tip,tube,unit,uprigh,usually,vary,wide,ympodial	age,articulation,branching,capitate,colour,corolla,form,growth,height,inflorescence,length,ovary,plant,seed,shape,size,staman,texture,type
95	wfo-0001026925	success	215	90	68	147	22	0.316	0-20,1-3.5,1/3-1/2,4-10,5-6,6-8,anther,base,berry,branched,calyx,chartaceous,cm,connivent,cream,curved,dark,deltate,elliptic,equal,flattened,flattened-reniform,flower,fruit,fruiting,gently,glabrous,green,hair,lateral,leaf,length,lobed,long,long-styled,margin,marking,maturity,mauve,membranous,minute,mm,moderately,orange-brown,ovate,pale,per,petiole,poricidal,prickle,rarely,reflexed,short-styled,shrub,simple,sparsely,spherical,stellate-pubescent,stem,straight,tapering,terminal,tip,way,white,yellow,yellow-orange,young	-2,.5,/6,0,0-10,0-5,0-7,0.1,0.1-0.2,0.1-0.3,0.2,0.5-1.5,0.5-4,0.7-1.8,0.9-1.8,00-200,1-1.3,1-1.4,1-25,1-3,1-4,1.5-2,1.5-2.5,1.5-4.5,1.8-2,1.8-2.5,1/3,1/4-2/3,1/6-1/3,2-4,2-5,2.4-2.6,2.4-3,2.5-6,2/,3-20,3-7,4-14,4-5,4-7,5-8,5-merous,5.5-10,6-10,6-17,7-12,abaxially,acuminat,acute,alyx,ame,andromonoecious,apar,apart,apex,apically,apparently,articulated,attenuate,bark,blade,broad-deltate,brow,c.,concolorous,diameter,distal,distance,drying,eaf,eed,elongating,erect,extending,filament,free,glabrescent,green-brown,hermaphrodite,heterostylous,infructescence,lobe,lobing,longer,lower,lowermost,mature,midpoint,midvein,narrow-deltate,nflorescence,oblong,older,one,open,orolla,oung,pair,pedicel,peduncle,pendent,pendulous,pericarp,plant,plurifoliat,porrect,portion,prickl,prickly,primary,ray,red-brown,reduced,rounded,ruit,scar,secondary,sessile,side,smooth,sometimes,spaced,spreading,stalk,stalked,staminat,stellate,stout,style,surface,tamen,terete,tertiary,time,translucent,trichome,tube,unarmed,unit,upper,vary,vein,venation,visible,wide,woody,ympodial	100-200,abaxial,adaxial,branching,colour,corolla,form,growth,heteromorphism,inflorescence,na,number,orientation,placement,position,seed,shape,staman,symmetry,texture,type,zygomorphy
96	wfo-0001026946	success	205	131	108	97	23	0.527	0-20,0.5-2,0.9-4.3,1-2,1-4,1.5-2,1.6-3.7,10-39,2,2-15,3-20,3-5,3.5-10,4-7,4.1-9.4,5-7,6-24,8-15,8-25,abaxially,adaxially,anther,blade,borne,brownish,cell,chartaceous,clavate,cm,condition,connivent,corolla,creamy,deeply,densely,diameter,digestion,distal,dot,drying,end,enzyme,filament,flower,forked,fresh,fruit,generally,glabrous,globose,green,greenish,hair,half,herb,homostylous,honeycomb-shaped,interjected,lanceolate,lateral,leaflet,lengthening,like,long,membranous,mm,mottled,odd-pinnate,often,ovoid,pair,pentagonal,petiole,plant,pore,poricidal,pubescent,pure,purple,removed,ripe,scattered,seed,short,short-pubescent,singly,size,slightly,slit,stellate,stem,stigma,straight,streak,style,terminal,testal,tip,tuber,typically,unwinged,usually,wall,white,whitish,wing,x,yellow-white	0-5,0.9-3.5,1,1-10,12-23,2-5,2.5-10.5,2.7-9,3-6,5-merou,acumen,acuminate,acute,ag,along,alyx,apart,apex,apparently,articulation,attenuate,axe,axillary,base,berry,broadly,bud,capitat,ciliate,covering,dorsally,eaf,edge,eed,elliptic,erec,especially,exceeding,except,extremely,flat,folded,geminat,glabrou,greatly,green-white,hair-like,living,lobe,lower,make,margin,midrib,minutely,mucilaginous,narrowly,nflorescence,oblique,orbicular,orolla,ovate,pedicel,peduncle,perfect,petiolulate,petiolule,plurifoliate,proximal,puberulent,pubescen,reduced,rounded,ruit,sessile,seudostipule,spaced,specimen,stamen,ste,stolo,subequal,subtending,tall,tamen,tem,thick,thir,throughout,tri-,truncate,tube,unit,variable,vary,wet,yellow,ympodial	5-merous,age,arrangement,branching,calyx,capitate,colour,form,growth,height,inflorescence,leaf,length,number,ovary,presence,pseudostipule,pubescence,shape,staman,stolon,texture,type
97	wfo-0001026962	success	205	95	80	125	15	0.39	0,0.3-0.7,0.8-1,1,1-1.2,1-1.5,1-3,1-4.5,1-6,1.5-17,1.5-2,1.5-5,10-12,2-2.5,2-6,3-3.5,4-5,acute,anther,apex,base,broadly,calyx,chartaceous,cm,corolla,darker,deltate,densely,diameter,elliptic,entire,filament,flattened-reniform,fruit,globose,green,incrassate,inflorescence,internodal,leaf,lobe,lobed,margin,minutely,mm,narrowly,oblong,occasionally,opposite,pedicel,peduncle,petiole,pitted,pore,pubescent,purplish,rachi,rounded,sagittate,shaped,shrub,simple,size,slightly,small,sometimes,somewhat,stellate,surface,tear-drop,tinged,tip,tree,triangular,tube,unbranched,white,x,yellow	.05,.5,0.5,0.5-0.8,0.5-1,0.5-1.5,1-2,1.5-3,10-20,15-22,2-5,2/3-3/4,3-6,6-7,9-12,9-17,abaxially,abrupt,abruptly,accrescent,adaxially,ag,alyx,anthesi,apparently,appearing,arising,articulated,axe,bark,basebud,becoming,beneath,blade,brittle,bud,capitat,cell,closely,composed,connivent,constricted,cucullat,cylindrical,deflexed,denser,differing,difoliate,dimorphic,dry,eaf,eed,elongate,evenly,except,exerted,flower,free,fruiting,geminat,glabrate,glabrou,glabrous,ilament,later,lateral,like,long,longitudinal,main,major,material,minor,nflorescence,obconic,obovoid,often,older,one,opening,orolla,oung,outline,ovate-lanceolate,overlapping,packed,pair,pale,papillose,paten,pendent,perfect,portion,prominent,pubescen,raised,reflexed,remaining,rest,rounder,ruit,slender,slit,soon,stem,stigma,straight,style,tal,tapering,tooth,trichome,trunk,unarmed,unifoliate,uniseriate,unit,vary,vein,way,whit,woody,yellowish,ympodial,young	abaxial,adaxial,arrangement,branching,colour,form,growth,hair,height,length,plant,position,seed,shape,texture
98	wfo-0001026964	success	128	97	78	50	19	0.609	.2,.5,0,0.5,0.5-1,1-1.2,1-2.5,10,10-30,2-2.5,2-4,3-5,3.5-7,4.5-8.5,7-8,acuminate,acute,along,anther,apex,attenuate,axillary,basal,base,beak,cm,conical,corolla,diameter,elliptic,filament,filiform,fruiting,glabrous,globose,greenish,herb,horizontal,lateral,leaflet,lobed,long,long-attenuate,margin,minutely,mm,nearly,obovate,onto,ovary,pair,papillate,pedicel,petiole,pinnate,poricidal,primary,pubescent,purple,rachi,rugose,shape,simple,size,smooth,somewhat,sparsely,stigma,style,surface,terminal,tip,trichome,tube,uniseriate,vein,x,yellow	?,anthesi,bearing,berry,calyx,capitat,conspicuously,differentiated,distinct,eaf,edicel,equal,erec,exserted,fleshy,flower,free,glabrou,green,immature,known,lenticellate,lightly,line,lobe,lower,nflorescence,noddin,often,one,open,ot,petiolule,portion,purpli,reflexed,ruit,scar,side,slender,small,tal,tem,time,tub,ud,unifoliat,unit,winged,ympodial	arrangement,bud,capitate,colour,erect,form,fruit,growth,height,inflorescence,leaf,length,nodding,number,plant,position,stem,texture,type
99	wfo-0001026981	success	252	138	117	135	21	0.464	-0.8,-2.5,-35,0.05-0.1,0.1-0.3,0.15-0.2,0.3-0.5,0.4-0.5,0.4-0.7,0.4-2,0.45-1.3,0.5,0.5-0.3,0.5-30,0.6-1.4,0.6-2,0.7-0.8,0.8-1.2,0.8-6,0.9-1.5,1-2,1-3,1-3-celled,1-3.3,1-4,1.5-2.0,1.5-8.5,1.8-2.8,1/3,2-3-branched,2-locular,3.5-14,6-10,7.5,<,absent,anther,apical,appendage,articulation,asymmetric,base,brown,calyx,capitate,cell,cm,column,conical,cordate,corolla,dark,densely,diameter,distal,entire,filament,fruit,fruiting,glabrescent,glandular,globose,green,hair-like,herb,imparipinnate,interrupted,irregularly,lateral,leaf,leaflet,lime,lobe,lobed,margin,maturity,minutely,mm,obovate,occasionally,orange,orbicular,outgrowth,ovary,ovate,pale,patent,pedicel,peduncle,pentagonal,perennial,petiole,pseudostipule,pubescence,pubescent,rounded,shorter,simple,slender,sometimes,sparsely,staminal,stem,sterile,stigma,style,terminal,testa,trichome,tube,type,uniseriate,variously,velvety,wall,without,yellow	-0.4,-14,-2,-4,-8,.2,.2-0.2,0-5,0.1-0.2,0.2,0.2-0.4,0.2-2,0.25-0.4,0.3.6,0.9-1.4,1,1-2-cellular,1.5-5,11,196.,2-3,3-foliate,4,4-8,4-celled,abaxially,absen,abundant,academy,accrescent,acute,adaxially,adpressed,along,amongst,angled,anthesi,apex,appearance,appressed,articulated,axi,basiscopically,bay,beak,becoming,bract,bracteole-like,citrus-like,coastal,composed,cone,d,deltate,eaf,ebracteate,edicel,eed,erect,exserted,flower,giving,gree,half,halfway,head,included,initially,interjected,internode,jointles,larger,later,less,like,linear,lon,long,lower,mainly,mixed,much,multicellular,narrowly,nflorescence,pair,per,petiolule,plant,population,present,primary,procumbent,pronounced,proximal,rachi,reflexed,rick,robust,ruit,scen,secondary,see,sessile,several,shaggy,shaped,short,silky,smaller,sparser,specimen,spreadin,straight,strong,surface,tangled,tem,tertiary,thick,tightly,transparent,tub,uni-,unicellular,unit,upto,usually,villous,viny,wide,winged,ympodial,â,â	0.1,0.3-0.6,abaxial,adaxial,arrangement,branching,bud,colour,form,growth,history,inflorescence,length,life,locularity,seed,shape,texture,thicknes,villousnes,width
100	wfo-0001026992	success	243	134	115	128	19	0.473	0.2-0.5,0.25-0.45,0.5-1.2,0.6-1.5,0.8-3.4,1-4,1.2-1.4,1.2-1.7,1.4-1.6,1.4-1.9,1.7-2.4,1.7-4.3,2-10,2.8-4.7,3-4,3.3-5.5,3.3-5.6,5.3-12.1,6-10,8,8-11,8-14,abaxially,abruptly,acuminate,acute,adaxially,anther,apex,appressed,articulated,attenuate,bark,base,blunt-tipped,branch,branched,broadly,brown,calyx,chartaceous,cm,corolla,deltoid,diameter,directed,distally,echinoid,elliptic,entire,filament,flat-topped,flower,fruit,globose,granular-tomentose,greenish,hair,lance-ovate,lanceolate,leaf,length,lobe,many,margin,mm,moderately,multangulate,oblong,often,ovate,pedicel,peduncle,petiole,plant,pore,poricidal,pubescence,pubescent,rachi,reniform,reticulate-punctate,ripe,scabridulous-,semi-ovate,short,shrub,simple,size,small,sometimes,somewhat,sparingly,spreading,stellate,stigma,style,subcampanulate,subglobose,surface,time,tip,tomentose,tree,tube,unarmed,unequal,velutinous,violet,white,whitish,x,yellow,yellowish,young	-2.5,/7,00-170,1.3-2.6,1.3-4.3,1.5-3.4,1.7-1.9,1/2,10-12,12-33,2-5.6,2.3-3.3,2.6-4.6,2.8-4.6,4-8,5-15,5-merou,abaxial,accrescent,adaxiall,ag,along,alyx,angled,anthesi,apart,apparently,approximately,around,axe,axillary,ba,berry,blade,capitat,completely,coriaceous,covering,crown,cylindrical,dark,densely,drying,eaf,echinoi,edge,eed,enveloping,equal,evident,exserted,farinose,fleshy,forming,free,fruiting,geminate,glabrescen,glabrous,grooved,high,homostylous,immature,inserted,lacking,lateral,lengthening,less,line,lobed,long,long-stalked,longitudinal,longitudinally,lower,m.,main,mature,maturity,midrib,minute,mostly,nearly,nflorescence,obtuse,occasional,occasionally,older,orange-tan,orolla,ovate-lanceolate,overlapping,perfect,plurifoliate,porrect-stellate,rare,rather,ruit,runk,sessile,short-,short-stalked,shorter,side,slit,spaced,split,stalked,stamen,stem,stout-stalked,suture,tamen,tan,terete,terminal,thin-textured,ud,unarme,unit,usually,vary,vein,way,weakly,wide,ympodial,Â½	articulation,branching,bud,capitate,colour,form,growth,height,inflorescence,ovary,pattern,position,prickle,seed,shape,staman,texture,trunk,type
101	wfo-0001026994	success	266	114	86	180	28	0.323	0.5,0.5-0.7,0.5-0.8,4-15,anther,articulation,base,bent,berry,bifurcate,bracteate,branched,bright,brown,calyx,cell,cm,corolla,dark,darker,densely,developed,distal,ebracteate,eglandular,elliptic,filament,fruit,fruiting,glandular,globose,greenish,hair-like,half,head,herb,imparipinnate,inflorescence,interrupted,investing,lateral,leaf,leaflet,less,lobe,locule,long,loosely,lower,margin,medial,midvein,mm,narrowly,node,oblique,obovate,occasionally,outgrowth,pedicel,peduncle,perennial,pseudostipule,pubescent,purple,rachi,regularly,ripe,rotate-stellate,simple,spreading,stem,stripe,surface,testa,tip,trichome,unicellular,uniseriate,usually,velvety,wall,weak-walled,well,white,yellow	-0.7,-10,-20,-30,-foliate,.2,.5,0.05-0.1,0.05-0.2,0.1,0.1-0.2,0.1-0.3,0.15-0.2,0.2-0.4,0.2-0.5,0.25,0.3-0.4,0.4-0.5,0.4-1.2,0.5-0.6,0.5-0.9,0.5-1.2,0.5-1.3,0.5-2,0.7-2.5,0.9-1.2,0.9-1.3,1,1-1.2,1-1.4,1-1.5,1-1.6,1-2,1.2-1.6,1.2-3.5,1.4-2.1,10-20,12-,2,2-,2-2.6,2-4,2-5-locular,2.2-3.2,2.5-6.5,20-50,3,3-branched,4,4-celled,5,5-,5-7,6-20,7-13,8,8-12,abaxially,absent,abundant,acroscopically,acuminate,acute,additional,adpressed,along,also,amongst,andscattered,anthesi,apex,apical,apically,appearance,appendage,articulate,basal,basally,basiscopically,becoming,beneath,bifurcation,bract,broader,broadly,capitate,celled,column,conical,crenat,crenate,crowded,decreasing,decumbent,decurrent,deeply,diameter,eaf,edicel,eed,erect,especially,essentially,exserted,fewer,flower,giving,glabrous,grayish,gree,green,habitat,hal,halfway,interjected,internode,irregularly,lamina,lanceolate,large,larger,largest,leave,like,lobed,lon,markedly,minutely,moderately,much,narrower,narrowing,nearly,nflorescence,often,ovary,pair,paler,papillate,petiole,petiolule,present,primary,puberulent,rarely,reflexed,robust,rocky,secondary,sessile,set,shaggy,short,silky,sinus,size,slightly,sometimes,sparsely,specimen,spreadin,staminal,sterile,stigma,straight,style,tall,tem,terminal,tertiary,thick,toward,tube,ud,unit,wide,winged,woody,ympodial,young	abaxial,arrangement,branching,colour,decurred,form,growth,hair,hirsute,history,length,life,marking,mature,modification,na,orientation,placement,pore,position,prickle,scattered,seed,shape,spot,symmetry,texture,type
102	wfo-0001026996	success	188	95	78	110	17	0.415	0-6,0.6-1,0.9-2.7,1-2,1.3-7.7,1.8-4.4,14-33,15-28,3-10,3-7,3.3-6,3.8-14.1,4-4.4,4-8,4.5-10.5,5-8,6-8,6.9-10.9,8.7-18.6,abaxially,acumen,adaxially,anther,blade,blue,brownish,cm,condition,coriaceous,corolla,dark,deep,diameter,drying,filament,flower,forked,fresh,fruit,glabrous,globose,green,greenish,herb,homostylous,interjected,lanceolate,lateral,leaf,leaflet,lilac,medium,mm,moniliform,mottled,mucilaginous,odd-pinnate,ovoid,pedicel,peduncle,petiole,plant,pore,poricidal,purple,ripe,seed,size,stripe,style,terminal,tip,tuber,unwinged,wet,white,whitish,x	1-3,1-4,1-5,1.2-1.8,2-3,3-5,5-merou,abaxiall,acuminate,acute,ag,along,alyx,apart,apex,apparently,arranged,articulated,asymmetric,attenuate,axe,axillary,base,basiscopic,bead,berry,bud,capitat,cell,clavate,connivent,considerably,covering,decreasing,digestion,distal,dorsally,eaf,edge,eed,elliptic,enzyme,erec,exceeding,flat,folded,geminat,generally,glabrou,green-white,hair-like,half,honeycomb-shaped,larger,lengthening,like,linear,living,lobe,long,lower,make,middl,multiple,necklace,nflorescence,orbicular,orolla,ovate,pair,pentagonal,perfect,petiolulate,plurifoliate,removed,rotate,rounded,ruit,sessile,seudostipule,side,slightly,slit,sometimes,spaced,specimen,stamen,stigma,stolon,straight,subglabrou,subtending,symmetric,tall,tamen,tem,testal,thick,throughout,tissue,toward,tri-,tube,typically,unit,usually,vary,wall,yellow,ympodial	arrangement,branching,calyx,colour,form,growth,height,inflorescence,length,number,ovary,pseudostipule,shape,stem,subglabrous,symmetry,texture
103	wfo-0001027010	success	198	124	103	95	21	0.52	0-2,0.4-5.1,0.5-1.5,1-10,1-2,1-4,1.2-1.7,1.2-1.9,10-60,14-46,2-9.4,2.1-15.3,2.1-4.3,2.2-12.9,3-10,3-5,3-6,3-8,4-12,4-8,4.4-29,4.9-31,5-13,5-14,abaxially,acute,adaxially,anther,blade,brownish,cell,clavate,cm,condition,coriaceous,corolla,deep,diameter,digestion,distal,drying,elliptic,enzyme,filament,flower,forked,fresh,fruit,glabrescent,glabrous,green,greenish,hair,half,herb,high,homostylous,honeycomb-shaped,interjected,lanceolate,lateral,leaf,leaflet,light,lobe,long,mm,moniliform,occasionally,odd-pinnate,ovate,ovoid,pair,pedicel,peduncle,pentagonal,petiole,plant,pore,poricidal,purple,removed,ripe,rotate,scabrous,seed,short,size,spot,stigma,straight,stripe,style,terminal,testal,tip,tube,tuber,wall,white,whitish,wide,x	0-2.5,0-3,1-7,1.4-6.9,2-6,3.5-13.6,5-merou,acumen,acuminate,adaxiall,ag,along,alyx,apart,apex,apparently,arranged,articulated,asymmetric,attenuate,axe,axillary,base,basiscopic,bead,bud,capitat,coloration,connivent,covering,decreasing,dorsally,eaf,edge,eed,erec,exceeding,flat,folded,geminat,generally,glabrescen,glabrou,green-white,hair-like,hal,larger,lengthening,like,living,lower,make,mucilaginous,multiple,narrow,necklace,nflorescence,orbicular,orolla,perfect,petiolulate,plurifoliate,present,rounded,ruit,scabrou,sessile,seudostipule,side,slightly,slit,sometimes,spaced,specimen,stamen,stolon,subequal,subtending,tall,tamen,tem,thick,throughout,tissue,toward,tri-,typically,unit,usually,vary,wet,wing,winged,yellow,ympodial	abaxial,adaxial,arrangement,articulation,branching,calyx,capitate,colour,form,growth,height,inflorescence,length,marking,ovary,pseudostipule,shape,spacing,staman,stem,texture
104	wfo-0001027019	invalid_json	142	126	98	44	28	0.69	.5,/4,0-0.5,0.5-1,1-1.5,1.5-2,1.5-3,1/2,12-30,2-3,2-5,2-8,4-5,4-8.5,7-14,abaxial,abaxially,acute,adaxially,anther,anthesi,apex,attenuate,bark,base,branched,bright,calyx,capitate,cm,constriction,corolla,cyathiform,densely,dia,distal,ellipsoid,elliptic,exserted,filament,flattened,fleshy,fruiting,glabrous,globose,golden,green,inflorescence,largely,later,leaf,like,live,lobed,long,major,minor,minutely,mm,obovate,older,onto,opposite,ovary,overlapping,ovoid-reniform,pale,papillose,pedicel,petiole,planar,plant,pore,pubescent,scar,shaped,shrub,small,somewhat,spaced,sparsely,stem,stigma,strongly,style,surface,tan,tapering,tear-drop,tree,trichome,tube,waxy,way,white,winged,x,young	1-2,10,10-40-flowered,abruptly,along,apparent,ba,berry,deflexed,deltoid,difoliate,eaf,edicel,eed,erect,even,free,geminat,glabrate,inflorescenc,lobe,lon,lower,midrib,narrowed,nflorescence,papillo,pitted,poricidal,portion,reddish-brow,rest,ruit,straight,tall,third,tip,tub,ud,unit,widest,wing,woody,ympodial	'',10-40,[,``,branching,bud,characteristic,colour,diameter,exsertion,flower,form,fruit,growth,height,length,number,position,reddish-brown,seed,shape,size,spacing,texture,value,winging,{,}
105	wfo-0001027030	success	234	154	133	101	21	0.568	-11,-15,.5,0-4,0.1-0.9,0.15-0.2,0.2-0.3,0.2-1,0.3-0.5,0.3-0.7,0.4-0.5,0.4-0.8,0.5,0.5-,0.5-0.8,0.5-1,0.6-0.7,0.6-0.8,0.7-1,0.8-0.9,0.8-1,0.9-1.1,1,1-,1-1.2,1-1.3,1-3,1-3.4,1.2-1.6,1.5-,2-,2-3,2-4,2-4.8,2-6,2-7,2.2-3.2,3-9,5-12,abaxial,acuminate,anther,apex,apical,appendage,articulation,base,bract,branched,bright,brown,calyx,capitate,cell,cm,column,conical,corolla,crenate,dark,decurrent,deeply,densely,denser,diameter,distal,elliptic,entire,evenly,filament,flower,fruit,fruiting,globose,grayish,green,hair-like,half,herb,imparipinnate,inflorescence,interjected,interrupted,lateral,leaflet,like,lobe,long,margin,minutely,mm,narrowly,oblique,obovate,outgrowth,ovary,pair,pale,paler,papillate,pedicel,peduncle,perennial,petiole,petiolule,primary,pseudostipule,pubescent,rotate-stellate,sessile,simple,size,soft,sometimes,sparsely,spread,staminal,stem,sterile,stigma,stripe,style,tall,terminal,testa,thick,truncate,tube,velvety,wall,wide,woody,yellow	.2,0.05-0.1,0.1-0.7,0.2,0.3-,0.4-1.5,0.5-0.7,0.6-1.8,1.6-2,2-foliate,2-locular,3-4-celled,3-8,4-celled,8-celled,abaxially,absent,abundant,acute,adaxially,adpressed,angled,anthesi,appearance,articulated,axi,basal,basiscopically,beneath,berry,beyond,crenat,crenation,darker,deeper,diamete,due,eaf,edicel,eed,eglandular,exserted,extremely,giving,gland,glandular,gree,growt,hal,halfway,internode,interspersed,investing,irregularly,lamina,lanceolate,larger,less,lon,longer,loosely,lower,multicellular,near,nflorescence,node,occasionally,often,present,pubescence,reflexed,robust,ruit,secondary,silky,similar,slender,slightly,small,smaller,somewhat,spreadin,spreading,straight,surface,tem,tertiary,tiny,trailing,trichome,ud,unicellular,uniseriate,unit,usually,vein,weak,white,winged,ympodial,young	adaxial,arrangement,branching,bud,colour,form,growth,height,history,leaf,length,life,papillae,placement,plant,prickle,seed,shape,texture,thicknes,width
106	wfo-0001027035	success	199	115	97	102	18	0.487	0-36,0.1-0.9,0.3-2.3,0.4-12.8,0.5-7,0.8-4.2,0.9-3.1,1-2,1-3,1-3.4,1-8,1.7-8,1.8-5.2,10-80,2-38,2-7,2.8-10.3,3-10,4-18,4-18.5,4.9-23.5,anther,blade,blue,brownish,cell,clavate,cm,completely,condition,corolla,deep,diameter,digestion,drying,elliptic,enzyme,filament,flower,forked,fresh,fruit,glabrescent,glabrous,globose,green,greenish,hair,herb,homostylous,honeycomb,interjected,lanceolate,lateral,leaf,leaflet,light,lilac,lobe,long,medium,mm,moniliform,odd-pinnate,ovate,ovoid,pair,pedicel,peduncle,pentagonal,petiole,plant,pore,poricidal,purple,removed,rotate,seed,shape,shaped,short,size,stigma,straight,style,terminal,testal,throughout,tip,tube,tuber,usually,wall,white,whitish,wide,x	0-7,0.5-3.4,0.5-5,0.8-3,1.5-5.9,3-5,5-merou,abaxially,acumen,acuminate,acute,adaxiall,adaxially,ag,along,alyx,apart,apex,apparently,arranged,articulated,asymmetric,attenuate,axe,axillary,base,basiscopic,bead,bud,capitat,coloration,connivent,covering,decreasing,distal,dorsally,eaf,edge,eed,erec,exceeding,flat,folded,geminat,generally,glabrescen,glabrou,green-white,hair-like,hal,half,high,larger,lengthening,like,living,lower,make,mucilaginous,multiple,necklace,nflorescence,orbicular,orolla,perfect,petiolulate,plurifoliate,present,ripe,rounded,ruit,second,sessile,seudostipule,side,slightly,slit,smaller,sometimes,spaced,specimen,stamen,stolon,stripe,subequal,subglabrous,subtending,tall,tamen,tem,thick,tissue,toward,tri-,typically,unit,unwinged,variable,vary,wet,yellow,ympodial	abaxial,arrangement,branching,calyx,capitate,colour,form,glabrousnes,growth,height,inflorescence,length,number,ovary,pseudostipule,staman,stem,texture
107	wfo-0001027050	success	244	131	109	135	22	0.447	-12,-9,0-0.2,0.1-3,0.3-1.5,0.5-3,0.9-2.1,1-1.5,1-2,1.5-6,10-13.5,15-50+,2-2.5,2-4,2-5,2-8,2.5-3,4-20,5-10,5-7,5-9,5-merous,50,8-26,abaxial,absent,adaxial,anther,articulated,base,branched,broad-based,broadly,calyx,capitate,chartaceous,cm,coarsely,conical,cordate,cuneate,curved,densely,diameter,elliptic,entire,flower,fruit,fruiting,green,growth,hair,heterostylous,inflorescence,interpetalar,juvenile,lanceolate,leaf,length,lobe,lobed,long,margin,midpoint,minutely,mm,moderately,obtuse,ovate,pedicel,peduncle,petiole,plant,pore,poricidal,present,prickle,pricklier,pubescent,ray,ripe,rounded,several,shallowly,short-stalked,shrub,slightly,small,sparsely,spherical,stalk,stellate,stellate-pubescent,stem,stigma,straight,style,surface,time,tip,tissue,toothed,tree,trichome,truncate,unbranched,white,wide,yellowish-green	.2,.5,/3,0-3,0.1-0.3,0.2-0.5,0.2-1,0.8,1,1.5-2,12-15,2-3,3-5,4-8,5,5-6,6-8,7-30+,abaxially,absen,abundant,acuminate,acute,adaxiall,adult,alyx,andromonoeciou,apar,apex,arme,axe,bark,basal,berry,blade,branch,broad,brow,brown,closely,connivent,deeply,difoliate,directed,distal,distall,distally,drying,eaf,eed,eglandular,equal,erec,erect,except,ferruginous,filament,flattened,flattened-reniform,free,geminat,glabrous,glandular-puberulent,half,infructescence,inside,juicy,larger,lateral,leaf-opposed,least,less,like,long-styled,longer,lower,markedly,mature,mid-way,midrib,midvein,minute,moist,mucilaginous,multiseriate,narrowly,near,nflorescence,numerous,oblique,occasionally,often,older,orolla,oung,ovate-lanceolate,pale,papillat,per,pericarp,porrect,portion,prickly,rest,ruit,scar,scattered,secondary,sessile,shiny,short-styled,shorter,side,somewhat,spaced,stalked,tall,tamen,terete,thicker,touching,triangular,tube,unarmed,unit,usually,vary,way,weakly,whitish,woody,yellow,ympodial,young,younger	0.5,armed,arming,articulation,branching,colour,corolla,form,height,number,ovary,papillate,placement,position,pricklines,seed,shape,size,staman,texture,type,width
108	wfo-0001027050	success	234	99	77	157	22	0.329	1.5-6,2-10,2.5-3,5-7,5-9,absent,accrescent,anther,articulated,base,branched,brown,calyx,chartaceous,cm,coarsely,cordate,cuneate,densely,directed,distally,drying,entire,extra-axillary,ferruginous,flattened,forked,fruit,fruiting,globose,green,growth,hair,inflorescence,lanceolate,leaf,leaf-opposed,length,lobe,lobed,long,margin,minute,minutely,mm,moderately,oblique,obtuse,often,pale,pedicel,petiole,pitted,plant,pore,present,rounded,shallowly,shrub,simple,slightly,small,sparsely,stellate,stellate-pubescent,stem,surface,toothed,tree,truncate,unbranched,usually,white,whitish,x,yellow,yellowish-green	.2,0-0.2,0-0.5,0-1,0-3,0.1-3,0.2-0.6,0.2-1,0.3-0.6,0.4-1,0.5-0.8,0.5-1,0.5-3,0.8,1-1.5,1-2,1-5,1.5-2,10-13.5,10-30,11-21,12-15,14-20,15-50+,16-40,2-2.5,2-3,2-3-locular,2-4,2-5,2-6,2-8,2-foliate,23-40+,3-15,3-5,4-19,4-40,4-8,5,5-10,5-6,5-merous,6-8,7-30+,8-26,8-40+,abaxially,absen,abundant,across,acuminate,acute,adaxiall,adaxially,adult,andromonoecious,anvil-shape,apart,apex,armed,axe,ba,blade,branche,broad-based,broadly,capitat,connivent,contiguous,cross-section,curved,cylindrical,deeply,diameter,distall,distributed,eaf,eed,eglandular,elliptic,erect,except,exocarp,filament,flower,functional,geminat,glabrous,glandular-puberulent,half,held,interpetalar,juicy,juvenile,lateral,less,like,longer,lower,markedly,mature,mesocarp,midpoint,midvein,moist,mucilaginous,multiseriate,narrowly,nearly,nflorescence,orolla,ovate,ovate-lanceolate,pair,peduncle,per,pinnatifid,placenta,porrect,prickle,rachi,ray,ruit,scattered,sessile,shorter,side,somewhat,spaced,stalk,stalked,stellae,stigma,straight,style,tal,tamen,tem,thick,thicker,throughout,time,tip,tissue,triangular,tube,unarme,unarmed,unit,upper,upright,vary,weakly,wide,ympodial,younger	abaxial,adaxial,articulation,berry,bract,branching,colour,connective,corolla,form,height,heteromorphism,marking,position,seed,shape,spot,staman,symmetry,texture,type,zygomorphy
109	wfo-0001027091	success	142	133	99	43	34	0.697	1-1.6,1.1-1.6,1.8-2.6,1/2-2/3,2.3-2.9,3-8,3-9,30-60,4-10,5-11,6-10,8.5-11.5,9-13,accrescent,acute-tipped,along,annual,anther,arcuate,base,blade,blue,bristly,broadly,brown,calyx,campanulate,capitate-glandular,cm,dark,deltoid,densely,developing,dm,dry,enveloped,few-rayed,glabrous,gland,glandular,hair,herb,internodal,invested,lenticular,linear-lanceolate,lobe,long,longer,low,main,maturity,mm,narrowly,near,obtuse,occasionally,oriented,ovate,pedicel,per,petiole,pinnatifid,pinnatisect,prickly,radially,reticulately,ridge,rounded,scattered,sessile,short,short-stipitate,simple,sometimes,sparsely,spherical,splitting,stellae,stellate-pentagonal,stem,strait,suffused,surface,tapering,terete,terminally,tightly,tube,twice,undulate,uniseriate,usually,variously,vein,vestiture,violet,wholly,wrinkled	.3,0.7,0.8,2.5-3.5,6-10-flowere,across,alyx,anthesi,armed,beneath,berry,branched,cauline,dia,difoliate,divided,eaf,eed,extended,fully,geminat,green,high,lon,mostly,nflorescence,orolla,ruit,slende,somewhat,spreadingly,ste,tamen,taprooted,tigma,tub,tyle,unexpande,unit,vary,yello,ympodial,younger	6-10-flowered,colour,corolla,diameter,envelopment,flower,form,fruit,glabrousnes,glandularity,growth,height,history,inflorescence,investment,leaf,length,life,lobing,number,orientation,ovary,pinnation,plant,position,prickle,prickling,seed,shape,slender,stigma,style,unexpanded,yellow
110	wfo-0001027102	success	167	113	90	77	23	0.539	.5,0.2-2,0.5-1,0.5-2,0.5-3,1-1.5,1-2,1-2.5,1-4,1.5-2,10-20,15,2-3,3,3-12,3-4,4-5,4-7,<,acuman,adaxial,adaxially,almost,anther,apex,base,broad,broadly,calyx,chartaceous,cm,cuneate,cylindrical,deltate,densely,diameter,directed,distally,elliptic,entire,few-,filament,flattened,forked,fruit,glabrous,globose,hair,lanceolate,leaf,leaf-opposed,lobe,long-tapered,margin,mm,moderately,narrowly,oblong,obtuse,orange,pedicel,peduncle,per,petiole,pore,pubescent,rachi,rarely,rugulose,shrub,simple,size,small,somewhat,stellate,stem,stigma,straight,style,subcoriaceous,surface,tip,tomentose,truncate,tube,unbranched,white,x,yellow,yellow-brown	.5-6,0.5,1-3,1-6,15-35,2-2.5,3-5,5-12,abaxially,absen,absent,accrescent,acuminate,acute,adaxiall,ag,aggregate,alyx,apart,appearance,articulated,axe,ba,blade,cell,channe,ciliate,congested,connivent,corky,curved,differing,difoliate,dimorphic,eaf,eed,flower,free,fruiting,geminat,giving,ilament,long,longitudinal,m.,major,minor,multiseriate,nflorescence,often,one,opening,orolla,ovate,perfect,portion,ripe,roughened,ruit,short,slender,slit,spaced,sparsely,stone,tal,tem,time,triangular,truncat,unarme,unit,usually,vary,wide,ympodial,young	abaxial,articulation,branching,colour,corolla,dimorphism,form,growth,height,inflorescence,length,number,ovary,placement,plant,position,prickle,seed,shape,texture,type,unarmed,ye
111	wfo-0001027104	success	141	104	78	63	26	0.553	0.15-0.35,0.5-0.8,1-3,1-4,1.2-6,1.5-2.3,1.5-4.2,10-15,2-3,2-6,3-5.5,4-15,5-15,6-7.5,acuminate,acute,apex,apical,apically,attenuate,base,branched,cell,cm,connate,cordate,corolla,covering,dehiscent,diameter,dichasially,distal,filament,finely,flower,globose,green,green-white,hair-like,half,herbaceous,introrse,lateral,linear,maturing,mm,narrowly,odd-pinnate,often,ovate,ovoid,pedicel,peduncle,perennial,perfect,petiole,plant,poricidally,proximal,pubescent,seed,short,slit,stellate,straight,style,testal,thick,throughout,tone,truncate,tuber-bearing,unit,wall,white,yellow,yellow-green,Â¼	1-1.5,2.2-5,3-6-foliat,abaxially,acumen,adaxially,articulate,calyx,condition,cyme,dichasial,digestion,dorsally,eaf,ebracteate,edge,eed,emoval,enzyme,epiphyti,epiphytic-like,exceeding,flat,folded,forked,generally,globo,growing,honeycomb,living,lobe,lon,long,lower,make,monochasial,mos,mucilaginous,mucronate,nflorescence,nther,orolla,ovat,pattern,plan,rarely,reveal,ruit,seudostipule,simple,specimen,stamen,stigma,tall,tem,terrestrial,throughou,typically,vary,viole,wide,without,ympodial	3-6-foliate,anther,arrangement,articulation,branching,colour,connective,form,fruit,growth,height,inflorescence,leaf,length,ovary,pore,position,pseudostipule,shape,stem,structure,sympodial,texture,type,violet,width
112	wfo-0001027114	success	154	90	72	82	18	0.468	-17,-2,-30,.5,1-1.1,1-1.2,1-1.5,1.5-1.7,1.5-2,1/2,13-21,2-2.5,2-3,3-4,3-7,6-8,6-9,7-9,abaxial,acute,anther,apex,base,branched,calyx,capitate,cm,conical,corolla,dendritic,dia,elliptic,filament,flattened-reniform,fruiting,glabrous,globose,green,inflorescence,lateral,leaf,lobed,long,main,many,minute,minutely,mm,occasionally,ovary,pair,pedicel,petiole,pitted,pore,poricidal,projection,shrub,size,soft,stigma,style,surface,time,tip,triangular,trichome,tube,vein,way,white,wide	0.5-1,1-2,20-40,5,7-10,abaxially,adaxially,along,alternating,anthesi,apar,appearing,axillary,ba,bark,berry,bushy,closely,commonly,dark,deltate,densely,differing,difoliate,drying,due,eaf,edicel,eed,erect,exserted,flowered,free,geminate,glabrou,growt,halfway,inflorescenc,investing,lamina,like,lobe,lon,lower,major,margin,minor,nflorescence,older,opening,opposite,papillo,planar,plurifoliate,portion,pubescent,rapid,reddish,reddish-brown,rest,ruit,scar,scattered,several,shoot,shoot-terminal,simple,slit,spaced,stem,tall,tapering,thickened,tub,ud,unevenly,uniseriate,unit,woody,yellowish,ympodial,young	0.5,1.5,branching,colour,diameter,form,fruit,growth,height,length,papillose,plant,pubescence,seed,shape,texture,venation,width
113	wfo-0001027117	success	235	87	60	175	27	0.255	0-25,0.5-1.5,1-2,3-15,4.5-6.5,accrescent,almost,anther,attenuate,base,berry,black,branched,brown,calyx,cell,chartaceous,cm,cordate,dark,enclosing,evenly,filament,fine,flattened-reniform,flower,fruit,fruiting,glabrous,green,herb,lateral,leaf,length,lobed,long,lower,margin,mature,mauve,mm,oblong,outline,per,petiole,pit,poricidal,prickle,raised,small,smooth,spherical,staman,stellate-pubescent,stem,surface,tapering,unequal,yellow,yellow-green	-1.5,-11,-12,-2.8,-3/4,.5,/3,0-10,0-15,0-20,0-40,0-5,0.1,0.1-,0.1-0.7,0.15-0.25,0.15-0.35,0.2,0.2-0.45,0.5,0.6-0.9,0.7-0.9,0.7-1.3,0.7-1.5,0.8-,1-4,1-6,1.2,1.5-,1.5-2.3,1.5-6.5,1.7-2.5,1.8-2.5,1/,1/3,1/4,1/8-1/2,10-20,2-3,2-6,2-8,2.3-2.8,25-100,3-10,3-6,4-6.5,4-7,4-8,4.5-8,5-11,5-14,5-merous,6-10,6-9,7-,8,abaxially,acicular,acute,alyx,ame,apar,apart,apex,apically,apparently,articulated,bark,beyond,blade,brittle,c.,concolorous,connivent,curved,deltate,densely,diameter,discolorous,distance,drying,eaf,eed,elongating,erect,extending,fifth,four,free,gently,glabrescent,gra,herbarium,infructescence,irregularly,less,lobe,lon,long-acuminat,longer,maturity,membranous,midpoint,midvein,moderately,narrow-deltate,narrow-elliptic,narrow-lanceolate,nflorescence,obovate,older,one,open,orolla,oung,ovate,pair,pale,pedicel,peduncle,pendulous,perfec,pericarp,perpendicular,plurifoliat,porrect,portion,prickl,prickly,primary,ray,red-brown,reduced,reflexed,rounded,ruit,scar,sessile,shallowly,shiny,shorter,side,sometimes,spaced,sparsely,specimen,spreading,stalk,stalked,stellate,straight,style,tamen,tearing,terete,tertiary,time,tip,tissue,translucent,trichome,tube,unit,upper,variously,vary,vein,venation,visible,way,weakly,wide,woody,ympodial,young	abaxial,adaxial,appressed,branching,colour,corolla,form,growth,hair,heteromorphism,inflated,inflorescence,marking,na,needle-like,number,odour,orientation,placement,pore,position,seed,shape,spot,symmetry,texture,type
114	wfo-0001027123	success	181	152	130	51	22	0.718	-10,-20,.3,.5,0.5,0.8-1.3,1,1-1.2,1-1.5,1.5-2,2-2.2,2-2.5,2-2.6,2-3,2-5.5,2-lobed,2.5-4,2.5-6,3-15,4-6,5-10,5-6,acute,adaxially,anther,apex,attenuate,axi,bark,base,branched,bright,broadly,brown,calyx,cell,clavate,cm,commonly,conical,constricted,coriaceous,corolla,cup-shaped,dark,deltate,dendritic,densely,diameter,elliptic,enlarged,erect,exerted,filament,flattened,flower,free,fruiting,glabrous,globose,green,inflorescence,inserted,leaf,less,like,lobe,lobed,long,loose,loosely,lower,margin,mauve-purple,minute,minutely,mm,narrowly,nodding,outline,ovary,pair,papillate,pedicel,peduncle,perfect,petiole,pitted,portion,primary,pubescent,reddish,reniform,revolute,scar,scattered,shining,short,simple,sinuate,sleeve,soon,spaced,sparsely,stellate,stem,stigma,straight,strongly,style,subshrub,surface,terminal,testal,thick,time,tip,trichome,tube,turned,upper,vein,violet,warty,way,white,widely,x,young,Â¾	0.3-1.6cm,0.5-0.8,0.7-3.5,0.9-1.3,2.5-10.4,3-4,4-5,abaxial,adaxial,along,anthesi,appearing,axe,campanulate,completely,darker,denser,drying,eaf,edge,eed,fide,glandular,lamina,lax,lewi,lon,midvein,monopodia,nflorescence,older,papillae,perhaps,petal,planar,plurifoliate,prominent,scatted,shin,shinin,shiny,slightly,sometimes,stoutish,trailing,tub,ud,unit,usually,wood,ympodial	0.3-1.6,arrangement,branching,bud,colour,form,glabrousnes,growth,height,insertion,length,number,papilla,plant,position,seed,shape,spacing,texture,thicknes,type,woody
115	wfo-0001027146	invalid_json	213	155	130	83	25	0.61	0-11,0.3-2.2,0.7-2.4,0.8,0.8-5.8,1-10,1-2,1-2.5,1-9.5,10,13-36,2-12.2,2-13,2-4.2,2-5,3.3-6.1,3.5-22,4-11,4-12.5,4-38,4-8,6-10,6-17.5,6.5-52,abaxially,adaxially,along,anther,apart,berry,blade,brownish,cell,chartaceous,ciliate,clavate,cm,coarsely,condition,conical,connivent,corolla,covering,dark,deep,diameter,dorsally,drying,edge,elliptic,especially,filament,finely,flat,flower,folded,forked,fresh,fruit,glabrous,green,green-white,greenish,hair,hair-like,herb,homostylous,interjected,lanceolate,lateral,leaf,leaflet,lengthening,like,lobe,long,make,margin,medium,membranous,midrib,minute,minutely,mm,moniliform,mottled,mucilaginous,odd-pinnate,ovate,ovoid,pair,pedicel,peduncle,pentagonal,petiole,plant,pore,poricidal,puberulent,pubescent,purple,ripe,rotate,seed,simple,size,slit,stem,stigma,straight,style,subglabrous,terminal,testal,thick,throughout,tinged,tip,tube,tuber,unwinged,violet,wall,wet,white,whitish,wide,wing,x,yellow	0.5-3.2,0.6-3.3,0.8-3.1,1.9-10,5-merou,6,acumen,acuminate,ag,alyx,apex,apparently,arranged,articulated,asymmetrical,attenuate,axe,axillary,base,basiscopic,bead,bud,capitat,commonly,darker,decreasing,digestion,distal,eaf,eed,enzyme,erec,exceeding,fourt,fourth,geminat,generally,glabrou,gradually,half,honeycomb-shaped,living,lower,multiple,necklace,nflorescence,orbicular,orolla,perfect,petiolule,plurifoliate,proximal,rarely,ray,removed,ruit,secondary,semierect,sessile,seudostipule,side,sometimes,spaced,specimen,stamen,ste,stolon,subequal,subglabrou,subsessile,subtending,symmetrical,tall,tamen,tem,tissue,toward,tri-,typically,unit,usually,vary,ympodial	'',[,``,age,arrangement,branching,calyx,capitate,characteristic,colour,form,glabrousnes,growth,height,inflorescence,length,ovary,pseudostipule,shape,spacing,texture,value,width,{,}
116	wfo-0001027157	success	207	89	73	134	16	0.353	0-3,0.15-0.3,0.9-2.8,1,1.5-6.5,10-30,2-15,2-2.5,2-3,2-5,2.3-4,2.5-3,3-12,3-7,3.3-7.8,3.8-8.3,4-5,6.5-14.5,abaxially,absent,adaxially,anther,blade,brownish,chartaceous,cm,condition,conical,corolla,deeply,diameter,drying,flower,forked,fresh,fruit,glabrous,green,greenish,herb,homostylous,interjected,lanceolate,lateral,leaf,leaflet,long,membranous,mm,odd-pinnate,ovoid,pair,pedicel,peduncle,petiole,plant,pore,poricidal,pubescent,ripe,seed,shady,situation,size,sometimes,stellate,terminal,tinged,tip,violet,white,whitish,x	0.7-2,1-10,1-2,1-3,1-3.8,1-6,2,5-merou,9-12,acumen,acuminate,acute,ag,along,alyx,among,apart,apex,apparently,articulated,attenuate,axe,axillary,base,berry,broadly,bud,capitat,cell,ciliate,clavate,connivent,cordate,covering,cuneate,decreasing,decurrent,densely,digestion,distal,dorsally,eaf,edge,eed,elliptic,end,enzyme,erec,especially,exceeding,filament,flat,folded,geminat,generally,glabrou,grassland,greatly,green-white,hair,hair-like,half,honeycomb-shaped,lengthening,like,living,lobe,low-growing,lower,make,margin,markedly,middl,midrib,minutely,mucilaginous,narrowly,nflorescence,oblique,obtuse,one,orbicular,orolla,ovate,perfect,petiolulate,petiolule,placed,plurifoliate,puberulent,rarely,removed,rounded,ruit,semi-rosette,sessile,seudostipule,short,slightly,slit,spaced,specimen,stamen,ste,stem,stigma,stolo,straight,style,subsessile,subtending,sunny,tall,tamen,tem,testal,thick,throughout,toward,tri-,tube,tuber,typically,unequal,unit,unwinged,usually,vary,wall,wet,wide,woodland,yellow,ympodial	arrangement,branching,calyx,colour,form,growth,hairines,height,inflorescence,length,number,pseudostipule,shape,symmetry,texture,width
117	wfo-0001027184	success	219	108	80	139	28	0.365	.3,.5,.7,0-0.2,0.2-0.4,0.4-2,0.5-2,0.8,1.5-5,2,4,5,5-7,adventitious,anther,base,blue,broad,brown,calyx,chartaceous,cm,connivent,cylindrical,diameter,directed,epidermal,extension,filament,flattened,fleshy,fruit,glabrous,globose,hair,hairlike,half,imparipinnate,introrsely,lanceolate,leaf,leaflet,light,lobe,lower,margin,membranous,mm,oblong,opposite,orange,pedicel,peduncle,per,petiole,pilose,pore,pseudostipule,pubescent,rachi,red,revolute,root,shape,simple,size,slightly,sparsely,stellate,stem,stigma,straight,style,subopposite,tube,unbranched,vine,wall,white,x	.8,0-,0.4â0.9,0.8â1.6,0â3,1-2,1.5,1.8â3.5,13â18,19,1â2,1â2.5,1â4,2.8â4.1,2â4-celled,3-4-,3-foliolate,3.5â8,3â,3â4-celled,4â12,7,9,abaxially,absent,accrescent,acute,adaxiall,adaxially,ag,along,always,alyx,apart,apex,appressed,articulated,axe,axi,axillary,ba,basal,blade,borne,bract-like,branch,broadly,cell,clavat,cluster,cordat,covered,densely,eaf,eed,elliptic,entire,especially,fasciculate,flower,foliaceous,free,fruiting,geminat,generally,glabrescent,glabrou,grading,herbaceous,ilament,larger,largest,lateral,leafy,least,less,like,long,longitudinal,m.,meter,midrib,minutely,mostly,much,narrowly,nearly,nflorescence,node,obtuse,often,older,opening,orolla,ovate,ower,petiolule,plurifoliate,portion,prominent,prominently,puberulent,raised,rarely,reticulate,ripe,ruit,scarcely,secondary,several,shoot,short,slit,small,soft-woody,somewhat,spaced,sulcate,surface,terminal,tertiary,tightly,tip,tree,truncate,trunk,unarme,unequal,uniform,unit,usually,vary,vein,visible,weak,yellow,ympodial,young,â9	0-3,1-4,13-18,2-4-celled,3-9,3.5-8,4-12,arrangement,articulation,branching,clavate,colour,connivence,cordate,corolla,form,growth,inflorescence,length,number,ovary,pubescence,seed,spacing,sulcation,texture,type,ye
118	wfo-0001027186	success	168	136	120	48	16	0.714	-6,.4,.5,0.5-1,1-1.5,1-2.5,1.4-1.6,1.5-2,1.5-2.5,2-6,2-lobed,2.5-3,3-4,3.5-4,4-9,6-7,9-10,abaxial,acute,age,anther,anthesi,apart,apex,attenuate,bark,base,berry,branched,broadly,brown,calyx,clavate,cm,conical,corolla,dark,deflexed,deltate,dendritic,densely,diameter,dry,ellipsoid,elliptic,enlarging,entire,exerted,filament,filiform,fruit,fruiting,glabrescent,glabrous,globose,golden,green,growth,irregularly,lengthening,less,like,lobe,lobed,loose,margin,maturity,midrib,minutely,mm,narrowly,new,ovary,ovoid,pair,pale,papillate,pedicel,peduncle,pendent,pericarp,petiole,pitted,plane,pointed,pore,poridical,primary,pubescent,rachi,reddish,reniform,rough,scar,seed,shiny,simple,slightly,slit,soon,spaced,sparsely,stem,stigma,straight,strongly,style,surface,time,tip,tree,trichome,tube,uniseriate,variably,vein,way,woody,x,yellow	1.5,1.6-5,15,30-40,4-15,5-10,?,abaxially,adaxially,always,apparently,axil,branch,dbh,denditic,denser,eaf,flower,free,immature,incrassat,keeled,lamina,longer,lower,m.,much,nflorescence,occasionally,papillat,perfect,planar,plurifoliat,portion,pubescen,ruit,scattered,short,small,spreading,stalk,terminal,treelet,tub,ud,unit,white,ympodial	adaxial,branching,bud,colour,exertion,form,hair,incrassate,inflorescence,keeling,leaf,length,shape,texture,type,width
119	wfo-0001027198	success	191	127	104	87	23	0.545	.4,.5,0.5-0.75,0.8-1,1-1.5,1-10,1.5-10,1.5-2,10-11,11-20,2-5.5,3/4,4-9,5-6,7.5-9,acuminate,acute,anther,anthesi,apart,apex,attenuate,base,calyx,channeled,clavate,cm,corolla,cyathiform,decurrent,dendritic,densely,dia,difoliate,elliptic,erect,female,filament,flower,fruiting,furcate,glabrate,glabrous,globose,golden,inflorescence,lateral,leaf,lobe,lobed,major,male,many,margin,middle,minor,minute,minutely,mm,obovate,often,older,opposite,ovary,ovoid-reniform,paler,papillose,pedicel,petiole,pitted,planar,plant,pore,puberulent,pubescent,reflexed,scar,set,shaped,shining,shrub,simple,size,slightly,speciman,stem,stigma,straight,style,surface,tear-drop,time,tip,trichome,tube,two,type,uniseriate,unit,vein,way,widest,x,young	0.05-1.0,0.5-1,0.7-1,1-5,5-120-flowered,abruptly,always,axil,ba,beginning,beneath,berry,broadening,bushy,caly,closely,complex,constriction,corky,corresponding,deltoid,differing,dry,eaf,edge,edicel,eed,entire,evenly,exserted,extremely,eye,found,free,geminat,green,impressed,inflorescenc,invisible,large,like,live,lon,long,lower,main,medium,meet,naked,nearly,nflorescence,overlapping,ovoid,pale,papillo,pendan,poricidal,portion,pubescence,rather,reddi,rest,rounded,ruit,sessile,short,slender,small,soon,spaced,specimen,strong,styled,tall,tannish-yellow,testae,thickened,thin,top,tree,ud,undersurface,usually,white,woody,yellowish,ympodial	5-120,abaxial,adaxial,branching,diameter,form,fruit,geminate,growth,hair,height,length,number,pendant,position,reddish,seed,shape,spacing,structure,sympodial,texture,width
120	wfo-0001027200	success	139	102	88	51	14	0.633	0.05-0.25,0.25-0.5,0.5-0.75,0.5-1,0.6-1,0.7-2.5,1-1.5,1.2-1.5,1.5-2,1.5-5,1.6-6,2-3,2.5-3,3-3.5,3.5-6,6-8,8-15,acute,anther,apex,bark,base,beneath,broadly,calyx,capitate,cm,conical,corolla,decurrent,deeply,deflexed,deltoid,dia,elliptic,filament,fruiting,geminate,glabrous,globose,golden,green,leaf,lobe,lobed,long,major,minor,minute,minutely,mm,nearly,node,non-reproductive,occasionally,onto,ovary,ovoid-reniform,papillose,pedicel,petiole,pitted,pore,puberulent,shaped,shrub,size,slightly,small,sparse,sparsely,stem,stigma,style,surface,tear-drop,tip,tree,trichome,tube,unicellular,uniseriate,vein,white,widened,woody,x,young	1-1.4,9-11,across,anthesi,aspec,ba,berry,branch,branche,brown,converging,dark,densely,differing,eaf,eed,except,flattened,free,giving,grey-brown,horizontally,impressed,inflorescence,lateral,lightly,like,lon,lower,main,margin,middle,near,older,papillo,planar,poricidal,portion,prominent,reflexed,rest,ruit,spreading,straight,tall,unifoliate,unit,widest,winged,yellowish,ympodial	arrangement,colour,diameter,flower,form,fruit,growth,hair,height,length,plant,seed,shape,texture
121	wfo-0001027213	success	231	143	121	110	22	0.524	-19,-230,-3.3,-4.5,0-2.5,0.2-0.4,0.2-0.5,0.7-2.3,0.8-1.8,1-2,1-5,1.1-1.7,1.2-1.6,1.2-1.7,1.2-2.5,1.3-2.2,1.7-3.6,1.7-3.9,1.8-3.2,12.3-16.3,2-5,2.9-3.8,2.9-4.8,2/3,4-9.5,4.2-5.9,5.7-6.2,8-24,8.2-10.5,abaxially,accrescent,acute,adaxially,anther,apex,attenuate,basal,base,blunt-tipped,branch,branched,broadly,brown,calyx,cm,conical,corolla,cuneate,cylindrical,dark,deltoid,diameter,elliptic,entire,few-rayed,filament,flower,fruit,fruiting,glabrous,globose,granular,grayish-brown,hair,lanceolate,leaf,length,lobe,long-,long-stalked,many,margin,mixed,mm,mostly,multangulate,oblanceolate,obovate,obtuse,orbicular,pale,partly,pedicel,peduncle,petiole,pore,poricidal,porrect-stellate,pubescent,rachi,rather,reniform,reticulate-punctate,scabrous,sessile,short,short-,short-attenuate,short-stalked,shrub,simple,sparsely,stem,stigma,style,subcampanulate,surface,thick-stalked,thin-stalked,time,tip,tomentose,tomentose-pubescent,tree,tube,unarmed,whitish,whitish-green,x,yellowish,young	/10,0-160,1.8-2.8,1/2-2/3,10-24,2.4-4.7,2.5-5.1,3.5-5,3.5-8,5-7.5,5-8,5-merou,9-13,acuminate,ag,along,alyx,anthesi,apart,apparently,ark,around,articulated,axe,axillary,ba,blade,capitat,cell,completely,covering,decurrent,directed,distally,drying,eaf,early,edge,eed,enveloping,epidermal,eventually,exserted,farinose,free,glabrescen,glabrescent,green,group,high,homostylous,immature,inserted,lackin,lateral,lengthening,lobed,long,longitudinal,lower,m.,main,midrib,moderately,multangulat,nearly,nflorescence,obscured,often,older,orolla,ovate,ovate-lanceolate,perfect,plurifoliate,porrect-stellat,prominent,pseudo-terminal,pubescence,relatively,ruit,side,slit,sometimes,somewhat,spaced,stamen,stellate,suture,tamen,terete,thick,ti,tomentu,touching,ud,unarme,unit,unwinged,vary,vein,vestigial-rayed,violet,way,white,wide,yellow,yellow-green,yellow-tan,ympodial	90-160,bark,branching,bud,capitate,colour,form,growth,height,inflorescence,insertion,number,ovary,plant,prickle,seed,shape,size,spacing,staman,texture,type
122	wfo-0001027214	success	181	101	81	100	20	0.448	0.25,0.5-1,0.7-2.5,0.8-1,1-1.5,1-2.8,1.5,1.5-1.8,10-13,2,2-9,3-6,6-12,anther,anticlinal,apex,apical,base,broadly,calyx,cell,cm,conical,corolla,deltate,densely,diameter,elliptic,epidermal,filament,flattened-round,flower,fruit,fruiting,glabrous,green,greenish,grown,height,herb,inflorescence,irregular,leaflet,length,lobe,long-acuminate,long-conical,minutely,mm,oblique,occasionally,once-branched,ovary,pedicel,per,petiole,pinnate,pointed,poricidal,projection,pubescent,rachi,rugose,rugosity,seed,sharply,simple,sinuous,somewhat,stigma,style,thickening,tip,triangular,trichome,truncate,tube,uniseriate,white,without,x	-20,-38,-9,..,.25,.5,0,0-16,0.3-1.5,0.3-1.7,0.5-0.8,0.7-2,1.2-3,1.5-6,10-,12-17,15-25,3-,4-5,5-6,6-,7-12,8-9,abaxially,absent,acuminate,acute,adaxially,along,anthesi,basal,berry,capitat,climbing,composed,conspicuously,decurrent,dr.,drying,eaf,edicel,eed,erect,exserted,extending,finely,free,globose,groove,horizontal,inflorescenc,lamina,lanceolate,lateral,less,like,lobed,lon,long,lower,margin,markedly,midrib,narrowly,nearly,nflorescence,noddin,nodding,obovate,often,onto,open,opposite,pair,paired,papilla,papillate,perfectly,petiolule,portion,reflexed,rest,ruit,scar,scattered,scrambling,smaller,surface,tem,terminal,time,tub,ud,unevenly,unifoliat,unit,vein,white-lenticellate,whitish,ympodial	0.5,2.0,3-5,40,5,arrangement,branching,capitate,colour,form,growth,leaf,number,plant,pore,shape,size,stem,texture,type
123	wfo-0001027219	success	143	121	102	41	19	0.713	.5,/4,0.4-0.6,0.5,0.5-0.8,1-15,1.5-2.5,2,2-2.5,2-3,2-3.5,2-4,3-5,3-6,6-8,acuminate,acute,age,anther,anthesi,apex,axillary,bark,base,berry,bright,broadly,brown,capitate,closely,cm,conical,corolla,deltate,densely,diameter,edge,elliptic,entire,filament,flower,fruiting,glabrescent,glabrous,globose,green,greyish,growth,hard,known,leaf-opposed,lengthening,less,lobe,lobed,long-conical,long-styled,margin,maturity,minutely,mm,new,ovary,pale,papillose-pubescent,pedicel,pendent,pericarp,petiole,planar,pointed,pore,poricidal,pubescent,purple,scar,sharply,shoot,short,short-styled,shrub,simple,slightly,slit,somewhat,spaced,stem,stigma,style,surface,terminal,thickened,tip,trichome,uniseriate,violet,way,weight,white,woody,x,â1/3	0.3,1,1-2,1-3,1.5-2,7-8,absent,berr,c.,calyx,completely,cup-shaped,drying,eaf,eed,erect,exerte,exfoliatin,free,glabrou,heterostylous,lower,nflorescence,overlappin,pair,papillo,peduncle,plurifoliat,portion,primary,ruit,sometimes,soon,stout,tube,tuft,ud,unit,vein,yellowish,ympodial	arrangement,branching,bud,colour,exfoliating,form,fruit,inflorescence,information,leaf,length,overlapping,papillose,position,seed,shape,size,texture,type
124	wfo-0001027223	success	189	105	86	103	19	0.455	0.19-0.75,0.3-1.2,1-3,1.5-3.5,1.8-3.5,16-41,3-10,3-11,3-5,3-5.2,3.5-4,3.5-7,3.7-9.3,4-6,5-21,5-8,5.9-12.2,9-15,9-22,9-35,abaxially,adaxially,anther,articulated,blade,brownish,cm,condition,conical,corolla,deep,densely,diameter,distal,drying,elliptic,end,flower,forked,fresh,fruit,green,greenish,hair,half,herb,homostylous,hyaline,interjected,lanceolate,lateral,leaf,leaflet,light,like,lobe,long,middle,mm,odd-pinnate,one,ovate,ovoid,pair,pedicel,peduncle,pentagonal,petiole,placed,plant,pore,poricidal,pubescent,rotate,seed,size,style,terminal,tip,tube,tuber,typically,usually,white,whitish,x	.5,1-2,1.3-2,2-4,2-7,3.5-6,5-10,5-merou,acumen,acuminate,adaxiall,ag,alyx,apart,apex,apparently,asymmetric,attenuate,axe,axillary,base,basiscopic,berry,bud,capitat,cell,clavate,connivent,covering,decreasing,digestion,dorsally,dot,eaf,edge,eed,enzyme,erec,exceeding,filament,flat,folded,geminat,generally,glabrou,glabrous,green-white,hair-like,hal,honeycomb-shaped,larger,lengthening,living,lower,make,mucilaginous,nflorescence,orbicular,orolla,perfect,petiolulate,plurifoliate,present,purple,removed,ripe,rounded,ruit,sessile,seudostipule,short,shortly,side,slightly,slit,sometimes,spaced,specimen,stamen,ste,stigma,stolo,straight,stripe,subequal,subtending,tall,tamen,tem,testal,thick,throughout,tissue,toward,tri-,unit,unwinged,vary,wall,wet,wide,yellow,ympodial	abaxial,adaxial,arrangement,articulation,branching,calyx,colour,form,growth,height,inflorescence,length,number,placement,pseudostipule,pubescence,shape,stem,stolon
125	wfo-0001027237	success	122	100	77	45	23	0.631	.5,/4,1-1.2,1.5-2,1.5-2.5,2-3,3-3.5,3-4,30-100-flowered,6-11,6-8,8,anther,anthesi,bark,base,black,branched,brown,calyx,clavate,cm,completely,corolla,cucullate,cup-shaped,dark,deflexed,difoliate,drying,ellipsoid,filament,flattened,free,fruiting,geminate,glabrous,globose,green,greenish-white,inflorescence,internodal,later,leaf,many,margin,minutely,mm,occasionally,ovary,paler,papillose,pedicel,pitted,pore,portion,regularly,reniform,shaped,shining,shrub,small,stem,stigma,style,surface,tapering,tear-drop,time,tip,tree,tube,unit,way,white,x,young	0.5-1,5,apart,apiculae,apiculate,appearing,ba,berry,blac,branc,broadly,deltoid,dia,edicel,eed,erect,exsertion,greyi,lobe,lobed,long,lower,nflorescence,older,papillate,papillo,part,plurifoliat,poricidal,reflexed,regulary,ruit,scar,slender,spaced,straight,tall,terminal,ud,upper,usually,widely,woody,x.,ympodial	0.5,branching,bud,colour,diameter,flower,form,fruit,greyish,growth,height,length,lobing,number,plant,plurifoliate,position,seed,shape,size,structure,sympodial,texture
126	wfo-0001027238	success	204	106	84	120	22	0.412	-25,0-1,0-1.5,0.3-0.5,0.3-0.8,0.3-5,0.5-1,0.5-16,1-1.5,1.5-3,2-4,3-4,5-7,6-15,anther,apex,berry,black,brown,chartaceous,cm,connivent,dark,densely,diameter,directed,discolorous,distally,elliptic,elliptic-ovate,entire,extra-axillary,flattened,fleshy,flower,fruit,globose,green,greenish,hair,homostylous,introrsely,large,lavender,leaf,light,long,longitudinal,margin,membranaceous,mm,multangulate,oblong,obtuse,opening,outline,pale,petiole,pore,porrect-stellate,pubescent,purple,reniform,ripe,scandent,shiny,shrub,simple,slit,small,somewhat,sparsely,sprawling,stellate,stellate-pubescent,stem,strongly,tree,unbranched,white,whitish,x,yellow,yellowish	-5,.3,.5,0-0.7,0.3-1,0.5-2,1-2,1.5-4,1.5-7,10,15-30,2-3,3-5,3-6,4-,4-10,4-16,4-5,4-8,5-15,5-merou,6-8,abaxially,accrescent,acuminate,acute,adaxiall,adaxially,ag,alyx,apparently,articulated,axe,ba,base,blade,branch,calyx,capitat,contiguous,covering,cuneate,cylindrical,deltate,differentiated,eaf,eed,equal,filament,foliaceous,fork,free,frui,fruiting,geminate,glabrescent,glabrous,gland,gland-tipped,growt,interpetalar,juic,lighter,like,lobe,lower,major,midpoint,minor,minutely,mixed,narrowly,near,nearly,new,nflorescence,oblique,often,one,orolla,paired,part,pedicel,peduncle,perfect,pericarp,pitted,plurifoliate,rachi,ray,rounded,ruit,sessile,short-stalked,side,similar,sometimes,sparse,ste,stigma,straight,style,subtending,surface,tamen,tem,time,tip,tissue,toward,triangular,tube,unarme,unequal,unit,vary,vein,wide,without,ympodial	abaxial,adaxial,age,branching,colour,corolla,form,growth,inflorescence,length,number,pattern,position,prickle,seed,shape,size,symmetry,texture,trichome,type,unarmed
127	wfo-0001027244	success	294	105	73	221	32	0.248	-2,0.2-1,0.45-0.6,0.5,0.5-0.8,1.2-1.6,1.7-3.0,2-4-celled,anther,articulation,base,berry,bifurcate,bract,branched,broadly,calyx,cm,cordate,corolla,crenate,dark,decurrent,densely,dentate,distal,elliptic,filament,fruit,fruiting,globose,green,greenish,half,herb,imparipinnate,inflorescence,interjected,interrupted,irregularly,leaflet,length,lobed,long,lower,margin,middle,mm,oblique,orbicular,patent,pedicel,perennial,petiole,present,pseudostipule,pubescent,purple,rotate-stellate,simple,stem,stout,stripe,surface,thick,trichome,truncate,uniseriate,velvety,vivid,white,wide,yellow	-1.2,-12,-3.2,.5,0-,0.02-,0.04-,0.05,0.05-1,0.07-0.15,0.1-,0.1-0.3,0.1-0.5,0.1-0.6,0.15-0.2,0.2,0.2-,0.25-0.4,0.3,0.3-0.4,0.3-0.5,0.3-0.6,0.3-0.8,0.4-,0.4-0.6,0.4-1,0.5-1,0.6-0.9,0.6-09,0.7-1,0.7-1.5,0.7-2,0.7-3,0.8-1.2,0.9-1.3,0.9-1.7,1,1-2-celled,1-2.5,1-3.5,1-celled,1.1-1.3,1.5-2,1.5-2.1,1.5-2.4,1.5-6.5,1/2,2-,2-4,2-9,2-foliate,2-locular,2.1-8,3-5,3.5-13,3/4,4-12,4-celled,5-,5-10,5-9-celled,7-12,8-16,8-celled,abaxially,absent,abundance,abundant,acroscopically,acuminate,acute,adaxially,adpressed,alfway,along,also,always,amongst,angled,anthesi,apex,apical,apparently,appearance,appendage,arequipa,around,articulated,articulatio,axi,basal,berr,bracteate,brown,c.,cage,capitate,cell,column,common,conical,curved,deciduous,decumbent,deeper,deltate,dense,density,developed,diamete,diameter,eaf,edicel,eed,eglandular,either,elliptical,erect,exserted,extremely,flower,flushed,forming,general,giving,glabrescent,glabrous,gland,glandular,gree,hair-like,halfway,head,hyaline,internode,investing,lamina,lanceolate,larger,largest,lateral,leave,like,lobe,lobing,lon,longer,midvein,minute,mixed,mixture,multicellular,narrowly,near,node,obovate,occasionally,often,onto,outgrowth,ovary,pair,papillate-pubescent,peduncle,petiolule,population,primary,rachi,reflexed,rest,ripe,rounded,ruit,scattered,secondary,sessile,shaggy,short,shorter,silky,sinus,size,slender,small,sometimes,somewhat,sparse,sparsely,sparser,spreading,staminal,sterile,stigma,straight,strongly,style,tall,tem,terminal,tertiary,testa,tiny,tip,tipped,toward,tube,two,ud,undulate,unicellular,unit,united,upper,usually,variable,variety,vein,wall,winged,woody,ympodial	abaxial,adaxial,appressed,arrangement,branching,colour,form,growth,hair,history,inflated,insertion,leaf,life,marking,mature,modification,orientation,placement,pore,position,prickle,seed,shape,spot,symmetry,texture,thicknes,type,unknown,width,zygomorphy
128	wfo-0001027248	success	158	95	73	85	22	0.462	.5,0.5-1,0.5-2.5,0.7-1.2,1-1.5,1-2,1-5,2-2.5,3-4,3-7,3.5-4,5-5.5,6.5-8,abaxial,acute,anther,apex,arachnoid,arachnoid-pubescent,area,base,beige,berry,broadened,broadly,brown,calyx,cm,conical,corolla,dark,densely,dirty,elliptic,filament,fleshy,fruit,fruiting,glabrous,globose,green,leaf,lobed,merely,minutely,mm,nearly,opposite,ovary,ovoid-reniform,papillose,patch,pedicel,petiole,pitted,pore,pubescence,pubescent,scattered,shaped,shrub,simple,small,sparsely,stigma,style,surface,tear-drop,top,tree,trichome,tube,white	0,1-3,2-4.5,3-7-flowered,4-8,6-13,7-9,abaxially,adaxially,along,anthesi,ape,appearing,arachnoid-pubescen,bark,beneath,brownish,brownish-gra,closely,deflexed,deltate,denser,dia,differing,difoliate,eaf,edicel,eed,ellipsoid,erect,exserted,felty,free,geminate,glabrescent,grayish-green,impressed,lamina,later,lateral,lightly,lobe,long,lower,main,major,margin,minor,nflorescence,node,occasionally,older,overlappin,pair,pale,papillo,per,planar,poricidal,portion,present,ruit,scar,shoot,size,somewhat,soon,spaced,specimen,stem,strongly,tall,thick,tip,tub,ud,unifoliate,unit,vein,wid,wide,winged,woody,ympodial,young	0.5,adaxial,branching,colour,diameter,flower,form,growth,hair,height,inflorescence,length,na,number,plant,position,seed,shape,symmetry,texture,type,width
129	wfo-0001027258	success	178	150	127	51	23	0.713	.25,.5,/4,0.5-1,0.6-2,0.9-1.3,1-1.5,1-2.3,1-4,1.2-2,2-2.5,2.5-8,3-4,3-6,3.5-4,4-5,4.5-5,5-10-flowered,6-8,7-13,7-9,acuminate,acute,age,anther,anthesi,apex,attenuate,axil,bark,base,broadly,calyx,capitate,cm,corolla,crystal,darker,deflexed,dense,densely,deposit,dia,difoliate,ellipsoid,elliptic,evenly,exserted,filament,flattened-reniform,fruit,fruiting,glabrous,globose,green,greenish-yellow,incrassate,internodal,lamina,large,lateral,leaf,length,lengthening,lenticel,lobe,lobed,long,main,major,margin,middle,minor,minutely,mm,occasionally,onto,opposite,ovary,ovate,pair,pale,papillose,pedicel,petiole,pitted,pore,poricidal,pubescent,red-papillose,reddish,sand,scar,scattered,shrub,simple,size,slender,slightly,slit,spaced,sparsely,speck,stem,stigma,strongly,style,surface,swollen,tiny,tip,treelet,trichome,tube,tuft,uniseriate,unit,urceolate,vein,visible,way,white,widest,winged,x,yellowish-tan,young	0.25-0.5,1.5-1.6,abaxially,abruptly,adaxially,along,apar,apical,apiculae,ba,beneath,berry,decurrent,deltate,differing,dissecting,drying,eaf,edicel,eed,enlarge,entire,extending,fide,fragrant,free,geminat,glabrou,lower,microscope,minute,nee,nflorescence,often,older,papillo,planar,portion,projection,prominent,ruit,small,straight,sweetly,tall,tub,ud,widening,woody,yellowish,ympodial	abaxial,adaxial,apart,bud,colour,diameter,exsertion,form,geminate,growth,hair,height,inflorescence,part,placement,plant,position,seed,shape,structure,sympodial,texture,type
130	wfo-0001027260	success	176	145	118	58	27	0.67	-17,-60,0.25-1,0.5-1,0.5-3,0.5-6.5,1-2,1-4,1.5-13,10-25,15-30,2-18,2-2.5,2.5-3.5,3-11,3-4.5,3-6,5-25,5-merous,abaxially,absent,acuminate,acute,acute-,adaxially,age,also,apart,apex,articulated,basal,base,branched,chartaceous,clavate,cm,connective,connivent,cordate,cylindrical,darker,densely,diameter,directed,distally,eglandular,ellipsoidal,elliptic,elliptic-ovate,entire,equal,exceeding,fading,flattened,flower,fruit,glabrate,glabrous,globose,greenish,hair,lanceolate,lavender,leaving,lobe,long,longitudinal,margin,membranaceous,mm,moderately,narrowly,nearly,obtuse,often,ovate,pedicel,pedicellar,peduncle,perfect,petiole,pilose,pink,pore,puberulent,puberulent-pubescent,pubescent,pubescent-pilose,purple,rachi,radiu,remnant,shorter,shrub,simple,slightly,small,spaced,sparsely,stellate,stigma,stripe,strongly,style,subcoriaceous,tapered,thecae,tree,triangular,truncate,unbranched,usually,vein,white,x,yellow,yellow-green,yellowish	-2,-7,0.75-1,0.8-2,1-,1-3,1-6,1-7,1.5-2,2-,2-10,2.5-14,3-,3-10,3.5-25,4-25,4-32,4-5-foliat,4-6,4.5-14,5-,5-40,6-20,aggregate,alyx,ape,axe,berry,beyond,blade,cell,diamete,eaf,eed,exserted,lon,lower,nflorescence,nther,orolla,perfec,pilo,presen,puberulent-pubescen,ruit,stamen,stone,tal,tem,time,tomento,tube,ud,unit,vary,wide,yellow-orang,ympodial	1-10,1-4.5-14,15-40,2-20,anther,arrangement,branching,bud,calyx,colour,corolla,form,growth,height,inflorescence,leaf,length,number,ovary,plant,seed,shape,size,stem,texture,theca,yellow-orange
131	wfo-0001027265	success	159	101	80	79	21	0.503	.2,0.1â2,0.5,0.5-1,1-1.3,1-3,1.2-1.3,1.2-2,1.2â1.4,1.5â1.8,1.5â2,2-3,2â2.5,2â3,3-lobed,4-5,4â6,4â7-branched,anther,apart,apex,articulated,base,broad,calyx,chartaceous,cm,diameter,entire,filament,flattened-reniform,flower,fruit,fruiting,glabrous,globose,granule,hair,herb,hermaphroditic,light,lobe,long-attenuate,margin,minutely,mm,near,nearly,oblong,orange,ovate-lanceolate,partially,pedicel,peduncle,petiole,pitted,pore,present,prominent,puberulent,pubescent,purple,rachi,rarely,red,rotate-stellate,sclerotic,seed,simple,slightly,sometimes,sparsely,subcoriaceous,surface,tip,triangular,tube,white,x,yellow	-2.5,.3,.5,0.2-0.4,0.5â0.6,1-2.5,1.5-2.5,1.5â4,2,2-,2-4,2/3,20-30,3-,30â50,4.5â8,5-merou,58409,abaxially,accrescent,acute,adaxiall,adaxially,alyx,apparently,axe,ba,berry,blade,capitat,ciliate,connivent,covering,croat,cylindrical,dehiscent,eaf,eed,erect,extra-axillary,foliate,frui,geminat,juic,larger,leaf-opposed,lon,long,longitudinall,low,lower,mesocarp,nflorescence,node,numerous,obtuse,orolla,paired,recurved,ripe,rooting,ruit,scarcely,somewhat,spaced,stigma,style,tall,tamen,tem,time,unit,usually,vary,weak,white-puberulent,wide,winged,ympodial	30-50,arrangement,articulation,branching,colour,corolla,form,growth,height,inflorescence,leaf,length,longitudinally,plant,shape,size,spacing,staman,stem,texture,type
132	wfo-0001027265	success	156	111	79	77	32	0.506	.2,0.2-0.4,0.5,0.5-1,1-1.3,1-3,1.2-1.3,1.2-2,2,2-3,2/3,4-5,acute,anther,apart,apex,articulated,base,broad,calyx,chartaceous,cm,cylindrical,diameter,entire,extra-axillary,filament,flattened-reniform,flower,fruit,fruiting,glabrous,globose,granule,herb,hermaphroditic,larger,leaf-opposed,light,lobe,long-attenuate,lower,margin,minutely,mm,near,oblong,orange,ovate-lanceolate,paired,partially,pedicel,peduncle,petiole,pitted,pore,prominent,puberulent,pubescent,purple,rachi,red,ripe,rotate-stellate,sclerotic,seed,simple,sometimes,sparsely,stigma,style,subcoriaceous,surface,tip,triangular,tube,white,x,yellow	-2.5,.3,.5,0.1â2,0.5â0.6,1-2.5,1.2â1.4,1.5-2.5,1.5â1.8,1.5â2,1.5â4,2-,2-4,20-30,2â2.5,2â3,3-,3-lobed,30â50,4.5â8,4â6,4â7-branched,5-merou,58409,abaxially,accrescent,adaxiall,adaxially,alyx,apparently,axe,ba,blade,capitat,ciliate,connivent,covering,croat,dehiscent,eaf,eed,erect,foliate,frui,geminat,hair,juic,lon,long,longitudinall,low,mesocarp,nearly,nflorescence,node,numerous,obtuse,orolla,rarely,recurved,rooting,ruit,scarcely,slightly,somewhat,spaced,tall,tamen,tem,time,unit,vary,weak,white-puberulent,wide,winged,ympodial	0.1-2,1.2-1.4,1.5-1.8,1.5-2,2-2.5,30-50,4-6,4-7-branched,abaxial,adaxial,arrangement,articulation,branching,capitate,colour,corolla,form,growth,height,inflorescence,leaf,length,longitudinally,ovary,plant,position,shape,size,spacing,staman,texture,type
133	wfo-0001027284	success	172	102	81	91	21	0.471	0.1â0.5,0.1â2,0.7â0.9,0.7â1,1.2â1.5,1.5â5.5,1.5â8,1.8â2,1â1.5,1â3,2â16,2â2.2,3.5â14,3â4,4â12,5â7,9â18,abaxially,adaxially,anther,apex,axillary,base,berry,branched,brownish,cm,cordate,densely,elliptic,entire,extra-axillary,filament,flattened-reniform,fleshy,flower,fruit,glabrous,globose,green,inflorescence,margin,maturity,minutely,mm,near,nearly,oblique,orangish,ovate,ovoid,pair,pale,pedicel,peduncle,petiole,pinnate,pubescent,rachi,rarely,reticulate-rugulose,rounded,scandent,secondary,shrub,simple,size,sometimes,somewhat,sparsely,stellate,stem-terminal,surface,tan,truncate,unbranched,vein,venation,vine,white,x	.3,0.2â,1.5â2,1.5â2.5,1â2,2.5â3,2.5â3.5,4,4â6,5-merous,5â8,accrescent,acuminate,acute,alyx,anthesi,axe,blade,branch,c.,calyx,capitat,ciliat,climbing,conspicuous,contiguousl,cylindrical,deflected,deltoid,diameter,distally,eaf,eed,enlarged,fine,flattened,fruiting,glabrescen,glabrou,gradually,herbaceous,immature,leafy,lobe,long,lower,m.,midvein,nflorescence,nternode,one,orolla,pendulou,perfec,pink,planar,plurifoliate,pointed,prominent,pubescence,reduced,ruit,sand-punctat,sand-punctate,scar,seen,shortly,side,slightly,soon,spaced,spreading,stigma,style,tamen,tem,thickened,thickly,time,tip,toward,tree,tube,understory,unifoliat,unit,vary,weakly,wide,woody,ympodial	0.2â1.5,abaxial,adaxial,branching,ciliate,colour,corolla,form,growth,internode,leaf,length,na,number,pore,position,seed,shape,symmetry,texture,type
134	wfo-0001027302	success	188	134	112	76	22	0.596	.5,0.4-5,0.5,0.5-1,0.6-1,1-1.3,1-1.5,1-2,1-3,1.2-1.6,1.5-2,10,2-3,2.2,2.7-7.5,3.5-5,3/4,5-7,6-12,7,7/8,abaxial,acuminate,acute,adaxial,age,anther,apex,appearing,bark,base,becoming,branching,bright,brownish-yellow,capitate,clavate,cm,cordate,corolla,crispate,dendritic,densely,diameter,elliptic,filament,fine,flat-topped,flattened,fruiting,glabrous,globose,growth,later,lateral,leaf,length,lenticular,less,lobed,long,margin,minutely,mm,narrowly,ovary,ovate,pair,pale,pedicle,pericarp,petiole,pitted,plant,pore,poridical,prominent,puberulent,pubescent,pyramidal,red,reddish-brown,scar,scattered,secondary,shrub,simple,sleeve,slit-like,small,somewhat,stem,stigma,strongly,style,surface,terminal,thin,time,tiny,tip,tree,trichome,truncate,tube,undulate,vein,violet,way,winged,x,young	0.8-1,1,1.2-2.5,10-20,2,2-6,abaxially,adaxially,along,anthesi,apical,ba,basal,berry,blade,broader,calyx,conical,cultivation,decurrent,deflexed,deltoid,denser,dichasia,discussion,eaf,edicel,eed,entire,especially,ew,exserted,flower,free,growing,inserted,juvenile,larger,lax,like,lobe,lon,long-triangular,lower,m.,main,monochasial,nflorescence,nodding,occasionally,older,otherwise,overtopping,papillo,per,planar,plurifoliate,portion,reflexed,ruit,scrambling,see,shade,shin,shoot,sparsely,stamen,tall,tapering,tub,ud,unit,usually,wide,woody,ympodial	bud,colour,form,fruit,height,inflorescence,insertion,new,papillose,pedicel,position,prominence,seed,shape,shiny,size,texture,thicknes,type,venation,width,winging
135	wfo-0001027310	success	215	101	84	131	17	0.391	/3,0,0.6-1,0.7-2,1-1.2,1.1-1.5,2.2-2.5,2.8-3,3-15,4.5-5.5,5-20,abaxial,abaxially,acute,adaxial,anther,apart,apex,bark,base,berry,branched,branching,broadly,calyx,chartaceous,cm,connivent,cuneate,dark,deltate,densely,diameter,entire,evenly,flattened,flattened-reniform,flower,foliaceous,fruit,fruiting,glabrescent,glaucous,gray,green,green-brown,hair,lanceolate,lateral,leaf,length,lobed,margin,maturity,mauve,mm,moderately,orange-brown,pale,per,petiole,poricidal,prickle,primary,purple,red,rounded,secondary,shrub,simple,sometimes,sparse,spherical,stellate-pubescent,straight,style,tapering,terminal,tip,tree,truncate,way,yellow,young	-2.2,-20,.8,0-20,0-5,0.05,0.05-0.15,0.1,0.1-0.2,0.15-0.3,0.9-0.17,1-1.7,1-6,1.5-2.2,1.5-5,1/10-1/6,1/3-1/2,1/3-3/4,11-16,2-10,2-3.1,2-4,2-5,2/3,20-60,22-30,4-10,4-9,4.5-7,5-10,5-7,5-merous,6-8,7-10,8-10,9-13,acut,alyx,andromonoecious,apar,apically,apparently,articulated,blade,curved,discolorous,distal,drying,eaf,eed,elongating,equal,erect,faint,filament,free,fused,gently,glabrou,glabrous,hermaphrodite,heterostylous,inflated,infructescence,less,lobe,long,long-styled,longer,lower,lowermost,mature,midpoint,minutely,nflorescence,older,one,open,orolla,oung,pair,pedicel,peduncle,pendulous,pericarp,pitted,plant,plurifoliat,porrect,porrect-lepidote,portion,prickly,pubescent,ray,reddi,reflexed,ruit,scar,sessile,shallowly,short-styled,shorter,smooth,spaced,sparsely,spreading,stalk,stalked,staminat,stellate,stem,stout,strongly,surface,tamen,terete,tertiary,time,toward,trichome,tube,unarme,unarmed,unit,vary,vein,venation,visible,wide,woody,ympodial	colour,corolla,form,growth,inflorescence,number,orientation,ovary,position,reddish,seed,shape,spacing,staman,texture,type,width
136	wfo-0001027317	success	144	92	71	73	21	0.493	.5,0.1-0.2,0.3-1,0.4-1.5,1,1-1.5,1-2,1.5-2,3-3.5,4.5-5,?,acute,anther,apex,apically,base,berry,bilobed,calyx,cm,corolla,densely,dia,ellipsoid,elliptic,erect,filament,fruit,fruiting,glabrous,globose,golden,green,known,leaf,like,lobed,long,long-exserted,major,margin,mature,minor,minute,minutely,mm,nearly,offset,opposite,ovary,papillose,pedicel,petiole,pointed,pore,poricidal,pubescent,shaped,shrub,simple,slightly,stem,stigma,style,tear-drop,tip,trichome,tube,uniseriate,white,x	.25,0.5-1,0.5-3,0.8-3.5,1-5,1.4-1.6,2-3-flowered,2-9,7-9,abaxial,acuminate,adaxially,along,anthesi,apical,arch,ba,bark,beneath,broadly,closely,conical,cucullate,deciduous,deflexed,deltoid,differing,difoliate,drying,eaf,edicel,eed,elongated,expanded,filiform,free,geminat,greyish-whit,immature,inflorescenc,joined,lateral,lobe,lon,lower,main,nflorescence,older,overlappin,pair,pale,papillo,portion,projection,prominent,reflexed,rest,ruit,scar,series,size,soon,spaced,sparsely,strongly,surface,tall,tub,ud,vein,woody,ympodia,young	branching,bud,colour,diameter,exsertion,form,growth,hair,height,inflorescence,information,length,na,odour,plant,position,seed,shape,symmetry,texture,type
137	wfo-0001027323	success	175	103	84	91	19	0.48	/3,0.5-1,1-1.5,1.2-1.5,10-15,2-6,2.5-3,5-20-flowered,5-7,6-11,along,anther,anthesi,area,asymmetric,attenuate,bark,base,berry,broadened,bud,calyx,campanulate,closed,closely,cm,corolla,decurrent,densely,dia,elliptic,elongate,filament,fleshy,flopping,flower,fruit,fruiting,furcate,glabrate,globose,grey,immature,leaf,lobed,minor,minutely,mm,occasionally,opposite,ovary,overlapping,ovoid,ovoid-reniform,papillose,partially,pedicel,petiole,pinkish-grey,pitted,plant,pore,rather,red-papillose,reddish-grey,rest,scar,shaped,size,slightly,spaced,stem,stigma,style,surface,tear-drop,tip,treelet,tube,vein,way,white,winged,x	.75,1-2,14-21,2-3,20-45,3-5,7-9,acute,adaxial,apex,apparent,appearing,arising,ba,character,cork,deflexed,differing,difoliate,dried,dry,eaf,edicel,eed,entire,erect,erose,exserted,five-pointed,free,geminat,glabrous,growing,held,higher,hood,hooded,interpetalar,lateral,like,live,lobe,lon,long,long-triangular-deltoid,lower,main,major,margin,matte,mature,measured,middle,nflorescence,older,one,onto,pair,papillae,papillo,persistent,planar,poricidal,portion,prominent,proximal,ridge,ruit,secondary,seen,sinus,small,smoot,soon,specimen,straight,tall,tan,thickened,thin,tiny,trunk,two,ud,unit,upper,visible,widest,woody,ympodial,young	0.75,branching,colour,corky,decurren,diameter,form,growth,hair,height,inflorescence,length,number,position,seed,shape,smooth,symmetry,texture
138	wfo-0001027340	success	189	151	130	59	21	0.688	0.5-0.9,1-10,1-2,1-3,1.5-2.7,10-16,16-22,2-3,2-4,2.7-4.5,3.5-5,3.5-9,4-6,4-7.5,5-11,5-6,6-8.5,7-18,7-8,8-14,8-9.5,abaxially,abruptly,absent,acumen,adaxially,along,anther,apart,apex,auriculate,axillary,base,blade,brownish,bud,cell,chartaceous,ciliate,cm,condition,connivent,corolla,dark,decreasing,diameter,digestion,distal,dorsally,drying,edge,elliptic,enzyme,especially,filament,flat,flower,folded,forked,fresh,fruit,generally,glabrous,globose,green,greenish,hair,half,herb,homostylous,honeycomb-shaped,interjected,lanceolate,lateral,leaflet,lengthening,like,lilac-purple,lobe,long,margin,membranous,midrib,minute,minutely,mm,narrow,narrowed,odd-pinnate,ovate,ovoid,pair,papillose,pedicel,peduncle,petiole,petiolulate,plant,pointed,pore,poricidal,puberulent,pubescent,purple,removed,ripe,rotate,seed,sessile,short,size,slit,sparsely,splotched,stem,stigma,straight,style,subtending,terminal,testal,tinged,tip,tube,usually,wall,whitish,wing,x,yellow	2-3.5,2.5-4.5,3-4,5-merou,acuminate,ag,alyx,apparently,articulated,articulation,axe,berry,capitat,cordate,covering,developing,distinct,eaf,eed,exceeding,geminat,glabrou,green-white,hair-like,hal,high,indistinct,living,lower,make,mucilaginous,nflorescence,orolla,perfect,plurifoliate,purpl,rounded,ruit,semi-erec,semi-rosette,seudostipule,shortly,slightly,spaced,specimen,stamen,ste,tall,tamen,tem,thick,throughout,tri-,truncate,unit,vary,wet,ympodial,young	5-merous,age,arrangement,branching,calyx,capitate,colour,form,growth,height,inflorescence,leaf,length,ovary,position,pseudostipule,shape,spacing,staman,texture,type
139	wfo-0001027354	success	166	108	91	75	17	0.548	.5,0,0.5-2,0.7-1.3,1-1.2,1-1.5,1-7,1.7-5,2.5-3.5,3-4,3.4-4,3/4,4-10,5-7,6.5-13,8-12,abaxial,abaxially,acute,adaxial,along,anther,apex,bark,base,bi-lobed,branching,cm,corolla,dark,dendritic,densely,diameter,elliptic,entire,erect,filament,flattened,fruit,fruiting,glabrous,globose,golden,growth,leaf,length,lenticular,less,lobed,long,loosely,minutely,mm,narrowly,nodding,occasionally,ovary,pair,pedicel,petiole,pitted,poricidal,pubescent,purplish-black,pyramidal,raised,reddish-brown,scar,secondary,shrub,sleeve,small,somewhat,sparsely,stem,stigma,style,surface,tapering,time,tiny,tip,tree,tree-like,trichome,vein,violet,way,white,woody,x	0.5,1,1.5-1.8,1.5-2,10,10-20,absent,age,anthesi,apical,appearing,ba,basal,becoming,belo,berry,blade,branch,calyx,conical,covered,deltoid,denser,dichasia,drying,eaf,edicel,eed,ew,exserted,flower,fork,free,glabrate,inserted,later,lateral,like,lobe,loose,lower,m.,monochasial,mostly,near,nflorescence,older,papillo,per,pericarp,planar,plurifoliate,pore,portion,pubescen,ruit,side,simple,slightly,slit-like,stamen,strongly,tall,terminal,thecalyx,thin,tub,tube,type,ud,unit,wide,winged,ympodial,young	bud,colour,form,hair,height,inflorescence,insertion,new,papillose,plant,seed,shape,size,staman,texture,venation,width
140	wfo-0001027359	success	224	96	78	146	18	0.348	-3,/3,0,0-9,0.1-1.5,0.3-1.2,0.5,0.5-1,1.5-2,4-,5-6.5,6-8,abaxially,acute,anther,apex,base,berry,branched,bright,calyx,chartaceous,cm,cream,cuneate,dark,deltate,densely,dull,entire,equal,flattened,flattened-reniform,fruit,fruiting,glabrous,green,lateral,leaf,length,less,lobed,margin,marking,maturity,membranous,mm,moderately,obtuse,orange-brown,ovate,ovoid,pale,pedicel,peduncle,petiole,poricidal,prickle,purple,rachi,red,reflexed,shallowly,shrub,sometimes,spherical,spreading,stellate-pubescent,surface,tapering,terminal,tip,undulate,way,white,yellow,yellow-brown,young	-0.25,-2,-20,-4,-7,-9,.1,.2,.5,/4,0-2,0-3,0-5,0.1,0.1-0.2,0.3-0.5,0.5-2,0.6-0.8,0.6-1,1-1.2,1-2,1-3,1-4,1-5,1.2-1.5,1.2-2,1.5-2.5,1.8-3.2,1/5-1/4,2-10,2-3,2-4,2.5-3.5,2.5-5.5,3-10,4-5,5-,5-merous,7-8,acut,alyx,apar,apart,apically,apparently,articulated,ba,bark,blade,brow,cell,concolorous,coroll,curved,diameter,difoliate,distinctive,drying,eaf,eed,elongate,elongating,erect,eye,filament,filiform,flower,free,geminat,glabrescent,gray,herbaceous,infructescence,like,lobe,long,longer,lower,mature,midpoint,minutely,naked,narrow-deltate,narrow-ovate,near,nflorescence,occasional,often,older,one,open,orolla,oung,outline,pair,per,perfec,pericarp,pit,porrect,portion,prickly,primary,raised,rarely,ray,reticulate,ruit,scandent,scar,sessile,shorter,simple,slender,slightly,small,smooth,spaced,sparsely,stalk,stalked,stellate,stem,stump,style,tamen,terete,tertiary,time,tinge,trichome,tube,ud,unarme,unarmed,unit,usually,variously,vary,vein,venation,visible,weakly,wide,woody,ympodial	abaxial,adaxial,articulation,branching,colour,corolla,form,growth,heteromorphism,inflorescence,placement,position,seed,shape,staman,texture,type,width
141	wfo-0001027366	success	136	83	64	72	19	0.471	/4,0.25-0.5,0.7-1,1-1.5,1-2,1-3,1.5-2,11-21,2-2.5,3-10-flowered,4-4.5,4-5,5-7,6-19,abaxially,acute,adaxially,anther,anthesi,apex,base,bright,broadly,calyx,capitate,cm,conical,conspicuously,corolla,elliptic,filament,fruiting,glabrous,globose,golden,green,greenish-white,internodal,leaf,lobed,minutely,mm,opposite,orbicular,ovary,ovoid-reniform,papillose,parallel,pedicel,petiole,pitted,pore,rounded,shaped,shrub,simple,sometimes,stigma,style,surface,tear-drop,tube,venation,way	.5,/2,0.5-1,3-9,603,ape,axe,ba,bark,berry,brown,closely,dark,deflexed,deltate,dia,drying,eaf,edicel,eed,erect,et,except,exserted,fide,free,lamina,lateral,less,lobe,lon,long,long-triangular,lower,main,margin,middle,nflorescence,older,overlappin,ovoid,packed,pair,pale,papillo,planar,pointed,poridical,portion,ramo,reddish,ruit,scar,secondary,shining,somewhat,stem,straight,tall,tip,trichome,tub,ud,unifoliat,unit,vein,wide,widest,woody,yellowish-gre,ympodial,young	0.5,1,abaxial,branching,colour,diameter,form,fruit,growth,height,inflorescence,length,plant,position,seed,shape,texture,width,ye
142	wfo-0001027368	success	145	87	65	80	22	0.448	-20,-5,0.3-2.5,0.5-3.5,0.5-5,1-2,1.5-2,2,2-2.5,3,4-6,5-15,acuminate,acute,adaxially,apex,articulated,base,branched,chartaceous,cm,cuneate,decurrent,dendritically,densely,diameter,directed,distally,ellipsiodal,elliptic,elliptic-ovate,entire,forked,glabrous,globose,hair,lanceolate,lenticular,margin,mm,moderately,narrowly,nearly,oblong,occasionally,otherwise,ovoid-fusiform,pedicel,peduncle,petiole,pore,puberulent,pubescent,purple,rachi,shrub,simple,sparsely,stellate,subcoriaceous,subhastate,unbranched,unknown,white,x	-10,-15,-2,.5,0.8-2,1-15-flower,1-6,1.5-2.5,2-3,2-4,2-9,3-12.5,4-many-foliat,5-10,5-6,8-13,abaxially,abruptly,absen,adaxiall,aggregate,also,apart,axe,ba,blade,calyx,cell,color,connivent,contiguous,cylindrical,darker,deltate,denser,eaf,eed,except,gland,lighter,lobe,long,long-stalked,lower,midvein,narrowed,nflorescence,nther,obtuse,often,orolla,pubescen,radiu,ray,ruit,small,sometimes,spaced,stalked,star,stigma,stone,style,subcapitat,tal,tem,terminal,three,time,tip,triangular,truncate,tube,unit,usually,vary,vein,wide,yellow,ympodial	abaxial,adaxial,anther,articulation,branching,colour,corolla,form,fruit,growth,height,inflorescence,leaf,length,plant,position,seed,shape,size,stem,texture,type
143	wfo-0001027369	success	191	82	63	128	19	0.33	-1,-10,.5,.7,/4,0-15,0.2-0.5,1-2.5,1.2-2.5,1.2-3,2-4,3,4-8,5,anther,berry,branched,calyx,cm,concolorous,diameter,drying,flower,fruit,fruiting,hair,known,lateral,leaf,length,lobed,long,margin,mature,mauve,membranous,mm,multangulate,one,orbicular,pale,per,perpendicular,petiole,poricidal,prickle,reniform,sessile,shrub,simple,sparsely,spherical,spreading,stellate-pubescent,stem,surface,tapering,terminal,tip,trichome,unequal,wide,yellow	-11,-2,.1,.4,0,0-1,0-3,0-5,0-6,0.05-0.15,0.1,0.1-0.2,0.1-0.3,0.25-0.4,0.3-1.5,0.5,0.5-0.8,0.5-1.5,0.6-0.8,1-,1-2,1-3,1-4,1.5-2,1/3,2-3,2-5,3-10,3-4,4-5,5-merous,7-15,abaxially,acut,almost,alyx,ame,apar,apart,apex,apically,apparently,articulated,bark,base,blade,broad-deltate,c.,color,cordate,curved,deltate,densely,difoliate,distance,eaf,eed,elongating,equal,erect,extending,eye,filament,filiform,free,geminat,glabrou,glabrous,glaucous,gra,green,herbaceous,infructescence,know,lanceolate,less,lobe,lon,lower,midpoint,midvein,moderately,naked,narrowly,nflorescence,older,open,orolla,oung,pedicel,peduncle,pendulous,perfec,pericarp,porrect,portion,prickl,prickly,ray,reflexed,rounded,ruit,scandent,scar,side,slender,slightly,smooth,spaced,stalk,stalked,stellate,straight,strongly,style,tamen,terete,time,tube,unarmed,unit,vary,venation,visible,way,wider,winged,ympodial	branching,colour,corolla,elbowing,form,growth,heteromorphism,inflorescence,number,orientation,placement,position,shape,size,specified,staman,texture,type,width
144	wfo-0001027378	success	149	108	90	59	18	0.604	0.5â1,0.7â1,0.8â2.5,1.5â1.8,15â35,1â1.5,2.5â7,2â11,2â2.2,3â4.5,5-merous,5â10,5â13,5â7,6â10,abaxially,acuminate,acute,adaxially,anther,base,berry,blue,broadly,calyx,chartaceous,cm,cordate,deeply,densely,diameter,extra-axillary,filament,flattened,fleshy,flower,fruit,glabrous,hair,hair-tipped,herbaceous,lanceolate,leaf,light,lobe,long,margin,markedly,membranous,minutely,mm,moderately,obscure,often,ovate,ovoid,palmate,pedicel,peduncle,pentagonal,petiole,primary,pubescent,rachi,revolute,rotate-stellate,rounded,sand-punctate,scattered,short,simple,slightly,small,somewhat,spaced,sparsely,stem,terrestrial,tip,tooth,trichome,tube,unbranched,unknown,vein,venation,vine,white,widely,x	.2,1.2â1.5,1.2â1.8,1.5â8,1â3,2.3â5,2â2.5,3â5,3â6,4â6,4â9,5-8,6â7,adaxial,alyx,apar,apex,apicall,axe,blade,c.,capitat,ciliate,clavate,climbin,color,cylindrical,deltoid,eaf,eed,fruiting,glabrou,half,like,lon,longer,lower,m.,narrowly,nflorescence,nternode,orolla,papillose,perfec,plurifoliat,pointed,ruit,sand-punctat,side,slender,stigma,style,tamen,tem,unit,unknow,vary,wide,ympodial	branching,climbing,colour,corolla,form,growth,habit,inflorescence,internode,length,merosity,perfect,plant,position,shape,staman,texture,type
145	wfo-0001027378	success	141	99	76	65	23	0.539	.2,0.7-1,0.8-2.5,1-1.5,1.5-1.8,1.5-8,15-35,2-11,2-2.2,2-4,2.5-7,3-4.5,3-5,4-6,5-13,abaxially,acuminate,acute,anther,apex,base,blue,broadly,calyx,chartaceous,cm,cordate,deeply,diameter,directed,distally,extra-axillary,fleshy,flower,glabrous,herb,lanceolate,large,leaf,light,lobe,longitudinal,margin,minutely,mm,node,oblong,opening,ovate,pedicel,peduncle,perfect,petiole,pore,pubescent,rachi,revolute,rooting,rotate-pentagonal,rounded,simple,slit,small,somewhat,spaced,sparsely,stigma,style,tip,tooth,trailing,tube,unbranched,white,widely,x	1-3,1.2-1.5,2.3-5,3-6,4-9,5-8,5-merou,6-10,6-7,adaxially,ag,alyx,apart,apicall,apparently,articulated,axe,ba,basally,blade,capitat,ciliate,clavate,climbing,connivent,cylindrical,deltoid,densely,eaf,eed,equal,filament,fruit,fruiting,geminat,hair,hair-tipped,long,longer,lower,moderately,multicellular,narrowly,nflorescence,obscure,often,orolla,plurifoliate,pubescen,scattered,short,slender,slightly,tamen,tem,terrestrial,unit,unknow,unknown,vary,vein,weakly,wide,yellow,ympodial	abaxial,adaxial,age,articulation,branching,capitate,colour,corolla,form,growth,habit,inflorescence,length,ovary,plant,position,pubescence,shape,size,staman,stem,texture,type
146	wfo-0001027384	success	155	117	97	58	20	0.626	.75,0.4-1.1,0.5-1,0.9-1,1-1.3,1-1.5,1-3,1-4,1.5-2,2.5-6.5,3-3.5,3-4,3/4,4-7,5-15-flowered,5-5.5,7-14,7.5-8,acute,anther,anthesi,apart,apex,bark,base,berry,brown,bud,calyx,capitate,clavate,closely,cm,corolla,cuneate,deep,dia,drying,ellipsoid,filament,flattened-reniform,fruiting,glabrous,globose,green,hard,herbarium,later,lateral,leaf,lobed,long-exserted,main,margin,minutely,mm,mustard,narrowly,obovate,older,opposite,ovary,overlapping,pair,pale,papillose,pedicel,petiole,pitted,pore,pseudo-terminal,reddish-purple,rounded,scar,shaped,shining,shrub,slender,small,spaced,specimen,stem,stigma,style,sulcate,surface,tapering,tear-drop,tree,tube,vein,way,white,widely,yellow,yellowish,young	.25,.5,/3,abov,anothe,ba,beginning,beneath,breaking,broadly,difoliate,distal,eaf,edicel,eed,equal,erect,free,geminate,incrassate,inflorescenc,lobe,long,lower,member,middle,nflorescence,occasionally,paler,papillo,peeling,planar,poricidal,portion,prominent,rarely,ruit,section,simple,siz,straight,subcoriaceous-fleshy,tall,thick,tip,transverse,triangular,trichome,tub,tuft,ud,uniseriate,unit,widest,without,woody,x,ympodial	1.5,colour,diameter,flower,form,fruit,growth,height,inflorescence,length,number,plant,position,seed,shape,spacing,texture,type,venation,width
147	wfo-0001027389	success	154	80	64	90	16	0.416	.1,.25,.5,0.25-0.3,0.25-0.5,0.5-0.75,0.5-1.5,0.6-1,1.8-1.9,11-14,2-2.5,3-3.5,3-4.5,5-7,anther,base,berry,broadening,broadly,calyx,cm,conical,corolla,deltoid,elliptic,erect,filament,fruiting,glabrous,globose,inflorescence,leaf,lobe,lobed,minutely,mm,nearly,one,opposite,ovary,ovate,ovoid-reniform,pedicel,petiole,pitted,pore,poricidal,shaped,shrub,side,simple,slight,stem,stigma,style,surface,tear-drop,tip,top,trichome,truncate,tube,uniseriate,white	1,1-1.5,1-2,4-5-flowered,7-8,acuminate,acute,along,anthesi,apart,apex,ba,bark,beneath,brown,bud,dark,decurrent,deflexed,dia,dry,eaf,edicel,eed,ellipsoid,evenly,except,expanded,exserted,filiform,foetid,foliage,free,geminate,green,hispidulous,lateral,like,lon,long,lower,main,making,margin,material,middle,nflorescence,node,non-reproductive,obovoi,occasionally,often,older,pair,paler,papillo,papillose,portion,prominent,prominently,proximal,puberulent,raise,raised,reddish-golden,reflexed,rest,ruit,scar,shin,slender,slightly,soon,spaced,sparsely,straight,tall,tapering,thread-like,ud,unifoliat,unit,vein,widest,winged,woody,x,yellowish,ympodial,young	colour,decurren,diameter,form,fruit,growth,hair,length,orientation,position,seed,shape,symmetry,texture,type,width
148	wfo-0001027395	success	153	79	61	92	18	0.399	.25,.5,0.25-0.5,0.75-1,1-1.5,1-2,1-5,1.1-1.5,1.5-1.9,1.5-2.5,12.5-17.3,2-3,3.5-4,5-6.5,8,anther,anthesi,apiculate,attenuate,base,calyx,capitate,cm,corolla,deltoid,densely,dia,filament,fruit,fruiting,glabrous,globose,green,immature,leaf,lobe,lobed,mm,narrowly,nearly,obovate,occasionally,once-furcate,opposite,ovary,pedicel,petiole,pore,pubescent,shaped,shrub,simple,size,stigma,style,tear-drop,trichome,tube,uniseriate,white,x	0.6-1.1,1.6-2.9,10-20-flowered,11-15,2.2-7,4-6,acute,apex,apically,bark,becoming,beginning,beneath,berry,black,caly,closely,conical,constricted,cucullate,decurrent,deflexed,depressed,differing,difoliate,drying,eaf,edicel,eed,enlarging,erect,exfoliating,exserted,fleshy,free,geminat,imperceptibly,inflorescenc,known,large,lateral,lon,long,lower,main,major,margin,midrib,minor,minutely,nflorescence,older,overlapping,ovoid,pair,papillo,papillose,partially,piece,planar,pointed,poricidal,portion,primary,raised,restricted,robust,ruit,rusty-papillate,scar,secondary,shining,shiny,small,somewhat,spaced,stem,straight,tall,tapering,thick,thickened,tip,transverse,ud,unit,vein,within,without,woody,ympodial,young	10-20,abaxial,adaxial,branching,colour,diameter,flower,form,growth,height,inflorescence,length,number,plant,position,shape,texture,type
149	wfo-0001027396	success	244	104	89	155	15	0.365	/3,0-100,0-4,0-5,1/4-1/3,1/6,15-40,20-100,5-10,5-50,5.5-7.5,6.5-7.5,abaxial,acute,adaxial,almost,anther,apart,apex,base,berry,black,blade,brown,calyx,chartaceous,cm,connivent,cream,dark,decurrent,densely,elliptic,elongate,elongating,equal,flattened-reniform,flower,fruit,fruiting,glabrous,green,herb,lateral,leaf,length,less,lobed,long,long-styled,lower,margin,marking,mature,maturity,mauve,mm,obtuse,often,orange,pale,per,petiole,poricidal,prickle,pubescent,purple,reflexed,rotate,short-styled,shrub,sometimes,somewhat,spaced,sparsely,spherical,stellate-pubescent,stem,surface,tapering,tearing,tip,unbranched,usually,way,white,yellow,yellowish,young	-2,-5,-6,0-3,0-30,0.1-0.5,0.1-1,0.4-0.7,0.5-1,0.5-1.5,0.5-2,0.5-2.5,0.7-2.5,0.8,0.8-1.3,1,1-4,1.2-2,1.5-3,1.5-3.5,1.8-3,1/2-2/3,1/3,10-15,10-25,10-30,10-35,12-25,2-3,2-3.5,2-7,2.5-4,2.8-4.5,3-,3-9,3.5-6,4,4-5,4-6,4-7,5-20,5-30,5-8,5-merous,6-20,7-10,7-15,8-20,abaxially,alyx,ame,andromonoecious,apar,apically,apparently,articulated,attenuate,ba,bark,broad,broad-deltate,bulbous,c.,concolorous,cuneate,curved,deltate,diameter,difoliate,discolorous,distal,distance,drying,eaf,eed,erect,extending,extensive,fewer,filament,flattened,free,fully,geminat,glabrescent,glandular,gray-brow,hair,hermaphrodite,heterostylous,infructescence,lignified,lobe,lobing,lon,long-acuminat,longer,lowermost,midpoint,midvein,moderately,near,nflorescence,older,one,open,opening,orolla,oung,pair,pedicel,peduncle,pendulous,pericarp,perpendicular,plant,porrect,portion,prickl,prickly,primary,ray,red-brown,ruit,scar,secondary,sessile,side,simple,smooth,spreading,stalk,stalked,staminat,stout,straight,style,tamen,terete,tertiary,time,trichome,tube,unarmed,unit,upper,variously,vary,vein,venation,visible,wide,woody,yellow-green,ympodial	branching,colour,corolla,form,growth,heteromorphism,inflorescence,na,number,position,seed,shape,staman,texture,type
150	wfo-0001027449	success	160	99	76	84	23	0.475	.4,.75,0.5-1,0.5-1.5,0.8-1.5,1.2-1.5,1.4-1.5,1.5-2.5,2-3,2-4,3,3-3.5,3-7,5-6,8-15,anther,area,bark,brown,bud,closely,cm,corolla,dark,deciduous,density,difoliate,elliptic,filament,fruit,fruiting,glabrate,glabrous,globose,green,inflorescence,leaf,major,minor,minutely,mm,narrowly,often,older,opposite,ovary,overlapping,ovoid-reniform,packed,pale,papillose,pedicel,petiole,pitted,pointed,pore,pubescent,red-papillose,scar,shaped,shrub,size,small,stem,stigma,style,surface,tear-drop,tree,trichome,tube,uniseriate,unit,white,x,young	.5,/3,0.9-1.1,10-15-flowered,4-6,acuminate,acute,anthesi,apex,appearing,arising,around,axil,base,becoming,beginning,beneath,berry,calyx,cup,deflexed,dense,densely,dia,differing,dry,eaf,edicel,eed,ellipsoid,erect,exserted,extreme,forming,free,frui,geminat,inflorescenc,lamina,later,lateral,like,lobe,lobed,lon,long,long-acuminate,long-triangular,lower,main,material,nflorescence,obconic,oblique,one,orangish,pair,persistent,poricidal,portion,prominent,raised,reddish-brow,reflexed,rest,ruit,simple,slender,soon,sparse,sparsely,straight,styl,tall,tapering,tip,trunk,tuft,ud,varying,vein,way,woody,ympodial	10-15,abaxial,adaxial,colour,diameter,flower,form,geminate,growth,hair,height,length,number,plant,position,reddish-brown,seed,shape,structure,sympodial,texture,type,ye
151	wfo-0001027452	success	152	91	70	82	21	0.461	.5,0.5-1,1,1-5,1.5,10-20,2-4,3-9,4-6,5-12,5-20,absent,acute,anther,apex,base,berry,brown,calyx,chartaceous,ciliate,cm,connected,cordate,densely,diameter,drying,elliptic,elliptic-ovoid,entire,filament,flower,fruit,glabrous,globose,hair,herb,immature,large,margin,membranaceous,mm,moderately,nearly,notched,oblong,obtuse,outer,pedicel,peduncle,per,perpendicular,petiole,placenta,pubescent,rachi,raised,ridge,rotate,rounded,running,seed,semitransparent,significantly,sparsely,style,swollen,white,x,yellow	0.5-1.5,0.5-2,0.5-2.5,1-2,1-3,1-4.5,1.5-3,2-6,2-foliate,3-6,4,abaxially,abundant,adaxiall,adaxially,along,axe,beyond,blade,branched,cell,celled,center,decurrent,dehiscing,denser,dm,eaf,eed,emarginat,equal,explosively,exserted,flat,frui,geminat,growt,held,interpetalar,linear-lanceolate,lobe,long,lower,lying,maturing,maturit,mesocarp,new,nfloresence,often,one-,orolla,parallel,pressure,pubescen,ruit,short,single,slightly,smaller,smoother,sometimes,stamen,stigma,straight,tal,tamen,tem,tissue,triangular,tube,two-celled,unbranched,unit,usually,vary,vein,wall,watery,wid,woody,ympodial	arrangement,branching,colour,corolla,decument,emarginate,form,growth,inflorescence,leaf,length,notching,number,ovary,shape,simple,staman,stem,symmetry,texture,type
152	wfo-0001027471	success	165	137	120	45	17	0.727	.5,/4,0.1-0.2,0.2-0.4,0.2-0.5,0.4-1,0.5,0.5-0.6,0.5-0.7,0.7-0.9,1-1.6,1.4-3,1.5-2,2-2.5,2-3,2-lobed,3-4,3-7,4-5,6-7,acute,age,anther,anthesi,apex,appressed,ascending,bark,base,berry,bifid,branched,calyx,closely,cm,conical,corolla,deltate,dendritic,diameter,drying,elliptic,entire,erect,filament,flattened,flower,fruiting,glabrous,globose,growth,herb,included,inflorescence,internodal,leaf,leaf-opposed,lengthening,less,lobe,lobed,major,margin,maturity,minor,minutely,mm,new,nodding,orbicular,ovary,ovate,overlapping,pair,pale,pedicel,peduncle,petiole,pitted,planar,plane,pore,poridical,primary,pubescent,rachi,red-orange,reflexed,reniform,scar,shape,shrub,similar,simple,size,slightly,slit,small,somewhat,spaced,sparsely,stem,stigma,straight,style,subshrub,surface,tan,thickened,tip,trichome,tube,uniseriate,usually,vein,way,white,woody,x,yellowish	0.5-1.5,0.9-1,1-1.2,1-1.5,abaxially,adaxially,along,brittle,c.,densely,desnsely,differing,difoliate,distant,eaf,eed,erec,especially,free,furcate-dendritic,geminate,lamina,like,long-triangular,lower,midvein,mixture,nflorescence,node,occasionally,open-conical,papillat,perfect,pericarp,petal,portion,pubscent,ruit,scattered,slender,thin,trifoliat,ud,unit,ympodial	arrangement,branching,bud,colour,dense,form,fruit,inclusion,length,number,orientation,papillate,position,pubescence,seed,spacing,type
153	wfo-0001027473	success	138	92	75	63	17	0.543	.25,0.25-0.5,0.5-1,0.8-1,1-1.5,1-2,1.3-2,1.5-2,1.8-2,2-2.5,2.5-3,3.5-5,4.5-13,8.5-37,?,along,anther,apex,base,brown,calyx,clavate,cm,conical,corolla,decurrent,deflexed,dendritic,densely,denser,di-,filament,flattened-reniform,fruiting,glabrous,globose,green,incrassate,leaf,less,lobe,lobed,long-triangular,margin,minutely,mm,near,obovate,occasionally,ovary,pedicel,petiole,pitted,pointed,pore,pubescent,rootstock,rusty,sessile,shape,shaped,shrub,somewhat,stem,stigma,style,subshrub,surface,tear-drop,trichome,trifoliate,tube,vein,white,woody	/2,1/3,5,6-9,abaxially,absen,acute,adaxially,anthesi,ape,apparently,bark,berry,deccurent,deep,dia,differing,drying,eaf,eed,empty,erect,free,geminat,giving,later,lateral,like,long,lower,main,major,middle,minor,minute,older,overall,pair,pale,papillo,planar,poricidal,portion,pubesent,ruit,sac,sparsely,sterile,strongly,tall,thick,tip,unit,usually,way,wide,widest,wing,winged,yellowish,yellowish-brow,ympodial,young	absent,arrangement,colour,deflexion,density,diameter,flower,form,fruit,growth,height,length,plant,seed,texture,type,width
154	wfo-0001027483	success	164	117	90	74	27	0.549	0.2-1.9,0.6,1-2.5,1-4,1-5,1.2-2.5,1.5-10,1.5-2.6,1.5-3,2-3,2-4,2-4.5,3-15,3-6,3.5-20,4.5-8,5-10,5-6,abaxially,adaxially,apical,apically,branched,calyx,cm,coarsely,connate,corolla,cyme,dehiscent,diameter,dichasial,dichasially,distal,dot,filament,finely,flower,forked,globose,green,green-white,hair-like,herbaceous,interjected,interpetiolar,introrse,lateral,leaf,leaflet,light,lighter,long,maturing,medium,mm,monochasial,odd-pinnate,often,ovoid,pedicel,peduncle,perennial,perfect,petiole,plant,poricidally,proximal,pubescent,purple,ray,rotate,seed,short,size,slit,smooth,sometimes,style,terminal,throughout,tuber-bearing,uniform,unit,violet,violet-purple,wall,white,wide,Â¼	0-1.,1,1-2,2,3-6-foliat,acumen,acute,apex,articulate,basal,base,cell,covering,cuneate,decurrent,digestion,diminishing,dorsally,eaf,ebracteate,edge,eed,elliptical,emoval,enzyme,erec,exceeding,flat,folded,generally,globo,gradually,half,honeycomb,living,lobe,lon,lower,lunat,make,minute,mucilaginous,nflorescence,nther,obtuse,orolla,ovate,pair,pattern,petiolule,plan,rachi,reveal,rosette,rounded,ruit,sessile,seudostipule,specimen,stamen,stigma,straight,subsessile,tall,tem,testal,thick,tissu,toward,typically,vary,varying,yellow,ympodial	0-10,3-6-foliate,anther,arrangement,articulation,branching,colour,form,fruit,growth,height,inflorescence,length,lunate,number,ovary,pore,present,pseudostipule,shape,stem,structure,sympodial,texture,tissue,type,width
155	wfo-0001027506	success	215	91	72	143	19	0.335	/2,/6,0-60,0.5-1.5,2.5-8,3-10,5-10,6-13,abaxially,anther,base,becoming,berry,branched,brown,calyx,chartaceous,cm,connivent,cream,dark,densely,elongating,entire,equal,flattened-reniform,flower,fruit,fruiting,green,lateral,leaf,length,lobed,long,lower,margin,marking,mature,maturity,mauve,mm,occasionally,orange,orange-brown,ovate,pale,per,petiole,poricidal,prickle,purple,reflexed,shrub,simple,small,sometimes,spherical,stellate,stellate-pubescent,stem,subentire,surface,tapering,terminal,tip,tree,twice,way,yellow,yellow-green,young	-0.35,-1,-20,-3,-7,-7.5,.2,.5,0,0-10,0-2,0-6,0.1-,0.1-0.3,0.2,0.2-0.3,0.25,0.5-6,0.7-1.3,0.8-1.5,1-2,1-3,1-4,1.2-1.5,1.5-2.2,1.8,1/3,1/6-1/4,10-40,2-3.2,2.2-3.5,2.5-5,3-5,3-6,3.5-5,5-7,5-merous,6.5-10,7-8,7-9,8-10,9-13,acuminat,acuminate,acute,alyx,ame,andromonoecious,apar,apart,apex,apically,apparently,articulated,bark,blade,brow,c.,cell,concolorous,cordate,cuneate,curved,diameter,distal,dry,drying,eaf,eed,erect,filament,fine,flattened,free,glabrescent,glabrous,hard,hermaphrodite,heterostylous,infructescence,lengt,lobe,long-styled,longer,lowermost,midpoint,moderately,multangulate,narrow-deltate,nflorescence,older,one,open,orolla,oung,outline,pair,pedicel,peduncle,pendulous,pericarp,pit,plant,plurifoliat,porrect,portion,prickl,prickly,primary,raised,ray,reddish,reduced,ruit,scar,sessile,short-styled,smooth,spaced,spreading,stalk,stalked,staminat,stout,style,tamen,terete,tertiary,time,trichome,truncate,tube,unarmed,unit,upper,variously,vary,vein,venation,visible,wide,woody,ympodial	branching,colour,corolla,form,growth,hair,heteromorphism,inflorescence,needle-like,number,orientation,placement,position,seed,shape,staman,texture,type,width
156	wfo-0001027548	success	216	87	76	140	11	0.352	0.3-1.2,0.5-2,1,1-1.5,1.5-2,10-12,10-50,acuminate,acute,almost,anther,apex,articulated,articulation,base,berry,black,branched,branching,cm,corolla,dendritic,densely,depressed-elliptic,dull,ellipsoid,elliptic,entire,filament,flattened-reniform,flower,fruiting,glabrous,globose,green,growth,immature,inflorescence,leaf,lengthening,like,lilac,lobed,loosely,lower,many,margin,matte,membranous,mm,narrowly,papillae,papillate,pedicel,peduncle,per,petiole,pore,poricidal,pubescent,ripe,scattered,simple,slit,stellate,stem,surface,terminal,time,tinged,tip,trichome,upper,vine,white,x	-11.5,.3,0.2,0.5,1-10,1-2.5,1-3.5,1.2,1.5,1.5-2.5,3-7,4-6,4-8,4.5,5-merou,6-9,7-10,8-9,abaxiall,adaxially,ag,along,also,although,alyx,anthesi,apart,apical,apparently,appearing,area,ark,attenuate,axi,basal,beneath,bent,branch,brown,bu,c.,calyx,capitate,cell,conical,connivent,dark,darker,deflexe,deltate,denser,diameter,drying,eaf,early,eed,elongate,em,exserted,extending,flexuous,free,geminat,glabrescen,glandular,half,herbarium,ilament,irregularly,lamina,leaving,less,lobe,lon,long,long-styled,loose,minute,minutely,mixed,near,new,nflorescence,occasionally,older,orolla,outline,pair,pale,papillo,perfect,pericarp,pitted,planar,plurifoliate,point,portion,primary,prominent,puberulent,rachi,rectangular,reddish,revolute,ruit,scar,size,slender,small,sometimes,somewhat,spaced,sparse,sparsely,specimen,spreading,stigma,strongly,style,swollen,tapering,testal,thickened,thin,tiny,transparent,tube,twinin,type,ud,uniseriate,unit,usually,vary,vein,warty,way,woody,yellow,ympodial	age,arrangement,colour,form,fruit,length,number,position,seed,shape,texture
157	wfo-0001027581	success	200	109	80	120	29	0.4	200,>,abaxial,acute,adaxial,along,anther,apex,articulated,base,berry,branched,branching,broadly,brown,c.,clavate,closely,cm,corolla,dark,densely,diameter,echinoid,ellipsoidal,elliptic,entire,evenly,filament,flattened-reniform,fruiting,globose,golden,green,growth,inflorescence,leaf,length,lengthening,lobed,long,many,margin,mm,moderately,multangulate,pedicel,peduncle,per,petiole,plane,pore,poricidal,pubescent,purple,ray,reddish,ripe,scar,sessile,short-stalked,shrub,simple,slit,small,spaced,sparsely,stellate,stem,stigma,style,surface,terminal,time,tip,tree,trichome,unevenly,varying,way	0.2â0.3,0.3,0.3â1,0.5â1,0.5â1.5,1,1.2â1.5,1.3â1.5,1.5,1.5â2,1.5â3,10,100+,10â16,12,12â30,15â20,1â1.5,1â3-rayed,2.5â3,3.5â4.5,3â3.5,4.5â16,4â8,5-merou,6â7,7â10,7â9,8,8â10,9â11,9â9.5,abaxially,ag,alyx,anthesi,apar,ark,axe,beneath,brow,bulbous,calyx,clearly,connivent,cup-shaped,deltate,dichasia,discolorous,distally,drying,eaf,eed,erec,exserted,flower,free,glabrescent,glabrous,gradually,greyish,ilament,lamina,largest,less,like,lobe,longest,loosely,lower,midvei,minute,minutely,mixed,multiseriate,narrowing,near,new,nflorescence,nodding,older,orolla,pair,papillo,part,perfect,pericarp,pitted,plurifoliate,porrect-stellate,portion,primary,reflexed,rhachi,ruit,scarcely,shiny,size,smaller,spreading,stalk,stout,tall,tem,thin,tube,ud,undersurface,unit,upper,vary,vein,visible,weak,whit,wide,woody,yellow,yellowish,ympodial	1-3-rayed,1.2-1.5,1.5-3,10-16,2.5-3,3-3.5,4-8,7-10,7-9,9-9.5,age,apart,articulation,bud,colour,dichasial,form,fruit,hair,height,number,ovary,pattern,plant,position,seed,shape,texture,type
158	wfo-0001027584	success	144	127	100	44	27	0.694	-16,-2,..,.5,0.5-1.5,0.9-1,0.9-2.5,1-1.2,1.2-1.4,1.5-2,1.6-1.9,10-15,11.5-45,2,2-10,2.5-3,3,3-.,4-6,4-7,4.5-20,7-10,abruptly,absent,acuminate,anther,apex,attenuate,bark,base,branched,broadly,calyx,cell,cm,conical,corolla,darker,deltate,densely,diameter,ellipsoid,elliptic,filament,flattened,four,fruit,fruiting,glabrous,green,herb,irregular,lamina,lobe,lobed,long,minutely,mm,nearly,outer,outline,ovary,ovate,pair,pale,papillate,pedicel,peduncle,per,petiole,primary,reddish,regularly,reniform,scattered,shrub,sinuate,small,smooth,sparse,sparsely,stem,stigma,striate,stripe,style,surface,tan,testal,thickening,time,trichome,tube,uniseriate,unit,vein,wall,white,without,x	0.5-1,1.5-8,100,8-9,anthesi,apical,becoming,beginning,beneath,branch,brittle,brow,c.,capitat,cucullate,deflexe,dry,eaf,edicel,eed,erec,flower,lower,margin,markedly,narrowly,nflorescence,open,pericarp,planar,plurifoliat,pointed,present,ruit,scar,single,single-stemmed,suffruticose,thin,tip,triangular,tuft,ud,ympdoial	branching,brown,capitate,colour,deflexed,deflexion,erect,form,glabrousnes,growth,height,inflorescence,leaf,length,number,orientation,plant,plurifoliate,presence,seed,shape,size,striation,structure,sympodial,texture,venation
159	wfo-0001027600	success	185	128	103	82	25	0.557	-10,0.5-1.5,1,1-14,1-2,1-4,1-5,1.5-2,10-20,2-11,2-18,2-3,2-3.5,2-4,2-4.5,2-5,2-6,2.5-21,2.5-6,20-30,3-15,3-5,3-5-lobed,3-6,4-6,5-13,8-17,abaxially,abruptly,acuminate,acute,apex,apical,apiculate,basal,base,calyx,campanulate,cm,concave,connective,cordate,cuneate,deltate,densely,diameter,directed,distally,ellipsoidal,entire,fading,flattened,forked,fruit,glabrescent,glabrous,gland,greenish-white,laterally,leaf,lobe,lobed,margin,minutely,mm,moderately,narrowed,oblong,obtuse,occasionally,older,orange,ovoid,pedicel,peduncle,petiole,pilose,pinnately,pore,puberulent,purple,purplish,rachi,radiu,rarely,remnant,rounded,simple,stigma,style,tree,triangular,truncate,tube,two,unbranched,unit,unlobed,white,x,yellow,yellow-green,young	-3,0.5-1,1.5-2.5,1/2-3/4,10-,15-25,4-foliat,absen,absent,adaxial,adaxially,adpressed,aggregate,along,apart,ape,articulated,axe,beyond,blade,brow,cell,channe,collection,coriaceous,cream,dilated,divided,eaf,eed,elliptic,especially,exceeding,except,exserted,fleshy,flower,glandular-puberulent,leaving,lon,long,lower,main,mature,midrib,nflorescence,nther,obconical,orolla,ovate,papillose,pedicellar,perfect,pilo,puberulen,puberulence,pubescent,ruit,shorter,sinus,slightly,small,somewhat,spaced,sparsely,stamen,stone,strongly,subcoriaceous,surface,tal,tem,thecae,time,tip,tomento,ud,vary,vein,wide,yellowish,ympodial	4-foliate,anther,articulation,branching,bud,colour,corolla,form,growth,hair,height,inflorescence,length,ovary,plant,position,seed,shape,spacing,stem,structure,sympodial,theca,type,width
160	wfo-0001027607	success	167	100	81	86	19	0.485	.1,.25,.5,0.5,0.5-1,0.8-1,1-4,1.2-1.5,1.5-3,2-3,2-4,3-3.5,3/4,4-10-flowered,5-10,acuminate,acute,age,anther,apex,arching,area,bark,base,becoming,branch,brown,calyx,cm,corky,corolla,curling,dark,decurrent,dry,ellipsoid,elliptic,elongate,filament,flattened,fruiting,glabrate,glabrous,globose,golden,green,leaf,lobed,long,material,mm,narrowly,obovoid,opposite,ovary,ovoid-reniform,papillose,pedicel,petiole,plant,pore,poricidal,raised,reddish-brown,scar,shaped,shrub,stem,stigma,style,tan,tear-drop,tip,treelet,trichome,tube,uniseriate,way,white,widened,winged	0.25-0.5,1,2-2.5,2.5-3,5-7,8-9,anthesi,apar,aspect,ba,basal,berry,branche,deflexed,deltoid,densely,dia,eaf,edicel,eed,erect,evenly,except,exserted,f,filiform,free,geminate,gently,giving,lamina,lateral,lenticellat,less,like,lobe,lon,lower,m.,main,middle,midrib,minute,minutely,narrow,nflorescence,non-reproductive,occasionally,older,pagoda-like,pair,pitted,portion,present,prominent,pubescent,rarely,reflexed,ruit,short,simple,slender,slight,slightly,small,soon,spaced,straight,strongly,styl,surface,tall,tapering,tub,ud,unifoliate,unit,vein,widening,widest,woody,x,yellowish,ympodial,young,zig-zag	apart,bud,colour,diameter,flower,form,fruit,growth,height,inflorescence,length,number,position,pubescence,seed,shape,spacing,texture,width
161	wfo-0001027618	success	202	132	108	94	24	0.535	-pubescent,0.5,0.5-1,1,1-1.5,1-13,1-14,1-23,1-3,1-5,11-16,11-pinnate,15-35,2-12,2-5,2.5-6,3-30,3-7-pinnate,4,4-8,5-20,5-7.5,5.5-12,6-40,8-35,abaxially,adaxially,also,apart,apex,basal,base,blade,branched,bud,campanulate,capitate,chartaceous,cm,compound,connective,cordate,cuneate,cylindrical,densely,dia,diameter,dilated,directed,distally,ellipsoidal,elliptic,elliptic-ovate,flower,fruit,fusiform,glabrous,globose,greenish,laterally,leaf,length,less,lobe,long,margin,membranaceous,minutely,mm,near,oblong,obtuse,orange,ovate,pedicel,peduncle,per,perfect,pilose,pinnately,pore,puberulent,puberulent-pubescent,pubescent-pilose,purple,rachi,reticulate,ripe,shallowly,shrub,simple,slightly,sometimes,sparsely,stigma,style,sympodial,tree,truncate,tube,unbranched,unit,urceolate,white,wide,width,x,yellow	-10,0-10,0.5-6,1-,1-9,1.4-4,1.5-13,1.5-3,1.5-7,1.5-8.5,11-22,12-27,15-30,2-11,2-11.5,2-27,2-8.5,2-9,3-18,3-5,3-7,3.5-6,5-18,5-30,5-merous,6-25,7-25,8-16,acuminat,acut,acute,aggregate,alyx,ape,articulated,ascending,axe,beyond,cell,darker,deltate,diamete,eaf,eed,entire,exceeding,exserted,fleshy,lateral,leaflet,leaving,lon,longitudinal,lower,mesocarp,moderately,nflorescence,nther,obovate,obtu,often,orolla,papillose,pedicellar,perfec,petiole,petiolule,pilo,presen,puberulent-pilo,pubescent,radiu,ranch,ratio,remnant,rown,ruit,runk,shorter,small,somewhat,spaced,spreading,stamen,stone,stripe,tal,terminal,thecae,tomentose,triangular,uni,vary,without	1-8.5,acuminate,anther,arrangement,articulation,branching,colour,corolla,crown,form,growth,height,inflorescence,number,ovary,pattern,plant,position,seed,shape,spacing,texture,trunk,type
162	wfo-0001027622	success	203	159	137	66	22	0.675	.5,0-14,0-16,0.3-10,1,1-2,1.5-3.5,1.5-4.2,1.6-4.5,12-23,2-25,2-6,2.5-3.5,3-16,3-4,3-4.5,3.5-11,4-9.5,5-11,6-17,6-7,8-16,8-20,abaxially,acuminate,adaxially,anther,axillary,berry,blade,blue,blue-purple,borne,brownish,bud,cell,chartaceous,clavate,cm,condition,connivent,corolla,covering,diameter,different,distal,drying,end,except,filament,flower,forked,fresh,fruit,generally,glabrescent,glabrous,globose,greatly,green,green-white,greenish,hair,hair-like,half,herb,homostylous,interjected,lanceolate,lateral,leaflet,lengthening,light,like,lobe,long,make,membranous,middle,mm,mottled,mucilaginous,odd-pinnate,often,ovate-lanceolate,ovoid,pair,pale,pedicel,peduncle,pentagonal,petal,petiole,petiolule,plant,population,pore,poricidal,proximal,pubescent,purple,reduced,seed,shortly,singly,size,slightly,slit,sometimes,star,stellate,stem,stigma,straight,striped,style,subequal,subglabrous,subtending,terminal,testal,thick,throughout,tip,tube,tuber,typically,unwinged,usually,varying,wall,wet,whitish,wide,wing,x,yellow	1-10,1/,2-3,4-5,5-merou,acumen,acute,ag,along,alyx,apart,apex,apparently,articulated,axe,base,broadly,capitat,ciliate,decumben,digestion,dorsally,eaf,edge,eed,elliptic,elliptical,enzyme,erect,especially,exceeding,flat,folded,geminat,glabrou,honeycomb-shaped,living,lower,margin,midrib,minutely,narrowly,nflorescence,oblique,orolla,ovate,perfect,plurifoliate,puberulent,removed,rounded,ruit,seudostipule,spaced,specimen,stamen,ste,stolo,tall,tamen,tem,tri-,truncate,unit,vary,ympodial	5-merous,age,arrangement,branching,calyx,capitate,colour,form,growth,height,inflorescence,leaf,length,ovary,position,presence,pseudostipule,shape,staman,stolon,texture,variation
163	wfo-0001027624	success	189	116	97	92	19	0.513	0-7,0.1-0.9,0.3-1,0.4-3,0.5-1.5,0.8-5.6,1-2,1-3,1.1-8.4,1.2-2.6,1.3-2.9,1.5-6.6,2-20,2-5,2.4-4.8,2.9-12,3-10,3-11,4-15.2,4-7,4-8,5-9,6-18.5,9-41,acuman,anther,blade,brownish,cell,clavate,cm,condition,corolla,deep,densely,diameter,digestion,drying,entirely,enzyme,filament,flower,forked,fresh,fruit,glabrous,globose,green,greenish,hair,herb,homostylous,honeycomb-shaped,interjected,lanceolate,lateral,leaf,leaflet,light,like,lobe,long,mm,moniliform,mottled,odd-pinnate,ovate,ovoid,pedicel,peduncle,pentagonal,petiole,plant,pore,poricidal,pubescent,purple,removed,rotate,seed,short,size,sometimes,stigma,straight,style,terminal,testal,tip,tube,tuber,usually,wall,white,whitish,wide,x	0-3,1-5,2-7,3-4,3-5,5-merou,abaxially,acumen,acuminate,acute,adaxially,ag,along,alyx,apart,apex,apparently,arranged,articulated,axe,axillary,base,bead,berry,bud,capitat,connivent,considerably,covering,cuneate,decreasing,decumben,decurrent,distal,dorsally,eaf,edge,eed,elliptic,erect,exceeding,flat,folded,geminat,glabrou,green-white,hair-like,half,larger,leave,lengthening,living,lower,make,middl,mucilaginous,multiple,necklace,nflorescence,onto,orbicular,orolla,pair,perfect,plurifoliate,present,rachi,ruit,sessile,seudostipule,slightly,slit,spaced,specimen,stamen,stolon,subtending,tall,tamen,tem,thick,throughout,toward,tri-,typically,unit,unwinged,vary,wet,widely,yellow,ympodial	abaxial,adaxial,arrangement,branching,calyx,capitate,colour,form,growth,height,inflorescence,length,number,ovary,pseudostipule,pubescence,shape,staman,stem
164	wfo-0001027626	success	152	97	74	78	23	0.487	.3,.5,0.1â0.2,0.2â0.6,0.5-1,1,1.5â8,13â14,14â116,2â49,2â5,3â4,3â55,5â6,8,acuminate,along,anther,apex,arrangement,base,chartaceous,clavate,cm,cordate,coriaceous,distichous,distinct,elliptical,entire,extra-axillary,filament,fleshy,flower,fruit,glabrous,greenish-white,leaf-opposed,liana,line,margin,membranous,midvein,minutely,mm,moderately,nearly,oblique,ovate,pair,pedicel,peduncle,petiole,pinnate,possibly,pubescent,rachi,rounded,secondary,shrub,somewhat,spindle-shaped,stellate,stigma,style,terminal,trichome,truncate,unbranched,unknown,vein,venation,white,x	0.5â1,0.7â1,0.7â2.8,1.3â4.5,1.5â2,2â3,3â4.5,3â5,4.4â11,4â6,5-merous,9â18,abaxially,accrescen,acute,adaxially,alyx,apar,axe,berry,blade,broadly,c.,calyx,capitat,center,ciliat,climbing,color,densely,diameter,distant,eaf,eed,frequently,fruiting,glabrou,immature,lamina,lanceolate,lobe,long,lower,m.,maturity,mor,nflorescence,nternode,orolla,perfec,petal,plurifoliat,pointed,reflexed,ruit,sand-punctat,sand-punctate,scandent,scar,seen,shortly,side,simple,slender,spaced,sparsely,ste,tamen,tem,time,tip,tube,two,unit,vary,wide,wiry-woody,ympodial	abaxial,apart,branching,capitate,ciliate,colour,corolla,form,growth,height,inflorescence,leaf,length,na,number,ovary,plant,position,seed,shape,spacing,stem,texture
165	wfo-0001027630	success	149	89	67	82	22	0.45	0.5-1,0.5-1.2,0.5-2,1-5,1.4-1.7,1.5-2,4-6,5.5-11.2,6-10,8-9,acute,anther,anthesi,apart,apex,bark,base,berry,calyx,ciliate,climbing,cm,corolla,deflexed,erose,filament,fruit,fruiting,glabrate,glabrous,globose,golden,green,hirsute,internodal,known,lanceolate,lateral,leaf,linear,lobed,long-acuminate,main,margin,mm,occasionally,opposite,ovary,pair,pedicel,petiole,pore,poricidal,pubescent,scar,shaped,shrub,sparsely,stem,style,tear-drop,tip,tube,vein,white,winged,young	.1,.2,.5,0.05-0.1,1-1.5,2-3,2-6-flowered,3/4,also,arising,beginning,blunt,branchlet,broadly,de,decurrent,deltoid,densely,dia,distinguishable,eaf,edicel,eed,elongat,except,extreme,free,globo,immature,indistinct,inflorescenc,irregularly,knob-like,lobe,lon,long,lower,middle,midrib,minutely,near,nflorescence,novo,older,paler,papillose,partially,portion,prominent,proximal,puberulent,raised,reflexed,rest,rounded,ruit,seen,simple,slender,spaced,stigma,straight,strongly,swollen,tall,tapering,terminal,thickened,ti,trichome,ud,ultimate,unifoliat,uniseriate,unit,way,wide,widest,wing,x,yellowish,ympodial	2-6,colour,diameter,elongate,flower,form,growth,hair,height,inflorescence,length,number,plant,position,presence,seed,shape,spacing,texture,type,venation,width
166	wfo-0001027661	invalid_json	222	168	139	83	29	0.626	+,-10,0.5,0.5-2,0.6-1.1,0.6-1.5,1-1.5,1-5,1.2-6,1.3,1.5,1.5-2,2,2.5-7,30,4-8-celled,4.5-6,5-9,6-12,8-10,>,acuminate,acute,along,anther,apart,apex,articulate,axi,basal,base,berry,branch,branched,bright,capitate,cell,cm,commonly,cordate,corolla,deeply,dendritic,densely,denser,diameter,ellipsoid,entire,even,extremely,filament,flattened,free,fruiting,glabrous,globose,grey,growth,lamina,leaf,leaving,lengthening,like,lobe,lobed,long,lower,many,margin,minute,minutely,mixture,mm,moderately,narrowing,near,often,pale,papillate,pedicel,peduncle,peg,pentagonal,per,petiole,pinnatifid,pitted,pore,poricidal,portion,prominent,pubescence,pubescent,purple,rarely,red,reniform,ripe,scar,shape,short,simple,single,sinus,size,sleeve,slit,small,sparsely,stellate,stem,stigma,style,surface,swollen,tan,tangled,ternately,testa,time,tip,trichome,truncate,tube,turbinate,two,type,uniseriate,upper,usually,variable,vein,vine,violet,way,white,yellow,yellowish,Â¾	0.5-,1-,1-7,2.5-3,4-15,40,5-merou,6-8,6-9,<,abaxially,adaxiall,ag,alyx,anthesi,ark,broadly,calyx,column,conical,connivent,creeping,density,eaf,eed,elliptic,flower,fused,gre,green,ground,herbaceous,hue,ilament,irregularly,lateral,leaf-opposed,long-exserted,markedly,membraneous,new,nflorescence,occasionally,older,open,orolla,outline,ovate,pair,papillat,papillo,perfect,pericarp,plurifoliat,pointed,primary,pubescen,purplish,rachi,reflexed,ruit,shiny,slender,spaced,spot,spreadin,spreading,strongly,tem,terminal,thin,tightly,trailing,triangular,ud,underground,unieriate,unit,vary,wide,woody,ympodial,zig-za	'',.5-3,0.5-7,1-15,[,``,age,arrangement,articulation,bark,branching,bud,characteristic,colour,form,fruit,inflorescence,length,number,ovary,papillose,seed,spacing,texture,value,width,zig-zag,{,}
167	wfo-0001027714	success	251	114	104	147	10	0.414	+,/3,0.5,1-1.5,1-1.6,1-2,1.5-5,3-3.5,4.5-5,5,7-20,acuminate,acute,almost,along,anther,anthesi,apex,basal,base,berry,branched,bright,brown,calyx,cm,confined,cordate,corolla,deep,deflexed,dendritic,denser,diameter,ellipsoid,elliptic,elongate,entire,flattened,fleshy,fruit,fruiting,furcate,glabrous,globose,growth,individual,inflorescence,juicy,lamina,leaf,lobe,lobed,longer,lower,many,margin,mm,nodding,obovate,occasionally,often,pair,pale,pedicel,peduncle,petiole,pinnatifid,pubescence,pubescent,purple,red,reddish,reniform,ripe,seed,shiny,similar,simple,slender,slightly,somewhat,stellate-rotate,stem,surface,tangled,thick,time,tip,trichome,truncate,uniformly,uniseriate,upper,usually,vein,vine,violet,way,weak,woody,x,yellow,yellowish	.5,0,0.4,0.5-0.7,0.6-0.7,0.9-1.5,1,1-,1.5-2,1.5-2.5,1.5-3,14-16,2-,2-2.5,2-8,2.5-,2.5-4,2373.,4-10,4-5,5-10,5-6,5-merou,6-7,80,<,abaxial,abaxially,adaxial,adaxially,age,aid,alyx,angle,apar,apice,appearance,ark,around,articulated,axi,canop,capitate,cell,channelled,climbin,conical,connected,connivent,corky,creating,cucullate,cupped,densely,drying,eaf,eed,enlarged,especially,exserted,fide,filament,flower,free,giving,glabrate,glabrou,groove,hairy,hanging,ilament,immature,inflated,irregularly,large,lateral,leaving,lengthening,like,lon,long,loosely,marginal,mature,mere,minute,minutely,mpodial,nee,new,nflorescence,older,orolla,otherwise,outline,ovary,papillate,papillo,peg,per,perfect,pericarp,petal,petiolule,pitted,plat,plurifoliat,pore,poricidal,portion,primary,prominent,reaching,rectangular,rim,ruit,scar,showy,sleeve,slit,small,spaced,sparsely,spreading,stigma,strongly,style,tem,terminal,testa,testal,thecae,thickened,thin,third,tiny,tooth,tube,twining,ud,unit,visible,wall,weight,widest,wing,younger	arrangement,bark,branching,colour,form,hair,length,plate,shape,texture
168	wfo-0001027720	success	184	111	89	95	22	0.484	0,0.25-0.35,0.4-0.7,0.5-0.8,0.5-1,0.8-1,1-1.5,1-2,1-3.5,1.5-2,13-35,15-25,2-3,2-4,2-7,2-branched,3-13,4-5.5,4-7,4.3-15,7-8,7-9,acute,adaxially,adult,anther,apex,base,berry,brown,calyx,chartaceous,cm,cuneate,cylindrical,deltate,densely,diameter,directed,distally,elliptic,entire,extra-axillary,filament,flattened,flower,fruit,glabrous,globose,hair,inflorescence,juvenile,lanceolate,leaf,length,lilac,lobe,margin,minute,mm,narrowly,notched,oblique,ovate,pale,pedicel,peduncle,per,perfect,petiole,pore,prickle,pubescent,rachi,red,shrub,simple,slightly,sparsely,stellate,stellate-pubescent,stigma,straight,style,subreniform,triangular,tube,x,yellow	%,.25-0.3,0-15,0.15-0.25,0.3-5,0.4-0.8,0.6-1.2,1-locular,13-23,2-foliate,2.8-3.1,23-35,4-,4.3-7.5,5-merous,6,7-10,8-11,8-16,9-15,abaxially,absen,absent,adaxiall,alyx,apparently,articulated,axe,ba,blade,capitat,confined,connivent,distall,eaf,eed,eglandular,erect,finger,fruiting,geminat,gland-tipped,green,half,hig,homostylous,incomplete,intepetalar,juicy,lamina,lateral,less,long,loosely,lower,markedly,mature,mesocarp,mid-point,midpoint,midrib,nflorescence,orolla,part,perennial,perfec,porrect,present,ray,rhizomatous,ruit,scarce,septum,sessile,short,stellae,succulen,surface,tamen,tem,thick,thicker,time,tissue,toward,unarme,unarmed,unit,upper,vary,white,wide,without,yellowi,ympodial	arrangement,branching,capitate,colour,corolla,form,growth,height,number,ovary,plant,position,seed,shape,size,staman,stem,symmetry,texture,thicknes,type,yellowish
169	wfo-0001027720	success	272	127	109	163	18	0.401	.3,.5,.9,0.2â0.4,0.3â0.4,0.7â1.1,0.8â1.3,1.4â1.9,1.5â2.5,1.5â3.3,1.5â9.0,1.7â2.5,1.8â2.0,10.0,19.7â30.0,2.0,2.5â2.8,2â3,3.7â5.7,4.0â12.6,5.1â18.6,6.5â9.5,8.0â11.9,9.5â16.0,adnate,anther,apical,apiculate,attachment,attenuate,base,berry,bilobed,broad-based,bud,calyx,capitate,cm,conical,corolla,cream,densely,developed,diameter,dry,elliptic,flattened-irregular,flattened-orbicular,flattened-reniform,flower,fruit,glabrous,glandular,globose,growth,hair,homostylous,internode,interpetalar,lavender,leaf,lobe,long,mature,minute,mm,notched,orange,ovate,pedicel,peduncle,petiole,point,poorly,pore,porrect,portion,prickle,proximal,pubescent,red,sessile,shrub,simple,slightly,small,sparsely,stellae,stellate,stellate-pubescent,stem,stigma,straight,style,subcoriaceous,tall,tissue,tree,tube,twice-branched,violet,white,wide,yellow,yellow-ferruginous,yellow-tan,young,Ã,â4	.0,.04,.2,0,0.1â0.6,0.7â0.9,0.7â1.2,0.8â1.9,0.8â2.0,0.9,1.5â1.7,1.5â2.0,1.7â1.8,1.7â2.0,1.9â2.2,1/2,1/3,1/3â1/2,10.8â18.2,12â16,13.0,2.5,2.5â2.9,3.2,3.6,3.9,4.0â18.0,4â5-merou,6â8,8.0,8.2â10.5,8.5â9.4,abaxially,acuminate,acute,adaxially,aequilateral,alyx,anthesi,apex,apparently,appearing,armed,articulated,axe,ba,becoming,blade,branch,broad,brochidodromous,cancellate,channel,channeled,colore,concave,congested,connivent,crisped,curved,deciduous,dehiscence,dentate,difoliate,distally,dorsally,eaf,eed,either,emerging,endocarp,entire,erect,especially,exocarp,extra-axillary,fertile,filament,filiform,free,geminat,glossy,gradually,heavily,hooked,inclined,increasing,intersepalar,juic,juvenile,lamina,large,lateral,least,like,line,lon,longer,lower,m.,major,margin,midpoint,midrib,midvein,minor,moderately,narrowly,nearly,nflorescence,oblique,oblong,occasionally,often,orolla,part,per,perforate,porrect-stellate,potentially,presumably,raised,ray,reflexed,rigid,rip,row,ruit,scattered,short,shorter,side,sinus,soon,splitting,spread,stamen,stellate-pubescen,subacute,surface,suture,tamen,tem,thin,time,tip,toward,translucent,triangular,truncate,two,ud,unarmed,upper,vary,vein,wavy,way,weakly,yellow-ferruginou,ympodia,youngest,Â±equal	adhesion,branching,colored,colour,form,height,inflorescence,length,ovary,plant,seed,shape,size,staman,symmetry,texture,type,width
170	wfo-0001027757	success	186	94	52	134	42	0.28	12,5,anther,anthesi,base,blue,branching,brown,calyx,campanulate,clavate,cm,colour,dark,diameter,filament,flattened,fruit,glabrous,globose,irregularly,leaf,lilac,lobed,margin,mm,moderately,oblong,occasionally,ovate,pale,pedicel,peduncle,perennial,petiole,pore,poricidal,pubescent,regularly,rootstock,rotate,shrub,simple,sparsely,stigma,style,tip,unbranched,violet,woody,x,yellow	0.2,0.2â0.3,0.3â2.0,0.5,0.6,0.6â1.0,0.7,0â1.4,1.0â1.1,1.0â2.5,1.2â4.0,1.5â1.6,1.5â2.5,1.6â2.4,1.9â2.7,1â1.5,1â11,1â2,1â3,2,2.5,2.5â4,2.5â5.5,2.5â7,2â,2â10,3â12,3â5,4â9,5â,60â100,6â9,7â8,8â16,abaxially,absen,accrescent,acute,adaxiall,adaxially,ag,along,apart,apex,apical,arising,articulated,axe,axillary,ba,basal,blade,borne,cell,chartaceous,concave,connivent,convex,cylindrical,decurrent,deeply,densely,directed,distally,eaf,eed,elliptic,entire,equal,erect,erose,fleshy,flower,geminat,glabrescen,glabrou,hair,lanceolate,leafy,lobe,lon,long,longitudinal,lower,m.,multicellular,narrowly,nflorescence,obtuse,often,opening,opposed,orolla,pair,perfect,pitted,plurifoliate,primary,probably,ruit,secondary,serrate,shoot,side,slit,smaller,sometimes,spaced,stone,straight,surface,tall,tamen,tem,thic,thickened,time,toward,tube,unicellular,uniseriate,unit,unknown,vary,white,wide,ympodial,â19,â2.7,â3.2,â4.0,â5.5,â6,â9	0-1.4,0.2-0.3,0.3-2.0,1-1.5,1.0-1.1,1.2-4.0,1.5-1.6,1.5-2.5,19,2-10,2.5-4,2.5-5.5,2.7,3.2,4-9,5-7-8,5.5,6,6-9,60-100,8-16,9,corolla,decurred,form,growth,height,history,inflorescence,length,life,number,ovary,plant,seed,shape,size,staman,stem,texture,thicknes,type
171	wfo-0001027765	success	167	109	80	87	29	0.479	-30,-44,0.8,1,1-10,1-11.5,1-4,1-5,1.5-6,10-13,2-2.5,2-4,2.5-4.2,20-30,3-,3-12,3-20,5-15,5-6,5-8,7-20,apical,branched,cm,connate,corolla,cyme,dehiscent,diameter,dichasial,dichasially,distal,filament,flower,glandular,globose,green,hair,herbaceous,interjected,introrse,lateral,leaf,leaflet,light,long,maturing,mm,monochasial,mucilaginous,odd-pinnate,often,ovoid,pedicel,peduncle,perennial,perfect,petiole,pilose,plant,proximal,seed,short,simple,size,slit,stellate,stigma,straight,style,terminal,throughout,tone,tuber-bearing,unit,violet,white,wide,yellow,Â¼	-4,0-.,1-,1-2,2-3,2.5-4,3-6-foliat,5,abaxial,abaxially,abruptly,acumen,acuminate,acute,apex,apically,apiculate,articulate,base,calyx,cell,cordate,covering,cuneate,digestion,diminishing,dorsally,eaf,ebracteate,edge,eed,elliptic,elliptic-lanceolate,emoval,enzyme,exceeding,flat,folded,forked,generally,globo,green-white,hair-like,half,honeycomb,living,lobe,lon,lower,lunat,make,nflorescence,nther,oblique,obtuse,orolla,ovate,ovate-elliptic,ovate-lanceolate,pair,pattern,petiolate,petiolule,plan,poricidally,reveal,rounded,ruit,sessile,seudostipule,side,slightly,specimen,stamen,tal,tem,testal,thick,throughou,tip,toward,truncate,typically,vary,wall,without,ympodial	0-2,3-6-foliate,anther,apicidally,arrangement,articulation,bract,branching,colour,connective,ebbrate,form,fruit,growth,height,inflorescence,length,lunate,number,ovary,pore,pseudostipule,shape,stem,structure,sympodial,type,wet,width
172	wfo-0001027807	success	116	82	67	49	15	0.578	0-0.2,0.1-1,0.9-1,1-1.5,15-30,2-6,acuminate,acute,apex,attenuate,bark,base,berry,brown,bud,closely,cm,diameter,dry,drying,elliptic,flattened,flower,fruiting,glabrous,globose,gray,grayish,green,growth,internodal,lanceolate,leaf,leaf-opposed,margin,material,midrib,minutely,narrowly,new,occasionally,overlapping,pair,pale,paler,papillate,pedicel,peduncle,pitted,primary,reddish,reniform,revolute,scar,shrub,simple,slightly,small,spaced,sparsely,stem,surface,thickened,tree,vein,white,yellowish	.5,0.2-0.3,0.2-0.9,0.3-0.4,0.9-2.5,2-5,3.5-9,abaxially,adaxially,almost,barely,brittle,decurrent,deflexe,deflexed,difoliate,eaf,eed,ellipti,geminat,know,known,maturity,mm,nflorescence,older,ot,papillae,parallel,petiole,plane,prominent,rachi,reddi,reproductive,ruit,seemingly,shoot,slender,somewhat,ud,unifoliate,unit,usually,visible,winged,x,ympodial,young	arrangement,colour,form,fruit,inflorescence,length,na,number,papilla,position,seed,shape,spacing,texture,type
173	wfo-0001027816	success	187	101	84	103	17	0.449	.5,0.5,0.5-1,0.6-0.8,1,1-3,1.2-2,1.5-2,12-14,4-5,<,acuminate,acute,anther,apex,articulated,attenuate,base,becoming,berry,bluish,branched,brown,capitate,cm,corolla,dark,densely,diameter,ellipsoid,entire,filament,flattened,fleshy,flower,fruiting,glabrous,gland-tipped,glandular,globose,growth,inflorescence,lateral,leaf,lower,margin,minute,minutely,mm,occasionally,often,orange,patent,pedicel,peduncle,per,perfect,petiole,pitted,pore,poricidal,pubescent,purple,reddish,reniform,several,shrub,simple,sparsely,stellate,stem,stigma,style,surface,terminal,time,tip,trichome,tube,uniformly,uniseriate,upper,variable,x	..,0.2,0.5-2,0.7-1,1-1,1-1.5,1-4,1.8-6,2-2.5,2-4,2/3,3-3.5,3.5-4,5-30,5-merou,6-9,ag,almost,along,alyx,anthesi,apar,ark,axi,calyx,cell,confined,conical,connivent,cupped,dense,drying,eaf,eed,em,erect,exserted,filiform,free,half,ilament,irregularly,lanceolate,leaving,lengthening,less,like,linear,lobe,lobed,loosely,m.,markedly,new,nflorescence,nodding,older,orolla,pair,papillo,peg,perhaps,pericarp,plant,plurifoliat,portion,primary,prominen,pubescen,rectangular,red,ripe,rounded,ruit,scar,shiny,sleeve,slightly,slit,small,sometimes,somewhat,spaced,sparse,spreadin,spreading,square,testal,thin,triangular,twinin,ud,ultimate,unit,usually,vary,vein,viscous,way,woody,yellowish,ympodial,Â½	articulation,branching,colour,form,fruit,length,na,number,ovary,papillose,position,pubescence,seed,shape,symmetry,texture,type
174	wfo-0001027819	success	199	130	105	94	25	0.528	-100,0.5-1,1,1-,1-2,10-50,2-,2-15,2-3,20-35,20-40,25-35,3-40,3-5,3-5-lobed,4,4-10,4-5,5-6,5-merous,8-10,9-12,acute,adaxially,aggregate,apart,apex,apical,basal,base,branched,cell,cm,concave,connective,cordate,cuneate,cylindrical,deeply,densely,diameter,directed,distally,ellipsoidal,entire,especially,fading,finely,fleshy,flower,forked,fruit,glabrous,globose,green,leaf,length,lobe,lobed,long,margin,mesocarp,mm,moderately,narrowly,near,oblong,obtuse,pedicel,peduncle,per,perfect,pinnately,pore,probably,protuberance,puberulent,purple,rachi,rarely,remnant,rugose,simple,sparsely,stellate,stigma,stone,style,subcoriaceous,sympodial,tree,triangular,truncate,two,umbrella-shaped,unbranched,unit,unknown,unlobed,usually,whitish,width,without,yellow,young	1-5,1.5-2,10-20,12-21,15-22,16-25,2,20-25,22-35,4-15,4-25,5,abaxially,also,alyx,ape,apiculat,articulated,axe,ba,beyond,blade,ciliate,color,denser,dia,diamete,dilated,divided,eaf,eed,eglandular,eglandular-pilose,elliptic,elliptic-ovate,equal,exceeding,except,exserted,hair,halfway,leaving,lon,lower,main,midrib,narrow,nflorescence,nther,oblique,obtu,occasionally,often,orolla,ovate,pedicellar,perfec,petiole,pilose,present,prominent,puberulen,puberulence,purplish,radiu,ranch,ratio,ripe,rounded,rown,ruit,runk,shallowly,short-acuminat,shorter,sinus,slightly,small,sometimes,spaced,stamen,strongly,swelling,tal,thecae,toward,tube,ud,uni,vary,vein,villous,wide,x	abaxial,anther,arrangement,articulation,branching,bud,calyx,colour,corolla,crown,form,growth,height,inflorescence,number,ovary,pattern,plant,position,seed,shape,short-acuminate,spacing,texture,trunk
175	wfo-0001027834	success	236	101	81	155	20	0.343	-6.1,0.2-0.6,0.5-2,1-10,2-8,2.3-3.4,4-5.2,4.8-6.9,6.9-18.1,9-11.9,abaxial,accrescent,acuminate,acute,adaxial,anther,apex,attenuate,base,berry,blunt-tipped,branched,branching,calyx,cm,completely,connivent,corolla,covering,deltoid,discolorous,ellipsoid,entire,enveloping,equal,finely,fleshy,fruit,fruiting,globose,granular-tomentose,hair,leaf,lenticular,many,margin,mm,multangulate,obtuse,ovate,ovate-elliptic,pedicel,peduncle,petiole,pore,poricidal,porrect-stellate,rachi,ripe,rounded,scabridulous,semi-spherical,short,shrub,simple,small,soft,stalked,stellate,stigma,style,subcampanulate,subcoriaceous,time,tip,tree,velutinous-tomentose,white,whitish-tomentose,yellow,yellowish-tan	.5-3,0-110,0.2-0.3,0.2-0.4,0.4-1.1,0.9-1.8,1-1.6,1-1.9,1-2.5,1.1-1.6,1.1-1.8,1.4-2,1.6-2.7,1.8-4.9,1/2,10-25,2-3.8,2.2-4.3,2.4-6.2,2.7-7.3,2.9-4.2,25,3-15,3-4.3,4-6,5-20,5-merous,5.1-8,9-13,abaxially,absent,adaxially,ag,alyx,angled,anthesi,apar,apical,around,articulated,axillary,ba,bark,becoming,blade,branch,brown,bud,capitat,closely,concentrated,coriaceous,crown,cylindrical,dendritic-echinoi,dendritic-echinoid,densely,diameter,dichasia,directed,distally,drying,eaf,echinoi,echinoid,edge,eed,enclosing,erec,exserted,farinose,filament,flat-topped,flower,forming,glabrescent,glabrous,gray,grooved,high,included,inserted,lengthening,less,light,lobe,lobed,long,long-stalked,longitudinal,longitudinally,lower,mostly,multangulat,near,nflorescence,numerous,obovate,obscured,older,orbicular,orolla,ovate-lanceolate,pair,perfec,persistent,plurifoliate,primary,pseudo-terminal,pubescence,pubescent,rarely,ray,reticulate-punctate,ruit,runk,scar,semi-ovate,sessile,short-stalked,slit,sometimes,somewhat,spaced,sparsely,spreading,stamen,stellate-pubescent,stem,surface,suture,tamen,though,tomentose,tomentu,tomentum,toward,trichome,tube,turbinoid,ud,unarme,unit,usually,vary,vein,villous,way,whitish,wide,x,yellowish,yellowish-tomentose,ympodial,young	articulation,capitate,colour,dichasial,form,growth,height,heteromorphism,inflorescence,length,ovary,pattern,plant,position,pseudoterminally,seed,shape,staman,texture,type
176	wfo-0001027843	success	154	82	55	99	27	0.357	.75,0.5-1,0.8-3.5,1-1.3,1-1.5,1.2-1.5,2-2.5,5-6,acute,anther,anthesi,base,berry,broadly,calyx,clavate,cm,conical,corolla,densely,erose,filament,flower,fruiting,glabrous,globose,green,leaf,lobed,margin,mm,nearly,opposite,ovary,ovate,pedicel,pore,poricidal,pubescent,shape,shaped,shrub,simple,somewhat,stigma,style,tapering,tear-drop,tip,trichome,tube,uniseriate,way,white,x	.5,/3,0.5-0.75,1-1.2,1.2-2.5,2-4,3-15-flowered,3-6,6-13,6-9,along,apart,apex,apiculate,ba,bark,bearing,becoming,beginning,beneath,coroll,curly,deflexed,deltoid,denser,dia,differing,difoliate,distally,eaf,edicel,eed,ellipsoid,exsertion,free,geminat,glabrate,hairy,impressed,irregularly,known,lamina,larger,later,lateral,like,lobe,lon,long,long-acuminate,lower,main,major,middle,minor,minutely,near,nflorescence,occasionally,older,one,orbicular,pair,papillo,papillose,petiole,pleated,portion,prominent,proximal,reddish-gre,reflexed,rounded,ruit,scar,sinus,size,slender,slightly,spaced,sparsely,sparser,stem,stiff,straight,strongly,surface,tall,time,tipped,two,ud,unit,vein,widest,winged,woody,ympodial,young	1/3,3-15,abaxial,adaxial,articulation,branching,colour,diameter,form,fruit,growth,hair,height,inflorescence,insertion,length,na,number,odour,paired,plant,position,presence,seed,symmetry,texture,type
177	wfo-0001027847	success	219	80	64	155	16	0.292	-5,/3,0.4-1,0.8-1.2,1-2,1/4,5-25,5-6,5.5-8,acute,anther,apex,base,berry,branched,calyx,cm,connivent,cordate,deltate,dull,elongating,equal,flattened-reniform,flower,fruit,fruiting,lateral,leaf,length,lobed,long,margin,maturity,mauve,mm,narrow-deltate,orange,orange-brown,per,perpendicular,petiole,poricidal,prickle,purple,red,retrorse,rounded,seed,shrub,simple,sometimes,spherical,stellate-pubescent,stem,style,surface,tapering,terminal,tip,upper,way,white,yellow	-0.8,-2,-2.5,-3,-4,-6,.35,.7,/2,0,0-2,0-7,0.1-0.4,0.15-0.2,0.2,0.5,0.5-1,0.8,0.8-0.9,1,1-2.5,1.5-2,1.5-2.5,1.5-5,1.9-2.3,1/2,1/6-1/3,2-2.8,2-3,2-4,2-5,2.2-3,2.5-3.5,2/,3-15,3-5,3-6,3.5-6,4-5-merous,6-11,6-8,7-10,abaxially,almost,alyx,ame,apar,apart,apically,apparently,articulated,bark,blade,broadly,brow,c.,chartaceous,curved,densely,diameter,dimorphic,discolorous,distance,drying,eaf,edge,eed,elliptic,erect,evenly,extending,faint,filament,filiform,filiform-acuminat,finely,flattened,free,geminate,glabrescent,glabrous,gray,green,increasing,infructescence,lobe,lon,longer,lower,mature,middle,midpoint,midvein,minor,moderately,nflorescence,older,one,open,orbicular,orolla,oung,ovate,pair,pedicel,peduncle,pendulous,perfec,pericarp,pit,pitted,plurifoliat,porrect,portion,prickl,prickly,primary,ray,red-brown,reddish,ruit,scandent,scar,sessile,side,size,slender,smooth,spaced,sparsely,spreading,stalk,stalked,stellate,straight,strongly,tamen,terete,tertiary,time,toward,trichome,tube,unarmed,unit,usually,variously,vary,vein,venation,visible,weakly,wide,ympodial,young	branching,colour,corolla,form,growth,heteromorphism,inflorescence,number,orientation,ovary,placement,position,shape,staman,texture,type
178	wfo-0001027872	success	190	165	128	62	37	0.674	1,1-4,1-8,10,12-35,15,2,2-3,2.2-3.5,20,35,4-6,5-7,5-8,5-lobed,6-20,8-11,abaxially,acuminate,acute,adaxially,angular,apex,apical,apically,articulate,b,base,branched,ca,calyx,celled,clasping,cm,commonly,connate,cordate,cuneate,cyme,decreasing,deep,dehiscent,densely,diameter,dichasial,dichasially,distal,elliptic,filament,flower,forked,four-celled,generally,glabrescent,gland,glandular,glandular-pubescent,globose,gray-green,green,hair-like,half,herbaceous,homogeneously,interjected,introrse,lanceolate,lateral,leaflet,light,longer,maturing,middle,mm,moderately,monochasial,mottled,mucilaginous,narrowly,nearly,obliquely,odd-pinnate,often,ovate,ovoid,pair,pedicel,peduncle,perennial,petiolule,plant,poricidally,puberulent,pubescent,purple,rarely,rhizomatous,rhizome,rotate,rounded,seed,semi-lunate,shape,short,single,size,slightly,slit,sometimes,somewhat,stigma,straight,style,subequal,symmetrically,terete,terminal,tinged,tip,type,typically,unbranched,unit,usually,wall,wider,yellow,yellowish-green	0.5,1-1.2,1.0-1.3,1.5-4,2.8,3-6-foliat,5-10,acumen,apiculate,ba,basal,becoming,caudate,cell,covering,digestion,eaf,ebracteate,eed,emoval,enzyme,erect,exceeding,externally,globo,green-white,honeycomb,living,lobe,lon,long,lower,make,nflorescence,nther,oblong,orolla,pattern,pentagonal,perfect,petiolate,petiolulate,purpl,reduced,reveal,rotate-,ruit,sessile,seudostipule,specimen,stamen,ste,tem,testal,thick,trailing,uniformly,vary,viole,wid,wide,ympodial	3-6-foliate,anther,arrangement,articulation,bract,branching,colour,connation,corolla,dehiscence,ebbrate,forkednes,form,fruit,glandularity,growth,height,inflorescence,leaf,length,mottling,number,ovary,petiole,position,presence,present,property,pseudostipule,pubescence,rotate-pentagonal,stem,structure,sympodial,texture,violet,width
179	wfo-0001027880	success	185	107	92	93	15	0.497	.25,0.3-3,0.5-5,0.6-1,0.6-1.5,0.8-1.5,1-14,1-15,1-3,1.5-2,1.5-3,10-15,2-3,2-80,4-10,4-6,abaxially,adaxially,along,anther,blade,calyx,chartaceous,clavate,cm,conical,coriaceous,densely,diameter,discolorous,entire,extra-axillary,flower,fruit,glabrous,globose,green,greenish,hair,inflorescence,leaf,leaf-opposed,longer,longitudinal,lower,margin,midvein,minutely,mm,multicellular,nearly,node,oblong,oblong-ovate,occasionally,ovate,ovoid,pale,papillose,pedicel,peduncle,petiole,pink,pore,pubescent,purple,rachi,red-brown,reddish,revolute,ripe,rooting,rounded,rugulose,shrub,simple,size,slit,somewhat,sparsely,stellate,stigma,style,surface,tan,truncate,unbranched,undulate,uniseriate,vine,white,x	-3,-3.5,0.5-1.5,1-2,1-2.5,2/,3-4,5-11,5-8,5-merou,8,absen,accrescen,acuminate,acute,ag,aggregate,alyx,apart,apex,apiculate,apparently,articulated,axe,ba,base,branch,branching,cell,ciliat,connivent,contiguously,cordate,curled,cylindrical,deltate,dense,diminishing,directed,distally,distichous,distinct,distinctly,eaf,eed,epiphytic,equal,filament,flattened,fruiting,geminat,growing,increasing,internode,line,lobe,long,nflorescence,oblique,often,opening,orolla,pair,perfect,plurifoliate,point,pubescen,ruit,scar,secondary,slender,slightly,sometimes,spaced,ste,stone,tamen,tem,thickened,time,tip,trailing,tree,trunk,tube,typically,unit,usually,vary,vein,wide,yellow,ympodial	2/3,age,arrangement,colour,corolla,form,growth,length,number,ovary,seed,shape,staman,stem,texture
180	wfo-0001027880	success	170	89	72	98	17	0.424	0.2-0.5,0.5,0.6â1.5,0.8â1.5,1.5â2,1.5â3,10â15,1â14,1â15,1â2,2-80,2â3,4â10,5â8,absent,acute,anther,apex,apiculate,arrangement,base,bluish-purple,calyx,chartaceous,cm,conical,cordate,coriaceous,densely,diameter,distichous,entire,extra-axillary,flower,fruit,glabrous,globose,greenish,hair,leaf,leaf-opposed,margin,membranous,midvein,mm,nearly,oblique,oblong-ovate,ovate,ovoid,pedicel,peduncle,petiole,pink,pubescent,rachi,red,reddish-brown,rounded,rugulose,slender,sparsely,stellate,surface,truncate,unbranched,undulate,vine,white,woody,x,â3.5	.25,0.3â3,0.5â1.5,0.5â5,0.6â1,1â2.5,1â3,2/3,3â4,4â6,5-merous,5â11,8,abaxially,accrescen,acuminate,adaxially,along,alyx,apar,axe,berry,blade,c.,capitat,ciliat,clavate,climbing,contiguously,curled,cylindrical,deltate,dense,discolored,distinct,distinctly,eaf,eed,filament,flattened,fruiting,green,lanceolate,line,lobe,long,longer,lower,m.,minutely,mottled,nflorescence,nternode,occasionally,often,orolla,pair,pale,papillose,perfec,pinnate,plurifoliat,reddish,revolute,rip,ruit,sand-punctat,sand-punctate,scar,secondary,shrubby,simple,slightly,sometimes,somewhat,spaced,ste,stigma,style,tamen,tan,tem,thickened,time,tip,tree,trichome,trunk,tube,typically,uniseriate,unit,vary,vegetatio,vein,venation,wide,ympodial	0.5-1.5,branching,colour,corolla,form,growth,inflorescence,internode,length,number,position,seed,shape,staman,stem,symmetry,texture
181	wfo-0001027881	success	215	109	75	140	34	0.349	-3,5-merous,abundant,acute,anther,apex,articulated,attenuate,base,berry,blackish,camptodromous,chartaceous,ciliate,cm,connivent,cordate,cordiform,cylindrical,decurrent,densely,diameter,eglandular,entire,extra-axillary,filament,flattened,flower,fruit,glabrous,glandular,globose,greenish,groove,hair,herb,immature,interpetalar,introrsely,lateral,leaf,light-brown,margin,membranaceous,mm,moderately,ovate-elliptic,parallel,pedicel,per,petiole,pore,projection,pubescence,pubescent,raised,reniform,rotate,seed,simple,slightly,sparsely,staman,stem,stigma,style,subapically,subopposite,surface,tissue,translucent,unbranched,venation,white,yellow	.3â0.5,0.5â2.2,0.8â1.5,1-celled,1.3â2,1.8â2.9,10â25,1â2,1â2-celled,1â2.5,1â2.6,1â3,1â3-celled,1â4,2.5â3.6,20â40,2â4,2â6,2â7,4â6,4â9.5,5,6â10,7â14,7â9,8,abaxially,absent,accrescent,acuminate,adaxiall,adaxially,almost,alyx,appressed,asymmetric,axe,ba,barely,blade,bulge,calyx,capitat,case,central,closely,commonly,connected,contiguous,curved,dehiscing,denser,difoliate,directed,dorsally,drying,eaf,ed,emarginate,emerging,equal,erect,exceeding,exclusively,explosively,eye,few-,fewer,forming,frequent,geminate,giving,half,held,hollow,impression,larger,less,like,lobe,long,longer,longitudinal,lower,mainly,many-branched,maturit,maturity,mesocarp,mixed,much,multicelled,multicellular,naked,near,netlike,nflorescence,normally,one,opening,orolla,other,pair,part,peduncle,perfec,placenta,pressure,primary,prominent,rachi,ruit,secondary,sessile,short,side,similar,size,slit,small,smaller,solitary,sometimes,stalk,stamen,tal,tamen,tem,triangular,tube,two,unit,vary,vein,visible,watery,winged,woody,ympodial,Ã	0.3-0.5,0.5-2.2,1-2,1-2.5,1-3,10-25,20-40,4-9.5,6-10,7-14,7-9,arrangement,articulation,branching,capitate,colour,corolla,decurrency,dried,form,glabrousnes,growth,height,inflorescence,length,mature,merosity,number,ovary,plant,position,shape,texture,type
182	wfo-0001027882	success	184	141	123	61	18	0.668	.25,.5,0.5-1,1-1.5,1.5-2,1.5-2.2,1.5-6,10-40,2-3,2-6,2-lobed,2.1-2.6,2.5-3,3-4,3.5-4,3.5-5,4-5,6-9,9-13,acuminate,age,anther,apart,apex,apparently,appearing,attenuate,bark,base,berry,branch,branched,branching,broadly,brown,c.,calyx,clavate,cm,completely,conical,corolla,cucullate,dark,deltate,densely,diameter,elliptic,entire,erect,exerted,filament,flattened,flower,fork,fruiting,fusiform,glabrous,globose,green,growth,hairy,hooked,inflorescence,irregularly,leaf-opposed,lengthening,less,lobe,lobed,margin,maturity,minutely,mm,new,occasionally,ovary,ovoid,pair,pale,papillate,pedicel,perfect,petiole,pitted,plane,pointed,pore,poricidal,primary,pulp,rachi,reddish,reniform,scar,shiny,shrub,simple,slit,small,sometimes,spaced,sparse,sparsely,stem,sticky,stigma,straight,strongly,style,surface,sweet-scented,time,tip,tree,trichome,tube,uniseriate,vein,way,white,x,yellow	0.1,06a,1,1-5,1.5-,1.6-2.2,10-25,3.2-6,7-,abaxially,absent,adaxially,along,anthesi,axil,caly,dense,difoliate,dry,drying,eaf,eed,et,fide,free,geminat,glabrou,hollow,junction,kallunki,lamina,lower,markedly,midrib,nflorescence,nodding,papillat,paulo,peduncle,penden,planar,population,portion,rarely,red-papillat,ruit,shattering,slender,specimen,stout,structurally,swollen,sÃ£o,thickened,tuft,ud,unit,usually,woody,yellowish,ympodial	abaxial,adaxial,bud,colour,form,fruit,leaf,length,number,position,red-papillate,scent,seed,shape,size,texture,type,width
183	wfo-0001027889	success	151	138	111	40	27	0.735	-2.5,-pubescent,.5,0,0.5-1,0.5-11,0.7-2,1,1-3,1-3.5,1.5,10-12,10-20,10-30,2-3,3-4,3-8,3-9,5-10,abaxially,acuminate,acute,acute-acuminate,adaxially,aggregate,apart,apex,basal,base,beyond,cell,chartaceous,cm,connective,connivent,cylindrical,darker,densely,diameter,dilated,directed,distally,eglandular-puberulent,eglandular-pubescent,elliptic,entire,equal,exceeding,extending,finely,flower,fruit,glabrous,glandular-,green,greenish,immature,introrse,laterally,leaving,length,light,lobe,long,longitudinal,margin,mm,moderately,narrow,oblong,ovate,ovoid,pedicel,pedicellar,peduncle,petiole,pore,present,probably,puberulent,puberulent-pubescent,rachi,radiu,remnant,ripe,shrub,simple,slightly,somewhat,sparsely,stamen,stellate,stigma,stone,stripe,style,subcordate,subcoriaceous,swelling,thecae,tomentose,tree,triangular,truncate,tube,unbranched,unknown,violet,white,x,yellowish	.5-2,1-10,1.5-2,2-20,4-foliat,ape,apiculate,articulated,axe,blade,calyx,capitat,color,deltate,eaf,eed,exserted,lon,lower,nflorescence,nther,orolla,perfect,presen,puberulen,puberulent-pubescen,ruit,small,spaced,tal,tem,time,tip,tomento,ud,unit,vary,wide,yello,ympodial	abaxial,adaxial,anther,articulation,branching,bud,capitate,colour,corolla,exsertion,form,growth,hair,height,inflorescence,leaf,na,ovary,plant,seed,shape,spacing,stem,texture,theca,type,yellow
184	wfo-0001027901	success	156	97	80	76	17	0.513	.5,0.5-1,0.8-1,0.8-2,0.9-2.3,1-1.5,1-2.5,1.5-1.8,1.8-4.5,2.5-3,3-5,4-5,4.7-12,abaxially,acuminate,acute,adaxially,anther,anthesi,apex,area,attenuate,base,bright,broadened,brown,cm,corolla,dark,direction,dry,elliptic,filament,fresh,fruiting,glabrous,globose,green,immature,inflorescence,leaf,lobed,major,material,minor,minutely,mm,nearly,opposite,orbicular,oriented,ovary,ovoid-reniform,papillose,pedicel,pitted,pore,pubescent,ripe,rounded,shape,shaped,shiny,shrub,simple,single,size,stigma,style,surface,swollen,tear-drop,translucent,trichome,tube,uniseriate,usually,white,x,yellow	.25,0.3-1.2,1-2,4-10-flowered,6-7,?,abaxial,ba,bark,beneath,berry,brow,calyx,closely,conical,curled,deflexed,densely,dia,differing,difoliate,drying,eaf,edicel,eed,ellipsoid,exserted,firm,fleshy,free,geminat,imbedded,keeled,later,lateral,like,lobe,lon,long,lower,main,matrix,middle,midrib,nflorescence,older,overlappin,pair,papillo,petiole,planar,poricidal,portion,prominently,reddish,reflexed,rest,ruit,scar,slender,spaced,sparsely,stem,straight,strongly,tall,tip,triangular,tub,ud,unit,vein,widest,woody,ympodial,young	0.25,0.5,1,2,colour,diameter,form,fruit,growth,height,length,orientation,plant,position,seed,texture,type
185	wfo-0001027902	invalid_json	128	113	82	46	31	0.641	-2.5,0.5-1,1-1.5,1-2,1-6,10-20,15-30,2-12,2-15,2-8,2-9,20-50,3-4,3-5,4-25,4-5,5-20,6-37,7-9,abaxially,acute,adaxially,angled,apart,apex,base,branched,chartaceous,cm,cordate,cylindrical,deeply,densely,diameter,distally,eglandular,entire,flower,forked,fruit,glabrous,glandular,globose,hair,lobe,long,margin,mm,moderately,narrowly,nearly,obtuse,ovate,pedicel,peduncle,petiole,pore,puberulent,pubescent,purple,purplish,rachi,remnant,reticulate,shrub,simple,small,sparsely,stellate,stigma,style,subcoriaceous,tree,triangular,truncate,tube,unbranched,unknown,usually,whitish,x,yellow	1.5-3,10-15,2,2-3,3-foliat,8-13,absen,acuminate,adaxiall,aggregate,articulated,axe,blade,calyx,cell,color,connivent,directed,distall,eaf,eed,inflated,leaving,like,lon,lower,nflorescence,nther,orolla,pedicellar,pubescen,radiu,ripe,ruit,spaced,ste,stone,tal,tem,time,tip,truncat,unit,vary,wide,ympodial	'',[,``,abaxial,adaxial,anther,articulation,axi,branching,characteristic,colour,corolla,direction,form,growth,height,inflorescence,leaf,length,ovary,plant,seed,shape,size,spacing,stem,texture,type,value,{,}
186	wfo-0001027929	success	193	136	111	82	25	0.575	1,1-10,1-4,1-8,1.0-1.3,10,2,2-3,2.0-3.0,20,3.5-5,35,4-30,4-5,4-6,5-6,5-lobed,6-15,acuminate,acute,along,angular,apex,apical,apically,articulate,base,branched,calyx,cell,cm,coat,connate,cordate,corolla,covering,cuneate,cyme,deep,dehiscent,diameter,dichasial,dichasially,distal,elliptic,except,filament,flower,forked,generally,glabrous,globose,green,hair,hair-like,half,herbaceous,interjected,introrse,lanceolate,lateral,leaflet,make,maturing,middle,mm,monochasial,mostly,mucilaginous,narrowly,nearly,obliquely,occasional,odd-pinnate,often,ovate,ovoid,pair,pedicel,peduncle,perennial,perfect,petiolule,plant,poricidally,puberulent,purple,rhizomatous,rhizome,rotate,rounded,seed,shape,short,size,slightly,slit,sometimes,style,symmetrically,terete,terminal,testal,thick,tinged,unbranched,vein,violet,violet-blue,wall,wider	0.2-0.9,1.5-4,15,3-6-foliat,5-10,abaxially,acumen,adaxially,apiculate,ba,basal,becoming,beyond,caudate,cente,center,clasping,color,dark,darker-violet-blue,decreasing,digestion,eaf,ebracteate,eed,embryo,emoval,enzyme,erect,exceeding,formed,globo,green-white,honeycomb,included,light,living,lobe,lon,long,lower,nflorescence,nther,oblong,orolla,pattern,pentagonal,petiolate,petiolulate,purpl,radiating,rarely,reduced,reveal,rotate-,ruit,semi-lunate,sessile,seudostipule,somewhat,specimen,spot,stamen,star,ste,stigma,straight,subequal,tem,tip,trailing,typically,unit,usually,vary,visible,white,wid,wide,without,yellow,ympodial	anther,arrangement,articulation,branching,colour,connective,form,fruit,growth,height,inflorescence,leaf,length,number,ovary,petiole,pore,position,present,rotate-pentagonal,stem,texture,type,wet,width
187	wfo-0001027948	success	186	139	121	65	18	0.651	-15,-16,-6,.5,0.5-0.7,0.5-2,0.8-,1-1.2,1-2,1.2-2.2,1.3-1.8,1.5-4.5,10-14,13,14,2-,2.2-,2.5-,3-8.2,3.2-5.2,3.7-4,5-,6-celled,7,7-15,7.5-10,8-celled,abundant,acuminate,aggregate,anther,apex,articulate,attenuate,basal,base,berry,branch,calyx,campanulate,cell,cm,connectival,corolla,delicate,diameter,directed,dorsally,edentate,ellipsoidal,elliptical,filament,finely,flexuous,fragrance,glabrous,glandular,globose,head,herb,herbaceous,hollow,ill-smelling,leaf,length,light,lobe,long,longer,longitudinal,longitudinally,margin,mm,narrow,narrowly,non-glandular,occasionally,opening,ovate,ovoid,pair,papillate,patent,pericarp,petiole,pore,poricidal,prolongation,pubescent,purple,ridged,serrulate,shorter,simple,single-celled,slightly,slit,small,spur-like,stalk,stem,stigma,stone,straight,striate,style,sub-shrub,thickened,tip,tooth,triangular,trichome,tube,unequal,upward,verrucate,violet,viscid-pubescent,x,Â¼,Â½	0-,0.4,0.6,1.6,1/10,3.5,5,abaxially,accrescen,adaxially,ag,antrorse,ape,ature,bicellular,c.,crushed,cuticle,dark,diamete,difoliate,eaf,erect,free,fruiting,generally,hig,inconspicuous,inserted,lamina,long-stalked,lower,many-,midvein,near,odorles,orolla,portion,pubescence,reduced,ree,ruit,saddle-shape,scarce,scarcely,secondary,seed,seeded,seen,separated,short-stalked,sinus,smooth,solitary,striat,sub-opposite,tem,thecae,time,twice,unit,vary,vein,ventrifixed,ympodial	age,arrangement,colour,edentation,form,fruit,growth,height,modification,odour,ovary,plant,ridging,saddle-shaped,shape,size,texture,type
188	wfo-0001027961	success	177	125	102	75	23	0.576	.5,0.25,0.25-0.5,0.5-1,0.9-1,1-1.5,1-5,2-2.5,3-3.5,4.5-5,8-10,<,?,abaxially,acute,always,anther,apex,articulated,asymmetric,base,berry,branched,c.,clavate,cm,cordate,corolla,curling,densely,diameter,ellipsoid,elliptic,entire,fading,filament,flower,fruiting,fusiform,glabrous,globose,green,growth,immature,inflorescence,irregularly,lateral,lobed,long,lower,many,margin,mature,membranous,midrib,mm,new,obovate,observed,occasionally,often,one,other,pedicel,peduncle,perfect,petiole,pinnatifid,pore,poricidal,present,pubescent,purple,reddish,rotate-stellate,scar,simple,sleeve,slightly,small,spaced,sparsely,stem,stigma,style,surface,terminal,time,tip,triangular,trichome,truncate,twining,uniseriate,upper,vine,violet,way,white,white-pubescent,woody,x	1,1-3,1-4,1-9,10-50,2.3-2.5,2.5-9,5-8,5-merou,6-9,7-9,adaxiall,adaxially,age,alyx,anthesi,apar,ark,axil,broadly,brow,calyx,clear,conical,connivent,deltate,distributed,eaf,early,eed,equalling,exserted,free,geminat,ilament,lamina,lengthening,lobe,lon,loosely,maturity,minute,minutely,nflorescence,older,orolla,pair,papillo,pendan,pericarp,pinched,planar,plurifoliate,portion,primary,probably,pubescen,ruit,shiny,slender,slit,spreading,tem,thin,transition,tube,tuft,twinin,ud,unequal,unit,vary,vein,yellow,ympodial	5-merous,apart,arrangement,articulation,bark,branching,brown,bud,colour,form,fruit,hair,leaf,length,ovary,pendant,position,presence,seed,shape,symmetry,texture,type
189	wfo-0001027966	success	207	143	119	88	24	0.575	0.4-0.5,0.7-3,0.8,1-1.8,1-10,1-2,1-3,1-4.2,1-5,1.2-4.5,1.3-2.2,10,10-30,2.2-2.9,2.5-10.5,2.8-9,3-4,3-5,3-7,4,40-80,5-10,5-6,5-9.5,5.5-14,6-11,abaxially,absent,acumen,acuminate,adaxially,anther,apex,attenuate,base,berry,blade,blue-violet,brownish,cell,chartaceous,cm,condition,conical,corolla,decreasing,densely,diameter,digestion,dorsally,drying,edge,enzyme,filament,flat,flower,folded,forked,fresh,fruit,glabrous,gradually,green,greenish,hair,herb,homostylous,honeycomb-shaped,interjected,lanceolate,lateral,leaf,leaflet,lengthening,less,light,lobe,medium,membranous,middle,minute,mm,moniliform,mottled,odd-pinnate,ovate,ovoid,pedicel,peduncle,pentagonal,petiole,plant,pore,poricidal,proximal,pubescent,purple,rarely,removed,ripe,rotate,seed,size,slit,somewhat,sparsely,stem,stigma,subequal,terminal,testal,tip,tube,tuber,usually,wall,whitish,wing,x	0.8-2.5,1.5-3,1.5-5.2,5-merou,ag,along,alyx,apart,apparently,arranged,articulated,asymmetrical,axe,axillary,basiscopic,bead,bud,capitat,ciliate,commonly,connivent,covering,distal,eaf,eed,elliptic,erec,especially,exceeding,geminat,generally,glabrou,green-white,hair-like,half,larger,like,living,long,lower,make,margin,mucilaginous,multiple,narrow,necklace,nflorescence,orbicular,orolla,pair,pale,perfect,petiolule,plurifoliate,ray,ruit,secondary,semierect,sessile,seudostipule,shorter,side,slightly,spaced,specimen,stamen,ste,stolon,straight,subsessile,subtending,symmetrical,tall,tamen,tem,thick,throughout,tissue,tri-,tyle,typically,unit,violet,wet,white,wide,yellow,ympodial	abaxial,adaxial,age,arrangement,articulation,branching,calyx,capitate,colour,density,form,growth,height,inflorescence,length,number,pseudostipule,shape,spacing,staman,style,texture,width,Â¼
190	wfo-0001028014	success	222	87	73	149	14	0.329	-1/2,-15,-2.5,/5,0.2-1.6,0.25,1/4,2-20,4.5-7,almost,anther,apex,base,berry,black,branched,calyx,cell,cm,connivent,cordate,curved,diameter,elongating,equal,flattened,flattened-reniform,flower,fruit,fruiting,lateral,leaf,length,lobed,long,lower,margin,mature,maturity,mauve,mm,obtuse,occasionally,orange,outline,per,petiole,pit,poricidal,prickle,purple,raised,red,reflexed,rough,rounded,seed,shiny,shrub,simple,spherical,spreading,stellate-pubescent,stem,straight,strongly,surface,tapering,terminal,tip,visibly,way,weakly	-0.5,-1,-10,-3,-4,-5,-6,.5,0,0.1-0.2,0.15,0.15-0.3,0.2,0.2-0.4,0.2-1,0.3-0.4,0.5,0.5-1,0.5-1.5,0.5-2,0.5-3,0.6-0.9,0.7-1,0.7-1.6,0.9-1.2,1-,1-10,1-2,1-3,1-4,1.3-2.4,1.5,1.5-2,1.8-3,1/4-2/3,2,2-3,2-4.5,2-6.5,2.5-4,3-10,4-10,5-merous,6-10,6-11,abaxially,acuminat,alyx,ame,apar,apart,apically,apparently,around,articulated,bark,blade,broad-deltate,brown,brown-green,c.,chartaceous,concolorous,decurrent,deltate,densely,difoliate,discolorous,distance,drying,eaf,edge,eed,erect,extending,eye,filament,free,geminat,glabrescent,glabrou,glabrous,gland,globular,gray,gray-green,herbaceous,infructescence,lobe,lon,longer,membranous,midpoint,midvein,moderately,naked,nflorescence,older,one,open,orange-gra,orolla,oung,outer,ovate,pair,pale,pedicel,peduncle,pendulous,perfec,pericarp,porrect,portion,prickl,prickly,primary,ray,reduced,ruit,scandent,scar,sessile,shorter,side,slender,smooth,sometimes,spaced,stalk,stalked,stellate,style,tamen,terete,tertiary,time,trichome,tube,unit,vary,vein,venation,visible,wide,winged,yellow,yellow-green,ympodial	branching,colour,corolla,form,growth,heteromorphism,inflorescence,number,orientation,placement,position,shape,staman,type
191	wfo-0001028017	success	158	130	103	55	27	0.652	-2.5,0.3-1,1-10,1-2,1-3,1.5-2,15-35,2,2-3,2-4,2.5-5,3,3-12,3-14,3-4,40-50,5-7,5-9,6-7,6-8,acuminate,acute,apex,apiculate,base,beyond,brown,calyx,chartaceous,clavate,cm,connective,cream,cuneate,cylindrical,densely,diameter,directed,distally,eglandular,eglandular-puberulent,eglandular-pubescent,ellipsoidal,elliptic,entire,flattened,fleshy,flower,forked,fruit,fusiform,glabrous,glandular,glandular-,glandular-puberulent,green,greenish,hair,immature,introrse,lanceolate,leaving,lobe,long,margin,mm,moderately,narrowly,near,oblique,obtuse,ovate,ovoid,pedicel,pedicellar,peduncle,petiole,pore,pubescent,purple,rachi,radiu,rarely,remnant,ripe,short-acuminate,simple,sometimes,sparsely,stamen,stellate,stellate-campanulate,stigma,style,subcoriaceous,tan,tip,tree,truncate,unbranched,white,x,yellow	1,10-22,13-40,15-50-flower,3-foliat,5,9-11,abaxially,absen,absent,adaxially,aggregate,apart,ape,articulated,axe,basal,blade,cell,ciliat,connivent,eaf,eed,exceeding,exserted,lon,lower,nflorescence,nther,orolla,perfect,pointed,puberulen,purplish,ruit,shorter,slightly,small,spaced,stone,tal,tem,thecae,time,tomentose,triangular,truncat,tube,ud,unit,vary,vein,wide,without,ympodial	15-50,abaxial,adaxial,anther,articulation,branching,bud,colour,corolla,exsertion,form,growth,height,inflorescence,leaf,length,ovary,plant,puberulent,seed,shape,size,spacing,stem,texture,theca,type
192	wfo-0001028033	success	157	107	84	73	23	0.535	1.4â1.8,2â4,3â4,3â5,4â12,4â5,50,6â12,abaxially,anther,attenuate,base,brochidodromous,brown,calyx,chartaceous,ciliate,cm,connivent,cylindrical,cyme,darker,decurrent,densely,diameter,discolorous,drying,elliptic,entire,few-branched,filament,flower,fruit,glabrescent,glabrous,green,greenish,growth,herb,hispid-pubescent,introrsely,known,lateral,length,light,like,lobe,long,longitudinal,margin,membranaceous,mm,new,oblong,opening,pedicel,perfect,petiole,pore,pubescence,pubescent,rhizomatous,shiny,shrub,simple,slightly,slit,solitary,sparsely,spreading,stellate,stem,stigma,straight,style,surface,trichome,unbranched,uniseriate,upright,venation,white,wide,woody	.6,1.5,1â4,1â5,2â3,2âfoliate,3,3â11,5-merou,5â7,acuminate,acute,adaxiall,adaxially,along,alyx,anthesi,apex,ark,ascending,becoming,blade,branch,capitat,cell,contiguou,cordate,deeply,denser,directed,eaf,eed,emarginate,equal,eye,florescence,geminat,high,know,linear-lanceolate,lobed,lower,mainly,midrib,naked,nearly,older,onto,order,orolla,ovate-lanceolate,poricidal,prominent,prostrat,recurved,ruit,secondary,sessile,shin,shorter,strongly,subapical,tamen,tem,tube,unit,unknown,vary,vein,visible,yellow,ympodial,Ã	5-merous,arrangement,bark,branching,capitate,colour,corolla,form,hair,height,inflorescence,leaf,ovary,pattern,plant,position,rhizome,seed,shape,staman,texture,type,ye
193	wfo-0001028067	success	139	89	67	72	22	0.482	-30,0.5-1,0.5-1.5,0.5-2,1-10,1-11,1-7,1.5-2.5,10-25,2,2-2.5,2.5-3,3-17,3-5,3-7,5-7,6-18,7-11-compound,7-20,7-9,acuminate,acute,apex,base,blade,calyx,cm,cuneate,cylindrical,dark,diameter,elliptic-fusiform,elliptic-ovate,entire,flattened,fruit,glabrous,hair,leaf,lobe,margin,mm,narrowly,pedicel,peduncle,petiole,pink,pinnately,pore,purple,rachi,radiu,shrub,simple,slightly,stellate,stigma,strongly,style,subcoriaceous,tomentulose,triangular,triangular-deltate,truncate,unbranched,x,yellow	1,1-2,1-3,2-3,3-4,4-foliat,6-12,8-13,abaxially,adaxiall,adaxially,aggregate,along,apart,articulated,axe,basiscopically,cell,chartaceous,color,compound,connivent,decurrent,directed,distall,eaf,eed,especially,flower,glabrou,lateral,leaflet,leaving,lon,long,lower,midrib,moderately,nearly,nflorescence,nther,obtuse,often,orolla,pedicellar,per,puberulen,puberulent,rarely,remnant,ripe,ruit,several,smal,spaced,sparsely,stone,tal,tem,time,tip,truncat,tube,unequal,unit,unknown,upper,usually,vary,wide,ympodial,zigzag	anther,articulation,branching,colour,corolla,direction,distally,form,growth,height,inflorescence,length,ovary,plant,seed,shape,size,spacing,stem,texture,type,width
194	wfo-0001028069	success	253	115	96	157	19	0.379	-0.4,0.1-0.2,0.3-0.4,0.3-0.45,0.3-0.7,0.4-0.5,0.4-0.8,0.5,0.5-0.7,0.5-1.8,0.5-2,0.7-1,0.7-1.3,0.7-1.5,0.8-1.2,1-2.7,1-3.5,1.4,1.5-2.0,10,10-12,12,2-17,2-3-branched,2-locular,3,5-25,acute,anther,apex,apical,appendage,base,bright,brown,calyx,cm,column,conical,corolla,decurrent,deep,deeply,densely,diameter,eglandular,filament,flower,fruit,fruiting,glabrescent,glandular,glandular-villous,globose,green,hair-like,herb,imparipinnate,interrupted,leaf,leaflet,length,lobe,lobed,margin,minute,minutely,mm,oblique,obovate,occasionally,orange,outgrowth,ovary,ovate,pale,patent,pedicel,peduncle,pentagonal,perennial,plant,pubescent,rounded,simple,size,staminal,stem,sterile,stigma,style,trichome,tube,uniseriate,weak,yellow	-30,-6,.1,.1-0.2,.2,.5,0.05-0.1,0.1-0.15,0.1-0.3,0.1-0.5,0.1-0.6,0.2-0.3,0.2-0.5,0.3,0.3-0.6,0.3-1,0.4,0.4-1,0.6-1.1,0.6-4,1-2-celled,1-4.5,1.5-3.5,1.6-3.2,10-30,2-4,2-7,3-,3-foliate,4-celled,5-22,6-,<,abaxially,absen,abundant,accrescent,adjacent,adpressed,along,alternate,always,among,anthesi,appearance,appressed,articulated,axi,ba,basal,basioscopically,becoming,berry,bilaterally,bract,bracteole-like,cell,citru,composed,cone-shaped,cordate,cuneate,curving,dense,due,eaf,ebracteate,edicel,eed,erect,exserted,forming,fusion,giving,gland,gland-tippe,gland-tipped,gree,half,halfway,head,included,initially,interjected,internode,larger,later,lateral,less,like,lime,linear,lon,long,longer,longest,lower,maturity,middl,midvein,multicellular,narrowly,nflorescence,often,one,pair,per,petiole,petiolule,population,present,primary,procumbent,pseudostipule,pubescence,quaternary,rarely,reflexed,robust,ruit,scarcely,scent,secondary,sessile,several,shaggy,short,shorter,silky,single-celled,slender,smaller,somewhat,straight,strong,subopposite,surface,symmetric,tangled,tem,terminal,tertiary,testa,thick,tightly,toward,transparent,ud,unicellular,unit,usually,varying,viny,wall,wide,winged,ympodial	0.1,arrangement,articulation,branching,bud,colour,form,growth,height,history,inflorescence,life,middle,seed,shape,texture,thicknes,type,width
195	wfo-0001028075	success	196	106	85	111	21	0.434	1.5-2.5,1.5-7,1.6-2.7,10-35,2-4.5,2-6,2.5-10,3-11,3-23.5,5-12,5-14,5-17,5-7,5-9,7-13,7-30,8-12,abaxially,adaxially,anther,blade,brownish,cell,chartaceous,ciliate,cm,condition,corolla,covering,dark,diameter,drying,edge,filament,flat,flower,forked,fresh,fruit,glabrescent,glabrous,globose,green,greenish,hair-like,herb,homostylous,lanceolate,lateral,leaf,leaflet,light,long,margin,membranous,minutely,mm,odd-pinnate,ovoid,pale,pedicel,peduncle,pentagonal,petiole,plant,pore,poricidal,puberulent,rotate,seed,size,slightly,stigma,straight,style,terminal,testal,thick,tip,tuber,wall,white,whitish,wide,x	.5,1-10,1-2,1-2.7,1-3,2-3,4-12,4-7,5-8,5-merou,absent,acuman,acumen,acuminate,acute,ag,along,alyx,apart,apex,apparently,articulated,axe,axillary,base,berry,borne,broadly,bud,capitat,connivent,cuneate,decreasing,differentiated,digestion,distal,distally,distinctively,dorsally,dot,eaf,eed,elliptic-lanceolate,end,enzyme,erec,especially,exceeding,folded,geminat,generally,glabrescen,green-white,half,honeycomb-shaped,interjected,larger,lengthening,ligulate,living,lobe,lower,make,middl,midrib,much,mucilaginous,narrow,nflorescence,oblique,obtuse,often,orolla,ovate,ovate-elliptic,pair,perfect,petiolule,plurifoliate,purple,reflexed,removed,rounded,ruit,scattered,seudostipule,singly,slit,sometimes,spaced,specimen,stamen,star,stolo,subcordate,subtending,tall,tamen,tem,throughout,toward,tri-,tube,typically,unit,usually,vary,wet,wing,yellow,ympodial	arrangement,articulation,branching,capitate,colour,form,growth,hair,height,inflorescence,length,middle,number,ovary,presence,present,pseudostipule,shape,stem,symmetry,texture
196	wfo-0001028076	success	195	147	122	73	25	0.626	.5,0.4-0.5,0.5,1-1.3,1-10,1-2,1.8-2.2,110,12-22,13-14,2-12,2-3,2-5.4,2.2-2.6,2.2-3.7,2.5-4,4-5,4.5-7,5,5-20,5-6,5-6.5,7-8,abaxially,adaxially,anther,apart,attenuate,axillary,berry,blade,borne,brownish,bud,cell,chartaceous,ciliate,cm,condition,conical,connivent,corolla,densely,diameter,digestion,distal,dorsally,drying,edge,elliptic,end,enzyme,filament,flat,flower,folded,forked,fresh,fruit,generally,glabrous,green,greenish,hair,half,herb,homostylous,honeycomb-shaped,lanceolate,lateral,leaf,leaflet,lengthening,less,light,like,lobe,long,margin,medium,membranous,minute,mm,odd-pinnate,ovate,ovoid,pedicel,peduncle,pentagonal,petiole,plant,pore,poricidal,proximal,pubescent,purple,removed,ripe,rotate,seed,singly,size,slit,stem,stigma,straight,style,subtending,terminal,testal,tip,tube,tuber,typically,unwinged,usually,wall,whitish,wide,wing,x,yellow	1-3,1.2-2.2,2.5-3,2.6-3.8,5-merou,?,absent,acumen,acuminate,ag,alyx,apex,apparently,articulated,axe,base,capitat,covering,decreasing,eaf,eed,erec,especially,exceeding,geminat,glabrou,gradually,green-white,hair-like,interjected,larger,living,lower,make,mucilaginous,nflorescence,obtuse,orolla,pair,perfect,petiolule,plurifoliate,pubescen,rarely,ray,round,ruit,secondary,semierect,sessile,seudostipule,slightly,spaced,specimen,stamen,ste,stolo,subequal,subsessile,symmetrical,tall,tamen,tem,thick,thir,throughout,toward,tri-,unit,vary,wet,white,ympodial	5-merous,age,arrangement,articulation,branching,calyx,capitate,colour,connivence,form,glabrousnes,growth,height,inflorescence,length,merosity,ovary,position,pseudostipule,shape,spacing,stolon,texture,third,width
197	wfo-0001028105	success	150	93	73	77	20	0.487	0.3-1.5,0.5,0.5-1,0.5-2,0.6-1,1-1.2,1-1.5,1-2.5,1.5,1.5-2,1.5-4.5,2,2-2.2,2-5,3.5-4,abaxially,acuminate,acute,adaxially,anther,anthesi,apex,attenuate,base,bilobed,calyx,clavate,cm,conical,corolla,dark,elliptic,filament,flattened-reniform,fruiting,glabrous,glandular,globose,green,incrassate,leaf,lobed,margin,minor,minutely,mm,nearly,opposite,ovary,papillose,pedicel,petiole,pitted,pore,pubescent,reddish-brown,shaped,shrub,simple,size,slightly,small,stigma,style,surface,tear-drop,tip,tree,trichome,tube,uniseriate,white,x	.1,.4,.5,1.5-1.8,3-5-celled,3-6,5-7-flowered,6-7,9.5-15,apar,apical,axi,axil,ba,bark,berry,deflexed,dense,dia,differing,difoliate,distinct,drying,eaf,edicel,eed,ellipsoid,erect,evenly,exserted,filiform,free,geminat,greenish-yello,lamina,lateral,like,lobe,lon,long,lower,main,major,middle,nflorescence,occasionally,older,olive-green,pair,pale,papillo,planar,poricidal,portion,projection,quadrate,reflexed,ruit,scar,scattered,spaced,sparsely,spreading,stem,straight,strongly,tall,tub,tuft,ud,unit,vein,widest,woody,yellowish,ympodial,young	0.1,2.5,3,3.5,branching,colour,diameter,form,fruit,growth,hair,height,inflorescence,length,plant,position,seed,shape,texture,type
198	wfo-0001028109	success	205	119	101	104	18	0.493	-7,0.4-0.8,0.4-1.5,0.45-0.65,0.5-1.2,0.6-0.8,0.8-1.5,0.8-1.6,1.5-2.5,1.5-5.5,10-30,12-40,2-15,2.3-2.9,2.5-3,2.5-5,2/3-3/4,20-60,3-,3-7,30-150,4-13,5-30,abaxial,adaxial,almost,anther,apart,articulated,base,berry,branching,bright,calyx,cm,connivent,deltate,densely,diameter,dull,elliptic,entire,evenly,flattened-reniform,flower,fruit,fruiting,glabrescent,glabrous,gray-green,green,green-brown,lateral,leaf,length,light,lobed,margin,maturity,mauve,mm,moderately,multangulate,one,open,opening,orange-brown,pedicel,peduncle,per,perpendicular,petiole,poricidal,prickle,primary,red,red-brown,reflexed,secondary,shrub,simple,small,sometimes,spherical,stalked,stellate,stellate-pubescent,stem,style,tapering,terminal,time,tip,tree,trichome,unarmed,way,weakly,white,yellow,young	-20,-4,.5,/3,0.05-0.15,0.05-0.2,0.1,0.1-0.2,0.3,0.5-2.5,0.7,1.5-10,1/8-1/4,10-25,15-100,2-4,3.5-6,3/4,4-5-merous,5-13,8-12,8-15,8-25,abaxially,acuminate,acut,acute,alyx,ame,apar,apex,apically,apparently,bark,blade,brow,c.,chartaceous,cuneate,curved,dimorphic,discolorous,drying,eaf,eed,elongating,equal,erect,filament,free,fully,geminate,gently,glabrou,infructescence,lobe,long,long-styled,longer,lower,mature,midpoint,minor,nflorescence,obtuse,occasionally,older,orolla,oung,pair,perfec,pericarp,plurifoliat,porrect,portion,prickl,prickly,ray,recurved,ruit,scar,sessile,slender,smooth,spaced,spreading,stalk,straight,strongly,surface,tamen,terete,tertiary,tube,unarme,unit,usually,vary,vein,venation,visible,wide,woody,ympodial	articulation,colour,corolla,form,growth,hair,inflorescence,number,orientation,ovary,position,seed,shape,spacing,staman,texture,type,width
199	wfo-0001028115	success	165	101	86	79	15	0.521	-1.1,-2.5,-5.2,.6,0.42,0.7-0.8,1-3,1.1-1.8,1.8-3.5,2-3.2,2.5-,3-4.5,4.7-,5-15,5-8.5,6-10,9-17,abaxially,adaxially,annular,anther,apex,articulate,attenuate,base,blue,calyx,campanulate,capitate,cm,coat,curved,diameter,ellipsoidal,elliptical,embryo,entire,evident,filament,fruiting,glabrescent,glabrous,globose,herb,length,light,linear,lobe,long,margin,mm,moderately,narrowly,near,non-glandular,ovate,pale,papery-scarious,petiole,pinnatifid,pinnatipartite,pinnatisect,pore,poricidal,pubescent,rarely,reticulate,seed,simple,slightly,stem,stigma,style,tip,trans-ovoidal,triangular,trichome,tube,tuberculate,uniseriate,venation,violet,wide,wider,x,yellow	.2,0.2-0.3,0.5,0.6-0.7,0.8-,1-2.4,1.3-1.8,1.4-1.7,1.7-2.2,12-13.5,2-,3-5,3-6.5,7-7.5,abundant,accrescent,acuminat,acute,ag,alternate,amply,antrorse,basal,berry,blade,connectival,difoliat,dorsal,eaf,eed,especially,exceeding,glandular,growing,half,herbaceous,hig,inflated,longer,longitudinal,longitudinally,lower,mixed,much,multi-seeded,nerve,oblong,one,opening,opposite,orolla,pair,papillo,portion,prolongation,prostrate,ree,ridged,ruit,scarce,segment,similar,slender,slit,small,smooth,sometimes,strongly,styl,subsessil,tem,time,unequal,unifoliate,unit,vary,width,winged,ympodial	arrangement,colour,corolla,form,fruit,growth,height,leaf,number,ovary,plant,shape,size,texture,type
200	wfo-0001028131	success	208	84	58	150	26	0.279	0.1-0.3,5-6.5,abaxial,absent,adaxial,anther,articulated,attenuate,base,berry,branched,calyx,chartaceous,connivent,densely,dull,erect,filament,flattened-reniform,fruit,fruiting,glabrescent,glabrous,herb,lateral,leaf,length,lobed,lower,margin,marking,mauve,membranous,mm,narrow-obovate,narrow-ovate,orange,orange-brown,pedicel,petiole,poricidal,prickle,prickly,purple,red,reflexed,simple,sparsely,spherical,spreading,stellate,stellate-pubescent,stem,surface,tapering,tip,unarmed,yellow	-1.2,.1,.5,/5,0-0.6,0-2,0-3,0-30,0-4,0.05-0.2,0.1-0.15,0.2-1.5,0.3-0.7,0.4-0.8,0.5-1.1,0.7-1.1,0.8-1,0.8-1.1,1-10,1-3,1-4,1-5,1.5-3,1.5-5,1.8-2,1.8-2.2,1/4-2/3,1/5,2-2.8,2-4,2-5,2-6.5,2/3,3-6,4-6,5-8,5-merous,6-7,7-8,abaxially,acuminat,alyx,apar,apart,apex,apically,apparently,bark,blade,broad-deltate,cell,cm,concolorous,cream,curved,dark,deltate,diameter,difoliate,distance,drying,eaf,eed,elongating,epidermi,equal,extending,eye,filiform,flattened,flower,free,geminat,gland,green,infructescence,lanceolate,lengt,like,lobe,long,longer,mature,maturity,midpoint,midvein,moderately,naked,nflorescence,oblong,obtuse,often,older,one,open,orolla,oung,outline,pair,pale,pale-brown,pale-gra,peduncle,pendulous,per,perfec,pericarp,pit,porrect,portion,prickl,primary,raised,ray,reduced,rounded,ruit,scar,sessil,sessile,shiny,shorter,side,small,smooth,sometimes,spaced,straight,strongly,style,sunk,tamen,terete,tertiary,time,trichome,tube,unarme,unit,upper,vary,vein,venation,visible,way,wide,woody,yellow-green,ympodial,young	appressed,articulation,branching,colour,connective,corolla,form,growth,hair,inflated,inflorescence,insertion,modification,na,odour,orientation,placement,pore,position,seed,shape,spot,symmetry,texture,type,zygomorphy
201	wfo-0001028148	success	157	136	109	48	27	0.694	-6,0.25-0.5,0.6-3.5,0.75-2,1-15,1-3.5,1.5,10-30,12-15,2,2-3,2-7,2.5-4,20-50,3.5-4,3.5-9,5,5-20,5-7,5-8,6-18,abaxially,acute,adaxially,aggregate,angled,apart,apex,apiculate,articulated,base,blue-black,branched,broadly,calyx,cell,chartaceous,cm,cylindrical,dark,decurrent,deltate,densely,diameter,directed,distal,elliptic,entire,especially,except,fleshy,flower,fruit,glabrous,glaucous,globose,hair,highly,less,light-colored,lobe,margin,minute,mm,moderately,narrowly,often,orange,ovate,part,pedicel,peduncle,perfect,petiole,pink,plicae,plicate,pore,puberulence,puberulent,puberulent-pubescent,purple,rachi,radiu,rarely,ridge,ripe,rotate-stellate,scalloped,shrub,simple,slightly,smooth,sometimes,sparse,stigma,stone,style,succulent,tapered,tip,treelet,triangular,tube,unbranched,violet,whitish,x,yellow	.5-4,0.5-1.5,1.5-2.5,15,4-10,4.5-10,5-10,absen,axe,ba,blade,central,connivent,distall,eaf,eed,fresh,long,lower,many-foliat,margi,material,mature,midrib,nflorescence,nther,obtuse,orolla,rhizomatous,ruit,slender,smoot,spaced,star,surface,tal,tem,thickened,time,truncat,unit,usually,vary,white,wide,winge,ympodial,young	0.5-4,absent,anther,articulation,branching,colour,corolla,direction,distally,form,growth,height,inflorescence,leaf,length,number,ovary,plant,seed,shape,size,spacing,stem,texture,truncate,type,winged
202	wfo-0001028161	invalid_json	124	85	58	66	27	0.468	.5,0.1-0.25,0.25-0.5,0.7-1.7,1-1.5,1-2,1-2.3,1/3,2-9,2.5-3,3-4,3-7,4-5,6-9,acuminate,acute,along,anthesi,apex,attenuate,base,branch,branched,cell,closely,cm,dendritic,densely,denser,distal,elliptic,fruiting,globose,green,lanceolate,leaf,minor,minutely,mm,narrowly,opposite,orbicular,outline,ovoid-reniform,pedicel,petiole,pitted,pubescent,rounded,shape,shrub,simple,sinuate,size,surface,trichome,vein,x	1-1.3,1.5-4.5,2-5-flowered,7.5-12,9-11,abaxially,adaxially,arising,ba,bark,berry,brown,calyx,congested,consisting,corolla,deflexed,dia,differing,difoliate,eaf,edicel,eed,exserted,geminat,glabrescen,incrassate,inflorescenc,later,lateral,like,lon,long,main,major,margin,middle,nflorescence,obovoid,often,older,overlappin,pair,pale,probably,pubescence,reddish-brown,rest,ruit,scar,short,somewhat,spaced,sparsely,stem,strongly,tall,tan,tapering,thin,tub,ud,unit,widest,ympodial,young	'',2-5,[,``,abaxial,adaxial,characteristic,colour,density,diameter,flower,form,fruit,growth,height,inflorescence,length,number,origin,plant,position,seed,texture,type,value,{,}
203	wfo-0001028164	success	197	113	91	106	22	0.462	-1,-6,/4,0-20,0.4-0.8,0.5-0.8,0.5-1,0.7-1.1,1-4.5,1/3,2.5-4,2.5-4.5,2.8-4,3-17,3-7,3.6-4.8,8-17,abaxial,almost,anther,articulated,base,berry,branched,bright,calyx,cm,concolorous,connivent,curved,dark,densely,diameter,drying,dull,elliptic,entire,equal,evenly,filiform,flattened-reniform,fruit,fruiting,glabrescent,glabrous,glandular,green,hair,lateral,leaf,length,lobed,margin,maturity,mauve,membranous,midvein,minute,mm,moderately,orange-brown,pale,pedicel,peduncle,per,petiole,poricidal,red,red-brown,shallowly,shrub,simple,sometimes,sparsely,spherical,spreading,stellate-pubescent,stem,straight,style,tapering,terminal,tip,unarmed,undulate,upper,way,white,yellow,yellow-green,young	-14,-8,0.05-0.2,0.05-1.5,0.1,0.3-0.8,0.8-1.5,0.9-1.6,1,1-1.5,1.5-2.5,1.8-2.5,1/6-1/4,12-20,2-2.5,4-13,4-5-merous,4-7,4-8,6-8,8-15,abaxially,acuminate,acute,alyx,ame,apar,apex,apically,apparently,attenuate,bark,blade,c.,deltate,difoliate,eaf,eed,elongating,erect,eye,filament,flower,free,geminat,glabrescen,glabrou,gray,infructescence,less,lobe,long,long-acuminat,longer,lower,mature,midpoint,multangulate,naked,narrow-deltate,nflorescence,obtuse,often,older,one,open,orolla,oung,pair,perfec,pericarp,porrect,portion,primary,ray,recurved,reflexe,ruit,scar,sessile,shorte,shorter,side,smooth,spaced,stalk,stalked,stellate,surface,tamen,terete,tertiary,time,trichome,tube,unarme,unit,variously,vary,vein,venation,visible,wide,woody,yellow-gra,ympodial	articulation,branching,colour,corolla,form,growth,height,heteromorphism,inflorescence,number,ovary,plant,position,prickle,reflexed,seed,shape,size,staman,texture,type,width
204	wfo-0001028180	success	147	78	59	88	19	0.401	1-1.2,1-1.5,1-1.8,1-3,1.5-5,15-28,2-2.2,2-3,2.5-3,3-10,3-4,4.5-5,5-6,5-8,7,anther,attenuate,base,berry,calyx,capitate,closely,cm,conical,corolla,dia,elliptic,filament,fruiting,glabrous,globose,golden,leaf,leathery,lobed,minor,mm,nearly,opposite,ovary,ovoid-reniform,pedicel,petiole,pinkish-white,pore,pubescent,scar,shaped,simple,size,spaced,stigma,style,tear-drop,tree,tube,white,winged,x	.05,.5,/2,0.7-1,20-30-flowered,8-10,abaxially,acute,adaxially,along,anthesi,apex,ba,bark,beginning,c.,cucullate,dark,darker,deflexed,deltate,densely,differing,difoliate,distinctly,drying,eaf,eed,elongate,erect,falcate,fleshy,four-angled,free,geminat,glabrat,gold,green,irregularly,know,larger,lateral,lobe,lon,long,lower,main,major,margin,midrib,minutely,nflorescence,obscure,older,onto,overlappin,pair,pale,papillose,pitted,planar,poricidal,portion,puberulent,ruit,shiny,small,somewhat,sparsely,stem,straight,styl,surface,tall,tan,thick,tip,trichome,ud,underside,uniseriate,unit,vein,way,woody,yellow-gray,ympodial,young	abaxial,adaxial,branching,colour,form,fruit,growth,hair,height,inflorescence,length,overlapping,plant,position,seed,shape,symmetry,texture,type
205	wfo-0001028182	success	150	82	66	84	16	0.44	0.1-0.2,0.5-0.6,0.5-1,0.8-1,0.9-1,1-1.5,2-2.5,2-6.5,3-5,4-6,5-ribbed,6-9,anther,apex,base,branch,calyx,capitate,ciliate,cm,conical,corolla,deflexed,ellipsoid,filament,filiform,glabrous,globose,inflorescence,later,lateral,leaf,lobed,long-acuminate,main,minutely,mm,narrowly,nearly,obovoid,ovary,ovate,pair,papillose,pedicel,petiole,pore,pubescent,purplish,scar,shaped,shrub,simple,sparsely,stem,stigma,strongly,style,tear-drop,trichome,tube,uniseriate,vein,white,young,zig-zag	.5,0-90,0.5,2,3,5-15-flowered,along,anthesi,apart,apiculae,apiculate,arching,axi,bark,bending,beneath,black,blade,brown,cordate,deltoid,densely,dia,dry,eaf,edicel,eed,evenly,except,extreme,flower,free,gre,hemiepiphyte,internodal,keeled,know,known,lax,less,like,lobe,long,lower,margin,material,midrib,minute,nflorescence,older,opposite,papillo,planar,poricidal,portion,present,prominent,proximal,reflexed,rib,rounded,ruit,sca,shiny,slender,slightly,somewhat,spaced,sparser,specimen,spindly,still,surface,tapering,third,time,tip,truncate,ud,unifoliat,unit,widest,x,ympodial	branching,bud,colour,diameter,form,fruit,growth,length,na,seed,shape,texture,type,unknown,venation,width
206	wfo-0001028183	success	237	96	80	157	16	0.338	-10,-5.3,0.2-0.5,0.5-2.5,0.8-3.1,1/3-1/2,10-15,2-4.2,2-5,3.5-6.6,5-8,5.2-6.2,6.6-20,7.5-23,abaxial,anthesi,apex,articulated,attenuate,bark,base,berry,branch,branched,bud,calyx,chartaceous,cm,corolla,cuneate,deltoid,diameter,dull,elliptic,entire,flower,fruit,glabrescent,glabrous,globose,granular-punctate,hair,lanceolate,leaf,lobe,long,many,margin,mm,narrowly,nearly,orangish-tan,pedicel,peduncle,petiole,porrect-stellate,pubescence,pubescent,rachi,reticulate-punctate,ripe,scabrous,shrub,simple,soon,sparingly,stellate,sub-lenticular,subcampanulate,surface,tan,time,tree,usually,way,white,whitish,x,yellowish,yellowish-tomentose	.5-3,0.1,0.1-0.2,0.1-0.4,0.1-0.9,0.2-0.3,0.2-0.4,0.5,0.6,0.7-1.2,0.7-2,0.8-1.4,1.1-1.8,1.2-1.4,1.3-1.4,1.3-1.7,1.4-2.8,1.5-3.4,1.6-2.3,1.7-2.7,1.9-3.7,11-30,2.2-5.7,2.5-4.1,2.6-4.4,2.8-4.2,3.2-,4.5-9,4.6-6.4,5-8.5,50-400,8-9.1,9-13,abaxially,accrescent,acute,adaxially,ag,along,alyx,anther,apart,apparently,around,axi,axillary,blade,blunt-tipped,brown,capitate,cell,central,closely,cylindrical,dark,dendritic-multangulate,directed,distally,distantly,drying,eaf,earl,edge,eed,elongated,epidermal,especially,evident,except,exserted,farinose,few-rayed,filament,free,fruiting,glabrescen,group,half,high,inserted,lackin,lateral,lengthening,lobed,lon,long-decurrent,longitudinal,lower,m.,main,midrib,multangulate,nflorescence,oblong,obovoid,older,open,orolla,ovate-lanceolate,overlapping,perfec,plurifoliate,pore,poricidal,porrect-stellat,present,prominent,pseudoterminal,purple,rarely,relatively,reportedly,ruit,runk,sessile,short,short-,side,slit,small,somewhat,spaced,sparse,spherical,splitting,stage,stalk,stamen,stem,stigma,stipitate-glandular,stout,streak,strongly,style,suture,tamen,terete,thick,thin,thin-textured,tip,tomentose,touching,translucent,tube,ud,unarme,unit,upper,vary,vein,violet,wide,yellow,ympodial,young	adaxial,arrangement,articulation,branching,colour,form,growth,height,inflorescence,length,plant,seed,shape,texture,trunk,type
207	wfo-0001028227	success	236	117	100	136	17	0.424	-6.2,0.2-0.3,0.2-0.4,0.4,0.7-2.1,0.9-1.4,1-4.2,1.1-3.1,1.3-4,1.4,10,2-12,3-4.9,3.7-7,4.8-7.6,6-16,6.7-15,8.5-22,abaxial,acuminate,acute,adaxially,anther,apart,apex,attenuate,bark,base,blunt-tipped,branch,branched,brown,brownish,bud,cm,corolla,cuneate,cylindrical,dark,deltoid,dendritic-echinoid,diameter,drying,echinoid,elliptic,elongate,entire,farinose,fleshy,fruit,glabrescent,glabrous,globose,granular-tomentose,hair,leaf,long,many,margin,mm,multangulate,oblong,oblong-lanceolate,obtuse,older,orangish-tan,orbicular,ovate-lanceolate,pale,pedicel,peduncle,petiole,porrect-stellate,pseudoterminal,pubescent,purple,rachi,reticulate-punctate,ripe,scabridulous,shrub,simple,sparsely,stalk,stellate,stem,stigma,style,sublenticular,subspherical,surface,time,tomentose,tree,velutinous,violet,x,yellow,yellowish,young	-2/3,.5-4,0-250,0.1,0.2,0.2-0.5,0.3,0.5,0.8,0.8-1.4,0.9,0.9-1.2,1,1-1.7,1-2.5,1.2-2,1.4-2.6,1.5-2.3,1.7-2.8,1.9,1.9-4.2,1.9-5.8,1/2,1/2-3/4,10-24,11-15,2-3.8,2.5-7.8,2.6-5.9,2.9-4.7,3.7-6.3,4-13,5-7.5,8.1-18,abaxially,accrescent,ag,age,along,alyx,anthesi,apparently,appressed,around,articulated,axillary,becoming,berry,blade,blunt-tippe,c.,calyx,closely,decurrent,directed,distally,eaf,early,echinoi,edge,eed,ength,exserted,filament,flower,free,fruiting,gray,grayish,green,high,inserted,lacking,lanceolate,lateral,lengthening,less,lobe,lobed,lon,longitudinal,lower,m.,main,midrib,midvein,mostly,nflorescence,obscured,occasionally,often,orolla,ovate-orbicula,overlapping,perfec,plurifoliate,pore,poricidal,present,prominent,pubescence,quarter,relatively,rounded,ruit,runk,sessile,side,slightly,slit,somewhat,spaced,stamen,stout,subcampanulate,sulcate,suture,tamen,thick,thicker,thin,tip,tomentu,touching,tube,ud,unarme,unit,upper,usually,vary,vein,way,well,wide,ympodial	arrangement,branching,colour,form,growth,height,inflorescence,length,ovary,plant,seed,shape,spacing,texture,tommentose,trunk,type
208	wfo-0001028228	success	143	129	104	39	25	0.727	.5,0.1-1.7,0.75,1-1.5,1.1-2.5,1.5-2,1.8-3.4,10-30-flowered,2,2-8,2.1-4.2,2.8-6.5,3/4,6-7,6-8,7.5-12.5,abruptly,acute,age,anther,anthesi,apex,area,bark,base,becoming,brown,calyx,campanulate,clavate,closely,cm,coriaceous,corolla,dark,deflexed,dia,difoliate,distal,dry,elliptic,exserted,filament,fragrant,fruiting,glabrous,globose,green,greenish-yellow,lateral,leaf,lobed,long,main,major,material,middle,minor,minute,minutely,mm,narrowing,obovate,occasionally,older,opposite,ovary,overlapping,ovoid,ovoid-reniform,pair,pale,papillose,pedicel,pore,portion,reticulate,rounded,scar,shaped,shining,shrub,small,spaced,stem,stigma,straight,style,surface,sweetly,tear-drop,terminal,thickened,tip,tree,tube,unit,usually,vein,way,white,widest,x,young	1.1-1.2,1.2-1.8,2-5,ba,beginning,beneath,berry,caly,deltoid,eaf,edicel,eed,erect,free,geminat,impressed,inflorescenc,lobe,lon,lower,margin,nflorescence,petiole,planar,poricidal,prominent,ruit,shinin,simple,slender,slightly,styl,tall,tapering,thick-margined,ud,weight,woody,ympodial	bud,colour,diameter,exsertion,flower,form,fragrance,fruit,geminate,growth,height,inflorescence,length,number,part,pattern,plant,position,seed,shape,size,spacing,structure,sympodial,texture
209	wfo-0001028263	success	156	101	74	82	27	0.474	0.25,1-3,1-4,11-13,11-23,14-44,2.6,3,3.4,3.5-4.2,4,4-5,5-7.5,6,6-8,9,abaxially,adaxially,apical,apically,branched,calyx,cm,conical,connate,corolla,cyme,darker,deep,dehiscent,diameter,dichasial,dichasially,distal,filament,green,green-white,herbaceous,interjected,introrse,lateral,leaf,leaflet,light,maturing,medium,mm,monochasial,mucilaginous,odd-pinnate,often,pair,pedicel,peduncle,perennial,petiole,plant,poricidally,proximal,puberulent,pubescent,rotate,seed,short,slit,strigose,style,terminal,throughout,tuber-bearing,unit,violet,yellow,Â¼	1-2,2,2-3,2-4,3-6-foliat,5-7,8-1.,8-14,abaxiall,acumen,acuminate,acute,apex,articulate,atenuate,base,broadly,cell,cordate,covering,cuneate,digestion,diminishing,dorsally,eaf,ebracteate,edge,eed,elliptical,emoval,enzyme,equal,exceeding,first,flat,flower,folded,forked,generally,globo,gradually,hair-like,half,honeycomb,living,lobe,lon,long,lower,lunat,make,nflorescence,nther,oblique,orolla,ovate,ovoid,pattern,perfect,plan,reveal,ruit,sessile,seudostipule,size,specimen,stamen,stigma,straight,tal,tem,testal,thick,throughou,toward,truncate,two,typically,vary,wall,wide,ympodial	3-6-foliate,8-19,anther,arrangement,articulation,bract,branching,colour,connective,ebbrate,form,fruit,growth,height,inflorescence,length,lunate,ovary,pore,pseudostipule,shape,stem,structure,sympodial,texture,wet,width
210	wfo-0001028280	success	87	71	48	39	23	0.552	.5,0.7-1,1-2,1-2-flowered,2-2.5,2-3,7-8,acuminate,almost,apex,arching,attenuate,base,berry,ciliate,closely,cm,completely,elliptic,flattened,fruiting,glabrous,globose,green,lanceolate,lateral,leaf,main,middle,minutely,mm,narrowly,onto,opposite,pair,pedicel,petiole,rounded,scar,shrub,simple,spaced,stem,surface,tip,vein,widest,winged	1.5-2.7,6-9,anthesi,ape,axil,bark,branch,brow,dark,decurrent,dia,eaf,eed,immature,know,known,lon,long,lower,margin,new,nflorescence,older,papillae,pendant,present,ruit,sessil,small,somewhat,tall,ud,ultimate,unifoliat,unit,woody,x,ympodial,young	branching,ciliation,colour,decurren,decurrency,diameter,flower,form,fruit,glabrousnes,growth,height,inflorescence,length,number,pattern,plant,position,sessile,shape,spacing,type,width
211	wfo-0001028281	success	267	156	137	130	19	0.513	+,-1,-20,-3,-36,-45,-5,.5,0.2-0.3,0.2-0.5,0.3-0.5,0.5-0.6,0.5-0.7,0.5-1,0.5-1.1,0.5-1.2,0.75-1,1,1-1.5,1-3,1.0-1.6,1.1-1.4,1.1-2.4,1.2-1.6,1.4-4,1.7-2.5,10-30,2-13,2-4,2.1-3.0,3-16,3-foliate,7-30,abaxial,acuminate,acute,adaxial,almost,anther,apex,apical,appendage,articulation,axi,base,basiscopically,bent,bract,branching,broadly,brown,calyx,capitate,cell,cm,column,conical,corolla,dark,darker,deep,densely,diameter,distal,doubly,eglandular,elliptic,elongate,entire,extended,filament,form,fruit,fruiting,glandular,globose,golden,green,hair-like,half,head,imparipinnate,inflorescence,interjected,internode,interrupted,lateral,leaf,leaflet,like,lobe,margin,medial,mm,multi-cellular,narrowly,oblique,obovate,occasionally,once-branched,outgrowth,ovary,ovate,pale,paler,pedicel,peduncle,point,pseudostipule,pubescent,regularly,rotate,serrate,shrub,small,smooth,sometimes,sparsely,staminal,stem,sterile,stigma,stripe,strongly,style,testa,three,toward,transparent,trichome,type,uniseriate,unit,usually,vine,wall,yellow	-0.9,-10,-7,-8,.2,.4,0.05-0.4,0.1-0.15,0.15-0.2,0.2-0.7,0.3-1,0.5-,0.7-,0.7-1.2,0.7-2.5,0.8-1,1-,1-5,1.2-1.5,1.5-2,1.5-6,10-18,2-4-celled,2-6.5,2-locular,2.5-,20-30,3-5,3-8.5,5-8-celled,6,6-15,abaxially,absent,alternate,anthesi,appearance,appressed,arising,autogamous,berr,blade,bracteate,composed,covering,decreasing,decurrent,developed,dry,eaf,edicel,eed,either,elongate-triangular,enclosing,exerted,exserted,flower,fragile,free,generally,giving,glabrous,gland,gree,hal,halfway,included,large,largest,less,lon,long,longest,lower,material,midvein,minute,mixture,multi-celled,multicellular,nflorescence,node,opposite,orbicular,other,pair,patent,petiole,petiolule,population,portion,present,primarily,primary,probably,proximal,rachi,rest,ruit,secondary,serrat,sessile,set,shorter,silky,size,smaller,sparser,sprawling,stiff,straight,subopposite,surface,tem,terminal,tertiary,thick,thin,tip,tube,ud,unicellular,vein,weak,weak-walled,well,wide,winged,ympodial	1-2,2,2.5-6-15,arrangement,bend,bud,colour,growth,length,locule,number,position,pubescence,seed,shape,structure,sympodial,thicknes,width
212	wfo-0001028317	success	204	95	76	128	19	0.373	0,0.5-3.5,0.6-1.2,0.6-1.5,1-1.3,1-4,1/4-2/3,1/5,5-8,anther,articulated,base,berry,branched,bright,brown,calyx,chartaceous,cm,cream,curved,dark,densely,dull,elongating,equal,filiform,flattened-reniform,fruit,fruiting,gray,green,hair,herb,lanceolate,lateral,leaf,length,lobed,margin,marking,mature,maturity,mauve,mm,moderately,orange-brown,ovate,pale,pedicel,per,petiole,poricidal,prickle,purple,red,reflexed,shrub,simple,sometimes,sparsely,spherical,spreading,stellate-pubescent,stem,straight,style,tapering,terminal,tip,toward,upper,white,yellow,yellow-green,young	-1.5,-5,/5,0-1,0-5,0.1,0.1-0.25,0.1-0.3,0.1-0.4,0.3-0.4,0.3-1,0.6-0.8,0.8-1.1,0.8-2.5,1-3,1.1-1.9,1.4-2,1.8-2.5,1/,1/3-1/4,2-2.8,2-4,2-4.5,2.5-6.5,2.8-3.3,2/3,3-10,3-4,3-5,4-5-merous,4-6,4-8,6-10,abaxially,absent,acuminat,acute,almost,alyx,apar,apart,apex,apically,apparently,bark,blade,broad-deltate,brow,concolorous,cuneate,deltate,diameter,difoliate,distance,drying,eaf,eed,erect,extending,eye,filament,flower,free,geminat,glabrous,herbaceous,infructescence,lobe,long,longer,lower,midpoint,midvein,minute,naked,nflorescence,oblong,obtuse,older,one,open,orolla,oung,pair,peduncle,pendulous,perfec,pericarp,porrect,portion,prickl,prickly,primary,ray,reduced,rounded,ruit,scandent,scar,sessile,shorter,side,smooth,spaced,stalk,stalked,stellate,subsessile,surface,tamen,terete,tertiary,time,translucent,trichome,truncate,tube,unarme,unarmed,unit,variously,vary,vein,venation,visible,way,wide,ympodial	articulation,branching,colour,corolla,form,growth,heteromorphism,inflorescence,number,ovary,position,seed,shape,staman,symmetry,texture,type,width,zygomorphy
213	wfo-0001028323	success	164	112	92	72	20	0.561	0.2-1,0.4-1.3,0.5,0.6-1,0.9-1.2,1-1.2,1-1.5,1.5-2.5,3.5-4,7.5-9,acute,anther,apex,appressed,attenuate,bark,base,blue-green,brown,c.,cell,cm,coriaceous,corolla,dark,dendritic,densely,ellipsoid,elliptic,entire,erect,fading,filament,fleshy,glabrous,globose,grey,growth,inflorescence,internodal,leaf-opposed,less,like,lobed,margin,maturity,minute,minutely,mm,new,occasionally,ovary,ovoid,pale,papillose,pedicel,peg,pericarp,petiole,pitted,pore,poricidal,pubescent,reddish,remaining,revolute,rounded,shiny,shoot,short,shrub,simple,small,soft,sometimes,sparsely,stem,stigma,straight,style,surface,testal,thick,thin,tip,trichome,uniseriate,violet,wall,way,white,x	-2,0.2-0.5,0.5-1,0.8,1,1-2,1.1-4.5,1.5,2-3,2-9,3,3-5,3-6,5-6,abaxially,abscissio,absent,along,anthesi,apart,apparently,articulated,ba,berry,calyx,capiatate,conical,cup-shaped,deltate,diameter,drying,eaf,eed,flower,free,fruiting,glabrescen,glabrescent,included,lanceolate,lengthening,lobe,longer,lower,main,nflorescence,ovate,pair,papillat,peduncle,perfect,planar,plurifoliat,portion,primary,proceed,ruit,scar,scattered,sinus,somewhat,soon,sparely,splitting,tearing,tube,tuft,ud,unit,vein,woody,ympodial	abaxial,abscission,adaxial,articulation,bud,capitate,colour,form,fruit,leaf,length,orientation,papillate,position,seed,shape,texture,thicknes,type,width
214	wfo-0001028329	success	215	140	115	100	25	0.535	0.2-0.3,0.8-1.1,0.8-1.4,0.9-1.3,1-6,1.0-1.4,1.5-3.5,1.5-8,12,3-8,4-15,5-10,6-11,6-8,7-19,abaxially,adaxially,angled,anther,apart,apical-lateral,asperous,bark,base,berry,blunt-tipped,branch,branched,brown,bud,calyx,chartaceous,cm,conical,corolla,deltoid,diameter,dichotomously,distantly,echinoid,filament,finely,fleshy,flower,fruit,glabrous,granular,granular-tomentose,gray,green,grooved,growth,hair,honeycombed,introrse,large,leaf,length,lobe,longitudinally,minutely,mm,moderately,mostly,multangulate,obelliptic,oblong,obovate,occasional,orbicular,ovate,ovate-elliptic,pale,pedicel,peduncle,petiole,pore,porrect-stellate,pubescent,rachi,rather,reniform,reticulate-punctate,ripe,sessile,short-stalked,shrub,simple,slightly,small,sometimes,spaced,sparse,sparsely,stalked,stellate,stellate-pubescent,stellate-rotate,stelliform,stigma,style,suborbicular,testa,tomentose,touching,tree,tube,turning,velutinous,vestigial,white,whitish,x,yellow,yellowish	.5-3,.75-2,.75-5.75,/10-3/10,0-100,1.1-2.5,1.3-1.8,1.3-2,1.5-2.3,1.5-2.75,10-34,2-3,2-4,2.2-3.9,2.6-5,2.75-4.5,3-14,3.75-7,3/4,4-5,6-9,absen,acuminate,acute,ag,anthesi,apex,apparently,articulated,axe,axillary,ba,becoming,blade,closely,continued,cylindrical,dehiscing,dendritic-echinoi,dendritic-echinoid,distinct,due,eaf,eed,entire,free,glabrescen,high,inserted,lateral,lengthening,lobed,long,long-attenuate,lower,main,margin,midvein,multangulat,nflorescence,obscured,obtuse,older,orolla,perfect,plurifoliate,present,pseudo-terminal,receptacle,relatively,ruit,runk,sessil,several,short-,side,slit,stellat,stem,subcapitat,subglobose,suture,swollen,tamen,thick,thickened,thin,time,tomentu,toward,unarme,unarmed,unit,usually,vary,vein,way,wide,ympodial,young	0.5-3,20-100,4.75-5.75,angle,arrangement,branching,colour,form,glabrescent,height,inflorescence,insertion,number,ovary,pattern,plant,seed,shape,spacing,staman,subcapitate,texture,thicknes,trunk,type
215	wfo-0001028337	success	195	84	68	127	16	0.349	-2,-2.5,-4,0.3-0.5,0.4-0.7,0.7-0.9,1-2,1-3,1.5-3,1.8-2,2-2.2,2-4,4-5,5-25,abaxial,adaxial,anther,berry,calyx,chartaceous,cm,connivent,dark,densely,diameter,elongating,evenly,flattened-reniform,flower,fruit,fruiting,glabrescent,glaucous,green,green-brown,hair,inflorescence,juvenile,lateral,leaf,length,lobed,long,marking,mauve,mm,moderately,narrow-oblong,orange-brown,per,petiole,poricidal,prickle,prickly,shrub,simple,sparse,spherical,stellate,stellate-pubescent,stem,tapering,terete,terminal,unarmed,white,wide,young	-6,.5,.8,/3,0,0.05-0.15,0.05-1,0.1-0.3,0.4-0.8,0.7-1,1,1-1.8,1.5-4,1/2,1/3-2/3,1/4-1/3,1/8-1/4,11-16,15-50,3-4,5-6,5-8,5-merous,6-7,8-10,8-14,abaxially,acut,alyx,apar,apart,ape,apex,apically,apparently,articulated,bark,base,blade,branched,color,conical,cuneate,curved,deltate,discolorous,drying,eaf,eed,entire,equal,erect,eye,filament,free,fused,gently,glabrou,glabrous,gray,gray-brown,infructescence,juvenil,known,lobe,long-styled,longer,lower,margin,mature,midpoint,minutely,naked,nflorescence,occasionally,older,one,open,orolla,oung,pale,pedicel,peduncle,perfect,pericarp,pitted,plurifoliat,porrect,porrect-lepidote,portion,primary,ray,reddish,reflexed,rounded,ruit,scar,sessile,shallowly,shoot,short,short-styled,shorter,slender,small,smooth,spaced,staminate,stout,straight,strongly,style,surface,tamen,time,tip,toward,trichome,tube,unarme,unit,usually,vary,vein,visible,way,ympodial	adult,colour,corolla,form,growth,height,number,ovary,plant,pore,position,seed,shape,size,texture,type
216	wfo-0001028339	success	195	95	82	113	13	0.421	.5,0.05-0.1,1-2,1-5,1.1-1.4,1.5,1.5-2,1.7-3.2,3.5-4,5-7,8182,anther,appressed,base,beneath,berry,blue,broadly,bud,calyx,capitate,cm,connate,corolla,cuneate,cup-shaped,dia,dried,filament,filiform,flattened,flower,fruiting,glabrous,globose,growth,later,leaf,like,lobed,long,minutely,mm,mustard,nearly,oblique,opposite,ovary,ovate,ovoid-reniform,papillate,pedicel,petiole,pore,schwarz,shaped,shrub,simple,size,slender,small,somewhat,specimen,stem,stigma,straight,strongly,style,tapering,tear-drop,texture,tightly,tree,trichome,tube,uniseriate,urceolate,vein,white,x,yellow,young	0.8-1.2,1-1.2,1-1.5,1.2-1.5,10-30-flowered,10.2-18.5,2.5-5,3.4-5.5,43191,5-angled,5.8-7.9,7-11,8-10,across,acuminate,acute,almost,anthesi,apex,appearance,appearing,attenuate,bark,becoming,brown,carinate,carpel,closely,covered,crystalline,dark,decurrent,deflexed,densely,differing,difoliate,distinctly,dry,eaf,edicel,eed,enclosed,epidermi,erect,evenly,exserted,fide,first,floccose,free,frui,geminat,glabrate,grainy,greyish-brown,irregular,large-celled,lateral,leave,little,lobe,lon,long-triangular,lower,main,major,margin,middle,minor,nee,nflorescence,obscure,occasionally,older,one,overlappin,ovoid,papery,papillose,pitted,planar,poricidal,portion,proximal,pulp,red-brown,reflexed,ruit,scar,secondary,septum,shining,slightly,spaced,sparsely,speckled,strong,surface,tall,tip,tub,ud,unit,venation,white-lenticellat,white-papillo,white-speckled,wide,widest,winged,woody,yellowish,ympodial	branching,colour,form,fruit,hair,height,inflorescence,length,plant,position,seed,shape,white-papillose
217	wfo-0001028351	success	175	145	124	51	21	0.709	.2,.8,.8â1.0,0,0.1,0.2,0.5,0â,1.0â,1.0â2.0,1.0â2.5,1.4â1.5,1.5â4.0,1.6â,2,2.0â2.5,2.0â5.0,2.1â3.5,2/3,2â2.5,2â4,3,3.4â5.0,3â4,4,40,5,5.0,5.5â10.5,5â7,6.5â8.5,6â12,8â15,abaxially,acute,adaxially,along,annual,anther,anthesi,apart,apex,articulated,base,becoming,blue,branching,brown,calyx,capitate,cell,clavate,cm,colour,cylindrical,densely,diameter,directed,distally,erect,filament,flattened,flower,fruit,glabrous,glandular,globose,green,hair,herb,lanceolate,leaf,like,lobe,lobed,long,longitudinal,lower,margin,midvein,mm,moderately,multicellular,number,oblong,opening,ovate,pair,pale,pedicel,peduncle,pentagonal,perennial,petiole,pitted,pore,present,pubescent,regularly,shallowly,shaped,shiny,simple,slender,slit,stem,stigma,stone,straight,style,surface,tardily,teardrop,truncate,tube,unbranched,unicellular,uniseriate,velutinous,white,woody,x,â,â3.0	0.6,1.0â1.6,10,5.0â5.5,absent,adaxiall,ag,apical,axe,ba,basal,blade,chartaceous,connivent,convex,eaf,eed,equal,fleshy,geminat,indumentum,lamin,lon,m.,narrowly,nfloresence,obtuse,occasionally,opposed,orolla,perfect,plurifoliate,probably,ruit,serrate,side,smaller,spaced,sparsely,tal,tamen,tem,time,unit,unknown,vary,wide,wing,winged,ympodial,young	age,articulation,corolla,form,growth,height,history,inflorescence,lamina,length,life,ovary,plant,position,seed,shape,size,spacing,staman,texture,type
218	wfo-0001028353	invalid_json	177	134	110	67	24	0.621	/3,0.2-0.4,0.5,1,1-4,1.4-2,1.5-2,1.5-5,2,2-3,2-4,3-5,4-7,6-8,7,acute,age,anther,anthesi,apart,apex,base,beneath,berry,bluntly,bright,calyx,campanulate,capitate,cell,centre,clasping,cm,coarsely,conical,cordate,corolla,dark,deep,deeply,diameter,ellipsoid,elliptic,erect,exerted,filament,fleshy,fruiting,glabrous,globose,green,greenish,herb,heteromorphic,hollow,honey-comb,internodal,leaf,lengthening,less,like,long,margin,midrib,minute,minutely,mm,nodding,ovary,ovoid,pale,papery,papillose,pedicel,peduncle,petiole,pitted,plant,plump,pore,poricidal,pubescent,purple,rhomboid,ripe,scar,scattered,short,simple,size,slender,slit,somewhat,sparsely,stem,stigma,strongly,style,surface,tan,testal,tip,toothed,trichome,truncate,uniseriate,vein,way,x,yellow	.5,0.5-,0.9-1.2,1-2,3,8-10,abaxially,accrescent,along,area,becoming,ciliate,cup-shaped,curved,decreasing,decumben,densely,difoliate,distally,dry,drying,eaf,edicel,eed,emarginated,flower,fracturing,free,frui,geminat,gree,growing,horn,horned,inserted,lobe,lon,lower,m.,material,nflorescence,often,open,outline,pair,papillate,pericarp,point,portion,primary,principal,reddish,ruit,sessil,sessile,shallow,sleeve,slightly,straight,thin,toward,tube,ud,unit,wall,wrinkled,ympodial	'',[,``,abaxial,arrangement,bud,characteristic,colour,form,fruit,growth,hair,height,inflorescence,length,modification,position,seed,shape,texture,type,value,{,}
219	wfo-0001028390	success	147	95	71	76	24	0.483	0.5,0.5-1,0.5-1.5,0.5-2.5,1-2.5,1.5-2,1.5-3.5,10-15,3-4,3-5,4-5,5-7,7-8,acute,angled,apex,apiculate,base,calyx,chartaceous,cm,cuneate,cylindrical,deltate,densely,diameter,directed,divided,elliptic,entire,felty-pubescent,forked,glabrous,globose,hair,lanceolate,lobe,margin,mm,near,obtuse,often,orange,ovate,pedicel,peduncle,petiole,pore,pseudohair,pubescent,rachi,radiu,rarely,shrub,simple,slightly,sparsely,stellate,stigma,style,subclavate,subcordate,subcoriaceous,truncate,unbranched,unequally,violet,white,white-pubescent,x,yellow	-10,.5-3.3,0,1,1-3,1-5,1.5-5.5,2,2.5,4-11,6-many-foliat,7,9,abaxially,absen,adaxiall,adaxially,aggregate,apart,articulated,axe,blade,branched,cell,connivent,curled,dendritically,dendritically-branched,dense,distall,eaf,eed,eglandular,flower,gland,leaving,less,like,lon,long,lower,midvein,mixed,moderately,mostly,narrowly,nflorescence,nther,occasionally,orolla,peg,perfect,presen,puberulent,pubescen,ripe,ruit,scar,short,small,spaced,stalked,ste,stone,subcapitat,tal,tem,time,tip,triangular,tube,unit,usually,vary,wide,ympodial	abaxial,adaxial,anther,articulation,branching,colour,corolla,direction,distally,form,fruit,growth,height,inflorescence,leaf,length,ovary,plant,seed,shape,stem,subcapitate,texture,type
220	wfo-0001028405	success	149	106	78	71	28	0.523	0.4-0.5,1-4,1-9,1.5-6.5,10-11,2,2-2.5,2-3,3-20,3-4,3.5-10,4-11.5,4-6,6-7,7-14.5,8-15,9-15,acute,apex,apical,attenuate,base,branched,calyx,cm,conical,connate,corolla,cyme,dehiscent,diameter,dichasially,distal,elliptic,elliptic-lanceolate,filament,flower,forked,green,green-white,hair-like,herbaceous,introrse,lanceolate,lateral,leaf,leaflet,maturing,mm,oblong,odd-pinnate,often,ovate-elliptic,ovoid,pedicel,peduncle,perennial,perfect,petiole,plant,proximal,puberulent,seed,short,short-acuminate,size,slit,stellate,stigma,straight,style,terminal,throughout,tuber-bearing,unit,wall,yellow,Â¼	0.5-3,1.3-8,2-4,3-6-foliat,3.5-6.5,abaxially,absen,acumen,adaxially,apically,apiculate,articulate,cell,covering,decurrent,dichasial,digestion,diminishing,dorsally,eaf,ebracteate,edge,eed,emoval,enzyme,exceeding,flat,folded,generally,globo,gradually,half,honeycomb,interjected,living,lobe,lon,long,lower,lunat,make,monochasial,mucilaginous,nflorescence,nther,oblique,orolla,pair,pattern,plan,poricidally,rachi,reveal,ruit,seudostipule,short-petiolate,specimen,stamen,subsessile,tal,tem,testal,thick,throughou,toward,typically,vary,whit,wide,without,ympodial	3-6-foliate,anther,apicidally,arrangement,articulation,branching,colour,form,fruit,globose,growth,height,inflorescence,length,lunate,number,ovary,pore,present,pseudostipule,shape,stem,structure,sympodial,texture,type,white,width
221	wfo-0001028429	success	162	129	102	60	27	0.63	0.2-0.4,0.8-1.2,0.9-2.3,1-2.5,1-4,1.5-3,10-11,10-27,10.5-21,2-3,2-4,2.5-12,2.5-4,2.5-7.5,2.7-3.6,3-6,4-14,5-12,6-18,6-28,abaxially,acumen,acute,adaxially,apical,apically,branched,calyx,cm,connate,corolla,cyme,darker,dehiscent,diameter,dichasial,dichasially,distal,dorsally,ebracteate,edge,filament,flat,flower,folded,forked,glabrescent,glabrous,globose,green,green-white,greenish,hair,hair-like,herbaceous,interjected,introrse,lateral,leaf,leaflet,light,lobe,long,long-attenuate,maturing,medium,mm,monochasial,mucilaginous,odd-pinnate,often,ovoid,pedicel,peduncle,pentagonal,perennial,perfect,petiole,plant,poricidally,proximal,rotate,scattered,seed,short,size,slightly,slit,spot,stigma,straight,style,terminal,throughout,tuber-bearing,unit,violet,wall,white,wide,yellow,Â¼	1.5-4,2-1.,2-8,3-6-foliat,7-7,abaxiall,acuminate,apex,articulate,base,broadly,cell,cordate,covering,cuneate,digestion,diminishing,eaf,eed,elliptical,emoval,enzyme,especially,exceeding,generally,globo,gradually,half,honeycomb,living,lon,lower,lunat,make,narrowly,nflorescence,nther,oblique,obovate,orolla,ovate,pair,pattern,petiolule,plan,reveal,ruit,seudostipule,specimen,stamen,tal,tem,testal,thick,throughou,toward,typically,vary,vein,ympodial	2-19,3-6-foliate,anther,arrangement,articulation,branching,colour,form,fruit,growth,height,inflorescence,length,lunate,number,ovary,pore,present,pseudostipule,shape,stem,structure,sympodial,texture,type,wet,width
222	wfo-0001028436	success	150	99	74	76	25	0.493	.5,0.2-0.4,0.5,1-2,1-2-celled,1.5,1.5-2,1.5-2.5,10-20,2-4,2.5-3,4,5-10,5-12,5-15,5-8,7,8-12,absent,acute,anther,base,berry,brown,calyx,center,chartaceous,ciliate,diameter,dm,dried,edge,elliptic,entire,filament,fine,flower,fruit,glabrous,globose,hair,leaf,linear,linear-lancolate,lobe,margin,membranaceous,mm,moderately,oblong,parallel,pedicel,per,petiole,pubescent,radiating,raised,ridge,rotate,running,shallow,shrub,stem,stigma,style,surface,taproot,triangular,tube,two-celled,unbranched,white,woody,x	0.5-1,0.8-1.5,1-3,1st,2-3,2nd,abaxially,abundant,adaxiall,adaxially,along,apex,apically,appearance,appearing,axe,beyond,blade,cell,cm,connected,cordat,decurrent,deflated,dehiscent,difficult,due,eaf,eed,evaluat,explosively,exserted,flat,frui,fruiting,geniculate,glabrescen,interpetalar,lengt,like,long,lower,lying,much-branched,nearly,nflorescence,notch,often,older,orolla,oung,peduncle,placenta,pointing,presence,pubescen,rachi,reaching,rhizomatous,ruit,small,sparsely,stamen,structure,swollen,tal,tamen,tear,thick,tissue,unifoliate,unit,vary,wid,wrinkled,ympodial	branching,colour,cordate,corolla,form,growth,height,inflorescence,length,na,number,ovary,plant,position,pubescence,reproduction,root,seed,shape,staman,symmetry,texture,type,wide,width
223	wfo-0001028465	success	159	112	85	74	27	0.535	0.75,1-4,1.2-2,1.5-2.9,10-24,11-23,2-3,2-6,2-9.3,2.4-2.8,2.5-4,3-4,3-5,3-8,4-8,4.5-5.5,7-15,8-10,9-19,apical,apically,branched,cell,cm,connate,corolla,covering,cyme,dehiscent,diameter,dichasially,distal,exceeding,filament,flower,forked,globose,green,green-white,hair-like,herbaceous,interjected,interpetalar,introrse,lateral,leaf,leaflet,make,maturing,medium,mm,mucilaginous,odd-pinnate,often,ovoid,pair,pedicel,peduncle,perennial,petiole,plant,poricidally,proximal,puberulent,pubescent,purple,rotate,seed,short,slit,spot,stamen,straight,strigose,style,terminal,testal,thick,throughout,tuber-bearing,unit,wall,white,yellow,Â¼	1-2,10,2,2-4,3-6-foliat,3.8-7,4-1.,5-7,abaxially,acumen,acuminate,acute,adaxially,apex,articulate,attenuate,base,broadly,calyx,cuneate,decurrent,dichasial,digestion,diminishing,dorsally,eaf,ebracteate,edge,eed,elliptical,emoval,enzyme,equal,first,flat,folded,generally,globo,gradually,half,honeycomb,living,lobe,lon,long,lower,lunat,monochasial,nflorescence,nther,oblique,orolla,pattern,perfect,petiolule,plan,rachi,rarely,reveal,ruit,sessile,seudostipule,size,specimen,stigma,tal,tem,tissu,toward,two,typically,vary,wide,ympodial	3-6-foliate,4-18,anther,arrangement,articulation,branching,colour,form,fruit,growth,height,inflorescence,length,lunate,number,ovary,pore,pseudostipule,shape,stem,structure,sympodial,texture,tissue,type,wet,width
224	wfo-0001028468	success	255	109	89	166	20	0.349	-5.5,.3-0.4,0.2-0.3,0.4-4,0.5-3,0.6-1.2,0.7-2.5,1.2-1.5,1.6,16,2.5-4,5-9,6-10,6-9,along,anther,berry,blue,broad-based,brown,bud,calyx,campanulate,central,chartaceous,cm,compressed,corolla,densely,diameter,ellipsoid,filament,flattened,flower,fruit,fruiting,gray,greenish,hair,lateral,laterally,length,light,lower,mixed,mm,moderately,oblique,oblong-conical,oblong-lanceolate,occasionally,orange,orangish,ovoid,pale,pedicel,peduncle,petiole,porrect-stellate,prickle,purple,rachi,rhombic,rotate-stellate,sessile,short-stalked,shrub,similar,simple,sparsely,stellate-pubescent,stelliform,stem,stigma,style,subcapitate,subelliptic,subglobose,sublenticular,subreniform,subshrub,surface,unbranched,upper,vein,x,yellow,yellowish,young	-1.3,-10,-3,-4,-7,.1-0.2,.1-0.3,.1-0.4,.2,.2-0.4,.3,.5,.5-1.5,.5-1.6,.6-1,/10-1/5,/4-1/3,0.05,0.1,0.2-0.6,0.2-1.5,0.4-1,0.5-2,0.5-3.3,0.5-3.5,0.5-8,0.6-2,0.8-3.5,1,1.3-2,1.5-2.2,1.5-3.1,1/3-1/2,1/5-1/2,2,2-9,2.2-3,2.8-4.1,2/3-3/4,20,3-4,4-6,4-9,5-21,abaxially,accrescent,acuminate,acute,adaxially,apart,apex,appressed,ark,armed,articulated,attenuate,axe,base,becoming,beyond,blade,broadly,bu,c.,cauline,clavate,commonly,compresse,connivent,d.,dark,decreasing,density,directed,distal,distally,distantly,dry,eaf,eed,equal,exserted,extra-axillary,foveate,geminat,glabrescent,glabrous,gradually,green,half,increasing,inserted,interpetalar,introrsel,lamin,lobe,lobed,long,longer,m.,main,margin,midpoint,midvein,minutely,mostly,multangulat,multangulate,narrowly,nflorescence,obtuse,older,orolla,ovate,overlapping,pair,papillo,per,perfect,pore,proximal,pubescence,pubescent,ray,recurved,reduced,relatively,reticulate,ruit,shallowly,short,short-,side,similarly,slightly,somewhat,spaced,specimen,stalk,stamen,straight,subacuminate,subchartaceous,subcuneate,subsessile,tal,tamen,terete,testa,thick,thick-stalked,thicknes,time,tissue,touching,toward,triangular,tube,unarmed,unifoliate,unit,usually,vary,way,wide,ympodial	0-1.3,0.5-1.5,arrangement,bark,branching,colour,form,growth,height,inflorescence,lamina,leaf,ovary,placement,plant,seed,shape,staman,texture,type
225	wfo-0001028470	success	185	136	111	74	25	0.6	0-18,0.25-0.75,0.9-2.2,0.9-2.3,1-12.3,1-2,1-3,1.6-3.2,11.8-21,12-44,2-10,2-7,2-8,2.1-3.9,3-10,3-5,3.5-16,3.5-7,4-6,4-7,5.5-11.6,6-33,abaxially,adaxially,anther,articulated,berry,blade,brownish,cell,chartaceous,clavate,cm,condition,corolla,covering,dark,deep,diameter,distal,dot,drying,end,filament,flower,forked,fresh,fruit,generally,glabrous,green,green-white,greenish,hair,hair-like,half,herb,high,homostylous,interjected,lanceolate,lateral,leaf,leaflet,light,lobe,long,make,medium,mm,mottled,mucilaginous,odd-pinnate,one,ovoid,pair,pedicel,peduncle,pentagonal,placed,plant,pore,poricidal,purple,ripe,scarce,seed,short,size,sometimes,stigma,straight,style,substellate,terminal,testal,thick,throughout,tip,tube,tuber,typically,unwinged,usually,wall,wet,white,whitish,wide,wing,x	1.5-2.8,2-5,3.2-5.5,5-merou,acumen,acute,adaxiall,ag,alyx,apart,apex,apparently,asymmetric,attenuate,axe,axillary,base,basiscopic,bud,capitat,connivent,decreasing,digestion,dorsally,eaf,edge,eed,elliptic,enzyme,erec,exceeding,flat,folded,geminat,glabrescent,glabrou,hal,honeycomb-shaped,lengthening,living,lower,nflorescence,orbicular,orolla,ovate,perfect,petiole,petiolulate,plurifoliate,pubescent,removed,rounded,ruit,sessile,seudostipule,side,slit,spaced,specimen,stamen,stolo,subequal,subglabrou,subtending,tall,tamen,tem,tissue,toward,tri-,unit,vary,yellow,ympodial	abaxial,adaxial,arrangement,articulation,branching,calyx,capitate,colour,form,growth,height,inflorescence,length,number,ovary,placement,presence,pseudostipule,shape,spacing,staman,stem,stolon,subglabrous,texture
226	wfo-0001028476	success	246	112	62	184	50	0.252	-6,0.4-0.6,0.5,0.5-0.6,1-4,1.1-1.5,2-foliate,2.4-3,3-foliate,absent,alternate,anther,apex,base,bract,branched,calyx,cell,cm,corolla,dark,distal,filament,fruit,fruiting,globose,green,half,herb,imparipinnate,inflorescence,interjected,interrupted,leaf,leaflet,less,long,lower,margin,mm,obovate,pedicel,perennial,petiole,present,pseudostipule,pubescent,purple,rarely,simple,stellate,stem,stripe,surface,thick,trichome,truncate,uniseriate,unit,white,wide,yellow	-1,-16,-20,-8,.05-0.1,.5,0-,0-0.5,0.1-0.15,0.1-0.4,0.15-0.2,0.15-0.4,0.2-0.3,0.2-0.5,0.2-0.6,0.25-0.4,0.25-0.5,0.3-0.4,0.3-0.5,0.3-0.7,0.3-1.2,0.4-0.5,0.4-1.5,0.5-1.7,0.7-2.5,0.8-1.2,0.8-1.6,1,1-1.2,1-1.4,1-1.5,1-2,1-2-celled,1-6,1-celled,1.1-1.6,1.2-2.5,1.8-2.5,12-30,2,2-6,2-locular,3-12,3-7,3.5-13,4-celled,5-15,6-,7-10,8-30,abaxially,abundant,acroscopically,acuminate,acute,age,almost,along,also,anthesi,ape,apical,appearance,appendage,articulated,axi,basal,basiscopically,becoming,bifurcate,bifurcation,bracteate,bright,brown,capitate,column,conical,curved,decurrent,deeply,diamete,diameter,eaf,ebracteate,edicel,eed,elliptic,elongate,entire,especially,exserted,first,flower,fortaleza,give,glabrescent,glandular,gradually,gree,hair-like,hal,head,hyaline,incurved,internode,irregularly,lanceolate,largest,lateral,like,lobe,lobed,lon,main,maturity,midvein,minute,minutely,mixed,narrowly,nflorescence,node,numerous,oblique,occasionally,often,outgrowth,ovary,pair,pale,peduncle,petiolule,population,primary,prominent,puberulent,pubescence,rachi,recurve,reflexed,regularly,rest,rounded,ruit,rÃ­o,scattered,secondary,sessile,set,short,silky,sinus,slightly,smaller,sparsely,sprawling,spreading,staminal,sterile,stiff,stigma,straight,style,subopposite,tall,tem,terminal,tertiary,testa,tip,toward,tube,ud,unicellular,uniformly,unpaired,usually,vein,wall,weak-walled,wid,winged,woody,ympodial	abaxial,adaxial,appressed,arrangement,articulation,berry,branching,breeding,broad-based,colour,connective,form,glabrous,greyish,growth,hair,heteromorphism,hirsute,history,inflated,insertion,length,life,marking,mature,modification,na,odour,orientation,placement,pore,position,prickle,rhizome,scale,seed,shape,size,spot,staman,stone,structure,symmetry,sympodial,system,texture,tuber,type,xylopodia,zygomorphy
227	wfo-0001028481	success	194	149	118	76	31	0.608	.1,.5,0.5-1,0.6-1,0Â°,1-3,1-4,1.5,1.8-2.5,1/2-2/3,2.5-3,3-3.5,3-4,3-6,5.5-7.5,8,absent,acuminate,almost,along,anther,anthesi,apex,apically,apparently,attenuate,bark,base,branch,branched,brown,chartaceous,clavate,close,cm,colour,conical,corolla,cuneate,cupular,deeply,dendritic,dendritic-pubescent,diameter,dilated,distributed,divided,dorsifixed,dry,drying,elliptic,entire,equal,evenly,filament,flaking,flower,free,glabrous,green,leaf,length,less,liana,like,lobed,long,longer,longitudinally,main,margin,midvein,mm,oblique,oblong,occasional,often,orange-brown,pair,pedicel,peduncle,petiole,poricidal,primary,pubescent,ray,reddish,ridged,scar,shortly,shrub,side,size,small,smoothly,sparsely,stem,stigma,stump,style,surface,terminal,tertiary,thickly,tip,together,trichome,tube,unarmed,unit,unknown,vein,venation,visible,white,x,yellowish,young	.3,0-2,0.1-0.2,0.15,1-1.4,1-2,1.5-2,2-3,3,3-4.5,abaxially,acute,adaxially,age,alyx,apar,articulated,canaliculate,clearly,delineated,deltoid,density,different,discolorous,domatia,eaf,eed,ellipsoi,erect,except,extending,extent,eye,faint,flat,flexuous,increasing,know,known,lamina,lengthening,linear,lobe,lon,long-acuminate,lower,m.,mostly,naked,narrowly,nflorescence,nther,orolla,ovate,perfec,plurifoliat,pore,portion,protruding,rachi,raised,ribbed,ruit,see,simple,sinus,slender,smoot,spreading,tearing,toward,ud,uneven,vary,wide,ympodial	angle,apart,armament,arrangement,articulation,branching,bud,calyx,division,ellipsoid,form,fruit,growth,inflorescence,modification,na,number,ovary,pattern,perfect,plurifoliate,position,protrusion,seed,shape,smooth,spacing,structure,sympodial,texture,type
228	wfo-0001028482	success	224	131	112	112	19	0.5	.1,.5,/3,0,0.5,0.5-1,0.5-5,1-4,1.5-3,10,2-3,2-celled,4-5,acuminate,acute,age,anther,apex,bark,base,becoming,berry,bilobed,bright,broadly,brochiodromous,brownish,bud,calyx,campanulate,capitate,chartaceous,circinate,closely,cm,corolla,creamy,cymose,deltate,diameter,distinct,drying,ellipsoid,elliptic,emarginate,embryo,entire,filament,flattened-reniform,fleshy,flower,fresh,fruit,fruiting,glabrous,glandular,globose,golden,grayish,green,growth,hard,heterostylous,internodal,leaf-opposed,lobe,lobed,long,margin,maturity,mm,new,obovate,olive,ovary,pale,pedicel,peduncle,pentamerous,per,petiole,pore,poricidal,revolute,row,scar,shaped,short,simple,slit,spaced,stem,stigma,style,subcoriaceous,subglobose,subpyramidal,tan,tear-drop,tip,tree,trichome,truncate,tube,two,uniseriate,venation,way,white,yellow,yellowish,Âµm	0.2,0.7-1.1,00,1-1.5,1-11,1-2,1.1-5,1.2-1.6,1.5-2,3-12,3-4,5-25,6-50,7-14,abaxially,adaxially,alternate,angled,anthesi,apiculae,ascending,asymmetric,basal,berr,bifid,bifurcate,branched,channeled,constriction,coriaceous,corky,corrugated,cucullate,curved,deciduous,deflexed,densely,diffusely,difoliate,discolorous,distally,dry,eaf,eed,enlarged,exerted,exfoliating,expanding,free,geminat,glabrou,halfway,impressed,incrassate,individual,investing,irregular,keeled,lengthening,less,lower,markedly,materia,material,midrib,midvein,minute,minutely,nflorescence,nodding,occasionally,overlappin,pair,papillat,pericarp,petal,pitted,portion,primary,pubescent,reddish,ruit,scandent,shiny,size,slightly,small,sometimes,somewhat,soon,sparsely,stout,straight,surface,tightly,tiny,transparent,transversely,tub,tuberculate,tuft,twice,ud,unifoliate,unit,usually,vegetative,vein,woody,x,ympodial,young	100,abaxial,adaxial,arrangement,colour,exfoliation,form,height,inflorescence,leaf,length,number,plant,position,seed,shape,texture,type,ye
229	wfo-0001028487	success	195	110	89	106	21	0.456	0-9,0.3-0.7,0.4-1.5,0.9-3,1-2,1-3,1.1-1.5,1.4-1.7,10-41,2-4,2-4.8,2-6,2.5-3.5,3-10,3-19,3.4-7.8,4-7,4.6-13.6,5-6,7.8-16.4,anther,berry,blade,brownish,central,clavate,cm,condition,coriaceous,corolla,dark,deep,diameter,drying,filament,flower,forked,fresh,fruit,glabrescent,glabrous,green,greenish,hair,herb,homostylous,interjected,lanceolate,lateral,leaf,leaflet,light,lobe,long,medium,mm,moniliform,mucilaginous,odd-pinnate,ovate,ovoid,pair,pentagonal,petiole,plant,pore,poricidal,purple,ripe,scabrous,scarce,seed,short,size,star,stigma,straight,style,substellate,terminal,tip,tube,tuber,wet,white,whitish,wide,wing,x	1-3.2,1.7-7,10-4.3,15-28,3-4,3-5,5-merou,abaxially,acumen,acuminate,acute,adaxiall,adaxially,ag,along,alyx,apart,apex,apparently,arranged,articulated,asymmetric,attenuate,axe,axillary,base,basiscopic,bead,bud,capitat,cell,connivent,considerably,covering,decreasing,digestion,distal,dorsally,eaf,edge,eed,elliptic,enzyme,erec,exceeding,flat,folded,geminat,generally,glabrou,green-white,hair-like,hal,half,high,honeycomb-shaped,lengthening,like,living,lower,make,multiple,narrow,necklace,nflorescence,orbicular,orolla,pedicel,peduncle,perfect,petiolulate,plurifoliate,removed,rounded,ruit,second,sessile,seudostipule,side,slit,smaller,sometimes,spaced,specimen,stamen,stolon,subequal,subglabrou,subtending,tall,tamen,tem,testal,thick,throughout,tissue,toward,tri-,typically,unit,unwinged,usually,vary,wall,yellow,ympodial	abaxial,adaxial,arrangement,branching,calyx,capitate,colour,form,growth,height,inflorescence,length,number,ovary,pseudostipule,shape,staman,stem,subglabrous,texture,type
230	wfo-0001028489	success	224	97	78	146	19	0.348	-2.5,0.3-1.2,0.5-1.5,0.6-1.2,1-7,1/3,1/3-1/2,2-6,3.5-6,5-25,abaxially,acicular,anther,apart,bark,berry,branched,calyx,chartaceous,cm,connivent,cream,dark,densely,diameter,dull,elliptic,elongating,equal,flattened-reniform,flower,fruit,fruiting,glabrous,gray,green,hair,lateral,leaf,length,lobed,margin,marking,mature,maturity,mauve,membranous,mm,moderately,orange,orange-brown,orange-green,ovate,pale,per,petiole,poricidal,prickle,purple,red-brown,shrub,simple,sometimes,sparsely,spherical,stellate,stellate-pubescent,stem,style,surface,tapering,tip,upper,white,yellow,yellow-green,yellow-orange,young	-0.6,-10,-4,-5,-6,/4,0-10,0-15,0-20,0-3,0-50,0.1,0.1-0.6,0.2,0.2-,0.2-0.4,0.2-0.5,0.2-0.6,0.2-0.7,0.3-0.5,0.3-0.7,0.3-1,0.4-0.8,0.5-0.8,0.5-1,0.5-1.1,0.7-3,1-3,1-4,1-6,1.5-3,1.5-4,1.8-2.2,1.8-4,1.8-5.5,1/4-1/2,2-3,2-4,2.1-3,3-7,4-10,4-13,4-8,5-8,5-merous,7.5,acute,alyx,apar,apex,apically,apparently,articulated,ba,base,beyond,blade,broad-deltate,caudat,cell,concolorous,cordate,cuneate,curved,deltate,difoliate,distance,drying,eaf,eed,erect,extending,eye,filament,free,geminat,herbaceous,infructescence,less,lobe,lon,long,longer,lower,midpoint,midvein,minute,naked,nflorescence,obtuse,occasionally,often,older,one,open,orolla,oung,outline,pair,pedicel,peduncle,pendulous,perfec,pericarp,perpendicular,porrect,portion,prickly,primary,protruding,raised,ray,rounded,ruit,scar,sessile,shiny,side,slender,smooth,spaced,spreading,stalk,straight,subsessile,tamen,terete,tertiary,time,toward,trichome,truncate,tube,unarme,unarmed,unit,vary,vein,venation,visible,way,weakly,white-gra,wide,woody,ympodial	branching,colour,corolla,form,growth,heteromorphism,inflorescence,number,ovary,placement,position,seed,shape,size,spacing,staman,texture,type,white-gray
231	wfo-0001028492	success	130	107	78	52	29	0.6	0.2-2,0.5-1,1-2.5,1-4,1-5,1.5-2.5,1.5-6,15-20,2-2.5,3,3-6,4,5-15,5-8,6-11,8-15,abaxially,acute,angled,apart,apex,axi,base,calyx,chartaceous,cm,colored,connivent,cylindrical,dark,deltate,diameter,elliptic-ovate,entire,except,forked,fruit,glabrous,globose,hair,herb,lobe,margin,mm,narrowly,obtuse,pedicel,peduncle,petiole,pore,pubescent,punctate,purple,rachi,radiu,rarely,reticulate,ripe,rounded,shrub,simple,somewhat,sparse,stellate,stigma,style,subcordate,subcoriaceous,succulent,tip,triangular,unbranched,unit,unknown,white,white-punctate,whitish,x	-5-foliat,1.5-3,1.75-3.5,2-3,2-4,2-5,2.5-9,5-25-flower,6-12,absen,adaxially,aggregate,apiculate,articulated,axe,blade,cell,ciliolate,color,containing,crystal,directed,distall,eaf,eed,glabrou,irregularly,leaving,long,lower,nflorescence,nther,orolla,ruit,san,sand-punctate,scar,spaced,splitting,stone,tal,tem,time,triangular-ovate,truncat,tube,unevenly,vary,veiny,wide,x1-3,ympodial	-5-foliate,5-25,anther,articulation,branching,colour,connivence,corolla,direction,distally,flower,form,growth,height,inflorescence,leaf,length,ovary,plant,seed,shape,spacing,stem,structure,sympodial,texture,truncate,type,width
232	wfo-0001028501	success	195	114	93	102	21	0.477	0-3,0-3.2,0-4,0.3-0.7,0.8-1.6,0.8-1.7,1,1-2,1-8,1.8-10.7,13-41,2.8-18,2.8-4.9,3-10,3-7,3.1-10.4,3.1-12,4-8,4.8-18,6.6-21.1,8-10,8-34,adaxially,anther,blade,broadly,brownish,clavate,cm,condition,coriaceous,corolla,dark,diameter,drying,filament,flower,forked,fresh,fruit,glabrescent,glabrous,green,greenish,hair,herb,homostylous,interjected,lanceolate,lateral,leaf,leaflet,light,lobe,long,medium,mm,moniliform,mottled,narrow,odd-pinnate,ovate,ovoid,pair,pedicel,peduncle,petiole,plant,pore,poricidal,purple,pyriform,rotate,scarce,seed,short,simple,size,sometimes,stigma,straight,style,terminal,tip,tube,tuber,unwinged,usually,white,whitish,wide,wing,x	0.3-3.3,0.6-5.8,1-3,2-4,2-5,3-5,5-merou,abaxially,acumen,acuminate,acute,adaxiall,ag,along,alyx,apart,apex,apparently,arranged,articulated,attenuate,axe,axillary,base,bead,berry,bud,capitat,cell,connivent,considerably,covering,decreasing,decurrent,digestion,distal,dorsally,eaf,edge,eed,elliptic,enzyme,erec,exceeding,flat,folded,geminat,generally,glabrou,green-white,hair-like,hal,half,high,honeycomb-shaped,larger,lengthening,like,linear,living,lower,make,mucilaginous,multiple,narrowly,necklace,nflorescence,onto,orbicular,orolla,perfect,plurifoliate,present,rachi,removed,ripe,ruit,sessile,seudostipule,slit,spaced,specimen,spot,stamen,stolon,subglabrou,subtending,tall,tamen,tem,testal,thick,throughout,toward,tri-,typically,unit,vary,wall,wet,yellow,ympodial	abaxial,adaxial,arrangement,branching,calyx,capitate,colour,form,growth,height,inflorescence,length,number,ovary,presence,pseudostipule,shape,staman,stem,subglabrous,texture
233	wfo-0001028502	success	158	83	64	94	19	0.405	0.5-1,1-2,1.5-2,1.5-2.5,1.5-6,1.6-2.4,2-4,2-5,2-7,2-8,3.5-15,3.5-4,abaxial,abaxially,acute,adaxially,anther,anthesi,apex,base,beige,blade,branched,calyx,campanulate,clavate,cm,congested,corolla,densely,filament,flattened-reniform,fruiting,glabrous,globose,inflorescence,leaf,lobed,margin,minutely,mm,obovate,ovary,papillose,pedicel,petiole,pitted,pore,poricidal,pubescent,reddish-brown,seed,shining,shrub,small,stigma,style,time,tree,tree-like,trichome,tube,warty,white	.5,/2,1.5-3,2-2.5,5-15,5-6,6-8,?,age,along,apar,ba,bark,body,branch,brown,cazalet,christmas-tree-like,closely,cone,constricted,dark,deltate,dendritic,denser,dia,eaf,edicel,eed,elliptic,erect,exserted,fawn,fide,flat,fleshy,flower,free,glabrat,heteromorphic,impressed,included,incrassate,inflorescenc,later,lateral,lengthening,light,like,lobe,lon,long,long-styled,lower,main,matted,middle,narrower,nflorescence,often,older,packed,pair,papillo,planar,plurifoliat,portion,prominent,rest,ruit,scar,scattered,short-styled,slit,spaced,stem,structure,surface,tall,terminal,thick,tip,tub,ud,unclear,unevenly,vein,way,wide,widest,within,woody,ympodia,young	0.5,1,4-6,branching,colour,diameter,form,fruit,growth,hair,height,heteromorphism,length,plant,shape,texture,type,width,ye
234	wfo-0001028505	success	168	101	85	83	16	0.506	.01,.3,.5,/3,0.25-0.5,0.8-1,0.8-1.5,1-3,1.2-2.5,10-14-flowered,2.5-4.5,anther,apex,basal,base,beneath,body,broadly,calyx,cm,conical,corolla,darker,deflexed,dia,elliptic,erect,expanded,f,filament,fruiting,gently,glabrous,globose,greatly,green,incrassate,leaf,lobe,lobed,long,margin,minor,minutely,mm,narrowly,opposite,ovary,ovate,ovoid-reniform,papillose,pedicel,petiole,pitted,plant,pore,poricidal,prominent,pubescent,purple,rounded,seed,shape,shaped,shrub,size,slightly,somewhat,stigma,style,surface,tan,tapering,tear-drop,tip,trichome,truncate,tube,unicellular,uniseriate,way,white,woody,x,yellowish	.1,1,1/3,10-15,2,3-5,3.5-5,7-8,acuminate,acute,anthesi,aspect,ba,barely,bark,berry,black,blade,branch,bright,bud,characteristic,deciduous,decurrent,delicate,deltoid,differentiated,differing,difoliate,distance,distinct,dried,dry,drying,eaf,edicel,eed,exserted,exsertion,flattened,free,geminat,grey,lateral,live,lon,lower,m.,main,major,materia,material,member,minute,nflorescence,obovoid,obvious,older,overlapping,pair,pale,portion,proximal,reflexed,ruit,scar,short,simple,soon,specimen,stem,straight,strongly,tall,touching,ud,unit,usually,vein,whit,widest,ympodial,young	colour,decurren,flower,form,fruit,growth,hair,height,inflorescence,length,number,position,symmetry,texture,type,venation
235	wfo-0001028524	success	236	156	133	103	23	0.564	.5-1,0.3,0.3-0.8,0.5-3.5,0.6-1.4,1-5,1.1-1.2,1.5-1.6,1/3-2/3,10-20,11,2-6,2.5-4,2.8-3.5,3-10,3-15,3.4-3.6,4-6,4-8,4.3-6,6-7,7-10,8-13,9-14,accrescent,along,anther,apart,apex,apical-lateral,bark,base,berry,blunt-tipped,branch,branched,brown,bud,calyx,chartaceous,cm,conical,corolla,cream,dark,deltoid,densely,diameter,dm,echinoid,exserted,extend,ferrugineous,filament,fleshy,flower,fruit,fruiting,glabrescent,granular-tomentose,gray,green,greenish,growth,hair,honeycombed,indument,introrse,lanceolate,large,leaf,length,lobe,long,longitudinal,many-rayed,midvein,mixed,mm,multangulate,nearly,oblong,obtuse,orbicular,ovate,pale,partly,pedicel,peduncle,persistent,petiole,pore,porrect-stellate,probably,pubescent,rachi,rather,relatively,reniform,reticulate-punctate,ripe,scabridulous,sessile,short,simple,slightly,slit,somewhat,sparingly,stamen,stellate,stelliform,stigma,style,subcoriaceous,subglobose,suborbicular,sulcate,terete,testa,thick-stalked,thin-stalked,time,tomentose,tree,tube,velutinous,way,x,yellow,yellowish,yellowish-green,young	-2.7,-3,/10-3/10,0-150,1.2-1.3,1.5-3,1.8-2.5,2-3.8,2.5-3.4,2.5-3.8,3-4.3,3.3-4,6-9,7-11,abaxially,acuminate,acute,adaxially,ag,anthesi,apparently,articulated,ascending,axe,axillary,ba,becoming,blade,capitat,closely,continued,dehiscing,distal,due,eaf,echinoi,eed,elliptic,entire,few-,few-rayed,first,free,glabrescen,glabrous,half,high,inserted,interpetalar,lacking,lanceolat,late,later,lateral,lobed,lower,m.,main,margin,matted,midvei,nflorescence,obscured,often,older,orolla,ovate-lanceolate,overlapping,perfect,plurifoliate,present,prominent,pseudo-terminal,ray,rounded,ruit,runk,short-stalked,side,small,spaced,sparsely,stalked,stem,stout-stalked,strongly,suture,tamen,thick,thin,tissue,tomentu,touching,translucent,unarme,unarmed,unit,usually,vary,vein,warty,wide,ympodial	30-150,abaxial,adaxial,age,arrangement,branching,capitate,colour,dehiscence,form,height,inflorescence,insertion,ovary,plant,seed,shape,size,spacing,staman,texture,thicknes,trunk
236	wfo-0001028525	success	257	102	85	172	17	0.331	0.2-0.3,0.5,0.5-1.5,0.5-2.5,1-2,1-2.5,1.1-1.7,10-13,2,4-15,4-5,6,accrescent,almost,anther,apically,base,berry,black,branched,branching,broadly,brown,calyx,capitate,chartaceous,clavate,cm,conical,corolla,dendritic,dendritic-pubescent,developed,dilated,drying,elongated,filament,form,frequently,fruit,fruiting,green-brown,leaf,liana,light,lobed,lumpy,mature,mauve,membranous,mm,multicellular-dendritic,obconical,oblong,orange-brown,ovate,partly,pedicel,peduncle,petiole,pore,poricidal,pubescent,pyriform,ray,red-brown,shrub,side,simple,slender,slightly,smooth,sometimes,spheroidal,stem,stigma,style,surface,terminal,tip,trichome,unarmed,whitish,x,young	.25,.4,0.2-0.6,0Â°,1-1.5,1-4,1.2-1.6,1.5,1.5-3,1/3-3/4,10,1mm,2-2.5,2-3,2.5-5,3,3-5,3-7,4,4-7,7,7-13,7.5,acuminate,acute,age,along,alternate,alyx,anthesi,apar,apart,apex,apice,apparently,around,articulated,attenuate,axil,bark,becoming,brachyblast,branch,centre,clearly,clum,clustered,cordate,cup,curved,dark,deeply,delineated,deltoid,densely,density,detaching,developing,diameter,discolorous,divided,domatia-like,dorsal,dorsifixed,eaf,eed,ellipsoi,entire,equal,erect,eye,fertilisation,fewer,fine,flat,flattened,flexible,flexuous,flower,formed,forming,free,frui,glabrescent,glabrous,grey,increasing,inside,known,lamina,lateral,laterally,leave,lengthening,less,like,linear,lobe,long,longer,longitudinally,loop,loose,lower,m.,main,margin,midvein,minute,much,naked,narrowly,nflorescence,nther,obscuring,often,one,orolla,outside,overlapping,ovoid,pair,pendulous,perfec,pericarp,plurifoliat,portion,primary,prominent,protruding,puberulous,rachi,ridged,rounded,ruit,scar,scattered,sessile,sinus,size,small,smaller,smoot,somewhat,soon,sparsely,spreading,stripe,structure,stump,tangling,tearing,terete,tertiary,thick,thin,toward,truncate,tube,ud,uneven,unit,vary,vein,venation,visible,weakly,well-developed,white,wide,wider,ympodial	0.25,arrangement,articulation,colour,growth,hair,inflorescence,length,number,ovary,pattern,position,prickle,shape,texture,type,width
237	wfo-0001028528	success	155	93	75	80	18	0.484	.5,0.9-1.2,1.5,1.8-2,2-3,2-4,3.5-4,3/4,8-9,absent,age,along,anther,attenuate,base,becoming,berry,bi-lobed,blackish,branch,branching,cm,coriaceous,corolla,decurrent,dendritic,densely,denser,diameter,elliptic,erect,filament,flattened,fork,fruiting,glabrous,globose,growth,later,leaf,lobed,long,margin,minutely,mm,narrowly,obovate,outline,ovary,pedicel,per,petiole,pitted,pore,poricidal,pubescent,reddish-brown,revolute,round,shrub,sleeve,slit-like,stigma,strongly,style,surface,terminal,time,tip,trichome,tube,vein,violet,way,x	1-2,1.1-1.2,2.5-3,3.5-6,4-5,4-6,6-10,6-7,?,abaxial,acuminate,acute,adaxial,adaxially,anthesi,apex,apical,ba,bark,basal,calyx,conical,dichasia,eaf,edicel,eed,ew,except,exserted,flower,free,glabrat,glandular,immature,impressed,inserted,leave,like,lobe,lower,m.,midvein,minute,mucronate,nflorescence,nodding,occasionally,older,pair,papillo,pericarp,petal,planar,plurifoliate,portion,prominent,pyramidal,ruit,scar,secondary,shiny,short,somewhat,sparsely,stamen,ste,stem,tall,tapering,thin,triangular,tub,ud,unit,white,wide,winged,woody,ympodial,young	bud,colour,form,fruit,height,inflorescence,insertion,length,papillose,plant,position,pubescence,seed,shape,size,texture,type,width
238	wfo-0001028529	success	164	94	75	89	19	0.457	.2,0.1,0.5-2,0.8-1.3,0.8-3.2,2.5-3,2/3,5-6,8-14,acuminate,anther,apart,apex,attenuate,bark,base,bluish,brown,bud,cast,cm,corolla,dark,decurrent,erect,exfoliating,filament,flower,fruiting,furcate,glabrous,globose,green,internodal,lanceolate,leaf,less,lobed,metallic,minutely,mm,narrowly,nearly,oblanceolate,occasionally,opposite,ovary,ovoid-reniform,paler,pedicel,petiole,pitted,planar,pore,poricidal,reflexed,scar,shape,shaped,shrub,simple,slightly,smooth,somewhat,stem,subshrub,surface,tapering,tear-drop,tip,tube,way,white,winged,woody	0.5,0.8-3,1,1-1.2,1-1.5,1.5,3-40-flowered,3-5,6-9,7-8,across,acute,age,anthesi,apiculate,becoming,beginning,beneath,berry,calyx,capitate,close,cork,course,deflexe,deltoid,dia,distal,eaf,edicel,eed,ellipsoi,elliptic,evenly,exserted,free,growing,heterostylous,hrub,hyaline,immature,indistinct,inflorescenc,lateral,lenticellat,linear,lobe,lon,long,lower,main,major,middle,minor,minute,much,nflorescence,older,one,pair,papillae,papillo,papillose,portion,present,prominent,range,river,ruit,scattered,short,size,slender,small,soon,spaced,species,stigma,straight,style,tall,ud,umbonate,variable,vein,widest,x,yellowish,young	3-40,branching,colour,deflexed,form,fruit,glabrousnes,growth,height,inflorescence,length,number,orientation,plant,position,seed,spacing,texture,width
239	wfo-0001028532	success	186	99	81	105	18	0.435	0-19,0.2-1,1-2,1-3,1.3-8.7,1.4-1.6,15-36,17-42,2-8,2.2-4.2,3-10,3-7,3.9-5,4-7,5-9,5.5-15,6.5-9.2,7.5-15.2,abaxially,adaxially,anther,blade,brownish,chartaceous,clavate,cm,condition,corolla,dark,deep,diameter,drying,filament,flower,forked,fresh,fruit,glabrous,globose,green,greenish,herb,homostylous,interjected,lanceolate,lateral,leaf,leaflet,lobe,medium,mm,moniliform,mottled,mucilaginous,odd-pinnate,ovate,ovate-lanceolate,ovoid,pair,pedicel,peduncle,pentagonal,petiole,plant,pore,poricidal,purple,rotate,seed,size,stigma,straight,style,terminal,tip,tube,tuber,wet,white,whitish,x	1-1.6,1-1.7,1-5,2-3,2-6,3-5,3.3-4.4,5-merou,abaxiall,acumen,acuminate,acute,ag,along,alyx,apart,apex,apparently,arranged,articulated,asymmetric,attenuate,axe,axillary,base,basiscopic,bead,berry,bud,capitat,cell,connivent,covering,decreasing,digestion,distal,dorsally,eaf,edge,eed,enzyme,erec,exceeding,flat,folded,geminat,generally,glabrou,green-white,hair-like,half,honeycomb-shaped,larger,lengthening,like,linear,living,long,lower,make,middl,multiple,necklace,nflorescence,orbicular,orolla,perfect,petiolulate,plurifoliate,removed,ripe,rounded,ruit,second,sessile,seudostipule,side,slightly,slit,sometimes,spaced,specimen,spot,stamen,stolon,subequal,subtending,symmetric,tall,tamen,tem,testal,thick,throughout,tissue,toward,tri-,typically,unit,unwinged,usually,vary,wall,yellow,ympodial	arrangement,branching,calyx,capitate,colour,form,growth,hair,height,inflorescence,length,ovary,pseudostipule,shape,staman,stem,symmetry,texture
240	wfo-0001028547	success	224	121	104	120	17	0.464	-13,-3,-6,.2,/2,/5,0-10,0-30,0-5,0.8-1,1-2.5,1.2-1.4,1.7-2,10-12,2-4,2-6,2.5-2.8,2.8-3.2,3.5-4.5,7-10,7-9,abaxial,acute,adaxial,anther,apex,apically,appearing,base,berry,branched,branching,bright,calyx,chartaceous,cm,conical,connivent,cuneate,curved,deltate,densely,diameter,discolorous,drying,dull,elongating,entire,equal,flattened,flattened-reniform,flower,fruit,fruiting,glabrous,inflorescence,lateral,leaf,length,lobed,long,long-acuminate,margin,mature,maturity,mauve,mm,moderately,narrow-deltate,orange,orange-brown,ovate,per,petiole,poricidal,porrect,prickle,purple,red,reflexed,sessile,shallowly,shrub,simple,sometimes,somewhat,spherical,stalked,stellate,stellate-pubescent,stem,straight,style,surface,tapering,terminal,tip,trichome,truncate,villous,way,wide,yellow,yellow-orange	-1/2,.5,.7,.8,0,0-1,0-15,0-2,0.05-0.15,0.1-0.2,0.15,0.2-0.35,0.3-0.4,0.5-,0.7-1,1-2,1-4,1-5,1.5-2.5,1/3,1/5-1/4,2-1.5,2-2.5,3-5,4-5,4-6,5-merous,6-8,abaxially,absent,alyx,apar,apart,ape,apparently,articulated,bark,blade,bulbous,cell,cream,dark,distance,eaf,eed,elongate,erect,extending,faint,filament,free,gently,glabrescent,glabrou,gray-brow,green,infructescence,lobe,lon,long-styled,longer,lower,marking,midpoint,midvein,nflorescence,oblong,occasionally,often,older,one,open,orolla,oung,outline,pair,pale,pedicel,peduncle,pendulous,perfect,pericarp,pit,plurifoliat,portion,prickl,prickly,primary,raised,ray,reddish,rounded,ruit,scandent,scar,short-styled,side,slender,small,smooth,spaced,spreading,stalk,staminate,subsessile,tamen,terete,tertiary,thin-acuminat,time,tube,unit,usually,vary,vein,venation,woody,yellow-green,ympodial,young	colour,corolla,form,growth,heteromorphism,number,ovary,placement,position,seed,shape,size,staman,texture,thin-acuminate,type,width
241	wfo-0001028587	success	178	141	119	59	22	0.669	.4,.5,.75,0,0.3,0.3-1,0.5,0.5-1,0.7-1.2,0.8-1.6,0.8-1.8,0.8-2.9,1-1.3,1-2,1-4,1.3-5.1,2.1-6.9,2.5,6-8,6.5-17.7,8-10-flowered,abruptly,across,anther,anthesi,bark,base,becoming,brown,calyx,closely,cm,coat,corolla,cracking,cup,densely,dia,difoliate,drying,ellipsoid,filament,flower,forming,fruit,fruiting,geminate,glabrous,globose,green,greenish-white,lamina,leaf,length,like,lobed,long,long-styled,lower,major,minor,minute,minutely,mm,narrowing,nearly,obovate,obovoid,older,open,opposite,ovary,ovate,ovoid-reniform,paler,papillose,pedicel,peeling,per,petiole,pitted,pore,poricidal,puberulent,pubescent,pubesent,scar,scattered,seed,short,shrub,simple,slender,slit-like,spaced,sparsely,stem,stigma,straight,straw-colored,style,subumbellate,surface,terminal,thickened,thin,tip,trichome,tube,unicellular,uniseriate,unit,upon,upper,vein,white,wide,x,young	1-1.5,1/4,2-5,3-8,8-10,accrescent,acuminate,acute,apex,baseflower,berry,ca,chartaceou,deflexed,degree,different,distal,eaf,edicel,eed,erect,free,geminat,impressed,keeled,lateral,layer,lobe,lon,main,middle,midrib,nflorescence,obe,occasionally,often,outer,overlappin,pair,papillo,persistent,portion,pubescence,reflexed,ruit,slightly,stiff,tall,transversel,triangular,two,type,ud,umbonate,usually,variable,widest,woody,ympodial	accrescence,arrangement,bud,colour,diameter,form,growth,hair,height,inflorescence,modification,number,overlapping,plant,position,shape,size,structure,sympodial,texture,thicknes,transversely
242	wfo-0001028594	success	142	107	88	54	19	0.62	.5,0-100,0.8-1.8,1-1.2,1-1.3,1-1.5,1-2,1-3,1.5-9,12,12-14,2,3-4,3-9,5-6,6-20,abaxially,acuminate,acute,anther,apex,axil,axillary,base,becoming,black,bottle-shaped,calyx,cell,cm,conical,corolla,densely,diameter,drying,ellipsoid,elliptic,epidermal,especially,exserted,filament,flattened-reniform,fruit,fruiting,glabrous,globose,green,hair-like,herb,immature,inflorescence,leaf,length,lobe,long,margin,maturity,minute,minutely,mm,obtuse,orange-brown,ovary,ovate,pedicel,per,petiole,planar,projection,pubescent,purple,rectangular,reddish,reflexed,regular,rounded,simple,slightly,smooth,somewhat,sparsely,spreading,stigma,strongly,style,tube,violet,x	0.3-1.0,3-6,6-7,adaxially,along,anthesi,bearing,berry,capitat,climbing,denser,eaf,edicel,eed,floo,flower,forest,free,glabrat,inflorescenc,lax,like,lon,lower,nflorescence,noddin,often,open,pair,papillate,pendent,portion,primary,quit,rest,ruit,scar,scattered,side,soft,strait,surface,tem,time,tip,trailing,trichome,tub,ud,unifoliat,uniseriate,unit,vein,ympodial	arrangement,branching,bud,capitate,colour,exsertion,form,growth,hair,height,nodding,number,plant,position,seed,shape,size,stem,straith
243	wfo-0001028660	success	204	108	89	115	19	0.436	0.2-1.1,0.5-2.8,0.5-5.5,0.9-2.5,1-2,1.5-2.8,1.5-4,1.5-7.6,2-11,2-5,2-6,2-9,3-30,3.8-13,4-6,5-8,6,7-10,abaxially,absent,adaxially,anther,blade,blue,brownish,chartaceous,cm,condition,corolla,densely,diameter,dorsally,drying,edge,entirely,filament,flat,flower,folded,forked,fresh,fruit,glabrous,globose,green,greenish,hair,herb,homostylous,interjected,lanceolate,lateral,leaflet,lengthening,membranous,minutely,mm,odd-pinnate,ovoid,pair,pedicel,peduncle,pentagonal,petiole,plant,pore,poricidal,puberulent,pubescent,purple,rarely,ripe,rotate,seed,size,slit,sparsely,stem,style,substellate,terminal,tinged,tip,tuber,typically,unwinged,white,whitish,x	0-5,0.1-0.3,0.3-1.1,0.7-4.2,0.8-1,1-10,20,3-5,3-7,3-9,5-merou,acumen,acute,ag,along,alyx,apart,apex,apparently,articulated,attenuate,axe,axillary,base,berry,borne,broadly,bud,capitat,cell,ciliate,clavate,connivent,covering,decumbent,decurrent,digestion,distal,dot,eaf,eed,elliptic,end,enzyme,erec,especially,exceeding,except,geminat,generally,glabrou,greatly,green-white,hair-like,half,honeycomb-shaped,less,like,linear,living,lobe,long,lower,make,margin,middl,midrib,mucilaginous,narrowly,nflorescence,oblique,obtuse,often,orbicular,orolla,ovate,perfect,petiolulate,petiolule,plurifoliate,proximal,reduced,removed,ruit,scabrous,scattered,sessile,seudostipule,short,singly,spaced,specimen,stamen,ste,stigma,stolo,straight,subequal,subtending,sunny,tall,tamen,tem,testal,thick,throughout,tri-,tube,unit,usually,vary,wall,wet,yellow,ympodial	age,arrangement,branching,calyx,colour,form,growth,height,inflorescence,leaf,length,ovary,presence,present,pseudostipule,shape,staman,symmetry,texture
244	wfo-0001028667	success	129	108	85	44	23	0.659	-2.6,.5,0.4-0.7,0.7-4,1-1.5,1-2-1.5,1-6,5,5-20,8-10,acute,anthesi,apex,articulated,axillary,base,berry,branch,branched,calyx,cell,clustered,cm,completely,coriaceous,corolla,creamy,diameter,discolorous,dry,ellipsoid,elliptic,entire,exfoliating,exserted,flattened,flower,fragrant,fruiting,glabrous,growth,inflorescence,irregularly,leaf,like,margin,minutely,mm,narrowly,new,occasionally,other,outer,pale,pedicel,peduncle,per,perfect,petiole,pitted,primary,reniform,revolute,scar,shiny,shoot,short,simple,sleeve,slightly,small,spaced,stem,straw-colored,strongly,surface,terminal,tip,twice,vein,vine,white,woody,wrinkling,yellow	1-4.5,1.3-2,3,3-11,5-merou,aid,alyx,apar,appearing,ark,around,climbin,climbing,conical,curling,deciduous,eaf,eed,exfoliatin,fide,lobe,long,lower,mentz,midrib,nflorescence,older,orolla,papilla,papillat,pendan,plurifoliat,slender,soon,support,tem,triangular,tube,twining,ud,unit,visible,x,ympodial	5-merous,apart,arrangement,articulation,bark,branching,bud,colour,discoloration,exfoliation,exsertion,form,fragrance,hair,length,morphology,number,papillae,pendant,position,seed,shape,texture
245	wfo-0001028688	success	137	93	73	64	20	0.533	.5,0.4-1,0.5,0.5-0.75,0.5-1,0.9-1,1-1.8,1-5,1.1-1.2,1.4-2.8,2-3,2.2-4.8,5-11,5-6,across,acute,anther,anthesi,area,bark,base,beneath,calyx,clavate,cm,corolla,curl-tipped,densely,filament,furcate,glabrous,golden,lanceolate,leaf,lobed,minor,mm,near,nearly,occasionally,opposite,ovary,overtopping,paler,papillose,pedicel,petiole,pilose,pore,pubescent,reddish-brown,shaped,shiny,shoot,shrub,size,slender,slightly,sparsely,stem,stigma,straight,style,tapering,tear-drop,terminal,thickened,tip,trichome,tube,uniseriate,white,x	0.5-1.5,1-1.5,1-3,acuminate,along,apar,apex,bi-cellular,branch,deciduous,decreasing,deflexed,deltoid,densest,dia,differing,difoliate,eaf,edicel,eed,elliptic,exfoliatin,exserted,free,geminat,globose,interpetalar,irregularly,know,known,like,lobe,lon,long,lower,major,markedly,membraneous,middle,minutely,nflorescence,often,older,planar,poricidal,portion,proximal,ruit,scar,sinus,soon,spaced,styl,tall,thin,tub,ud,unit,usually,vein,wide,widest,ympodial,young	branching,colour,deflexion,exfoliating,form,fruit,growth,hair,height,inflorescence,length,modification,na,plant,position,seed,shape,symmetry,texture,type
246	wfo-0001028698	success	166	113	84	82	29	0.506	0.3-0.75,1-2,1-4,1-9.8,1.9-4,13-25,2-10,2-4,3-17,3-5,5-15,5-6,5-8,6-13,6-27,8-10,9-35,acute,apical,apically,branched,calyx,cm,conical,connate,corolla,cyme,dark,dehiscent,diameter,dichasial,dichasially,distal,dorsally,edge,ellipsoid,filament,flat,flower,folded,green,green-white,herbaceous,interjected,introrse,lateral,leaf,leaflet,light,lobe,long-attenuate,maturing,medium,mm,monochasial,odd-pinnate,often,ovoid,pair,pedicel,peduncle,pentagonal,perennial,perfect,petiole,plant,poricidally,proximal,puberulent,pubescent,rotate,seed,short,slit,straight,strigose,style,terminal,throughout,tuber-bearing,unit,violet,white,Â¼	0-1.,1.8-5,2-3,3-6-foliat,3.5,4-14,6,abaxiall,abaxially,acumen,acuminate,adaxially,apex,articulate,base,broadly,cell,commonly,covering,cuneate,darker,decurrent,digestion,diminishing,dot,eaf,ebracteate,eed,elliptical,emoval,enzyme,equal,exceeding,first,forked,generally,globo,gradually,hair-like,half,honeycomb,living,lon,long,lower,lunat,make,minute,mucilaginous,nflorescence,nther,oblique,orolla,ovate,pattern,petiolule,plan,rachi,raised,rarely,reveal,ruit,sessile,seudostipule,size,smooth,specimen,stamen,stigma,tal,tem,testal,thick,toward,two,typically,usually,vary,wall,wide,yellow,ympodial	0-10,3-6-foliate,abaxial,adaxial,anther,arrangement,articulation,bract,branching,colour,ebbrate,form,fruit,growth,height,inflorescence,length,lunate,number,ovary,pore,pseudostipule,shape,stem,structure,sympodial,texture,type,width
247	wfo-0001028716	success	145	114	95	50	19	0.655	.2,.5,0.5,0.6-1.9,0.75,1-2,1.9-5.5,10-40-flowered,11-16.4,2.2-7.9,2.5-8,3.6-8.8,7-8,8-9,9-10,across,acuminate,anther,anthesi,apart,apex,bark,base,beginning,bi-cellular,brown,calyx,cm,corolla,cuneate,dark,decurrent,difoliate,ellipsoid,elliptic,evenly,except,filament,geminate,glabrous,glandular,hirsute,lateral,leaf,less,like,lobed,long,main,major,middle,minor,minutely,mm,nearly,node,often,older,opposite,orbicular,ovary,ovate,pair,papillose,pedicel,petiole,pore,proximal,puberulent,pubescent,rounded,scar,shape,shaped,shrub,simple,size,slightly,spaced,sparsely,stem,straight,strongly,style,tear-drop,trichome,truncate,uniseriate,unit,vein,white,widening,widest,x,young	2-4,5-6,anisophyllou,appearing,asymmetric,ba,becoming,beneath,branched,deflexed,dia,differing,eaf,edicel,eed,fertilization,fifth,filiform,free,fruit,inflorescenc,intermediate,know,known,lengthening,lenticellat,lobe,lon,long-triangular,lower,markedly,much,nflorescence,one,pointed,poricidal,portion,prominent,raised,reflexed,remaining,ruit,stigm,tall,tip,triangular,tube,two,ud,ympodial	anisophyllous,bud,colour,diameter,flower,form,growth,hair,height,inflorescence,length,lenticellate,plant,position,spacing,stigma,structure,sympodial,texture
248	wfo-0001028723	success	211	119	95	116	24	0.45	-1.5,0-0.5,0.2,0.8-1,1,1-1.8,1-2.2,1-2.5,1/3-1/2,1/5-1/3,10-15,2-2.5,2-2.7,3-4,3.5-4,4-5,5,5-6,5-7,abaxially,acute,adaxially,almost,anther,anthesi,apex,base,branched,branching,broadly,brown,calyx,capitate,clustered,cm,common,conical,corolla,dark,dendritic,diameter,domatia,elliptic,entire,faint,filament,fine,flat,glabrous,green,leaf,length,less,liana,lobed,long-attenuate,margin,membranous,midvein,minutely,mm,obconical,oblong,obovate,occasional,orange-brown,pair,pedicel,peduncle,petiole,pore,poricidal,primary,pubescent,raised,ray,shrub,simple,smooth,sparsely,stem,stigma,style,surface,terminal,tertiary,tip,trichome,tube,unarmed,unevenly,vein,venation,widely,x	.3,.5,0.8-2,0Â°,1-1.5,10-16,2-4,2.5,4,abaxial,age,alternate,alyx,another,apar,apically,apice,apparently,articulated,bark,becoming,brachyblast,branch,clearly,concolorous,curved,decurrent,delineated,deltoid,densely,density,developed,dilated,divided,dorsifixed,drying,eaf,eed,ellipsoi,equal,except,ey,flexuous,flower,formed,free,frequent,gradual,increasing,inner,junction,know,known,lengthening,like,lobe,long,longitudinally,lower,m.,main,middle,mostly,much,multiply,naked,narrowly,nflorescence,nther,obtuse,one,orolla,outer,ovate,overlapping,pale,papillo,perfec,plurifoliat,poorly,portion,prominent,protruding,rachi,region,regular,ridged,ruit,scar,separated,short,side,sinus,slender,small,smaller,spreading,stump,surrounding,tearing,tissu,toward,transition,tuft,ud,uneven,unit,vary,visible,white,wide,wrinkled,yellow,ympodial,young,youngest	arrangement,articulation,colour,division,form,fruit,growth,habit,hair,inflorescence,na,number,ovary,papillose,pattern,plant,position,prominence,protrusion,seed,shape,size,texture,type
249	wfo-0001028736	success	180	159	141	39	18	0.783	0.2-0.4,0.5,0.5-1,0.5-1.5,0.5-1mm,0.5-2,1,1-1.5,1-2,1-3,1.5,1.5-3,1/6,10-15,2-4,2-5,2-7,3-5,3-6,3-8,3.5-5,4-12,4-6,4-9,40-70,5-10,5-15,6-8,abaxially,absent,accrescent,acute,adaxially,anther,apex,apical,apparently,armed,attenuate,base,berry,beyond,brown,calyx,chartaceous,cm,connivent,cordate,created,cut,cylindrical,dark,decurrent,densely,diameter,directed,either,exserted,filament,flattened,flower,fruit,fruiting,glabrous,glandular,globose,green,hair,immature,leaf,length,less,light,like,lobe,long,major,many,mature,midpoint,midvein,mm,moderately,mottled,multicellular,multiseriate,narrowly,nearly,netlike,obtuse,occasionally,onto,orange,pedicel,peduncle,per,perfect,petiole,pit,pore,porrect-stellate,prickle,pubescent,purple,rachi,raised,ray,red,reniform,rhombic,ridge,roselike,shrub,side,simple,sinus,small,sparsely,stalk,stamen,stellate,stem,stigma,style,surface,tapering,thin-skinned,triangular,tube,unarmed,unbranched,unicellular,uniseriate,unlobed,vein,way,white,wide,x,yellow,yellow-white	5-merou,6-13x3-8,adaxiall,alyx,apar,axe,blade,contiguous,difoliate,discolorous,eaf,eed,extra-axillary,filiform,frui,geminate,glabrou,gree,introsel,lobed,lower,m.,midrib,nflorescence,occasional,orolla,pair,recurved,ruit,scanden,slightly,spaced,ste,tamen,tem,unequa,unit,vary,ympodial	5-merous,branching,colour,corolla,form,growth,inflorescence,introsely,number,ovary,pubescence,recurred,seed,shape,staman,texture,type,width
250	wfo-0001028737	success	151	96	68	83	28	0.45	0.2-0.5,0.7-2,1,1-2.5,1-6,1.5-3.5,10,12-14,16-30,2-3,2-5,2.8-3.5,3-5,4-10,4-6.5,4-9,6,7-15,apically,branched,cm,connate,corolla,cyme,dehiscent,diameter,dichasial,dichasially,distal,flower,forked,glabrescent,glandular,globose,green,green-white,hair-like,herbaceous,interjected,lateral,leaf,leaflet,long,mm,monochasial,odd-pinnate,ovoid,pedicel,peduncle,perennial,perfect,petiole,plant,poricidally,proximal,seed,size,stellate,stigma,style,terminal,throughout,tuber-bearing,unit,wall,wide,yellow,Â¼	1-4,3-4,3-6-foliat,5-6,abaxially,absen,acumen,acuminate,acute,adaxially,apex,apical,apiculate,articulate,attenuate,base,calyx,caudate,cell,covering,decurrent,digestion,diminishing,dorsally,eaf,ebracteate,edge,eed,elliptic-lanceolate,emoval,enzyme,exceeding,filament,flat,folded,generally,globo,gradually,half,honeycomb,introrse,lanceolate,larger,living,lobe,lon,lower,make,maturing,mucilaginous,nflorescence,nther,oblique,oblong,often,orolla,pair,pattern,pinnatifi,plan,rachi,reveal,ruit,second,sessile,seudostipule,short,slit,specimen,stamen,straight,strongly,tal,tem,testal,thick,throughou,toward,typically,vary,whit,without,ympodial	3-6-foliate,absent,anther,arrangement,articulation,branching,colour,connective,form,fruit,growth,height,inflorescence,length,number,ovary,pinnatifid,pore,present,pseudostipule,shape,stem,structure,sympodial,texture,type,white,width
251	wfo-0001028777	success	205	96	78	127	18	0.38	-10,0-30,0.4-0.8,0.7-1.2,1-3,1.5-4,2.5-5,3.5-5,3/4-4/5,4.5-8,abaxially,anther,apex,base,berry,branched,calyx,chartaceous,cm,connivent,dark,elongating,entire,equal,flattened-reniform,flower,fruit,fruiting,glabrescent,green,green-brown,inflorescence,leaf,length,lobed,long,margin,marking,maturity,mauve,minute,mm,moderately,obovate,occasionally,orange,ovate,pale,per,perfect,petiole,poricidal,reflexed,shoot,short,short-styled,shrub,simple,small,sometimes,spherical,staminate,stellate-pubescent,stem,style,surface,tapering,terete,terminal,tip,tree,trichome,unarmed,usually,way,white,yellow-green,young	-12,-2.5,-3,-4,.5,.8,.9,0-2,0.1-0.2,0.1-0.3,0.2,0.5-1.3,0.6-1,0.7-1.3,0.8-1,0.8-2.2,1,1-2,1-2.5,1.5,1.5-3,1.8-2.5,1/4,1/4-1/2,2-,2.5,2.5-3,3,4-5-merous,6-10,7-11,8,8-15,acuminat,acute,alyx,ame,apar,ape,apically,articulated,attenuate,bark,blade,briefly,c.,concolorous,curved,deciduou,deltate,diameter,discolorous,drying,eaf,eed,erect,faint,filament,free,glabrescen,glabrous,infructescence,lengt,less,lobe,long-styled,longer,lower,mature,midpoint,multangulate,narrow-deltate,nflorescence,older,one,open,orange-brown,orolla,oung,pair,pedicel,peduncle,pericarp,plurifoliat,porrect,portion,present,primary,ray,recurved,red-brown,reflexe,retuse,rounded,ruit,scar,sessile,shorte,shorter,smooth,somewhat,soon,spaced,sparsely,spreading,stalk,stalked,stellate,stout,strongly,tamen,tertiary,time,truncate,tube,unarme,unit,variously,vary,vein,venation,visible,whole,wide,wider,woody,ympodial	branching,colour,corolla,form,growth,hair,height,heteromorphism,number,ovary,plant,position,prickle,seed,shape,staman,texture,type
252	wfo-0001028791	success	257	142	118	139	24	0.459	+,0.05-0.2,0.25-0.3,0.3-0.4,0.4-0.5,0.4-0.65,0.45-0.55,0.6-0.8,0.8-1,0.8-1.3,1-1.5,1-2,1-2-celled,1-3-celled,1.5-2,1.7-2.1,1.8-3.3,10,2-3,2-3.5,2-7,2-7-celled,2-locular,2.8-3.0,3-,4-15,4-5+,4-celled,5-,5-15,5-22,5-plurifoliate,50-80,8-10-celled,9-30,9-35,absent,abundant,acute,anther,apex,articulation,base,branched,broadly,calyx,capitate,cm,conical,corolla,dark,deciduous,densely,developed,diameter,dichotomously,eglandular,elliptic,entire,fruit,fruiting,glandular,globose,green,growing,head,imparipinnate,internode,interrupted,leaf,leaflet,liana,lobe,long,many,margin,middle,mm,multicellular,near,oblique,ovary,pedicel,peduncle,petiole,plant,poorly,pseudostipule,pubescent,seed,short,simple,sometimes,somewhat,sparse,sparsely,stellate,stem,stiff,stigma,style,thick,time,tip,transparent,trichome,truncate,tube,unicellular,uniseriate,unit,usually,vine,white,wide,woody,yellow,â1-2-celled	-0.6,-1.5,-9,.5,0-6,0.05,0.2-0.3,0.2-0.4,0.2-0.8,0.3-0.5,0.3-0.6,0.3-0.8,0.4-0.6,0.4-1.1,0.5,0.6-0.9,0.7-1.5,1-3,1-celled,1.5-,1.6-4.5,100,2.5-4.5,20-to,3-4,4-11.5,5-10,abaxially,absen,acuminate,adaxially,addition,ag,along,anthesi,apical,appearance,appendage,articulated,basal,basiscopically,beneath,berr,border,breaking,brown,bullate,cell,clambering,colo.,column,consistently,darker,deltate,densest,eaf,ebracteate,edicel,eed,elongating,enlarged,even,exserted,extended,filament,flower,free,give,glabrescent,glabrous,gree,grow,hair-like,half,halfway,interjected,lamina,large,lateral,leaving,less,like,lon,lower,midvein,minutely,mixture,much,nflorescence,obovate,occasionally,often,outgrowth,pair,pale,paler,papillate,per,petiolule,present,primary,protuberance,pubescence,rachi,reflexed,rest,rough,round,ruit,sandpapery,scandent,secondary,sessile,shorter,silky,single,slightly,small,smaller,spreading,stamen,staminal,sterile,straight,surface,tal,tem,terminal,tertiary,testa,thickened,touch,ud,upper,vegetation,vein,wall,winged,ympodial	abaxial,adaxial,age,arrangement,branching,bud,colour,form,glabrescence,growth,hair,height,inflorescence,length,position,shape,staman,structure,sympodial,tall,texture,thicknes,type,width
253	wfo-0001028798	success	214	133	105	109	28	0.491	0-1,0.2-0.4,0.5-2,0.9-1.2,1-4.5,1/20,10,15-19,2-3,3-5,5-8,7-8,anther,apical-lateral,articulated,attenuate,base,becoming,blade,branch,branched,bud,calyx,chartaceous,cm,conical,continued,corolla,decurrent,dm,due,echinoid,entire,extend,filament,flower,fruit,green,greenish,growth,hair,introrse,lanceolate,large,lateral,leaf,length,less,lined,long,longitudinal,main,many,margin,midvein,mixed,mm,multangulate,nearly,oblanceolate,oblong,obovate,orbicular,pale,pedicel,peduncle,persistent,persistently,petiole,plurifoliate,pore,porrect-stellate,probably,rachi,ray,ripe,rotate-stellate,rough-granular,sessile,short-stalked,shrub,side,simple,slightly,slit,somewhat,stalked,stem,stigma,style,subcampanulate,subcoriaceous,subglobose,sulcate,time,tomentose,tomentum,translucent,unarmed,unit,vein,velutinous,x,yellow,yellowish	.5-5,0-60,1-3,1-6,1.1-2,1.5-1.8,1/2-2/3,2-3.75,2-6,2-7,2.4-4.4,2.5-3.5,2.6-4,2/3,3-4,3.3-5.6,3.8-4.2,4-5.4,5.25-7.5,6-10,6-8,8-18,8.5-13,abaxially,accrescent,acuminate,acute,adaxially,ag,anthesi,apart,apex,apparently,axe,axillary,ba,berry,blunt-tipped,boat-shaped,capitat,curved,cylindrical,dehiscing,densely,diameter,distal,downward,eaf,echinoi,eed,exserted,fleshy,free,fruiting,glabrous,granular,granular-tomentose,hal,high,included,inserted,irregularly,lacking,lobe,lobed,lower,m.,minutely,multangulat,nflorescence,oblanceolat,obscured,obtuse,often,orolla,oung,ovate-lanceolate,overlapping,perfect,present,prominent,pseudo-terminal,pubescent,quite,rather,rough,ruit,semi-ovate,short,small,spaced,sparingly,splitting,stamen,stellate-pubescent,strongly,suture,tamen,thick,tip,tomentu,toward,tube,unarme,unknow,vary,way,wide,ympodial	abaxial,adaxial,age,articulation,branching,capitate,colour,form,height,inflorescence,na,ovary,plant,position,prickle,pseudoterminally,scale,seed,shape,staman,structure,sulcation,sympodial,texture,trichome,type,unknown,young
254	wfo-0001028815	success	196	97	77	119	20	0.393	0.4-0.8,0.5-1,1-2,1-4,1-5,10-15,14-28,2-4,3-4,3-5,3-7,4-10,5-6,5-7,6-10,6-8,abaxially,adaxially,anther,auriculate,blade,brownish,chartaceous,cm,condition,corolla,dark,diameter,drying,elliptic-lanceolate,flower,forked,fresh,fruit,glabrous,globose,green,greenish,herb,homostylous,interjected,lanceolate,lateral,leaflet,lilac-purple,lobe,medium,membranous,mm,narrowly,odd-pinnate,ovoid,pair,petiole,plant,pore,poricidal,pubescent,purple,red-purple,rugose,seed,size,sparsely,stem,stigma,straight,style,terminal,tinged,tip,triangular-lanceolate,tube,unwinged,whitish,winged,x	1-10,1-3.5,2-4.5,2-9,2.5-6.5,22-35,5-merou,7-16,acumen,acute,ag,along,alyx,apart,apex,apparently,articulated,articulation,axe,axillary,base,basiscopic,berry,broadly,bud,capitat,cell,ciliate,connivent,covering,cuneate,decreasing,decurrent,developing,digestion,distal,distinct,dorsally,eaf,edge,eed,elliptic,enzyme,especially,exceeding,filament,flat,folded,geminat,generally,glabrou,green-white,hair,hair-like,hal,half,high,honeycomb-shaped,indistinct,lengthening,like,living,long,lower,make,margin,midrib,minutely,mucilaginous,nflorescence,obtuse,onto,orolla,ovate,papillose,pedicel,peduncle,perfect,petiolulate,plurifoliate,pointed,puberulent,purpl,rachi,removed,ripe,rotate,rounded,ruit,semi-erec,semi-rosette,sessile,seudostipule,short,side,slightly,slit,spaced,specimen,splotched,stamen,ste,subtending,tall,tamen,tem,terminated,testal,thick,throughout,tri-,unit,usually,vary,wall,wet,yellow,ympodial,young	arrangement,branching,calyx,capitate,colour,form,growth,height,inflorescence,leaf,length,number,ovary,pseudostipule,pubescence,rugosity,shape,symmetry,texture,winging
255	wfo-0001028876	success	127	68	53	74	15	0.417	.5,/4,0.4-1,0.5-2,1-2,1.5-2,5-6,abaxial,acute,anther,apex,attenuate,base,calyx,capitate,cm,conical,corolla,dendritic,densely,elliptic,filament,glabrous,internodal,leaf,lobed,minutely,mm,opposite,ovary,papillose,pedicel,petiole,pore,pubescent,sagittate,shaped,shining,shrub,simple,small,sparsely,stigma,style,subshrub,surface,tear-drop,trichome,tube,type,uniseriate,way,white	1.5-3,2-2.3,3-5,3-8,4-5,4-8,abaxially,adaxially,along,anthesi,bark,branched,brown,closely,dark,dia,difoliate,drying,eaf,edicel,eed,ellipsoid,flower,free,geminat,glabrat,golden,hroughout,included,inflorescenc,know,known,lamina,lateral,leave,like,lobe,long,long-triangular,lower,main,middle,midrib,nflorescence,nodding,occasionally,older,overlappin,pair,papillae,papillo,planar,poricidal,portion,reddish,rest,rounded,ruti,scar,slender,spaced,speciman,stem,straight,tall,tip,tub,ud,unit,vein,widest,x,ympodial,young	branching,colour,diameter,form,fruit,growth,height,inflorescence,length,na,plant,position,seed,shape,texture
256	wfo-0001028883	success	207	145	124	83	21	0.599	0.3â0.6,0.4â1.2,1,1â2,1â6,2,2â3,2â5,3â5,4,4â6,5,50,6,6â10,6â12,abaxially,absent,acuminate,acute,almost,anther,antrorse,apex,articulated,attenuate,base,berry,brochidodromous,calyx,cell,chartaceous,ciliate,circular,cm,completely,concolorous,connivent,coriaceous,curved,cylindrical,cyme,dark,deltate,diameter,drying,dull,elliptic,elliptic-ovate,entire,exfoliating,filament,flattened,flower,fruit,glabrescent,glabrous,globose,green,greenish,growth,herb,hilum,hollow,introrsely,lateral,leaf,length,light,like,lobe,longitudinal,margin,membranaceous,minor,mm,moderately,narrowly,normally,notably,oblong,obtuse,opening,pedicel,peduncle,per,perfect,petiole,pore,present,pubescence,pubescent,rachi,rarely,region,reniform,ripe,rounded,seed,shiny,shrub,similar,simple,size,slightly,slit,small,sparsely,stellate,stem,stigma,straight,style,subopposite,surface,trichome,unbranched,undulate,uniseriate,venation,white,whitish,yellow,Ã	0.5â2,0.6,1.5â7,5-merou,accrescent,adaxiall,adaxially,along,alyx,antrorsely,apar,arched,ark,ascending,axi,becoming,blade,branch,brow,capitat,capitate,common,decurrent,densely,differing,directed,eaf,eed,emarginate,equal,erect,eye,frui,geminate,geniculat,glabrou,glandular,head,impressed,less,long,lower,lying,midrib,multicellular,naked,new,nflorescence,often,older,onto,orolla,ovate-lanceolate,parallel,pendan,plurifoliate,poricidal,primarily,prominent,ruit,secondary,sessile,shap,single,single-celled,sometimes,spaced,sparse,spreading,stalk,subapical,subsessile,swollen,tall,tamen,tem,unit,vary,vein,visible,wide,woody,ympodial	5-merous,arrangement,articulation,bark,colour,corolla,direction,form,hair,height,inflorescence,number,orientation,ovary,plant,position,shape,staman,texture,type,width
257	wfo-0001028885	success	214	111	93	121	18	0.435	-1,.5,0.3-0.5,0.5-1,0.7-2,1-2,1.5-1.7,10-20,2/3,3-5,3.5-4.5,7-8,9-11,abaxial,acute,adaxially,anther,apex,attenuate,base,berry,black,branched,brown,capitate,cm,corolla,dark,densely,diameter,ellipsoid,elliptic,entire,filament,fleshy,flower,fruiting,furcate,glabrescent,glabrous,globose,golden,growth,height,inflorescence,known,lanceolate,lateral,leaf,lengthening,lobed,lower,margin,mm,multicellular,narrowly,occasionally,pedicel,petiole,plant,pore,poricidal,pubescent,purple,recorded,reddish,revolute,ripe,scandent,scattered,shiny,shrub,simple,slightly,slit,sometimes,sparsely,stellate,stem,stigma,style,surface,terminal,time,tip,trichome,uniseriate,upper,vine,way,winged,woody,Â¾	0.5-5,1-1.2,1-1.5,1-3,1.5-3.5,2,2-,2-2.5,2.3-2.5,2.5-3.5,3.5-8.5,4-5,5-merou,7-9,9-12,?,adaxial,ag,along,alyx,anthesi,apart,apiculate,apparently,archin,ark,articulated,basal,blackish,branch,broadly,calyx,cell,collapsing,connivent,cup-shaped,dark-pigmented,decurrent,deltate,dendriti,distal,dried,drying,eaf,eed,erect,exserted,extending,free,glabrou,glandular,gradually,groove,groupe,ilament,immature,inserted,irregularly,lamina,leaving,less,like,live,lobe,long,loosely,material,midvein,minute,minutely,mostly,narrowing,new,nflorescence,noddin,nodding,often,older,orolla,pair,papillo,part,peduncle,peg,perfect,pericarp,pigmentation,plurifoliat,portion,primary,quarter,retaining,rhachi,ruit,scar,shin,short,sleeve,slender,small,smaller,spaced,spheroidal,spreading,strongly,tangled,tem,thin,third,tube,twinin,ud,unit,usually,vary,vein,wall,weak,weak-walled,wide,ympodial	age,arching,bark,branching,colour,form,fruit,hair,length,ovary,pattern,presence,seed,shape,symmetry,texture,type,ye
258	wfo-0001028888	success	207	152	131	76	21	0.633	0-7,0.15-0.5,1-1.5,1-10,1-2,10-25,12.5-25,2.3-5,2.3-7,3-4,3.6-12.5,4-25,5-10,5-7,6-11,8-11,8-13.5,abaxially,adaxially,along,anther,apart,blade,brownish,cell,center,chartaceous,ciliate,clavate,cm,condition,connivent,corolla,covering,diameter,distal,dorsally,dot,drying,edge,end,especially,except,filament,flat,flower,folded,forked,fresh,fruit,generally,glabrous,glaucous,globose,greatly,green,green-white,greenish,hair,hair-like,half,herb,homostylous,interjected,lanceolate,lateral,leaflet,lengthening,like,lobe,long,low,make,margin,membranous,middle,midrib,minutely,mm,mottled,mucilaginous,odd-pinnate,often,one,ovoid,pair,pedicel,peduncle,pentagonal,petiolulate,placed,plant,pore,poricidal,proximal,puberulent,pubescent,purple,reduced,ripe,scattered,seed,sessile,short,size,slightly,slit,sometimes,sparsely,stem,stigma,straight,streak,style,subequal,subglabrous,substellate,terminal,testal,thick,throughout,tip,tuber,typically,usually,violet,wall,wet,white,whitish,x	0-3.5,0-5,1,1-3,1.5-4,2-5,2-6,2.5-3.3,3-5,3.8-8.3,4-7,5-merou,acumen,acuminate,acute,ag,alyx,apex,apiculate,apparently,articulated,axe,axillary,base,berry,broadly,bud,capitat,central,covered,cuneate,digestion,eaf,eed,elliptic,enzyme,erec,exceeding,geminat,glabrou,hal,honeycomb-shaped,less,living,lower,nflorescence,oblique,orbicular,orolla,ovate,perfect,petiole,petiolule,plurifoliate,removed,rounded,ruit,seudostipule,spaced,specimen,stamen,ste,stolo,subtending,tall,tamen,tem,tri-,truncate,tube,unit,unwinged,vary,wing,yellow,ympodial	age,arrangement,articulation,branching,capitate,colour,form,growth,height,inflorescence,leaf,length,number,ovary,placement,pseudostipule,shape,spacing,stolon,texture,type
259	wfo-0001028920	success	152	101	84	68	17	0.553	.25,.5,0.2-1,0.5-1,0.8-1.1,1-1.2,1-1.5,1-2.4,1-3,2-2.5,3-3.5,6-6.5,abaxially,acute,adaxially,anther,anthesi,apex,arachnoid,arachnoid-pubescent,area,attenuate,bark,base,broadly,brownish,calyx,cm,congested,conical,corolla,dendritic,dense,difoliate,elliptic,felty,filament,fruiting,glabrate,glabrous,globose,green,leaf,lobed,long-styled,minutely,mm,nearly,obovate,occasionally,opposite,ovary,ovoid-reniform,papillose,pedicel,petiole,pitted,pore,poricidal,pubescence,pubescent,shape,shaped,short-styled,shrub,simple,size,small,soon,stem,stigma,style,surface,tear-drop,tip,tree,trichome,tube,tuft,unifoliate,uniseriate,unit,white,x	1.5-2,2-7,3-15-flowered,3-4,5-9,6-15,acuminate,axil,ba,berry,brown,closely,cucullate,dark,decurrent,deflexed,deltate,densely,dia,differing,eaf,edicel,eed,ellipsoid,erect,exserted,fleshy,flower,free,geminat,gray-brow,later,lateral,lightly,lobe,lon,long,lower,main,major,middle,minor,nflorescence,obovoid,older,overlappin,pair,planar,portion,present,ruit,scar,somewhat,spaced,sparsely,strongly,styl,tall,tapering,thick,tub,ud,vein,widest,winged,woody,ympodial,young	colour,diameter,form,fruit,geminate,gray-brown,growth,hair,height,inflorescence,length,plant,position,seed,structure,sympodial,texture
260	wfo-0001028929	success	210	120	99	111	21	0.471	.7,.9,/5,0-10,0.1,0.2-0.3,0.2-0.4,0.3-0.6,0.5-2,0.7-1,0.7-2,1-1.1,1.5-2.4,2-3,2-4,2-6,2.2-2.3,2.5-4,2.7-3,3-20,4-6,5-25,5-6,5-7.5,6-8,8-10,abaxial,acute,adaxial,anther,apart,apex,bark,base,berry,branched,calyx,chartaceous,cm,connivent,cuneate,densely,diameter,dull,elliptic,elongating,flattened-reniform,flower,fruit,fruiting,glabrescent,glabrous,hair,inflorescence,lateral,leaf,length,lobe,lobed,long,margin,maturity,midpoint,mm,obovate,obtuse,older,orange-brown,pale,patch,pedicel,per,petiole,poricidal,porrect,prickle,ray,red,red-brown,red-green,sessile,shrub,simple,sometimes,spherical,stalked,stellate-pubescent,stem,style,surface,tapering,tip,trichome,variously,way,white,wide,yellow,yellow-green	-2,-2/3,.5,0,0-1,0-20,0-3,0.15-0.3,0.2-0.8,0.4-0.8,0.5-1.5,0.8-1,1,1-3,1/2,1/4-1/3,2-9,2/3-3/4,3-4,5-merous,7-9,abaxially,acicular,alyx,apar,ape,apically,apparently,articulated,blade,cell,concolorous,curved,difoliate,discolorous,distance,drying,eaf,eed,equal,erect,extending,filament,foliaceous,free,geminat,gently,glabrou,gra,infructescence,lon,long-styled,longer,lower,mature,midvein,minute,minutely,narrow-deltate,narrow-ovate,nflorescence,oblong,obtu,occasionally,one,open,orolla,oung,outline,pair,peduncle,pendulous,perfect,pericarp,perpendicular,pit,portion,prickl,prickly,primary,raised,reticulate,rounded,ruit,scar,short-styled,side,slender,small,smooth,spaced,spreading,stalk,staminate,stellate,straight,subsessile,tamen,terete,tertiary,time,tube,unarmed,unit,usually,vary,vein,venation,visible,woody,ympodial	branching,colour,corolla,form,gray,growth,height,number,ovary,plant,presence,present,seed,shape,size,spacing,staman,texture,type,width,young
261	wfo-0001028963	success	197	116	96	101	20	0.487	.5,0-0.4,0.1,0.1-0.25,0.15-0.3,0.3-0.6,0.3-0.7,0.3-1,0.45-0.6,0.6-0.9,0.8-1.8,0.9-1.5,1.5-2,1/5,2-2.3,2-4,2.4-2.8,3-4.5,3.5-4.2,4-10,5-25,7-8,abaxially,acute,anther,apex,apically,attenuate,base,berry,bright,broad-deltate,calyx,chartaceous,cm,connivent,densely,diameter,dull,entire,evenly,flattened-reniform,flower,fruiting,glabrous,gray-green,green,herb,inflorescence,lanceolate,lateral,leaf,length,lobe,long,margin,maturity,mauve,midpoint,mm,moderately,narrow-cuneate,narrow-elliptic,obtuse,orange,pale,pedicel,per,petiole,poricidal,porrect,purple,ray,red,sessile,shorter,shrub,simple,spherical,stalked,stellate-pubescent,stem,style,surface,tapering,terete,terminal,tip,trichome,unarmed,unbranched,upper,variously,wide,yellow-orange,young	/2,0-2,0.1-0.2,0.3-1.5,0.6-1,1-4,1/,1/4-1/3,1/6,2-3,2-5,2-9,4-8,5-merous,6-10,alyx,apar,ape,apparently,articulated,bark,becoming,blade,brown,cell,concolorous,curved,cuspidat,deltate,difoliate,discolorous,drying,eaf,eed,elongating,equal,erect,eye,filament,free,frui,geminat,glabrescent,gra,herbaceous,infructescence,less,light,lobed,long-styled,longer,lower,mature,naked,narrowly,nflorescence,occasionally,older,one,open,orolla,oung,outline,pair,peduncle,pendulous,perfect,pericarp,pit,portion,primary,raised,ruit,scar,short-styled,slender,slightly,small,smooth,spaced,spreading,stalk,staminate,stellate,straight,subsessile,tamen,tertiary,time,tube,unarme,unit,usually,vary,vein,venation,visible,way,winged,woody,ympodial	branching,colour,corolla,cuspidate,form,fruit,growth,hair,height,number,ovary,plant,position,prickle,seed,shape,staman,texture,type,width
262	wfo-0001028971	success	225	113	92	133	21	0.409	-0.8,.1-0.2,0.1-0.4,0.1-0.5,0.2-0.5,0.25-0.6,0.3-0.6,0.4-0.9,0.8-2.5,1-2,1.5-2.2,1.75-2.5,10-15,2.2-3.5,2.5-3.5,3-14,4-9,5-10,6-8.5,6-9,7-16,acute,anther,apex,articulated,attenuate,base,broad-based,broadly,calyx,campanulate,cm,coarsely,compressed,connivent,densely,dentate,diameter,directed,elongate-deltoid,essentially,extra-axillary,farinaceous,filament,flower,form,fruit,globose,hair,inflorescence,lateral,laterally,leaf,length,lenticular,linear-lanceolate,margin,midpoint,minute,mixture,mm,often,orange,outline,ovate,pedicel,peduncle,perennial,petiole,pore,prickle,pubescent,rachi,ray,reniform-ovate,ripe,sericeous,sessile,simple,spreading-hirsute,stellate,stem,stigma,stipitate,style,thin-textured,trichome,unbranched,variable,white,x,yellow	-1.4,0.25-1.25,0.4-1.5,05-2.5,1-5,1.5-4,1/5-1/2,15-30,2-5,2-foliate,2.5-4.5,2.5-5,20-35,3-5,3-6,4-5,5-15,5-8,6-16,abaxially,acute-,adaxiall,adaxially,along,also,apart,appearance,appearing,armed,ascending,axe,ba,bearing,becoming,blade,branched,capitat,cauline,close,cylindrical,delicate,deltoid,distal,distall,eaf,eed,elongate,entire,erect,felty,felty-pubescent,female-sterile,frequently,geminat,glabrous,grading,growt,inserted,interlobal,invested,lanceolate,largest,later,least,lignescent,like,lobe,lon,long,longer,longest,lower,major,manifestly,maturit,midrib,minutely,much,multiseriate,narrowly,nflorescence,numerous,obtuse,occasionally,one,orolla,other,ovate-apiculate,ovate-lanceolate,pair,per,persistent,pitted,prickly,principal,reduced,round-tipped,ruit,scattered,short,short-stalked,shorter,side,similar,sinus,smaller,sometimes,spaced,sparse,spreadingly,stalk,ste,stellae,stellate-pubescent,surface,tal,tamen,tan,tem,termination,time,tooth-like,truncate,tube,underdeveloped,unit,usually,variously,vary,vein,well-developed,wide,ympodial	abaxial,adaxial,arrangement,articulation,branching,capitate,colour,corolla,distally,growth,height,orientation,ovary,placement,plant,position,seed,shape,staman,texture,type
263	wfo-0001028975	success	163	97	75	88	22	0.46	.2,0.1-1,1,1-3,1-5,1.5-1.8,2.2-6,3-10-flowered,3-3.5,5.5-10,6-6.5,8-9,?,acute,along,anther,area,base,broad,brown,calyx,cm,conical,corolla,dark,decurrent,densely,denser,elliptic,filament,fruit,fruiting,glabrous,globose,golden,green,leaf,length,lobed,long,minor,minutely,mm,nearly,once-furcate,opposite,ovary,ovoid-reniform,pedicel,petiole,pore,pubescent,shaped,shiny,short,shrub,simple,size,slender,small,sparsely,stigma,style,tapering,tear-drop,tip,tree,trichome,tube,uniseriate,varying,vein,white,wide,x	.5,0.5-1,1.2-1.5,1.5-2,3-6.5,5-ribbed,7.5-15,acuminate,anthesi,apart,apex,appearing,bark,beneath,berry,closely,conically,corky,cup-shaped,deflexed,dia,differing,difoliate,eaf,edicel,eed,entire,epidermi,equal,erect,exserted,extension,free,geminat,hyaline,immature,large-celled,late,lateral,like,lobe,lon,lower,main,mainly,major,margin,member,mere,middle,narrowly,nflorescence,obscured,occasionally,older,one,pair,papillo,pitted,poricidal,portion,prominent,pubescenc,raised,reddi,reflexed,remaining,rib,ruit,scar,sinus,slightly,somewhat,spaced,stem,straight,strongly,surface,tall,triangular,tub,ud,unit,upper,widest,woody,ympodial,young	0.5,9,branching,bud,colour,density,diameter,flower,form,growth,hair,height,inflorescence,number,papillose,plant,position,seed,shape,symmetry,texture,width
264	wfo-0001028980	success	168	103	82	86	21	0.488	.5,1-1.2,1.2-3,1.5-1.8,1.5-2,1.5-6,2.5,2.5-5,20-25-flowered,4-5,5-6,6,acuminate,acute,anther,anthesi,apex,bark,base,calyx,capitate,cm,coarsely,corky,corolla,densely,dia,difoliate,dry,elliptic,expanded,filament,flattened-reniform,fleshy,fruiting,furcate,glabrate,glabrous,glandular,globose,green,leaf,long,material,minor,minutely,mm,opposite,ovary,ovate,ovoid,pedicel,petiole,pitted,planar,pore,reddish,reflexed,scar,seed,shaped,sharply,shining,shrub,simple,size,slightly,small,speciman,stigma,style,surface,tall,tear-drop,tree,tube,type,unit,usually,white,woody,x	.1,.75,/3,0.5-1.5,1.2-1.8,3-4,3/4,5-8,6-8,7-12,along,apart,axil,basal,beginning,beneath,berry,black,broadly,clearly,conical,cucullate,deflexed,deltoid,differentiated,differing,drying,eaf,edicel,eed,exserted,extending,f,free,frui,geminat,impressed,incrassate,inflorescenc,lamina,lateral,lenticellat,like,lobe,lobed,lon,lower,m.,main,major,margin,member,middle,nflorescence,occasionally,older,one,pair,pale,paler,papillose,peduncle,pit,poricidal,portion,prominent,pubescent,ruit,scarious,soon,sparsely,stem,strongly,tapering,thick,ti,tip,trichome,ud,uniseriate,vein,way,widest,yellowish,ympodial,young	branching,bud,colour,diameter,flower,form,fruit,geminate,growth,height,inflorescence,length,lenticellate,number,plant,position,pubescence,shape,structure,sympodial,texture
265	wfo-0001028984	success	180	130	107	73	23	0.594	-3,-6,-65,0.5-,1,1-,1-6,1-9,1.2-4,1.5,10-20,15-35,2,2-2.5,2-3,2-4,20-40,3-26,4-30,4-6,4-6.3,7-14,abaxially,abruptly,acuminate,acute,adpressed,age,almost,also,apex,apical,articulated,basal,base,broad,broadly,calyx,campanulate,chartaceous,cm,concave,connective,cordate,densely,diameter,dilated,directed,distally,ellipsoid-fusiform,entire,flower,forked,fruit,glabrous,gland,globose,greenish,hair,lanceolate,laterally,leaving,lobe,long,margin,mm,moderately,narrowed,obconical,obtuse,often,ovate,ovoid,pale,pedicel,pedicellar,peduncle,petiole,pilose,pore,presence,puberulent,puberulent-pubescent,pubescent-pilose,purple,rachi,radiu,rarely,remnant,shrub,simple,small,sparsely,stigma,strongly,style,subcoriaceous,tip,tree,truncate,turning,two,unbranched,unknown,violet,x,yellow	-14,-2,-2.5,-9,1-1.7,1-2,1-2.5,12-20,2-,2-16,3-10,3-28,3-6,4-5,4-7,4-foliat,5,5-10,8-15,absen,adaxially,aggregate,apart,ape,axe,blade,cell,color,eaf,eed,eglandular,equalling,especially,exceeding,fleshy,glandular-puberulent,lon,longer,lower,minutely,near,nflorescence,nther,orolla,papillose,perfect,pilo,possibly,present,pubescent-pilo,ripe,ruit,shorter,slightly,spaced,stamen,stone,swelling,tal,tem,thecae,time,tomento,tomentose,toward,triangular,tube,ud,unit,unknow,vary,wide,ympodial	abaxial,adaxial,anther,articulation,branching,bud,colour,corolla,form,growth,height,inflorescence,leaf,length,ovary,plant,seed,shape,stem,symmetry,texture,theca,type
266	wfo-0001028997	success	136	124	96	40	28	0.706	.5,0.5-0.7,0.5-1,0.5-1.5,0.8-1.1,1-1.5,2-2.5,2-3.5,20-50-flowered,3-4,4-10,4-angled,5-6,6-10,acute,anther,anthesi,apex,appearing,area,attenuate,bark,base,berry,branched,broadened,calyx,cm,conical,coriaceous,corolla,cucullate,deflexed,difoliate,dry,drying,elliptic,elliptic-obovate,erect,exserted,filament,filiform,flattened-reniform,fragrant,fruiting,glabrous,globose,golden,green,height,incrassate,later,leaf,lobe,lobed,many,margin,matte,merely,minutely,mm,mustard,nearly,opposite,ovary,pale,papillose,pedicel,petiole,pitted,pore,quadrate,revolute,scar,shaped,shiny,shrub,specimen,stem,stigma,strongly,style,surface,tan,tear-drop,terminal,thickened,time,tip,trifoliate,tube,unknown,white,x,yellow,young	1-1.2,3.3.5,4-4.5,6-7,abaxially,adaxially,apar,ba,dia,eaf,edicel,eed,free,geminat,glabrou,greenish-brow,lateral,lon,long,lower,main,middle,nflorescence,older,pair,partially,pericarp,poricidal,portion,ruit,spaced,styl,thick,tub,ud,unevenly,vein,widest,woody,ympodia	abaxial,adaxial,apart,branching,bud,colour,diameter,exsertion,flower,form,fragrance,fruit,greenish-brown,growth,inflorescence,length,number,plant,position,seed,shape,spacing,structure,sympodial,texture,type,unit,width
267	wfo-0001029003	invalid_json	207	134	106	101	28	0.512	0-6,0.5,1-2,1-3,1.2-1.9,1.2-2.5,1.5-2.3,11-32,12.2-30,13-36,2.5-10,3,3-20,3-5,3.5-7.5,4-8,5,5-10.5,5-12.5,7-15.5,7-9,9-14,abaxially,adaxially,anther,berry,blade,blue-violet,brownish,cell,chartaceous,cm,condition,conical,corolla,covering,diameter,drying,end,filament,flower,forked,fresh,fruit,glabrous,green,green-white,greenish,hair,hair-like,herb,homostylous,interjected,lanceolate,lateral,leaf,leaflet,light,like,long,make,medium,membranous,minute,mm,mottled,mucilaginous,odd-pinnate,one,ovoid,pale,pedicel,peduncle,pentagonal,petiole,placed,plant,pore,poricidal,pubescent,purple,ripe,rotate,seed,size,sparsely,stem,stigma,straight,style,subcapitate,subglabrous,terminal,testal,thick,throughout,tip,tuber,typically,usually,violet,wall,wet,whitish,wide,x	0.3-0.5,0.4-3,1,1-10,1-2.5,1-5,2-6,2.5-7.5,5-merou,absent,acumen,acuminate,ag,alyx,apart,apex,apparently,articulated,attenuate,axe,axillary,base,bud,capitat,ciliate,connivent,decreasing,digestion,distal,dorsally,eaf,edge,eed,elliptic,elongated,enzyme,equal,erec,especially,exceeding,flat,folded,fourth,geminat,generally,glabrou,gradually,hal,half,highly,honeycomb-shaped,larger,lengthening,living,lobe,lower,margin,middle,nflorescence,obtuse,orbicular,orolla,ovate,pair,perfect,petiolule,pigmentation,plurifoliate,prostrate,proximal,rarely,ray,removed,rounded,ruit,secondary,sessile,seudostipule,slightly,slit,sometimes,spaced,specimen,stamen,ste,stolo,subequal,subtending,symmetrical,tall,tamen,tem,toward,tri-,tube,unit,vary,white,wing,yellow,ympodial	'',5-merous,[,``,arrangement,branching,calyx,capitate,characteristic,colour,form,glabrousnes,growth,height,inflorescence,length,number,ovary,placement,pseudostipule,shape,staman,stolon,texture,type,value,{,}
268	wfo-0001029006	success	217	168	146	71	22	0.673	-+,0.2,0.4-2.5,0.5,0.5-2,0.5-4,1,1-1.5,1-5,1.2-1.5,10,10-20,2-3,3.5-4,5,7-8,<,>,abaxially,acuminate,acute,adaxial,age,along,anther,anthesi,apex,area,articulated,asymmetrical,axi,axil,base,berry,beyond,bilobed,blackish,branched,c.,cell,chartaceous,cm,connivent,corolla,deeply,dense,diameter,ellipsoid,elliptic,entire,exserted,extending,filament,filiform,flattened,flower,fruiting,glabrous,globose,green,groove,growth,inflated,inflorescence,lamina,later,lateral,leaving,lengthening,lobe,lobed,long,loosely,lower,many,margin,membranous,midrib,minutely,mm,narrowly,nearly,new,nodding,oblique,occasionally,often,pale,papillate,pedicel,peduncle,peg,pentagonal,per,perfect,petiole,pinnatifid,pitted,pore,poricidal,puberulent,pubescent,purple,purplish,reaching,reddish,reniform,ripe,rotate-stellate,sagittate,simple,sleeve,slit,small,sometimes,somewhat,sparsely,spreading,stem,stigma,strongly,style,surface,tan,terminal,testal,time,tiny,tip,trichome,truncate,tube,tuft,uniseriate,upper,usually,variously,vein,vine,violet,way,white,within,x,young,zig-zag	.5,1-4,1.8-2.2,1/3,2-6,2.5,4-6,5-6,5-merou,50,7-9,adaxiall,ag,alyx,apar,ark,basal,black,bright,broadest,calyx,clavat,conical,deltate,depending,drying,eaf,eed,elongate,free,growing,ilament,intramarginal,irregular,irregularly,keeled,markedly,minute,nflorescence,obvious,older,one,orolla,pair,part,pendan,pericarp,planar,plurifoliat,portion,primary,puberulen,ruit,scar,shiny,size,smaller,spaced,strong,sunligh,tem,thin,twinin,twining,ud,unit,variable,vary,widest,woody,ympodial	5-merous,adaxially,arrangement,bark,branching,bud,clavate,colour,form,fruit,hair,leaf,length,number,ovary,position,seed,shape,symmetry,texture,type,width
269	wfo-0001029031	success	213	124	106	107	18	0.498	-11.4,-12.3,-8,.5-1.2,0.1-0.5,0.5-1.5,0.5-4,0.6-1.2,0.7-1.1,1-1.5,1-5,1-9.4,1.8-2.7,13.5,2-10.7,2-3,2-3.3,2-5,2.5-5.5,20-150,3-10,4-5-,4-7.5,5-17,6-21,abaxially,adaxially,anther,apex,berry,black,bluish,branched,brown,calyx,capitate,chartaceous,cm,corolla,cylindrical,densely,diameter,directed,distally,elliptic,elliptic-ovate,flattened,fleshy,flower,forked,fruit,geminate,glabrescent,glabrous,globose,green,hair,large,leaf,length,light,like,many-foliate,mm,oblong,obtuse,occasionally,outline,pedicel,peduncle,peltate,peltate-stellate,petiole,pore,porrect-stellate,possibly,pubescent,rachi,rarely,reniform,ripening,sessile,short-stalked,shrub,silvery,simple,small,somewhat,sparsely,stellate,stellate-pubescent,stem,stigma,strongly,style,suborbicular,tall,tree,trichome,unbranched,unit,white,whitish,x,yellow,yellowish	-3.6,.1-0.3,0-5,0.5,1-2,1-2.5,1-2.6,1-3,1.3-3.3,1.5-2.8,1.5-3.5,1.8-4,1/3,10,2.5-5.6,6-12,absent,accrescent,acuminate,acute,adaxiall,ag,angle,apart,apexacute,apparently,around,articulated,axe,ba,base,becoming,bilobe,blade,center,connivent,covering,cuneate,curved,deltate,denser,eaf,edge,eed,eglandula,eglandular,entire,equal,erect,farinose,filament,frui,fruiting,fused,held,immature,impressed,inserted,lanceolate,lateral,leaf-opposed,least,lobe,long,longitudinal,lower,major,margin,midpoint,midvein,nearly,nflorescence,opening,orange,orolla,paired,perfect,prominent,pseudoterminal,pubescen,pubescence,ray,rounded,rugulose,ruit,short,side,slightly,slit,smaller,sometimes,spaced,ste,straight,subtending,surface,tamen,tem,time,tip,tube,unarme,usually,vary,vein,wide,ympodial	arming,bilobed,branching,colour,form,growth,height,inflorescence,ovary,plant,seed,shape,size,staman,sympodial,texture,type,unarmed
270	wfo-0001029048	success	162	123	103	59	20	0.636	.01,.2,.5,/3,0.5,0.5-1.7,0.8-1,1-2,1-8,1.5-2,14,2,25,26,3-4,3-7,3.5-4,4-6,9-15,anther,anthesi,apex,arching,attenuate,basal,base,beneath,bicellular,broadly,calyx,cm,conical,corolla,decurrent,dia,elliptic,elongated,expanded,f,filament,filiform,fruiting,glabrate,glabrous,globose,golden,greatly,greenish-white,greenish-yellow,hanging,hispidulous,incrassate,leaf,less,like,lobe,lobed,long,margin,matte,minute,minutely,mm,obtuse,older,opposite,ovary,ovoid-reniform,pale,papillose,pedicel,petiole,pitted,planar,pore,poricidal,puberulent,reflexed,ripe,scar,shaped,sharply,shrub,slender,slightly,small-capitate,somewhat,stem,stigma,straight,style,surface,tapering,tear-drop,thread-like,tip,trichome,tube,uni-,vein,way,x,young	0.5-1,1,11,5-8,8-10,acuminate,angle,another,apar,apparent,bearing,becoming,berry,blade,branch,bright,eaf,edicel,eed,except,flower,free,geminate,green,greenish-yello,lateral,live,lower,main,middle,midrib,much,nflorescence,node,non-reproductive,obovoid,one,pair,papillo,parallel,portion,right,rounded,ruit,spaced,specimen,tall,tan,time,translucent,ud,unevenly,unifoliate,unit,widely,widest,winged,ympodial,zig-zag	apart,branching,bud,colour,diameter,form,fruit,growth,hair,height,inflorescence,length,pattern,plant,position,seed,shape,size,spacing,width
271	wfo-0001029055	invalid_json	169	128	88	81	40	0.521	0.4-1.5,1-4,1-5,1.8-3.5,14-50,2-4,2.2-3,3-10,4-10,4-6,4-7,5-24,5.5-9,6-14,8-9,9-22,acute,apical,apically,base,branched,calyx,cm,connate,corolla,cyme,dehiscent,diameter,dichasial,dichasially,diminishing,distal,dorsally,edge,exceeding,filament,flat,flower,folded,gland,green,green-white,herbaceous,interjected,introrse,lateral,leaf,leaflet,lobe,long,long-attenuate,maturing,mm,monochasial,mucilaginous,odd-pinnate,often,outline,ovoid,pedicel,peduncle,pentagonal,perennial,perfect,petiole,pilose,plant,poricidally,proximal,pubescent,rotate,seed,short,short-stalked,size,slit,stamen,straight,style,terminal,throughout,toward,triangular,tuber-bearing,type,unit,yellow,Â¼	1-2.6,1.6-3.5,1.7-2.2,2-1.,2-3,2.5-8,3,3-6,3-6-foliat,abaxially,acumen,acuminate,adaxially,apex,articulate,attenuate,cell,cordate,covered,covering,cuneate,dark,decurrent,densely,digestion,eaf,ebracteate,eed,elliptcal,elliptical,emoval,enzyme,first,forked,generally,globo,hair,hair-like,half,honeycomb,living,lon,longer,longitudional,lower,lunat,make,near,nflorescence,nther,oblique,orolla,ovate,pair,pattern,plan,purple,rarely,reveal,ruit,second,sessile,seudostipule,short-petiolate,sometimes,specimen,spreading,stigma,stripe,tal,tem,testal,thick,time,typically,vary,wall,whit,wide,widest,ympodial	'','type,2-11,3-6-foliate,[,],``,anther,articulation,bract,branching,characteristic,colour,connective,ebbrate,form,fruit,growth,height,inflorescence,length,lunate,number,ovary,perfection,pore,presence,property,pseudostipule,shape,stem,structure,sympodial,texture,value,wet,white,width,{,}
272	wfo-0001029059	invalid_json	199	115	95	104	20	0.477	.5,0.1-0.5,0.2,0.5-1,1-1.5,1-3,1-4,1-6,1.2-3,1.5-2,10-19,2.5,3-3.5,3-6.5,3.5-6,3.5-8,4-10.5,7-9,acute,along,anther,base,branched,bud,clavate,closely,cm,cordate,corolla,cuneate,dense,densely,dia,dirty,elliptic,extremely,filament,flattened-reniform,fruiting,glabrous,globose,hispidulous,inflorescence,leaf,lobed,long,major,member,minor,minute,minutely,mm,nearly,oblique,occasionally,often,opposite,orbiculate,ovary,pair,papillose,pedicel,petiole,pitted,pubescence,pubescent,purplish,ripe,rounded,scar,shape,shaped,shrub,size,small,somewhat,spaced,sparse,stigma,style,surface,tear-drop,tinge,tree,trichome,underside,unicellular,uniseriate,variable,vein,waxy,white,x,yellowish-green,young	0.1-1,0.2-0.5,0.5,1-1.2,1.3-1.7,1.5-2.8,5,5-15-flowered,6-10,anisophyllou,anthesi,apar,ape,apex,apiculae,apiculate,arising,bark,beneath,berry,bout,calyx,coiba,connivent,covered,de,deep,deflexed,deltoid,differing,difoliate,eaf,edicel,eed,ellipsoid,expanded,exserted,extending,foetid,free,geminate,glabrate,greatly,impressed,incrassate,interpetalar,isla,lamina,lateral,lobe,lon,longest,lower,main,margin,membranous,middle,narrowly,nflorescence,older,one,orange,orangish-yellow,pale,paler,panama,papillo,partially,planar,pointed,population,pore,poricidal,portion,prominent,reddish-gre,rest,ruit,shallowly,simple,sinus,slender,soon,specimen,stem,straight,tall,tapering,terminal,thickened,ti,tightly,tip,triangular,tube,ud,unit,usually,wide,widest,woody,yellowish,yellowish-tan,ympodial	'',[,],``,apart,characteristic,colour,form,fruit,growth,hair,height,length,plant,position,seed,texture,value,{,}
273	wfo-0001029072	success	235	77	55	180	22	0.234	12-19,2-7,5-10,5-7,abaxial,acute,adaxial,anther,apex,base,berry,branched,bright,calyx,chartaceous,cm,connivent,cordate,densely,dirty,elongating,equal,flattened-reniform,flower,fruit,fruiting,green-brown,herb,lateral,leaf,length,lobed,long,lower,margin,mauve,mm,ovate,per,petiole,poricidal,prickle,rounded,shrub,simple,spherical,stellate-pubescent,stem,surface,tapering,terminal,tip,white,whitish,yellow	-1/2,-15,-2.5,.5,/6,0,0-2,0-20,0-4,0-8,0.1-0.4,0.2-0.3,0.2-0.4,0.3,0.4-0.9,0.5-2,0.5-3,0.7,0.8,0.8-1.5,00-200,1,1-1.2,1-1.5,1-25,1-3,1.5-2.5,1.5-2.6,1.5-3.2,1/3,1/4-1/2,1/4-1/3,2-10,2-5,2-8,2.2-2.5,2.2-3.2,2.5-3.5,2.5-3.8,2.5-4.5,20-50,3-10,3-20,3-5,3-50,3-8,3.5-6,3/,4-,4-10,4.2-6.5,4.5-9,5-50,5-9,5-merous,7-10,7-15,8-20,8-27,abaxially,adaxially,alyx,ame,andromonoecious,angled,apar,apart,apically,apparently,articulated,bark,blade,broad-deltate,broadly,c.,clearly,conical,cream,cuneate,curved,dark,deltate,diameter,discolorous,distal,distance,drying,dull,eaf,eed,elongated,erect,extending,filament,flattened,free,gently,glabrous,gra,green,hermaphrodite,heterostylous,infructescence,least,lobe,long-styled,longer,longitudinal,lowermost,marking,mature,maturity,midpoint,midvein,moderately,multangulate,narrow-deltate,nflorescence,obtu,older,one,open,orange-brown,orolla,oung,pair,pale,pedicel,peduncle,pendent,pendulous,pericarp,plant,plurifoliat,porrect,portion,prickl,prickly,primary,raised,ray,reflexed,ridge,ruit,scar,sessile,short-styled,side,smooth,sometimes,spaced,sparsely,spreading,stalk,stalked,staminat,stellate,stout,straight,strongly,style,tamen,tertiary,time,trichome,tube,unarmed,unit,upper,variously,vary,vein,venation,visible,way,weakly,wide,woody,ympodial,young	100-200,arrangement,branching,colour,corolla,form,growth,heteromorphism,inflorescence,na,needle-like,number,orientation,placement,position,seed,shape,staman,symmetry,texture,type,zygomorphy
274	wfo-0001029073	success	211	103	90	121	13	0.427	.5,0.3-1,1-1.2,1-1.5,1.1-1.5,1.5-2,10-16,2-3,4-5,5-8,acuminate,acute,adaxially,anther,apex,base,berry,broad-based,brown,calyx,chartaceous,cm,corolla,curved,dark,dense,densely,diameter,elliptic,entire,filament,flattened,fruiting,glabrous,globose,growth,inflorescence,internodal,interpetalar,lanceolate,leaf,length,lengthening,lobed,margin,maturity,minutely,mm,narrowly,occasionally,orange,pale,papillose,pedicel,peduncle,per,petiole,pore,poricidal,porrect,prickle,pubescence,pubescent,purple,reniform,reticulate,shallowly,shrub,simple,sinuate,slit,stellate,stem,stigma,straight,strongly,style,surface,tan,tapering,tip,tissue,trichome,tube,unequally,upward,whitish,x,yellow,yellowish	.7,0.5,0.5-1,0.6-0.7,0.6-2,1-2.5,1-3,1.2-1.6,10-15,2,2-4,2/3,3.5-9,4-6,5-6,5-merous,6-9,7-10,8-14,abaxially,along,another,anthesi,apart,armed,articulated,away,awn-like,ba,bark,basal,beneath,cell,conical,cream,darker,difoliate,dimorphic,discolorous,drying,eaf,eed,enlarged,equal,erect,except,exserted,flower,four,free,frui,geminat,golden,gre,hooked,lamina,like,linear,lobe,long,long-styled,lower,midpoint,midvein,mixture,multangulate,new,nflorescence,nodding,oblique,older,one,opposite,pair,paler,perfect,pericarp,planar,plurifoliate,portion,prickly,primary,ray,rectangular,ruit,scar,sessile,shiny,short,short-stalked,shorter,slightly,sometimes,somewhat,spaced,sparsely,splitting,styled,testal,thin,three,ti,triangular,truncate,two,ud,unarmed,underside,unequal,unisexual,unit,upper,vein,visible,wall,way,wide,woody,ympodial,zygomorphic,Â½	0.7,abaxial,articulation,branching,colour,form,fruit,number,position,seed,shape,texture,type
275	wfo-0001029074	invalid_json	174	137	110	64	27	0.632	.1,.5,0,0.2-1,0.3-0.8,0.5-1,0.5-1.2,0.7-0.8,1-1.2,1-1.5,1-2,1.4-1.8,1.5-2,2-2.3,2-4,3.5-5,5-6,acute,anther,anthesi,apart,apex,apparently,articulation,base,berry,black,broadly,calyx,capitate,cm,conical,corolla,cuneate,densely,diameter,ellipsoid,entire,exerted,filament,flattened,flower,fruiting,glabrous,globose,green,grey,growth,herb,immature,internodal,lacking,leaf,less,like,lobe,lobed,margin,midpoint,minutely,mixture,mm,opposite,ovary,ovate,pale,pedicel,peduncle,per,perfect,pericarp,petiole,pitted,poricidal,pubescent,pulp,purplish,ray,reflexed,reniform,ripening,rounded,sagittate,scar,sessile,simple,small,sparsely,stalked,stellate,stem,stigma,strongly,style,subshrub,surface,thin,tip,triangular,trichome,truncate,tube,underside,uniformly,watery,way,white,x,yellowish,Â¾	0.3-0.4,0.7-0.95,1,1-,1.5-4,11,2-5,2-7,3-,3-6,5-7,abaxially,absent,adaxially,age,almost,along,appearing,bark,basa,deflexed,denser,eaf,eed,expanding,free,frui,glabrescen,lengthening,lignescent,longest,lower,markedly,midvein,new,nflorescence,obscuring,often,older,pair,papillat,petal,planar,plurifoliat,pore,portion,primary,prominent,ruit,scattered,slit,somewhat,stalk,stellate-pubescent,swollen,tub,ud,uniseriate,unit,usually,vein,woody,yellow,ympodial	'',[,``,abaxial,adaxial,basal,bud,characteristic,colour,consistency,form,fruit,hair,height,inflorescence,length,number,papillate,plant,position,seed,shape,thicknes,type,value,{,}
276	wfo-0001029075	success	217	139	116	101	23	0.535	.3,.5,0.8-1.5,1-2,1-2.5,2-4,2.5-3,30-60,4-10,4-14,4-7,4.5-6.5,5-10,5-8.5,6-12,7-17,7-9,8-9,abaxially,adaxially,along,anther,berry,blade,brown,brownish,canescent,cell,ciliate,cm,condition,connivent,corolla,covering,dark,densely,diameter,distal,dot,drying,end,especially,filament,flecked,flower,forked,fresh,fruit,generally,glabrescent,glabrous,glandular-pilose,glandular-puberulent,gray-green,green,green-white,greenish,hair,hair-like,half,herb,homostylous,lanceolate,lateral,leaf,leaflet,lengthening,like,long,make,margin,midrib,minutely,mm,mucilaginous,odd-pinnate,orne,ovoid,pair,pentagonal,petiole,plant,pore,poricidal,puberulent,pubescent,seed,short,singly,size,slit,small,stem,stigma,straight,style,substellate,terminal,testal,thick,throughout,tip,tuber,typically,unwinged,usually,wall,wet,white,whitish,whitish-gray,wide,x,yellow,yellow-green,yellowish-white	0-3,0-8,0.5-0.8,0.8-1.2,1-10,1-3,10-20,2-5,2.7-4.2,4-5,5-8,5-merou,abruptly,acumen,ag,alyx,apart,apex,apparently,articulated,attenuate-acuminate,atypically,axe,axillary,base,broadly,bud,clavifor,cuneate,decreasing,decurrent,digestion,dorsally,eaf,edge,eed,elliptic-lanceolate,enzyme,erect,erect-ascendin,etota,exceeding,flat,folded,geminat,glabrou,gradually,greatly,honeycomb-shaped,interjected,larger,light,living,lobe,long-spatulate,lower,middl,narrowed,narrowly,nflorescence,orbicular,orolla,ovate,pedicel,peduncle,perfect,petal,petiolulate,petiolule,plurifoliate,pointed,purple,rachi,removed,rounded,ruit,sec,sessile,seudostipule,slightly,sometimes,spaced,specimen,stamen,ste,stolo,subequal,subobtuse,subquadrate,subtending,tall,tamen,tem,toward,tri-,tube,unit,upper,vary,woody,ympodial	5-merous,abaxial,adaxial,age,arrangement,branching,calyx,claviform,colour,form,growth,height,inflorescence,length,number,ovary,presence,pseudostipule,shape,staman,stolon,texture,type
277	wfo-0001029084	success	192	109	90	102	19	0.469	.5,0.8-2,0.8-2.1,1-10,1.1-2.2,1.5-2.5,10-50,2-3.5,2-5,3-6,3.5-7.5,3.5-8,4-17,4-7,4.5-6.5,5,6-13,7-9,8-23,abaxially,adaxially,anther,blade,brownish,cell,chartaceous,cm,condition,conical,corolla,diameter,digestion,dorsally,drying,edge,enzyme,flat,flower,folded,forked,fresh,fruit,glabrous,green,greenish,herb,homostylous,honeycomb-shaped,lanceolate,lateral,leaf,leaflet,lengthening,light,lilac,long,middle,minute,minutely,mm,moniliform,mottled,odd-pinnate,ovoid,pedicel,peduncle,petiole,plant,pore,poricidal,proximal,puberulent,pubescent,purple,removed,ripe,seed,size,slit,sparsely,style,subglabrous,terminal,testal,tip,tuber,wall,whitish,wide,x	1-2,1-3,1-4,2-4,4.5-10,5-7,5-merou,absent,acumen,acuminate,ag,along,alyx,apart,apex,apparently,arranged,articulated,axe,axillary,base,bead,berry,bud,capitat,ciliate,connivent,covering,darker,decreasing,distal,eaf,eed,especially,exceeding,filament,geminat,generally,glabrou,gradually,green-white,hair-like,half,interjected,interpetalar,larger,like,living,lobe,lon,lower,make,margin,midrib,mucilaginous,multiple,narrow,necklace,nflorescence,obtuse,orolla,ovate-lanceolate,pair,perfect,petiolule,pilose,plurifoliate,ray,rotate,ruit,secondary,semierec,seudostipule,spaced,specimen,stamen,stigma,stolon,subequal,subglabrou,subsessile,subtending,symmetrical,tall,tamen,tem,thick,thir,throughout,tissue,toward,tri-,tube,typically,unit,unwinged,usually,vary,wet,wing,yellow,ympodial	age,arrangement,articulation,branching,colour,form,growth,height,inflorescence,length,number,ovary,pseudostipule,shape,spacing,stem,texture,third,width
278	wfo-0001029088	success	149	99	76	73	23	0.51	0.1,0.9â1.5,1.3â4.5,15â25,1â1.6,2.5â20,2.5â4.2,25â30,2â2.5,3â16,4â8,5-merous,5â8,<,abaxially,acuminate,adaxially,anther,apex,base,berry,bronze-brown,calyx,climbing,cm,cordate,densely,diameter,entire,extra-axillary,filament,flavor,flower,fragrant,fruit,glabrous,greenish-brown,hair,heavy,immature,juicy,leaf,lenticular,light,margin,mature,membranous,minutely,mm,near,obtuse,ovoid-rhomboid,pedicel,peduncle,petiole,pubescent,purplish,rachi,reddish-brown,revolute,rounded,rugose,scent,shortly,simple,slightly,sparsely,stellate,strongly,surface,sweet,terrestrial,unbranched,vine,white,x	.2,.3,0.6â3.2,1.5â2,1.5â3,1â1.2,1â1.5,1â3,2-lobe,2â3,3.5â7,3.5â8,5,6-10,accrescent,acute,alyx,apar,apicall,axe,blade,c.,capitate,ciliate,cylindrical,eaf,eed,emarginate,flattened,fleshy,fruiting,glabrou,groun,half,herbaceous,lanceolate,lobe,long,lower,m.,moderately,narrowly,nflorescence,nternode,orolla,palmate,papillose,perfec,plurifoliat,primary,ruit,sand-punctate,slender,somewhat,spaced,stigma,stout,straight,style,swee,tamen,tem,tip,truncate,truncate-acuminat,tube,unit,vary,vein,venation,wider,ympodial,â7	branching,colour,corolla,form,fragrance,growth,habit,height,inflorescence,internode,juicines,length,merosity,na,perfect,plant,pore,position,seed,shape,stem,texture,type
279	wfo-0001029089	success	177	90	72	105	18	0.407	/4,0.1-0.25,0.5-0.6,0.5-1,0.8-1,1,1-1.5,1.5-2,1.5-6,10-25,4.5-5,5-10,5-20-flowered,5-9,6-7,acute,anther,anthesi,base,bilobed,branched,calyx,campanulate,cm,corolla,decurrent,deflexed,densely,dia,elliptic,filament,flattened-reniform,fruiting,furcate,glabrous,globose,golden,green,incrassate,leaf,lobed,margin,minutely,mm,occasionally,opposite,ovary,pedicel,petiole,pitted,pore,pubescent,purplish,shaped,shiny,shrub,simple,size,slightly,small,stigma,style,surface,tear-drop,tree,trichome,tube,uniseriate,usually,way,white,x	.5,.75,0.8-1.2,1/2,2.5-3.5,5-6,8-9,abrupt,along,apart,apex,apiculate,axil,ba,bark,beginning,beneath,berry,bud,caniculate,closely,completely,covered,covering,cracking,dark,differing,difoliate,drying,eaf,edicel,eed,either,enclosed,entire,erect,expand,exserted,free,geminat,glabrou,impressed,inflorescenc,lamina,later,lateral,like,lobe,lon,long,lower,main,major,material,member,middle,minor,nflorescence,obovoid,older,one,otherwise,overlapping,pair,papillo,papillose,part,peeling,persistent,pinkish,planar,poricidal,portion,primary,prominent,reddish-grey,resinou,resinous,rounded,rounded-deltoid,ruit,scar,secretion,smooth,somewhat,spaced,stem,still,straight,tall,tan,tapering,tip,tub,ud,underside,unit,varnish,varnished,vein,widening,widest,woody,ympodial,young	abaxial,adaxial,colour,diameter,flower,form,fruit,growth,height,inflorescence,length,number,plant,position,seed,shape,texture,type
280	wfo-0001029091	success	212	123	105	107	18	0.495	-4,1-10,1-2,1.5-,10,2-2.5,2-3,20-30,3,3-11-lobed,3-4,46/1,635/1,7-8,acuminate,acute,age,anther,apex,articulated,articulation,axil,base,becoming,broadly,brownish,buff,calyx,capitate,cell,clonal,close,cm,colour,conspicuous,corolla,cuneate,cyme,discoidal,effect,ellipsoid,elliptic,filament,flattened,flower,flushed,fork,fresh,fruiting,giving,glandular,globose,globular,grey,growing,hair,half,intense,irregularly,lasting,lavender,leaf,lengthening,light,long,may,mineral,minutely,mm,obovate,ochre-yellow,ovate,ovoid,pale,pedicel,pentagonal,petiolate,petiole,point,pore,poricidal,pubescent,reddish-purple,rh,several,shortly,shrub,simple,slightly,slit,sparsely,speckled,stellate-rotate,stem,stigma,stone,straggly,style,tip,toward,upper,violet,violet-purple,woody,year	-1,-15,-4.5,0.3-,0.5-0.8,0.5-1,1,1.5-2,10-20,10-toothed,15-40,170-210,2-12,2.5-,3-,4,5,5-7,appearing,aromatic,aspect,ba,berry,blunt,bluntly,campanulate,common,cut,dark,deeply,develop,developed,dia,downward,eed,emarginated,erect,exceeding,exerted,floral,forked,general,gree,interacuminal,irregular,juvenile,lacking,larger,later,lateral,lavende,line,linear,linear-lanceolate,lobe,long-triangular,lower,mid-vein,narrowly,nflorescence,oblong,obscure,occasionally,overlain,ower,pattern,pedicellate,peduncle,petiol,plurifoliat,rachi,raised,readily,relatively,reticulate-concentric,ridge,ridged,ripe,rounded,ruit,scarcely,separate,shallowly,shed,sigmoid,sinus,slender,soft,soft-wooded,soon,subulate,succulent,surface,swollen,tall,tissue,transverse,triangular,tub,ud,unit,usually,well,winged,without,x,ympodial	age-related,bud,clonality,form,fruit,growth,habit,height,history,inflorescence,length,life,lobing,plant,position,pubescence,seed,shape
281	wfo-0001029101	success	233	103	85	148	18	0.365	/3,/4,0.7-,00-200,1-3,1.5-2,1.5-2.5,1.8-3,2.5-3.5,2.8-3.3,3-,3-7,4-12,5-,5-7,5-9,7-13,8-15,abaxial,adaxial,anther,apex,base,berry,branched,calyx,chartaceous,cm,concolorous,connivent,cuneate,diameter,discolorous,drying,dull,elliptic,elongating,equal,flattened,flattened-reniform,flower,fruit,fruiting,glabrescent,glabrous,lateral,leaf,length,lobed,long,long-styled,margin,mature,maturity,mauve,mm,narrow-deltate,obovate,obtuse,orange-brown,ovate,pale,per,petiole,poricidal,prickle,rarely,reflexed,rounded,short-styled,shrub,simple,sometimes,sparsely,spherical,stellate-pubescent,stem,straight,surface,tapering,tip,way,wide,yellow,yellow-orange	-15,-3,.5,0-100,0-2,0-20,0-5,0-8,0.1,0.1-0.4,0.1-0.5,0.1-0.7,0.1-1,0.2,0.4-1.5,0.5-1,0.8-3.5,1,1-1.5,1-4,1-8,1.3-2,1.3-2.6,1.4-2.2,1.7,1/5-1/4,10-14,10-20,2-,2-20,2-6,2.5-6,2/3-3/4,3-10,3-4,30-100,4-7,5-20,5-6,5-8,5-merous,5.5-8,6-8,abaxially,acute,almost,always,alyx,andromonoecious,apar,apart,apically,apparently,articulated,bark,blade,broad-deltate,brown-green,cell,cream,dark,darker,deltate,distal,distance,eaf,eed,erect,extending,filament,free,green,green-brow,hermaphrodite,heterostylous,infructescence,lengt,like,lobe,lon,longer,lower,lowermost,marking,midpoint,midvein,moderately,multangulate,nflorescence,oblong,often,older,one,open,orolla,oung,outline,pair,pedicel,peduncle,pendulous,pericarp,pit,plant,plurifoliat,porrect,portion,present,prickl,prickly,primary,raised,ray,reduced,rounde,ruit,scar,secondary,sessile,side,small,smooth,spaced,spreading,stalk,stalked,staminat,stellate,style,suborbicular,tamen,terete,tertiary,thick,time,trichome,tube,unit,variously,vary,vein,venation,visible,well-developed,woody,yellow-green,ympodial,young	branching,colour,corolla,form,growth,heteromorphism,inflorescence,na,number,placement,position,seed,shape,size,staman,texture,type,width
282	wfo-0001029106	success	200	143	118	82	25	0.59	.1,.5,/3,0-10,0-2,0-20,0-5,0-6,0.1,0.2-0.4,0.2-1,0.25-0.7,0.5-0.8,0.5-0.9,0.5-2.5,0.9-1.2,1-1.6,1-5,1.5-3.5,2-5.5,2-8,2.2-3,3-3.5,3-4,4-6,5-14,anther,apex,articulated,base,berry,branched,calyx,cell,cm,concolorous,cuneate,curved,densely,diameter,discolorous,drying,elliptic,equal,erect,flattened,flattened-reniform,flower,fruit,fruiting,gently,glabrescent,glabrous,lateral,leaf,length,lobe,lobed,long,lower,margin,maturity,mauve,membranous,midpoint,mm,obtuse,orange,orange-brown,orbicular,outline,ovate,pale,pedicel,peduncle,per,petiole,pit,poricidal,porrect,prickle,prickly,raised,ray,red,reflexed,rounded,sessile,shiny,shrub,simple,size,slender,small,smooth,sometimes,sparsely,spherical,spreading,stalked,stellate,stellate-pubescent,stem,straight,style,subentire,surface,tapering,terete,tip,trichome,variously,way,weakly,white,wide,yellow-orange,yellowish-green	-6,0,0-0.3,0.5,0.5-1,1-2,1.5-1.8,1.5-2,1/4,1/5-1/4,2-3.5,2-4,2-6,2/,3-25,4-8,5-8,5-merous,6-8,abaxially,acuminat,acute,alyx,ame,apar,apart,apically,apparently,appearing,bark,blade,c.,deltate,distance,eaf,eed,elongating,extending,eye,filament,free,infructescence,light,lon,longer,mature,midvein,naked,nflorescence,older,one,open,orange-brow,orolla,oung,pair,pendulous,perfec,pericarp,plurifoliat,portion,prickl,primary,scandent,scar,shallow,shorter,side,spaced,stalk,tamen,tertiary,time,tube,uit,unit,vary,vein,venation,visible,woody,ympodial	2/3,articulation,branching,colour,corolla,form,glabrousnes,growth,hair,height,heteromorphism,inflorescence,number,ovary,plant,position,presence,present,seed,shape,staman,texture,type,width,young
283	wfo-0001029112	invalid_json	190	123	98	92	25	0.516	0.9-1.7,1-10,1-2,1.4-2.5,1.5-1.8,1.5-2,10-17,10-21,2-3.5,2.5-4.5,2.6-3,2.7-3.5,2.7-4.2,2.7-5.7,20,3-7,3.5-4.5,3.5-7,5,6.5-5.5,9.5-13,abaxially,adaxially,anther,berry,blade,brownish,cell,chartaceous,ciliate,cm,condition,conical,corolla,covering,densely,diameter,distal,dorsally,drying,edge,filament,flat,flower,folded,forked,fresh,fruit,glabrous,green,green-white,greenish,hair,hair-like,herb,lanceolate,lateral,leaf,leaflet,lengthening,light,like,make,margin,middle,minute,mm,moniliform,mottled,mucilaginous,odd-pinnate,ovoid,pale,pedicel,peduncle,petiole,plant,pore,poricidal,pubescent,purple,ripe,rotate,seed,size,slit,style,terminal,testal,thick,throughout,tip,tuber,violet,wall,wet,whitish,x	0-2,0.5,1-3,1-4,3-4,3-5,3-6,5-8,5-merou,acumen,acuminate,ag,along,alyx,apart,apex,apparently,arranged,articulated,axe,axillary,base,bead,bud,capitat,connivent,decreasing,digestion,eaf,eed,elliptic-lanceolate,enzyme,equal,especially,exceeding,geminat,generally,glabrou,gradually,half,homostylous,honeycomb-shaped,interjected,larger,living,lobe,long,lower,multiple,narrow,necklace,nflorescence,obtuse,orolla,ovate,pair,perfect,petiolule,plurifoliate,present,pubescen,ray,removed,ruit,secondary,semierec,seudostipule,slightly,spaced,specimen,stamen,ste,stigma,stolon,subequal,subtending,symmetrical,tall,tamen,tem,thir,toward,tri-,tube,typically,unit,usually,vary,wide,wing,yellow,ympodial	'',[,``,age,arrangement,articulation,branching,characteristic,colour,form,growth,height,inflorescence,length,ovary,pseudostipule,shape,spacing,stem,texture,third,value,width,{,}
284	wfo-0001029120	success	168	62	47	121	15	0.28	0.1-0.5,0.5-1.5,0.7-1,1-1.5,1.1-1.5,3-3.5,6-8,acuminate,acute,anther,apex,base,calyx,cm,corolla,decurrent,deflexed,erose,especially,filament,glabrous,internodal,larger,leaf,lobed,margin,minutely,mm,narrowly,nearly,opposite,ovary,ovate,pale,pedicel,petiole,pore,shaped,shrub,simple,slightly,stigma,style,tear-drop,tube,white,yellow-green	.05,.5,.75,/2,1.1-2,2.5-3.5,2.6-7,5-10-flowered,5-8,6.5-16.5,8511,abrupt,anthesi,apart,bark,basal,beginning,beneath,black,bud,bullate,cell,dark,densely,dia,difoliate,dry,drying,eaf,edicel,eed,epidermi,evenly,f,fide,fleshy,free,geminat,globose,golden,greenish-brown,hirsute,inflorescenc,infloresence,know,known,lanceolate,large,later,lateral,lehmann,like,lobe,lon,long,long-triangular,lower,main,middle,midrib,minor,narrow,narrower,nflorescence,occasionally,often,older,outer,pair,paler,papillose,peduncl,peduncle,petaloid,point,poricidal,portion,present,prominently,proximal,pubescent,raised,reproductive,rest,ruit,scar,scattered,slender,spaced,sparsely,specimen,speckle,stem,straight,surface,sympodial,tall,tapering,terminal,thickened,tip,trichome,tub,ud,unbranched,unifoliate,uniseriate,unit,upper,urceolate,vein,venation,way,white-papillo,wide,widening,widest,x,yellow,ympodial,young	articulation,branching,colour,decument,form,growth,hair,height,inflorescence,length,plant,position,shape,white-papillose,width
285	wfo-0001029121	success	161	111	83	78	28	0.516	0,0.2-2,1-4,1-5,1.1-3.9,1.2-2.5,15-30,2-10,2-13,2-3,2-3-celled,3.8-11,4-5.5,4.5-10.0,5-20,5-8,8-16,9-33,apical,apically,blue,branched,cell,cm,conical,connate,corolla,covering,cyme,deep,dehiscent,diameter,dichasially,distal,filament,flower,forked,glabrous,green,green-white,hair,hair-like,herbaceous,interjected,introrse,lateral,leaf,leaflet,make,maturing,medium,mm,mucilaginous,odd-pinnate,often,ovoid,pair,pedicel,peduncle,perennial,perfect,petiole,plant,poricidally,proximal,purple,rarely,rotate,scattered,seed,short,slit,stigma,straight,style,terminal,testal,thick,tuber-bearing,unit,wall,yellow,Â¼	-6,0-2,1.2-3.3,10,2-,3-5,3-6-foliat,3.6-9,4-10,abaxiall,abaxially,acumen,acuminate,acute,adaxially,apex,articulate,attenuate,base,calyx,commonly,cuneate,dichasial,digestion,diminishing,dorsally,eaf,ebracteate,edge,eed,elliptical,emoval,enzyme,exceeding,flat,folded,generally,globo,gradually,half,honeycomb,living,lobe,lon,long,lower,lunat,monochasial,narrowly,nflorescence,nther,oblique,obtuse,orolla,ovate,pattern,petiolule,plan,reveal,rounded,ruit,sessile,seudostipule,short-attenuate,size,specimen,stamen,subequal,tal,tem,throughou,throughout,tip,toward,typically,vary,wide,ympodial	2-6,3-6-foliate,6,anther,arrangement,articulation,branching,colour,form,fruit,globose,growth,height,inflorescence,length,lunate,number,ovary,pore,pseudostipule,shape,stem,structure,sympodial,texture,type,wet,width
286	wfo-0001029125	success	197	138	99	98	39	0.503	.1,.2,1,abaxial,abaxially,acuminate,adaxial,age,anther,apex,appressed,articulated,attenuate,base,berry,black,brownish,calyx,cell,central,cm,concave-reniform,conical,corolla,cuneate,densely,diameter,ellipsoid,end,entire,filament,flower,fruit,fruiting,glabrous,globose,green,herb,hilum,internodal,lateral,leaf,lengthening,live,lobe,lower,margin,maturity,minutely,mm,narrower,oblique,occasionally,one,orange,ovary,ovate-lanceolate,pale,papillate,pedicel,peduncle,per,petiole,plant,pore,poricidal,pubescent,purple,purple-tinged,purplish,ridged,ripe,scar,scattered,seed,simple,slightly,slit,small,sparsely,star,stellate,stem,stigma,stone,style,subshrub,terete,tip,toward,trichome,tube,turning,unequal,uniseriate,white,woody,yellow,Â¼	.0â3.5,.1â1.4,.4,.5â2.0,.6,0.5,0.5â0.6,0.5â1.0,0.8â0.9,0.9,1.0â1.2,1.0â1.5,1.0â4.0,1.5â2.0,1.5â3.0,1.7-,1.8â3.5,1â2-celled,2.5â12.0,2/3,20â100,2â3-celled,2â4,3.0â3.4,3.5â4,35â45,3â5,3â5-celled,4â8,5-merous,5â6,6,6â7,acute,adaxially,along,anthesi,apar,apparently,arising,ba,beyond,branching,closely,cone,delicate,deltate,difoliate,eaf,eed,especially,exerted,free,geminat,growt,later,like,lobed,lon,long,maximum,nearly,nflorescence,often,outline,pair,pentagonal,perfect,place,portion,positioned,primary,reflexe,reflexed,ruit,shiny,shorter,single,spaced,spreading,stemmed,straight,strongly,sub-lateral,surface,tall,tem,testal,tinged,traingular,ud,unit,usually,vein,whitewith,wide,ympodial,young	0.4-0.5,0.5-0.6,0.5-1.0,0.6-0.9,0.8-0.9,1-2-celled,1.0-1.2,1.0-1.5,1.0-4.0,1.5-3.0,1.7-3.4,1.8-3.5,2-3-celled,2-4,2.5-12.0,20-100,3-5-celled,3.5-4,35-45,6-7,apart,articulation,bud,colour,form,growth,hair,height,inflorescence,length,number,position,shape,spacing,symmetry,texture,type,width,ye
287	wfo-0001029150	success	177	123	101	76	22	0.571	.5,0.3,0.3-0.5,0.3â0.5,0.5â1.1,0.8-1,0.8â1,0.8â1.5,0.8â3.5,1.2â1.5,1.5,1.5â2.2,1â1.5,1â11,1â5,2.5â3,2.5â5,2.5â8,2â10,3-5,3â10,3â50,5-merous,6,8-shaped,9â12,acute,adaxially,anther,apex,apically,apiculate,base,branched,calyx,ciliate,climbing,cm,conical,cros,cylindrical,diameter,ellipsoidal,elliptical,enlarged,entire,except,extra-axillary,filament,flattened,fleshy,flower,fruit,glabrous,larger,leaf,light,lobe,long,margin,membranaceous,midvein,mm,moderately,nearly,oblique,opposed,ovate,pedicel,peduncle,petiole,pinnate,pubescent,rachi,rarely,rounded,rounded-deltoid,sand-punctate,section,shortly,simple,slender,slightly,small,somewhat,sparsely,stellate,stem,stigma,style,tan,teardrop-shaped,tip,trichome,truncate,tube,venation,vine,white,woody,x	1.5â2,15,1â2,1â6,2â2.5,2â3,3â4,7â8,abaxially,accrescent,across,adaxiall,alyx,apar,apicall,attenuate,axe,berry,blade,c.,canopy,capitat,color,delicate,distant,dried,eaf,eed,flush,fruiting,glabrou,inconspicuous,lamina,lanceolate,living,lon,lower,m.,material,minutely,mor,nflorescence,nternode,older,orolla,pair,pale,perfec,pinkish-white,plurifoliat,pointed,reaching,rugose,ruit,scar,secondary,side,spaced,specimen,strong,surface,tamen,tem,thick,thickened,time,translucent,tree,understory,unit,vary,vegetation,vein,wide,wiry,ympodial	abaxial,branching,capitate,colour,corolla,form,growth,hair,inflorescence,internode,length,number,ovary,perfect,position,seed,shape,size,staman,texture,thicknes,type
288	wfo-0001029152	success	197	86	70	127	16	0.355	0.25-0.5,0.5-1,0.75-1,0.8-1,0.9-1.3,1-1.5,1-4,1.1-1.3,1.5-1.7,1.5-2,2-2.5,2-5,2.5-3,anther,attenuate,base,broadly,brown,calyx,citronella,cm,conical,corolla,cuneate,dark,deltoid,elliptic,filament,flower,fragrance,fruit,fruiting,glabrous,globose,green,inflorescence,leaf,lightly,lobe,lobed,minutely,mm,obovate,opposite,ovary,ovoid-reniform,pale,papillose,pedicel,petiole,plant,pore,poricidal,red-floccose,shape,shaped,shrub,simple,size,small,stigma,straight,style,tapering,tear-drop,tree,tube,white,winged,x	.1,.5,1,1-2,1-3,2-3,2-4,3-5,3-8-flowered,4-6,6-8,61-25,8.5-16,acuminate,acute,anthesi,apex,appearanc,appearing,appressed,area,ba,bark,beginning,beneath,berry,blade,branch,broadened,bud,closely,completely,corky,deciduous,decurrent,deep,deflexed,densely,dia,differing,difoliate,distal,dry,eaf,edicel,eed,ellipsoi,enclosing,erect,et,exsertion,fide,flattened,floccose,free,geminat,giving,greyish-red,held,hyaline,inflorescenc,keeled,large-lenticellate,late,lateral,live,lon,long,long-styled,longer,lower,main,major,margin,material,middle,midrib,minor,nearly,nflorescence,often,older,one,overlapping,pair,per,pitted,planar,plane,portion,prominent,prominently,quite,red,reddish,reddish-floccose,reflexed,reminiscent,rounded,ruit,scar,shiny,short-styled,single,slender,slightly,somewhat,soon,spaced,stem,styl,surface,tall,terminal,third,tillett,tip,trichome,ud,unit,usually,vein,weak,widest,woody,ympodial,young	1.5-6,3-8,colour,decurred,diameter,form,growth,hair,height,length,number,position,seed,symmetry,texture,type
289	wfo-0001029156	success	65	59	48	17	11	0.738	0.5,1.5-2,10-12,4-6,6,6-8,<,almost,bark,berry,cell,center,cm,completely,deeply,diameter,exfoliating,flattened,fruiting,glabrous,golden,growth,lateral,liana,margin,minutely,mm,multiseriate,new,pale,pedicel,per,pitted,rectangular,reniform,rib-like,seed,shiny,sinuate,stem,surface,tan,testal,thickening,trichome,vine,wall,woody	-3,1,2,apex,apparently,eed,epiphytic,fide,long,markedly,minute,nee,noddin,occasionally,older,shreddy,wide	2-3,colour,form,length,nodding,number,plant,shape,texture,type,width
290	wfo-0001029156	success	65	55	41	24	14	0.631	0.5,1.5-2,10-12,4-6,6-8,<,berry,cell,cm,deeply,diameter,exfoliating,flattened,fruiting,glabrous,golden,growth,liana,margin,minutely,mm,multiseriate,new,pale,pedicel,per,pitted,rectangular,reniform,rib-like,seed,shiny,sinuate,stem,surface,tan,testal,thickening,trichome,vine,woody	-3,1,2,almost,apex,apparently,ark,center,completely,eed,em,epiphytic,fide,lateral,lon,markedly,minute,nee,noddin,occasionally,older,shreddy,wall,x	2-3,6,bark,colour,form,height,length,nodding,number,plant,shape,texture,type,width
291	wfo-0001029163	success	149	107	85	64	22	0.57	0.3-2.5,0.5-1,1,1-2,13-18,2,2-18,2-3,2-6,2.5-3,20-30,3-14,3-4,4-20,4-6,5-8,7-9,abaxially,acuminate,acute,apart,apex,base,calyx,chartaceous,cm,connivent,cuneate,cylindrical,decurrent,deltate,densely,diameter,directed,distally,elliptic,elliptic-ovate,entire,free,fruit,glabrous,globose,hair,herb,lanceolate,lenticular,lobe,long,margin,mm,moderately,narrowed,narrowly,nearly,obtuse,pedicel,peduncle,petiole,pore,pseudohair,puberulent,puberulent-pubescent,purple,rachi,radiu,remnant,shrub,simple,slightly,sparsely,stellate,stem,stigma,style,subcoriaceous,thickened,tip,triangular,tube,unbranched,unknown,white,whitish,x,yellow	-25,-4,-9,1.5-2,1.5-2.5,1.5-3,10-,2-7,3-5,4-5-foliat,4.5-23,5-12,9-15,abaxial,absen,adaxiall,adaxially,aggregate,articulated,axe,band,blade,cell,color,denser,distall,eaf,eed,eglandular,flower,glandular,leaving,like,lon,lower,nflorescence,nther,orolla,papillose,pedicellar,perennial,projection,puberulent-pubescen,pubescence,ripe,roughened,ruit,scale-like,small,sometimes,spaced,stalked,stone,subapical,surface,tal,tem,time,truncat,unit,vary,vein,wide,ympodial	anther,arrangement,articulation,branching,colour,connivence,corolla,form,growth,height,inflorescence,leaf,length,ovary,plant,seed,shape,size,spacing,texture,thicknes,truncate
292	wfo-0001029171	success	137	127	102	35	25	0.745	-,-10,-15,0.5,1-3,1-4.5,1-5,1.5-2,1.5-7.5,10-25,10-35,2-3,3-4,3.5-18,3.5-6.5,4-10,4-5,5-6,5-8,7-9,abaxially,abruptly,acuminate,acute,adaxially,also,and/or,angled,apart,apex,articulated,base,branched,calyx,chartaceous,cm,connivent,cuneate,cylindrical,decurrent,deltate,dendritically,dense,densely,diameter,directed,eglandular,elliptic,entire,flower,forked,fruit,glabrous,gland,glandular,globose,hair,lanceolate,like,lobe,margin,mm,moderately,narrowed,narrowly,obtuse,often,orange,ovate-elliptic,pedicel,peduncle,perfect,petiole,pore,puberulent,pubescent,purple,rachi,radiu,rarely,red,ripe,rugose,shoot,short-stalked,shrub,simple,slightly,smooth,sometimes,sparsely,stellate,stigma,style,tip,triangular,tube,unbranched,usually,white,x,yellow	11-20,6-,8-17,absen,aggregate,axe,ba,blade,cell,distall,eaf,eed,except,glandula,long,lower,many-foliat,midrib,near,nearly,nflorescence,nther,orolla,ruit,spaced,ste,stone,tal,tem,time,truncat,unit,vary,wide,ympodial	anther,articulation,axi,branching,colour,corolla,distally,form,growth,height,inflorescence,leaf,length,number,ovary,placement,plant,seed,shape,size,spacing,stem,texture,truncate,type
293	wfo-0001029215	success	49	49	31	18	18	0.633	0.3-0.5,0.5-0.7,0.5-2.5,1,2.3-2.9,border,brown,calyx,cm,diameter,elongating,entire,fruit,hair-like,herb,lobe,long,markedly,mm,narrowly,obovate,outgrowth,pubescent,round,shrub,small,smelling,strong,wide,winged,woody	-1.8-2.3,.2,appearance,cell,coarse,eed,fide,give,lateral,silky,spreadin,surface,tall,testa,thick,wall,weigend,xyledecor	0.2,1.8-2.3,colour,elongation,form,growth,height,leaf,length,odour,plant,seed,shape,spreading,texture,thicknes,width,wing
294	wfo-0001029216	success	243	165	142	101	23	0.584	+,-0.5,0.1-0.3,0.1-0.5,0.1-0.6,0.1-0.8,0.2-0.25,0.2-0.3,0.2-0.4,0.2-0.8,0.3-0.5,0.3-2,0.4-0.5,0.5,0.5-0.8,0.5-1.5,0.5-2,0.6-0.8,0.6-1,0.8-2.5,1-1.2,1-3,1-4,1-6,1.2-6,1.5-2.3,1.5-3,10,10-,10-14,2,2-4.5,2-locular,2.5-3.3,20-35,3,3-,3-5,3-7,3-foliate,7-10,<,absent,and/or,annual,anther,apical,appendage,articulation,axi,base,basiscopically,biennial,branch,bright,brown,calyx,capitate,cell,cm,column,conical,corolla,crenate,decurrent,deep,dentate,diameter,distal,elliptic,fruit,fruiting,glandular,globose,green,hair-like,herb,imparipinnate,inflorescence,interjected,internode,interrupted,lanceolate,lateral,leaflet,length,less,lobe,mainly,margin,minute,minutely,mm,multicellular,multilocular,narrowly,near,oblique,obovate,often,orange,outgrowth,ovary,ovate,pale,pedicel,peduncle,pentagonal,perennial,petiole,petiolule,primary,pseudostipule,pubescent,rarely,red,secondary,shape,simple,somewhat,sparsely,staminal,stem,sterile,stigma,straight,strongly,style,terminal,tertiary,testa,toward,trichome,tube,unicellular,uniseriate,unit,usually,varying,villous,wall,yellow	-10,-5,.5,.8-1,0.3-0.4,0.4,1-2,1.5-2.5,1/,3-4,4,5,5-15-flower,6-10,absen,accrescent,acroscopically,acute,adpressed,allogamous,always,angeld,anthesi,apex,appearance,articulated,attenuate,basal,becoming,cente,composed,cone,cordate,cultivar,deeply,eaf,edicel,eed,entire,erect,exserted,extending,facultatively,fasciated,filament,fruited,giving,glabrescent,gland-tipped,gree,half,halfway,included,initially,large,larger,later,like,linear,lobulate,lon,long,longer,lower,maturity,mixture,nflorescence,numerous,one,pair,particularly,plant,population,present,procumbent,reflexe,ruit,scen,sessile,shaggy,shaped,short,silky,sometimes,sparse,spreading,strong,surface,tangled,tem,thick,thickening,tip,total,truncate,ud,variety,viny,wide,winged,ympodial	0.8-1,1/3,angled,arrangement,branching,bud,colour,form,growth,history,leaf,life,position,presence,reflexed,seed,staman,structure,sympodial,texture,thicknes,type,width
295	wfo-0001029226	invalid_json	206	163	130	76	33	0.631	-7,-9,.5,0.5,0.5-5,1-1.5,1-2,1-3,1-celled,10-40+,2,2-6,2-9,2.5-10,3-3.5,30,4,4-6,5-7,7-11,>,acuminate,acute,anther,anthesi,apart,apex,apparently,articulated,base,berry,branched,bright,calyx,capitate,cell,cm,congested,cordate,corolla,decurrent,densely,diameter,ellipsoid,elongate,entire,exserted,filament,flattened,flexuous,flower,fruiting,glabrous,gland,glandular,globose,green,growth,hairy,herbaceous,lateral,lavender,leaf,lengthening,like,lobe,lobed,long,lyrate,many,margin,mature,membranous,minute,minutely,mm,occasionally,open,pale,papillate,pedicel,peduncle,per,petiole,pinnatifid,pitted,pore,poricidal,pubescent,red,reniform,ripe,scar,seed,shiny,shrub,simple,sleeve,slit,small,sparsely,spot,stellate,stem,stigma,strongly,style,surface,tan,terminal,testal,thin,time,tip,translucent,trichome,truncate,tube,uniformly,uniseriate,usually,vine,wall,way,weak,white,wide,woody,yellowish,Â¾	.75,0-1,2-3,3-6,5-merou,8-13,ag,alyx,ark,ba,basal,black,blue,breaking,completely,conical,connivent,dark,deltate,distall,divided,dry,eaf,eed,enation,free,glabrescent,ilament,irregularly,juice,longer,loosely,lower,material,mere,new,nflorescence,often,older,one,orolla,overtopping,pair,papillat,papillo,perfect,pinnate,plurifoliat,portion,primary,reflexed,remainin,rim,ruit,sagittate,scarlet,short-glandular,shorter,slender,sometimes,spaced,sprawling,spreadin,spreading,staining,tangled,tem,third,twinin,ud,unit,vary,vein,widest,winged,ympodial	'',[,``,age,articulation,branching,bud,characteristic,colour,distally,exsertion,flexibility,form,fruit,glabrousnes,inflorescence,length,lobing,number,ovary,pubescence,shape,spacing,symmetry,texture,transparency,type,value,width,winging,ye,{,}
296	wfo-0001029236	success	159	100	79	80	21	0.497	.5,0.2-0.7,0.45-0.5,0.5-1.5,0.9-2.3,1-1.5,1-2,1/2,2-4,3,abaxially,absent,anther,anthesi,apex,apically,bark,base,berry,branching,cm,coriaceous,corolla,dendritic,densely,diameter,elliptic,filament,flattened,fleshy,fruit,fruiting,glabrous,globose,grey-brown,growth,leaf,lenticular,lobed,margin,middle,mm,narrowly,near,obscurely,occasionally,ovary,pale,pedicel,per,petiole,pointed,pore,poricidal,prominent,pubescent,purplish,purplish-black,reddish-brown,revolute,scar,scattered,shrub,sleeve,slightly,stem,stigma,strongly,style,terminal,time,tip,trichome,tube,violet,way,winged,x,young	0.2-1,0.5,1.4-1.7,2-5,6-9,adaxial,age,apical,apparently,appearing,axi,ba,basal,becoming,bi-lobe,branch,branchlet,broadly,calyx,compact,completely,conical,cupulate,decurrent,deflexed,deltate,dichasial,eaf,edicel,eed,erect,ew,except,exserted,flower,free,inserted,later,lateral,less,lobe,long,lower,m.,many,midvein,minutely,nflorescence,nodding,obscure,older,overtopping,packe,pericarp,persistent,pitted,plurifoliate,portion,ruit,secondary,shiny,shoot,short,simple,slit-like,sparsely,stamen,surface,tall,tapering,thin,trongly,tub,ud,unit,usually,venation,wide,woody,ympodial	bi-lobed,bud,colour,form,hair,height,inflorescence,insertion,length,new,number,plant,position,presence,prominence,seed,shape,size,texture,type,width
297	wfo-0001029246	success	209	71	54	155	17	0.258	-1.5,0.1-0.4,0.8-1.1,1/3,3-5,3.5-5,5-20,abaxial,acuminate,adaxial,anther,base,berry,calyx,chartaceous,cm,cuneate,elliptic,elongating,entire,equal,flattened-reniform,flower,fruit,fruiting,glabrescent,lateral,leaf,length,lobed,margin,mauve,mm,moderately,narrow-deltate,orange-red,pale,per,petiole,poricidal,prickle,shrub,simple,sparsely,spherical,stellate-pubescent,straight,style,surface,tapering,tip,unbranched,upper,white	-1,-4,/5,0,0-15,0-5,0.1-0.3,0.15-0.3,0.2-1.5,0.3-0.5,0.3-0.8,0.5,0.5-1.5,0.7-1.3,0.7-1.5,0.7-2,0.8-3,0.9-1.3,1-1.5,1-1.8,1-10,1-3,1-4,1-5,1-8,1.2-2,1.5-2.3,1.5-2.5,1.5-6,1.7-6,1.8-3,1/10-1/5,2,2-3,2-3.5,2-5,2.5-3.2,2.8-4,2/3,2/3-3/,3-20,4-6,5-,5-merous,6-10,6-8,7-12,8-16,abaxially,acuminat,acute,almost,alyx,apar,apart,apex,apically,apparently,articulated,bark,blade,broad-deltate,c.,concolorous,connivent,curved,deltate,densely,diameter,discolorous,distance,drying,dull,eaf,eed,erect,extending,eye,filament,flattened,free,glabrous,infructescence,less,lobe,lon,long,longer,lower,mature,maturity,midpoint,midvein,naked,narrow-ovate,nflorescence,oblong,obtuse,older,one,open,orange-brow,orange-brown,orolla,oung,pair,pedicel,peduncle,pendulous,perfec,pericarp,plurifoliat,porrect,portion,prickl,prickly,primary,procumbent,pubescent,purple,ray,recurved,rounded,ruit,scar,sessile,side,smooth,sometimes,spaced,spreading,stellate,stem,stout,strongly,tamen,terete,tertiary,time,trichome,tube,unarmed,unit,usually,vary,vein,venation,visible,way,wide,woody,yellow,yellow-orange,ympodial,Â¼	branching,colour,corolla,form,growth,heteromorphism,inflorescence,number,orientation,ovary,placement,position,seed,shape,staman,texture,type
298	wfo-0001029286	success	224	127	103	121	24	0.46	0.4-1.2,0.8,1-1.5,1.5-2,1.5-4,2-3,2.5-3,4-5,4-6,4.5-7,5-6,6-9,7-10,abaxial,abaxially,acute,adaxially,almost,anther,apart,apex,apically,apiculate,articulation,attenuate,bark,base,branched,branching,broadly,brown,capitate,chartaceous,clustered,cm,conical,corolla,dendritic,diameter,dilated,domatia,entire,faint,filament,flat,formed,glabrescent,glabrous,green,grey,hair,inside,isolated,leaf,length,liana,light,lilac,lobed,long,margin,mauve,membranous,midvein,minutely,mm,obconical,oblong,obovate,outside,pair,pedicel,peduncle,petiole,pore,poricidal,primary,prominent,raised,scar,simple,smooth,sometimes,sparsely,stem,stigma,stump,style,surface,terminal,tertiary,time,tip,translucent,trichome,tube,tuft,unarmed,unit,vein,venation,widely,x	.4,.5,0-0.5,0.1,0.15-0.4,0.6-1.2,0Â°,1-2,1.5-8,1/8,15-50,3-4,4.5,5,6-8,abscising,age,along,altered,alyx,another,anthesi,apar,apice,apparently,arising,around,articulated,axil,becoming,branch,canaliculate,clearly,closer,concave,concolorous,crenulate,curved,cuspidate,delineated,deltoid,density,distributed,drying,eaf,eed,equal,except,extending,fertilization,flexuous,flower,forming,free,fresh,globo,increasing,inflorescenc,junction,know,known,lamina,lengthening,less,lobe,lower,m.,main,margi,mas,meeting,middle,much,multicellular,narrowly,nflorescence,nther,occasional,often,one,orolla,ovate,papillo,perfec,plurifoliat,portion,protruding,rachi,rarely,regular,rounded,ruit,separated,shallowly,side,slender,smaller,somewhat,soon,specimen,spreading,stretchy,tangled,tearing,terete,textur,thick,thickened,thinner,tissue,together,toward,translucent-violet,ud,uneven,vary,visible,wide,yellowish,ympodial,young	arrangement,calyx,colour,form,fruit,growth,habit,inflorescence,na,number,ovary,papillose,pattern,plant,plurifoliate,position,prominence,seed,shape,spacing,structure,sympodial,texture,type
299	wfo-0001029310	success	216	89	67	149	22	0.31	.5,0-5,00,1.2-1.5,2-3.5,2-4,20-40,20-60,3-4,4-10,5-6,8,accrescent,acute,anther,apex,base,berry,branched,brown,calyx,cm,conical,connivent,cordate,dark,diameter,elliptic,enclosing,flower,fruit,fruiting,glabrous,hair,herb,heterostylous,lateral,leaf,length,lobed,margin,mature,mauve,membranous,mm,orange-green,ornately,per,perpendicular,petiole,pinnatifid,porrect,prickle,sessile,shrub,simple,spherical,stalked,stellate,stem,straight,strongly,style,surface,tapering,truncate,yellow	-16,-25,.1,.6,/4,/6,0-20,0.1-0.2,0.2-0.3,0.2-0.8,0.5,0.5-3,0.6-1.1,1,1-1.5,1-2,1-4,1.8-3,1/,10,10-13,10-15,10-20,15-20,2.5-6,2/3-3/4,200-500,3-5,3.5,4-8,45-60,5,5-10,5-12,5-20,5-30,5-7,5-8,5-merous,6-8,7-12,7-13,abaxially,alyx,ame,andromonoecious,apar,apart,apically,apparently,articulated,bark,beyond,blade,c.,concolorous,deltate,difoliate,distal,distance,drying,dull,eaf,eed,elongating,equal,erect,extending,filament,filifor,flattened-reniform,free,geminat,gently,glabrescent,gray,hermaphrodite,inflated,infructescence,lobe,lobing,lon,long,long-styled,longer,lower,lowermost,maturity,midpoint,midvein,minute,moderately,narrow-deltate,nflorescence,older,one,open,orolla,oung,pair,pedicel,peduncle,pendent,pendulous,pericarp,plant,poricidal,portion,prickl,prickly,primary,ray,recurved,red-brow,retrorse,ruit,scar,secondary,short-styled,shorter,side,smooth,sometimes,spaced,sparsely,spreading,stalk,staminat,stellate-pubescent,stout,tamen,terete,tertiary,time,tip,tissue,toward,trichome,tube,unit,variously,vary,vein,venation,visible,way,wide,woody,ympodial	arrangement,branching,colour,corolla,form,growth,inflorescence,na,number,orientation,ovary,placement,position,seed,shape,staman,staminate,symmetry,texture,type,width,ye
300	wfo-0001029317	success	151	64	48	103	16	0.318	0.25,0.5,0.8-1,1,1-1.5,2-3,7-8,8-9,acuminate,anther,apex,attenuate,base,broadly,calyx,cm,corolla,cup-like,densely,filament,glabrous,inflorescence,leaf,lobed,margin,minutely,mm,narrowly,opposite,ovary,ovate,papillose,pedicel,petiole,pore,poricidal,pubescent,rounded,shaped,shrub,simple,stigma,style,tear-drop,trichome,tube,uniseriate,white	.5,0.5-0.75,0.5-1,1.5-3.5,10-16,10-30-flowered,11-14,2.5-5,6-8,6.5-11,along,anthesi,apar,area,barely,beneath,brow,bud,ca,channeled,closely,deciduou,deflexed,deltoid,denser,dia,differing,difoliate,dry,eaf,edicel,eed,ellipsoi,epidermi,erect,exserted,extreme,free,frui,fruiting,geminate,glabrate,globose,grayish,immature,known,lateral,like,lobe,lon,long,lower,main,major,middle,minor,nearly,nflorescence,occasionally,often,older,one,otherwise,overlapping,ovoid,pair,paler,portion,probably,prominent,proximal,rachi,raised,reflexed,remaining,rest,ruit,scar,size,slender,slightly,soft,soon,spaced,sparsely,specimen,stem,straight,styl,tall,tapering,thickened,tip,tuft,ud,unit,vein,visible,widest,x,yellowish,ympodial,young	2,5,colour,diameter,form,fruit,growth,height,length,na,plant,position,seed,shape,texture,type
301	wfo-0001029332	success	197	82	67	130	15	0.34	0,0-100,1-1.5,1-3,1.3-1.5,1.5-2,1/2,2-2.5,2.5-3.5,3-4,4-10,8.5-9.5,abaxial,adaxial,anther,apex,base,berry,calyx,chartaceous,cm,conical,connivent,cordate,curved,densely,elongating,equal,flattened,flower,fruit,fruiting,glabrescent,lateral,leaf,length,lobed,long,margin,maturity,mauve,mm,orange-brown,ovate,pale,per,petiole,poricidal,prickle,rounded,shrub,simple,spherical,spreading,stellate,stellate-pubescent,style,surface,tapering,terminal,tip,unbranched,upper,weakly,yellow,yellow-green,yellow-orange	-5,.5,/3,0-0.5,0-2,0-20,0-4,0-5,0.1,0.1-0.2,0.15-0.2,0.15-0.25,0.5-1,0.8-1,1-2,1-4,1/3,1/4,1/4-1/3,10-30,2,2-4,2.8-3.7,2/,2/3-3/4,3-6,3.5-5,4-15,5-6,5-8,5-merous,6-8,abaxially,alyx,andromonoecious,apar,apart,apically,apparently,articulated,bark,becoming,blade,broad-deltate,concolorous,diameter,difoliate,distal,distance,drying,eaf,eed,erect,extending,filament,flattened-reniform,free,geminat,glabrous,gland,globular,grayi,herbaceous,hermaphrodite,heterostylous,infructescence,less,lobe,long-acuminat,long-styled,longer,lower,lowermost,mature,midpoint,midvein,moderately,narrow-deltate,nflorescence,often,older,one,open,orolla,oung,pair,pedicel,peduncle,pendulous,pericarp,plant,porrect,portion,prickl,prickly,primary,pubescent,ray,reduced,ruit,scandent,scar,sessile,short-styled,shorter,side,slender,smooth,spaced,stalk,stalked,staminat,stem,subsessile,tamen,terete,tertiary,time,trichome,tube,unit,variously,vary,vein,venation,visible,way,wide,woody,ympodial	branching,colour,corolla,form,growth,inflorescence,number,ovary,position,seed,shape,staman,texture,type,width
302	wfo-0001029333	success	155	120	100	55	20	0.645	.25,.5,/4,0.5,0.5-1,0.7-1,1-1.2,1-1.5,1-15,1-3,1-7,1.5-2,1.5-2.5,1.5-3,10-15-flowered,100,17-26,2-2.5,3-7,3-7.5,5-6,8-15,9-13,abaxial,acuminate,acute,anther,apex,auriculate,bark,base,beige,broadly,calyx,clavate,cm,conical,corolla,dendritic,densely,dia,dry,elliptic-obovate,exserted,filament,flattened-reniform,flower,fresh,fruiting,glabrous,globose,golden,green,incrassate,lateral,leaf,lobed,long,long-styled,main,margin,minor,minutely,mm,obovate,occasionally,opposite,orbicular,ovary,pair,pale,paler,pedicel,petiole,pitted,pore,pubescent,reddish-brown,scar,sessile,shape,shaped,shining,short-styled,shrub,small,somewhat,spaced,stigma,strongly,style,surface,tear-drop,time,tree,trichome,truncate,tube,vein,way	1-2,abaxially,adaxially,along,anisophyllou,anthesi,ba,beneath,berry,contracted,deflexed,dendritic-pubescent,denser,differing,difoliate,eaf,edicel,eed,erect,free,geminate,heteromorphic,inflorescenc,like,lobe,lon,lower,major,nflorescence,older,overlappin,papillo,planar,poricidal,portion,present,pubescence,rest,rounded,ruit,simple,size,slender,sparsely,stem,tall,tip,triangular,type,ud,unit,wide,woody,ympodial,young	1,adaxial,bud,colour,diameter,exsertion,form,fruit,growth,hair,height,inflorescence,length,overlapping,papillose,plant,position,seed,texture,width
303	wfo-0001029334	success	211	101	83	128	18	0.393	0-4,0.15-0.3,1,1-2,1-3,1.3-4.5,1.5-3.9,1.5-6,2-2.5,2.5-3,3-5,3.2-5.8,4-5.5,4-8.5,5-10,7.5-15.5,8-30,9-12,abaxially,absent,adaxially,almost,anther,blade,brownish,chartaceous,ciliate,clavate,cm,condition,corolla,densely,diameter,drying,filament,flower,forked,fresh,fruit,glabrous,globose,green,greenish,hair,herb,homostylous,interjected,lanceolate,lateral,leaflet,long,margin,membranous,minutely,mm,odd-pinnate,ovoid,pair,pedicel,peduncle,petiole,plant,pore,poricidal,puberulent,pubescent,pure,ripe,seed,size,stellate,stem,stigma,style,terminal,tinged,tip,tuber,violet,white,whitish,wide,x	.2,1-10,1-6,1.8-2.9,2,2-4,2-5,2-8,3-7,3.3-6.5,5-merou,acumen,acute,ag,along,alyx,among,apart,apex,apparently,articulated,attenuate,axe,axillary,base,berry,borne,broadly,bud,capitat,cell,connivent,cordate,covering,cuneate,decreasing,decurrent,digestion,distal,dorsally,eaf,edge,eed,elliptic,end,enzyme,erect,especially,exceeding,except,flat,folded,geminat,generally,glabrou,gradually,grassland,greatly,green-white,hair-like,half,honeycomb-shaped,lengthening,like,living,lobe,low-growin,lower,make,middl,midrib,mucilaginous,narrowly,nflorescence,oblique,obtuse,often,orbicular,orolla,ovate,perfect,petiolulate,petiolule,plurifoliate,proximal,rarely,reduced,removed,rounded,ruit,semi-rosette,sessile,seudostipule,shady,short,singly,situation,slightly,slit,spaced,specimen,stamen,ste,stolo,straight,subequal,subsessile,subtending,sunny,tall,tamen,tem,testal,thick,throughout,toward,tri-,tube,typically,unit,unwinged,usually,vary,wall,wet,woodland,yellow,ympodial	arrangement,branching,capitate,colour,form,growth,height,inflorescence,leaf,length,ovary,presence,present,pseudostipule,shade,shape,symmetry,texture
304	wfo-0001029344	success	147	90	67	80	23	0.456	.5,0.4-1,0.5-1,1,1-5,1.5,10-20,10-35,2-4,3-10,4-6,5-15,absent,acute,anther,apex,base,brown,calyx,center,chartaceous,ciliate,cm,cordate,densely,diameter,drying,edge,elliptic,elliptic-ovoid,entire,filament,fine,flower,fruit,glabrous,globose,herb,immature,margin,membranaceous,mm,moderately,nearly,oblong,obtuse,parallel,pedicel,peduncle,per,petiole,pubescent,rachi,radiating,raised,ridge,rotate,rounded,running,semitransparent,shallow,sparsely,style,surface,white,x,yellow	0.5-1.5,0.5-3,1-2,1-3,1-6,1.5-3,1.5-4,2-3,2-3-celled,2-7,5-12,abaxially,abundant,adaxiall,adaxially,along,axe,berry,beyond,blade,connected,decurrent,dehiscing,denser,difoliate,dm,eaf,eed,emarginat,equal,explosively,exserted,flat,frui,geminat,hair,held,interpetalar,lacking,linear-lanceolate,lobe,long,lower,lying,maturing,maturit,mesocarp,nflorescence,notch,obvious,often,one-,orolla,placenta,pressure,pubescen,rhizomatous,ruit,short,slightly,sometimes,stamen,stigma,straight,swollen,tal,tamen,tem,tissue,triangular,tube,two-celled,unbranched,unit,vary,vein,watery,wid,woody,ympodial	abaxial,adaxial,branching,colour,corolla,decument,emarginate,form,growth,inflorescence,leaf,length,number,ovary,present,pubescence,rhizome,seed,shape,staman,stem,symmetry,texture
305	wfo-0001029363	success	152	97	81	71	16	0.533	.25,.75,/4,0.1-0.5,0.2-1.1,0.5,0.5-1,1,1-1.2,1.5-1.7,1.5-3.5,2-6,3-7,4-11,6-7,6-8,acute,anther,anthesi,bark,base,becoming,berry,bi-lobed,bud,calyx,capitate,cm,corolla,cup-shaped,deep,deflexed,densely,elliptic,filament,fruit,fruiting,glabrous,globose,green,greyish,immature,internodal,leaf,lobed,long,maroon,minutely,mm,narrowly,obtuse,occasionally,opposite,ovary,paler,pedicel,petiole,pore,poricidal,pubescent,shiny,shrub,small,somewhat,sparsely,stem,stigma,style,tapering,terminal,thickened,tip,tree,trichome,tube,tuft,uniseriate,way,white,white-papillose,young	0-0.1,5-7-flowered,7-10,acuminate,apex,axil,ba,beginning,beneath,closely,coroll,deltoid,dia,drying,eaf,edge,edicel,eed,erect,except,exsertion,free,inflorescenc,known,lamina,larger,later,lateral,lobe,lon,lower,main,margin,mature,meeting,middle,minute,much,near,nflorescence,often,older,overlapping,pair,pale,papillo,papillose,portion,prominent,reflexed,ruit,scar,simple,slender,slit-like,spaced,sparse,straight,surface,tall,ud,unifoliat,unit,upon,usually,vein,wide,widest,woody,yellowish,ympodial	5-7,colour,diameter,flower,form,growth,hair,height,inflorescence,length,number,plant,position,shape,texture,width
306	wfo-0001029364	success	153	114	86	67	28	0.562	-2,-6,.5,0.2-0.5,1-3,1-4,1-5,1.5-2,10-27,2,2-6,3-4,4-9,5-9,6-8,7-9,8-10,?,acuminate,acute,anther,apart,apex,base,calyx,chartaceous,cm,corolla,cream,cuneate,cylindrical,diameter,directed,distally,elliptic,entire,extra-axillary,filament,finger,fruit,glabrous,gland-tipped,globose,green,greenish,hair,herb,immature,lobe,margin,membranaceous,minutely,mm,narrowly,nearly,obtuse,ovate,pedicel,peduncle,petiole,pore,presence,puberulent,pubescent,rachi,radiu,sagittate,shallow,short-tomentose,shrub,simple,small,sparsely,spot,stellate,stigma,strongly,style,tapered,triangular,tube,unbranched,unknown,white,wide,x	-3,1,1-,191.,2-,2-foliat,4-12,5-,5-11,8-15,abaxially,according,adaxially,aggregate,around,articulated,axe,ba,bitter,blade,blue,cell,center,color,connivent,curled,darker,deep,distall,eaf,ed,fide,flower,free,glandular-puberulen,inserted,long,lower,major,mesocarp,moderately,nflorescence,orolla,part,perfect,present,puberulen,ripe,ruit,rusby,shorter,side,spaced,stone,tal,tamen,tem,thecae,tightly,time,tomento,truncat,unit,vary,vein,yellow,ympodial	1-6,2-12,abaxial,adaxial,articulation,branching,colour,form,growth,height,inflorescence,insertion,leaf,length,ovary,plant,position,seed,shape,size,spacing,staman,stem,texture,theca,truncate,type,width
307	wfo-0001029368	success	139	71	58	81	13	0.417	.5,0.5-2,0.9-1,1.5-1.6,1.5-3,1.5-4,2-5,2.5-4,5-6,abaxially,acute,anther,base,broadly,calyx,capitate,cm,conical,corolla,dia,elliptic,erect,filament,fruit,fruiting,glabrous,globose,golden,green,herb,inflorescence,internodal,known,leaf,long,minutely,mm,obtuse,opposite,ovary,pedicel,petiole,pore,poricidal,puberulent,shaped,shrub,somewhat,stigma,style,tear-drop,tip,trichome,uniseriate,white,winged,woody,x	.2,.25,0,1.5-2,11-13,16-25,?,acuminate,adaxially,along,anthesi,apex,apparently,bark,bearing,berry,bitter,borne,breaking,brow,closely,coarse,crumpled,cup,deflexed,densely,distal,eaf,edicel,eed,exserted,few-branched,fide,flattened,flower,free,half,indistinct,inflorescenc,lamina,lanceolate,lateral,leaving,like,lobe,lower,main,margi,margin,middle,midrib,minute,nflorescence,non-flower,older,one,overlappin,pair,papillo,papillose,parallel,portion,reflexed,rest,ruit,scar,simple,spaced,stem,straight,strongly,tall,tube,ud,unifoliat,unit,upper,vein,widest,ympodial,young	colour,form,growth,hair,height,length,plant,position,presence,seed,shape,symmetry,texture
308	wfo-0001029370	success	224	120	99	125	21	0.442	-32,0-35,0.5-2.2,1-2,1-3,1.5-6,1/4-1/3,15-30,3-4,3.5-4,3.5-8,5-12,5.5-7,6-15,7-13,8-23,abaxial,abaxially,adaxial,almost,anther,apex,articulated,basal,base,berry,branched,calyx,chartaceous,cm,conical,connivent,cordate,curved,densely,diameter,discolorous,drying,elongating,equal,erect,flattened,flattened-reniform,flower,fruit,fruiting,greenish,herb,lateral,leaf,length,lobe,lobed,long,margin,maturity,mauve,mm,multangulate,obtuse,orange,orange-brown,ovate,overlapping,pale,pedicel,peduncle,per,petiole,plant,poricidal,prickle,prickly,red-brown,rotate,rounded,shrub,side,simple,slightly,sometimes,spherical,stalked,stellate-pubescent,stem,straight,strongly,tapering,terete,tip,trichome,variously,venation,way,white,whitish,wide,yellow,young	-20,.1,.3,.5,/4,0-10,0-100,0-3,0.1,0.1-0.15,0.2,0.3,0.5-1,1,1-4,1.8-2.5,1.8-2.8,1/3-1/2,10-17,10-40,10-50,12-17,2-10,2-20,2-3,2-6,2.5-3.5,3/,4-6,4-7,4-9,5-10,5-merous,7-11,8-14,8-20,acut,alyx,ame,andromonoecious,apar,apart,apically,apparently,bark,blade,broad-deltate,c.,clearly,cream,dark,distal,distance,eaf,eed,elongate,extending,fewer,filament,fine,free,fully,gently,glabrescent,glabrous,green,hermaphrodite,heterostylous,infructescence,long-styled,longer,lower,lowermost,marking,mature,midpoint,midvein,mixture,moderately,nflorescence,often,older,one,open,opening,ornate,orolla,oung,pair,pattern,pendulous,pericarp,perpendicular,plurifoliat,porrect,portion,prickl,primary,ray,reticulate,ruit,scar,sessile,shiny,short-styled,smooth,spaced,spreading,stalk,staminat,stout,style,surface,tamen,tertiary,time,tube,unarmed,unit,vary,vein,visible,white-gra,woody,ympodial	50-100,articulation,branching,colour,corolla,form,growth,hair,height,heteromorphism,inflorescence,number,position,scale,seed,shape,size,staman,texture,type,width
309	wfo-0001029373	success	199	102	74	125	28	0.372	3,5,6.8,abaxial,acute,adaxial,anther,apex,appressed,articulated,bark,base,bayonet,berry,bud,calyx,clavate,cm,conical,corolla,densely,diameter,ellipsoid,enclosing,entire,filament,flattened-reniform,fruit,fruiting,glabrous,globose,green,grey-brown,growth,hair,herb,hilum,internodal,lateral,laterally,leaf,margin,middle,minute,minutely,mm,moderately,new,obtuse,ovary,ovate-lanceolate,papillate,pedicel,peduncle,petiole,pitted,pore,poricidal,pubescent,rounded,shallowly,shape,simple,stellate,stem,stigma,style,surface,terete,tip,tube,white,yellow,yellowish	.0â1.2,.2,.3,.5,.5â2.0,0.3â0.5,0.4â1.6,0.5â1.2,0.5â1.8,0.6â0.7,1.0â1.2,1.0â1.6,1.2â1.5,1.3â2.2,1.4â3.5,1.5â2.0,1.5â2.5,1.5â2.7,1.8â2.0,1.8â2.3,180Â°,2-celled,2.0â2.5,2.7â3.0,20â30,2â4-celled,3.5â4.0,30â40,3â5,4â5,4â6,5-merous,5â6,8â9,abaxially,accrescent,acuminate,adaxially,age,anthesi,apar,appearanc,arising,basal,beyond,broadly,capped,cell,cone,curved,deltate,developing,distal,eaf,eed,elongate,enclosed,exerted,finger,flower,free,fully,geminat,glandular-tipped,half,halfway,immature,individual,lengthening,less,like,live,lobe,lobed,lon,long,lower,mature,mesocarp,mouth,nflorescence,node,older,outline,pair,pentagonal,per,perfect,plant,plurifoliate,portion,positioned,primary,reflexed,resembling,root,ruit,scar,seen,seudostipule,short,slightly,slit,smoot,spaced,spreading,still,straight,tall,tem,testal,thicker-walled,trailing,trichome,tub,ud,uniseriate,unit,upper,vein,wide,woody,yellow-green,ympodial,â5	0.3,0.4-1.6,0.5-1.2,0.6-0.7,1.0-1.2,1.0-1.6,1.2-1.5,1.4-3.5,1.5-2.5,1.5-2.7,2.5,2.7-3.0,5-6,8-9,articulation,branching,colour,form,inflorescence,length,position,pseudostipule,pubescence,seed,smooth,texture,type,width
310	wfo-0001029402	success	113	66	40	73	26	0.354	0.5-1,0.5-2,2,2-3,3-4,3-6,7-11,7-8,7-9,articulated,base,branched,chartaceous,ciliolate,cm,connivent,cylindrical,elliptic,free,glabrous,hair,lanceolate,lobe,margin,mm,narrowly,pedicel,petiole,pore,shrub,simple,stellate,stigma,style,tapered,tube,unit,unknown,violet,x	1-2.5,11-17,15-30,2-10,3-5,4-6,4-7,4-8,5-25,6-16,8-15,abaxial,abaxially,acuminate,acute,adaxially,apart,apex,axe,band,blade,calyx,color,deltate,denser,diameter,directed,distall,eaf,eed,fleshy,flower,forked,glabrate,glabrou,inrolled,leaving,long,lower,many-foliat,moderately,narrowed,nearly,nflorescence,nther,often,orolla,papillose,peduncle,pubescence,pubescent,rachi,rachise,radiu,roughened,ruit,scale-like,scar,somewhat,spaced,sparsely,surface,tal,tem,thickened,time,tip,triangular,truncat,unknow,vary,wide,ympodial	anther,articulation,branching,colour,connective,corolla,form,fruit,growth,height,inflorescence,insertion,leaf,length,many-foliate,ovary,plant,position,seed,shape,stem,structure,sympodial,texture,truncate,type
311	wfo-0001029404	success	154	105	81	73	24	0.526	0.5-1,1-4,2-3,2-8,2.5-3,20-35,3-4,5-10,5-20,6-8,6-9,abaxially,acuminate,adaxially,anther,apex,apiculate,auriculate,base,branched,calyx,center,chartaceous,cm,connective,connivent,cordate,cream,dark,darker,deltate,densely,diameter,distally,ellipsoidal,entire,flattened,flower,fruit,glabrous,green,hair,lanceolate,lemon,light,lobe,longitudinal,margin,mm,moderately,mottling,narrowly,obtuse,orange,ovate,ovoid,pedicel,peduncle,petiole,pink,pore,puberulent,pubescent,purple,rachi,radiu,shrub,simple,somewhat,star,stellate,stigma,style,toward,tree,triangular,unbranched,vein,white,x,yellow	-1.5,-10,-3,-5,0-60-flower,1,1.5-2,15-25,2,2-4,2-5,2.5-22,3-5,3-8.5,4-foliat,5-24,5-6,6.5-34,8-12,absent,acute,aggregate,apart,ape,articulated,axe,basal,beyond,blade,cell,cylindrical,directed,eaf,eed,eglandular,exserted,fleshy,glandular,glandular-puberulen,leaving,less,lon,long,lower,nflorescence,nther,orang,orolla,pedicellar,perfect,presen,remnant,ripe,ruit,shorter,slightly,small,spaced,sparsely,stone,subcoriaceous,tal,tem,thecae,time,tomento,truncat,tube,ud,unit,vary,wide,ympodial	20-60,articulation,branching,bud,colour,corolla,direction,form,growth,height,inflorescence,leaf,length,number,ovary,plant,seed,shape,size,stem,texture,theca,truncate,type
312	wfo-0001029406	success	136	78	66	70	12	0.485	0.3-1,0.5-1,0.6-1,0.7-1.5,1-1.5,1-10,1-2,1.5-2.2,1.5-2.5,1.5-5,2,2-11,2-3,2.5-3.5,28,3-9,30,4-18,4-6,abaxially,acute,adaxially,anther,apex,arachnoid,base,broadly,calyx,clavate,cm,conical,corolla,elliptic,filament,fruiting,glabrous,globose,green,greenish-white,leaf,lobed,minor,minutely,mm,nearly,ovary,ovoid,ovoid-reniform,pedicel,petiole,pitted,pore,pubescent,shaped,shiny,shrub,slightly,small,stigma,style,surface,tear-drop,tree,trichome,tube,white	.5,7-12,along,anthesi,arachnoid-pubescent,ba,bark,berry,brown,brownish,bullate,conspicuously,dark,deciduous,deflexed,deltate,densely,dia,differing,difoliate,dry,eaf,eed,felt-like,free,geminat,grayish-brown,grayish-green,impressed,large,lateral,lenticel,lilac,lobe,lon,long,lower,main,major,margin,matted,maturity,middle,occasionally,often,older,pair,pale,papillo,papillose,planar,pointed,population,poricidal,portion,ruit,size,soon,stem,tall,tinge,tip,unit,vein,waxy,wide,widest,woody,ympodial,young	colour,diameter,form,fruit,growth,height,length,plant,seed,shape,texture,width
313	wfo-0001029407	success	208	118	99	109	19	0.476	-6,.5,/3,0-15,0.1-0.25,0.4-1,0.5-0.7,0.5-1.5,0.5-2,0.6,0.6-0.9,0.7-1.2,1-1.4,1-3,1.5,1.8-2.5,1/5,2-4,2.5-3,3-4,3-6,4.5-6,6-20,abaxial,abaxially,acute,adaxial,anther,apex,base,berry,bright-red,calyx,chartaceous,cm,connivent,cuneate,densely,diameter,dull,elliptic,entire,evenly,flattened-reniform,flower,fruit,fruiting,green,lateral,leaf,length,lobed,long,margin,mature,maturity,mauve,midpoint,mm,moderately,obtuse,occasionally,orange,orange-brown,ovate,pale,pedicel,per,petiole,poricidal,porrect,prickle,rarely,ray,recurved,rounded,sessile,shrub,simple,slender,sometimes,spherical,stalk,stalked,stellate-pubescent,stem,stout,straight,straw-yellow,style,tapering,tip,trichome,unbranched,upper,way,white,yellow,young	-10,-2,-25,-4,-7,0,0-2,0-4,0-5,0.1-0.2,0.15-0.4,0.2-0.3,0.4-0.7,1,1-2,1-4,1-4.5,1/3,1/3-1/2,1/8-1/5,2-3,2-5,3.5-4.5,4-15,4-9,5-7,5-merous,6-13,7-8,acut,almost,alyx,apar,apart,apically,apparently,articulated,bark,blade,brow,curved,dark,deltate,difoliate,discolorous,drying,eaf,eed,elongating,equal,erect,filament,flattened,free,geminat,geminate,glabrescent,glabrous,gray-greenish,green-brown,infructescence,lengt,lobe,longer,lower,nflorescence,older,one,open,orolla,oung,pair,peduncle,pendulous,perfec,pericarp,portion,prickl,prickly,primary,pubescent,reflexed,ruit,scar,shorter,side,smooth,spaced,sparsely,spreading,stellate,strongly,surface,tamen,terete,tertiary,thick,time,tube,unit,vary,vein,venation,visible,weakly,wide,woody,yellow-green,ympodial	branching,colour,corolla,form,growth,hair,height,inflorescence,number,ovary,plant,presence,present,seed,shape,staman,texture,type,width
314	wfo-0001029408	success	244	141	118	126	23	0.484	0,0.2-0.3,0.5-2.5,0.7-1.2,1-8,2-12,2-5,2.2-3.7,2.5-7,3-5,4-20,5-24,5-6,5-6.5,7-12,acute,anther,apical-lateral,articulated,bark,base,becoming,berry,blunt-tipped,branch,branched,broadly,brown,bud,chartaceous,clavate,cm,conical,continued,corolla,cuneate,dark,deltoid,dendritic-multangulate,diameter,due,echinoid,elliptic,entire,extend,fleshy,flower,fruit,globose,gray,green,growth,hair,honeycombed,introrse,lanate,large,lateral,leaf,length,lilac,long-,longitudinal,main,margin,midvein,mixed,mm,mostly,multangulate,oblong,ovate,pale,partly,pedicel,peduncle,petiole,plurifoliate,pore,porrect-stellate,pseudo-terminal,purplish,rachi,rarely,rather,reniform,reticulate-punctate,ripe,rotate-stellate,sessile,short-,short-attenuate,shrub,side,simple,slit,small,stem,stigma,style,suborbicular,terete,testa,thick-stalked,thick-textured,thin-stalked,time,tomentose,tree,unit,vein,velutinous,white,whitish,x,yellow,yellowish,young	-1.5,-10.5,-4.5,.2-3.5,/10,0-100,0.3-5,0.9-1.3,0.9-1.6,1.1-1.5,1.4-1.9,1.5-3,1.6-2.8,1.7-2.4,1.8-3.5,1/2,1/2-3/4,1/4,11-31,2-3.5,2-4,2/3,3.5-5,4-14,4-7.5,5-8,5-merou,abaxially,accrescent,acuminate,adaxiall,adaxially,ag,alyx,anthesi,apart,apex,axe,axillary,ba,barely,blade,calyx,capitat,decurrent,dehiscing,dendritic-echinoi,densely,develope,directed,distal,distall,eaf,echinoi,eed,exserted,faintly,few-rayed,filament,free,fruiting,glabrous,high,homostylous,indument,inserted,interpetalar,lacking,lanceolate,lobe,lobed,long,long-attenuate,long-stalked,lower,m.,many,moderately,near,nearly,nflorescence,obscured,obtuse,often,older,orbicular,orolla,ovate-lanceolate,overlapping,part,perfect,persistent,present,pubescent,ray,relatively,ribbed,ruit,runk,short-stalked,slightly,sometimes,spaced,stamen,stelliform,subcampanulate,subovate,suture,tamen,thick,tissue,tomentu,tomentum,top,touching,toward,tube,turbinate,unarme,unarmed,usually,vary,way,well,wide,ympodial	abaxial,adaxial,age,arrangement,articulation,branching,capitate,colour,dendritic-echinoid,form,height,inflorescence,ovary,plant,position,seed,shape,structure,sympodial,texture,thicknes,trunk,type
315	wfo-0001029417	success	213	155	134	79	21	0.629	.5,0-7,0.2-0.6,0.7-3,1-10,1-2,1-4,1-8,1.3-8,1.5-1.8,1.5-8,12,2.5-10,2.8-3.5,3-14,3-5,4-7,5-15,6-11,8-15,8-9,abaxially,adaxially,anther,apart,attenuate,blade,blue,borne,broadly,brownish,cell,chartaceous,clavate,cm,coarsely,condition,corolla,covering,dark,deep,diameter,distal,dorsally,dot,drying,edge,end,erect,filament,flat,flower,folded,forked,fresh,fruit,glabrous,globose,green,green-white,greenish,hair,hair-like,half,herb,homostylous,interjected,lanceolate,lateral,leaflet,lengthening,like,linear,lobe,long,lunate,make,medium,membranous,minute,minutely,mm,moderately,mucilaginous,narrowly,non-glandular,odd-pinnate,often,orbicular,ovate,ovoid,pair,pedicel,peduncle,pentagonal,petiole,pilose,plant,pore,poricidal,puberulent,pubescent,purple,rarely,ripe,rotate,scattered,seed,singly,size,slightly,slit,sometimes,stem,stigma,straight,style,terminal,testal,thick,throughout,tinged,tip,trichome,tube,tuber,typically,violet,wall,wet,white,whitish,wide,x	0.4-8,1,1-1.5,1.5-10,2-4,5-merou,acumen,acuminate,acute,ag,along,alyx,apex,apiculate,apparently,articulated,axe,axillary,base,basiscopic,berry,bud,capitat,central,ciliate,connivent,decreasing,decurrent,digestion,eaf,eed,enzyme,erec,especially,exceeding,geminat,generally,glabrou,greatly,hal,honeycomb-shaped,living,lower,margin,midrib,nflorescence,orolla,perfect,petiolulate,plurifoliate,rapidly,removed,rounded,ruit,sessile,seudostipule,short,short-petiolulate,side,spaced,specimen,stamen,star,ste,stolo,subequal,subtending,tall,tamen,tem,tri-,unit,unwinged,usually,vary,widely,wing,yellow,ympodial	age,arrangement,articulation,branching,calyx,capitate,colour,form,growth,height,inflorescence,leaf,length,ovary,presence,pseudostipule,shape,spacing,stolon,symmetry,texture
316	wfo-0001029461	success	217	77	61	156	16	0.281	-1.5,0.6-1,1/4-1/2,4.5-7,5-25,5-merous,abaxially,almost,anther,attenuate,base,berry,black,calyx,chartaceous,cm,cuneate,dull,elliptic,evenly,flattened-reniform,flower,fruit,fruiting,glabrous,green,leaf,length,lobed,long,lower,margin,maturity,mauve,mm,moderately,oblong,ovate,per,petiole,prickle,reddish,shiny,shrub,simple,sometimes,sparsely,spherical,spreading,staman,stellate-pubescent,stem,subentire,surface,unarmed,unequal,way,weakly,yellow,young,zygomorphic	-14,-2,-3,-3.2,-3/4,-4,-4.5,-5,.5,0,0.1,0.1-0.25,0.15-0.25,0.7-1,0.8,0.8-1.5,1-,1-1.6,1-2,1-3,1-4,1-6,1.2-1.7,1.2-1.8,1.3-2.2,1.5-,1.5-2,1/3,1/3-2/3,1/4,2-2.4,2-2.8,2-3,2-4,2.5-3,3-20,3-6,4-10,4-6.5,4-7,4.7-7.2,5-10,7-10,7-12,8-9,acuminat,alyx,ame,andromonoecious,apart,apex,apically,bark,becoming,blade,breaking,brittle,broad-deltate,brown,c.,cell,concolorous,curved,dark,densely,diameter,discolorous,distal,distance,drying,eaf,eed,elongating,erect,extending,faint,fifth,filament,fine,flattened,four,free,glabrescent,gra,hermaphrodite,heterostylous,infructescence,lengt,lobe,long-styled,longer,lowermost,mature,midpoint,midvein,obovate,obtuse,older,orange,orolla,oung,outline,pair,pedicel,pendulous,pericarp,pit,plant,plurifoliat,poricidal,porrect,portion,prickl,prickly,primary,raised,ray,reduced,reflexed,rounded,ruit,sessile,shallow,short-styled,shorter,side,slender,slightly,small,smooth,spaced,stalk,stalked,staminat,stellate,straight,strongly,style,tamen,terete,tertiary,time,tip,trichome,tube,unarme,unit,upper,variously,vary,vein,venation,visible,wide,woody,ympodial	arrangement,colour,corolla,form,growth,hair,heteromorphism,needle-like,number,orientation,placement,seed,shape,symmetry,texture,type
317	wfo-0001029462	success	166	119	88	78	31	0.53	-4,-5,0.5-1,0.5-2,1-3,1-6,2-6.5,2.5-3.5,20-35,3,3-27,3-7,5-30,6-9,abaxially,abruptly,acuminate,acute,aggregate,apex,base,broad,calyx,campanulate,cell,chartaceous,cm,connective,connivent,constricted,cuneate,cylindrical,dark,densely,diameter,directed,ellipsoidal,elliptic,entire,flattened,fruit,glabrous,green,hair,lanceolate,laterally,light,lobe,longitudinal,margin,membranaceous,minutely,mm,moderately,near,obtuse,occasionally,oval,ovate,ovoid,pedicel,peduncle,petiole,pore,puberulent,pubescent-pilose,purplish,rachi,radiu,reticulate,rounded,simple,smooth,somewhat,sparsely,stigma,stone,stripe,style,tip,tree,triangular,truncate,unbranched,unit,white,x,yellow	-2,-30,1,1-,1-2,1.5,1.5-2,1.5-3,1.5-7,10-,10-22,15-25,2-3,2.5-5.5,3-18,3-4,3-5,3-6,4-15,4-20,4-foliat,7-19,7-8,8-9,absent,adaxially,apart,ape,articulated,axe,basal,beyond,blade,ciliate,curled,dentate,eaf,eed,eglandular,equal,exceeding,exserted,flower,leaving,lon,long,lower,m.,narrowly,nflorescence,nther,often,orolla,pedicellar,perfect,pubescent,pubescent-pilo,purpl,remnant,ruit,shorter,slightly,small,spaced,stamen,stellate-,tal,tem,thecae,time,tomentose,truncat,tube,ud,vary,wide,without,ympodial	1-15,10-25,4-foliate,abaxial,adaxial,anther,articulation,branching,bud,colour,corolla,form,growth,height,inflorescence,leaf,length,ovary,plant,position,purple,seed,shape,size,spacing,stem,structure,sympodial,texture,theca,type
318	wfo-0001029464	success	235	118	86	149	32	0.366	0.2-0.5,00-200,1-10,1.2-3,12-50,2.2-2.5,2.9-3.2,5.5-7.5,abaxial,acicular,adaxial,andromonoecious,annual,anther,around,base,berry,black,branched,brown,calyx,chartaceous,cm,connivent,cordate,cultivar,cup-shaped,curved,dark,ellipsoid,elongating,equal,filament,flattened-reniform,fruit,fruiting,glabrescent,glabrous,glaucous,globular,green,hair,herb,lateral,leaf,length,lobed,long,margin,maroon,mature,maturity,mauve,mm,moderately,mottled,oblong,obtuse,orange-brown,ovate,ovoid,per,petiole,pink,plant,poricidal,prickle,purple,red-brown,simple,sometimes,stellate-pubescent,stem,straight,striped,tapering,terminal,tip,trichome,usually,variously,white,wide,yellow-green,yellow-orange,young	-2/3,-3,-30,-5,.9,0,0-2,0-80,0.2,0.2-0.7,0.3-0.7,0.3-1,0.5,0.5-2,0.8-2,1,1-3,1-8,1.5-2,1/,1/4,1/4-1/2,1/4-1/3,10-15,10-23,10-40,10-50,2,2-3,2-3.5,2-4,2.4-4,2.5-5,2.5-8,3-20,3-5,3-7,3.5-5,4-7,4-8,4-8-merous,5-17,5-8,5.5-6,6-15,7-10,8-13,8-15,9-15,abaxially,acute,alyx,ame,apar,apart,apex,apically,apparently,articulated,bark,blade,broad,broad-deltate,brow,c.,deltate,diameter,difoliate,discolorous,distal,distance,drying,eaf,eed,elongated,erect,extending,flower,free,fully,geminat,green-brown,hermaphrodite,heterostylous,infructescence,less,lobe,long-acuminat,long-styled,longer,lower,lowermost,midpoint,midvein,minute,narrow-deltate,nflorescence,occasionally,often,older,one,open,opening,orolla,oung,pair,pedicel,peduncle,pendent,pendulous,pericarp,porrect,portion,prickl,prickly,primary,ray,rounded,ruit,scar,sessile,short-styled,side,smooth,spaced,sparsely,spreading,stalk,stalked,staminat,stellate,style,surface,tamen,terete,tertiary,time,translucent,tube,unarmed,unit,upper,vary,vein,venation,visible,way,woody,ympodial	appressed,branching,breeding,colour,corolla,form,growth,height,heteromorphism,history,inflated,inflorescence,life,marking,modification,na,odour,orientation,placement,pore,position,seed,shape,smell,spot,staman,symmetry,system,texture,type,vegetative,zygomorphy
319	wfo-0001029546	success	203	128	112	91	16	0.552	0-2,0.3-1,1-2,1-4.5,1.5-2,1.5-6.2,2.2-2.8,3-8,4-10,4.5-12.5,4.5-7,5,5-10,5-18,5-8,7-10,8-17,8-19.5,abaxially,adaxially,anther,base,blue,broadly,brownish,cell,chartaceous,clavate,cm,condition,connivent,corolla,curved,decreasing,densely,diameter,digestion,dot,drying,elliptic,enzyme,filament,flower,forked,frequently,fresh,fruit,glabrous,glandular,globose,greatly,green,greenish,hair,herb,homostylous,honeycomb-shaped,lanceolate,lateral,leaf,leaflet,lengthening,long,longer,lunate,membranous,mm,nearly,non-glandular,odd-pinnate,often,orbicular,ovate,ovoid,pair,pedicel,peduncle,pentagonal,petiole,plant,pore,poricidal,pubescent,rachi,rarely,removed,ripe,rotate-pentagonal,seed,short,simple,size,slightly,slit,soft,sometimes,stem,stigma,straight,style,subequal,terminal,testal,tinged,tip,trichome,wall,white,whitish,wide,wing,x	1-10,1-3.2,1-5,1.6-6.5,2-4,2-9,3.5-5,5-merou,6.3-19.5,8,absent,acumen,acuminate,acute,adaxiall,ag,alyx,apart,apex,apiculate,apparently,articulated,attenuate,axe,axillary,berry,blade,bud,capitat,cordate,covered,covering,decumben,decurrent,distal,dorsally,eaf,edge,eed,elliptical,erect,exceeding,flat,folded,geminat,generally,glabrou,green-white,hair-like,half,interjected,like,living,lobe,lower,make,middl,minutely,mottle,mucilaginous,nflorescence,oblique,perfect,petiolule,plurifoliate,purple,regular,ruit,sessile,seudostipule,spaced,specimen,stamen,ste,subtending,tall,tamen,tem,thick,throughout,tri-,truncate,tube,typically,unit,unwinged,usually,vary,wet,yellow,ympodial	age,arrangement,branching,calyx,capitate,colour,form,growth,height,inflorescence,length,ovary,pseudostipule,shape,staman,symmetry
320	wfo-0001029552	success	161	117	101	60	16	0.627	.25,.5,0.5,0.6-1,1-1.5,1-2,1-3,1-5,1.5-2,1.5-6.5,10-20,12,2-2.5,2-9,2.5-3,5-10-flowered,5.5-8,abaxially,abruptly,acuminate,acute,adaxially,along,anther,apex,area,base,branched,broadened,calyx,clavate,cm,conical,contracted,corolla,decurrent,dendritic,densely,dia,elliptic,erect,filament,flattened-reniform,flower,fruiting,glabrous,globose,green,incrassate,inflorescence,lamina,leaf,like,lobed,long,long-styled,major,margin,middle,minor,minutely,mm,nearly,occasionally,opposite,orbicular,ovary,paler,pedicel,petiole,pitted,pore,pubescent,rest,rounded,shape,shaped,shining,short-styled,shrub,simple,size,small,somewhat,sparsely,stem,stigma,style,surface,tan,tear-drop,tip,tree,tree-like,trichome,tube,vein,white,wide,widest,x	0.1-0.5,1-1.3,6-9,abaxial,anthesi,bark,berry,broadly,closely,deflexed,deltate,denser,differing,difoliate,drying,eaf,edicel,eed,exserted,free,geminat,greyish-brow,heteromorphic,inflorescenc,later,lateral,lobe,lon,lower,main,minute,nflorescence,older,onto,overlappin,pair,pale,papillo,persistent,planar,poricidal,portion,present,reflexed,ruit,scar,scattered,slender,slightly,spaced,strongly,swollen,tall,tub,ud,unit,woody,yellowish,ympodial,young	branching,colour,diameter,form,fruit,growth,hair,height,length,number,papillose,plant,position,seed,texture,width
321	wfo-0001029584	success	180	128	104	76	24	0.578	0-30,1,1-2,1-6,1.5-6.5,16.2-33,2-3,2-4,3-10,3-7,4-14,4-15,4-5,4.5-11.5,6-7,6.1-9.4,7-14,8-15,9.7-23.4,9.8-17,abaxially,anther,borne,brownish,cell,clavate,cm,condition,coriaceous,corolla,covering,dark,dense,densely,diameter,distal,drying,end,filament,finer,flower,forked,fresh,fruit,generally,glabrescent,glabrous,green,green-white,greenish,hair,hair-like,half,herb,homostylous,interjected,lateral,leaf,leaflet,lengthening,light,lobe,long,make,mm,mucilaginous,oblong-lanceolate,odd-pinnate,ovoid,pair,pedicel,peduncle,pentagonal,petiole,plant,pore,poricidal,pubescent,purple,seed,short,simple,singly,size,slit,stigma,straight,style,substellate,terminal,testal,thick,throughout,tip,tube,tuber,typically,unwinged,usually,wall,wet,white,whitish,x	1-3,2.4-6.3,3-5,5-merou,5.3-13.3,acumen,acuminate,acute,adaxially,ag,alyx,apart,apex,apparently,articulated,asymmetric,attenuate,axe,axillary,base,basiscopic,blade,bud,capitat,connivent,considerably,decreasing,digestion,dorsally,eaf,edge,eed,elliptic,enzyme,erry,flat,folded,geminat,hal,honeycomb-shaped,larger,linear,living,lower,margin,middle,nflorescence,orbicular,orolla,ovate,perfect,petiolulate,plurifoliate,present,proximal,removed,second,semi-erec,sessile,seudostipule,side,spaced,specimen,stolo,subtending,tall,tamen,tem,tissue,toward,tri-,unit,unknow,vary,yellow,ympodial	abaxial,adaxial,age,arrangement,branching,calyx,capitate,colour,form,growth,height,inflorescence,length,ovary,presence,pseudostipule,shape,staman,stem,stolon,symmetry,texture,type,unknown
322	wfo-0001029593	success	181	124	108	73	16	0.597	-10,0.05,0.5-1,0.5-5,0.8-1,0.8-1.2,1,1-1.2,1-1.5,1-8,1.6-2.3,2,2-3,2-5,2.3,2.3-3.0,3-4,3.5-8,35-60,4-6,5-15,7.5-15,9-15,abaxially,abruptly,acuminate,acute,anther,anticlinal,apex,apically,arising,attenuate,axil,axillary,basal,base,basiscopically,broadly,brown,calyx,capitate,cell,cm,conical,decurrent,densely,diameter,elliptic,enlarged,epidermal,filament,filiform,fruit,fruiting,glabrous,globose,green,half,irregular,lateral,leaf,leaflet,long,lower,markedly,minutely,mm,narrowing,oblique,obovate,occasionally,once-branched,onto,ovary,ovoid-reniform,pair,papillose,pedicel,per,petiole,petiolule,pinnate,plant,pointed,poricidal,projection,pubescence,pubescent,rachi,seed,shape,shrub,sinuous,slightly,smaller,somewhat,stigma,style,terminal,thickening,tip,tube,usually,winged,without,woody,x	1-2,10-50,100,2-14,5-10,7-25,adaxially,age,always,anthesi,bearing,berry,cateniform,clavat,colony,cone,deltate,dry,drying,eaf,edicel,eed,entire,exserted,extremely,flower,free,glabrescent,growing,hollow,included,lamina,large,lobe,much,nflorescence,noddin,often,open,opposite,perfectly,place,portion,primary,pubescen,purple,rarely,reflecting,rest,ruit,scar,short-styled,similar,simple,single-stemmed,small,smooth,sparsely,surface,tall,tem,trichome,tub,ud,unifoliat,uniseriate,unit,variable,vein,white,white-lenticellate,wider,ympodial	arrangement,branching,bud,clavate,colour,form,growth,height,inflorescence,length,nodding,number,position,size,stem,texture
323	wfo-0001029601	success	187	126	103	84	23	0.551	0-37,0.2-0.8,0.5-5.8,1-2,1-3,1-4,1-53,1.7-6.5,2,2-12,2-7,2-9,2.3-5.9,2.8-10.5,3-10,3-7,4-13.5,5-41,6-10,6.6-22,6.8-14.5,abaxially,adaxially,anther,berry,blade,borne,brownish,cell,clavate,cm,condition,coriaceous,corolla,covering,dark,diameter,dot,drying,end,filament,flower,forked,fresh,fruit,glabrescent,glabrous,globose,green,green-white,greenish,hair,hair-like,herb,homostylous,interjected,lanceolate,lateral,leaf,leaflet,light,lobe,make,middle,mm,mucilaginous,narrow,odd-pinnate,ovoid,pair,pedicel,peduncle,pentagonal,petiole,plant,pore,poricidal,puberulent,ripe,rotate,seed,short,singly,size,slightly,small,stigma,straight,style,terminal,testal,thick,throughout,tip,tube,tuber,typically,wall,wet,white,whitish,wing,x	0.5-8,1.1-2.7,1.2-2.3,2-3,2.2-4.5,3-5,5-merou,abaxiall,acumen,acuminate,acute,ag,alyx,apart,apex,apparently,articulated,asymmetric,attenuate,axe,axillary,base,basiscopic,bud,capitat,connivent,decreasing,digestion,distal,dorsally,eaf,edge,eed,elliptic,enzyme,erec,exceeding,flat,folded,geminat,generally,glabrou,half,honeycomb-shaped,larger,lengthening,linear,living,long,lower,middl,nflorescence,orbicular,orolla,ovate,perfect,petiolulate,plurifoliate,removed,rounded,ruit,sessile,seudostipule,side,slit,spaced,specimen,stamen,stolo,subequal,subglabrou,subtending,tall,tamen,tem,tissue,toward,tri-,unit,unwinged,usually,vary,yellow,ympodial	abaxial,adaxial,arrangement,articulation,branching,calyx,capitate,colour,form,growth,height,inflorescence,length,number,ovary,presence,pseudostipule,shape,stem,stolon,subglabrous,texture,type
324	wfo-0001029621	success	165	124	100	65	24	0.606	.1,0.5-0.75,0.5-1.2,0.5-1.5,0.7-1.1,0.8-1,0.8-4.5,1-1.5,1.5-2.5,1.5-5,2/3,3-3.5,3.5-4.5,5-20-flowered,6-20,6-8,7-9,accrescent,acute,anther,apex,appressed,area,attenuate,base,becoming,branched,calyx,cluster,cm,completely,constricted,corolla,cup-shaped,decurrent,dia,ellipsoid,enclosed,erect,filament,fleshy,fruit,fruiting,glabrate,glabrous,globose,green,lanceolate,late,later,lateral,leaf,lobe,lobed,main,many,merely,minutely,mm,oblanceolate,often,older,onto,ovary,ovoid-reniform,pair,papillate,papillose,pedicel,pitted,plant,pore,puberulent,quite,reddish,ripe,scar,sessile,shaped,shrub,stem,stigma,style,surface,tear-drop,terminal,thick,time,tip,trichome,tube,uniseriate,vein,way,white,whorl-like,widened,woody,x,yellowish	0.5-1,1-2,1.5-2,1/3,2.5-3,along,anthesi,apar,appearing,bark,beneath,berry,borne,brown,caudate,course,dark,deltoid,densely,distal,dry,eaf,edicel,eed,elongate,exsertio,free,geminate,irregularly,like,live,lon,long,lower,margin,material,middle,nflorescence,occasionally,pale,papillo,planar,plurifoliat,poricidal,portion,prominent,rarely,reddish-gre,river,ruit,shiny,small,somewhat,spaced,ste,straight,tall,tan,tapering,ud,unit,widest,yellow,ympodial,young	apart,arrangement,branching,bud,colour,exsertion,flower,form,growth,hair,height,inflorescence,length,number,orientation,position,seed,shape,size,spacing,stage,texture,thicknes,type
325	wfo-0001029622	success	182	124	102	80	22	0.56	.1,.5,/3,0.5-1,0.8-1,1-1.2,1-1.5,1-4,1.5,2-11,2.5-3,3-4,3-5,30-35,4-6.5,5-6,absent,acute,anther,apex,appearing,attenuate,bark,base,beneath,brown,calyx,chartaceous,cm,consisting,corolla,cylindrical,deflexed,diameter,difoliate,elliptic,entire,filament,flower,fruit,geminate,glabrous,globose,green,inflorescence,internodal,jointed,known,lateral,leaf,lobe,lobed,long-acuminate,long-triangular,longitudinal,main,margin,mature,mm,narrowly,obconic,oblong,occasionally,older,opening,opposite,ovate,pair,pedicel,peduncle,petiole,pore,rachi,reddish,rounded,sagittate,shaped,shiny,shrub,simple,single,size,slightly,slit,somewhat,stellate,stem,stigma,straight,style,tapering,tear-drop,tip,trichome,tube,tuft,uniseriate,unit,vein,way,white,x	.2,0.3,0.5,0.5-0.7,0.6-0.9,1-2.7,2-4,2-5,40,45-50,7-11,abaxially,accrescent,adaxially,ag,alyx,anthesi,apparently,arising,axe,axil,blade,bud,capitat,connivent,deciduous,differing,dimorphic,eaf,eed,elongate,except,free,fruiting,glabrou,ilament,immature,included,interlaced,lamina,less,long,m.,major,measured,midrib,minor,minute,minutely,nflorescence,often,one,onto,orolla,oung,ovate-lanceolate,papillose,pendent,portion,present,probably,raised,reflexed,remaining,ruit,scar,second,slende,slender,tal,thin,thus,ud,unarme,unifoliat,vary,within,yellow,ympodial,young	abaxial,adaxial,age,capitate,colour,form,glabrousnes,growth,hair,height,information,length,ovary,plant,position,seed,shape,structure,sympodial,texture,type,unarmed
326	wfo-0001029625	success	168	147	132	36	15	0.786	-15,..,.1-0.2,0.5-1,0.5-2,0.5-2mm,0.8-1.4,0.8-1.8,1-1.5,1-2,1-3,1.2-1.6,2,3,3-,3-3.5,4-10,4-4,4-5-celled,4-7-celled,4-9,5,5-10,5-6,5-8,6-9,9-25,abaxial,along,anther,anthesi,bark,base,beneath,branch,branched,brittle,calyx,cell,cm,conical,corolla,cucullate,darker,deflexed,deltate,densely,denser,diameter,dry,elliptic,erect,filament,flattened,four,fruit,fruiting,glabrescent,glabrous,gland,gland-tipped,globose,green,greenish,growth,herb,hyaline,inflorescence,lamina,later,lighter,like,lobe,lobed,long,margin,markedly,midline,mixed,mm,narrowly,nearly,occasionally,outer,outline,ovary,ovate-reniform,pale,papillate,pedicel,peduncle,per,pericarp,planar,point,pointed,pubescent,purplish,rarely,reddish,regularly,scattered,shrub,single,sinuate,slightly,small,smooth,sparsely,stem,stigma,striate,stripe,strongly,style,surface,tan,testa,thin,time,tinged,tip,triangular,trichome,tube,uniseriate,vein,wall,weight,white,x,young	.5,0.5-1.3,100,2.5-.,3-3,8-13,apical,branc,brow,capitat,cel,deflexe,distinct,eaf,edicel,eed,flower,frui,glandular,lower,middle,minute,new,nflorescence,open,pair,plurifoliat,primary,ruit,scar,single-stemmed,tuft,ud,unit,without,ympodial	arrangement,branching,brown,capitate,colour,form,leaf,length,number,plurifoliate,pubescence,seed,shape,size,texture
327	wfo-0001029645	success	160	140	114	46	26	0.713	.5-1,0.2-0.5,0.3-0.5,0.5-2.5,0.5-7,1,1-1.5,1-2,1-4,1.3-7,1.5,1.5-2,2-4,2.5-17,2.5-4,3-10,3-15,3-7,3.5-4,337,4-5,4-8,5,5-8,6-12,7-12,750,?,acuminate,acute,aggregate,along,anther,apart,apex,base,blue,brown,calyx,cell,chartaceous,cm,corolla,cuneate,cylindrical,deltate,diameter,directed,distally,entire,et,except,extra-axillary,fide,filament,finger,flattened,fruit,glabrous,gland-tipped,globose,green,greenish,hair,herb,immature,kayap,line,lobe,margin,membranaceous,minutely,mm,moderately,nearly,obtuse,ovate,ovate-elliptic,pedicel,peduncle,petiole,pore,puberulent,purple,rachi,radiu,rarely,red,rotate-stellate,rugose-verrucate,sagittate,short,short-tomentose,side,simple,small,smith,sparsely,stigma,stone,strongly,style,subcordate,tapered,triangular,truncate,tube,unbranched,vein,white,wide,x,yellow,Â±	-1,2-3-foliat,abaxially,abundantly,adaxially,around,articulated,axe,ba,blade,connivent,decurrent,distall,eaf,eed,flower,free,glabrou,inserted,knapp,long,lower,major,mesocarp,nflorescence,orolla,part,perfect,puberulen,ruit,sand-punctate,shorter,shru,spaced,tal,tamen,tem,thecae,tightly,time,tomento,truncat,unit,vary,veiny,ympodial	0.5-1,articulation,branching,colour,decurred,form,growth,height,inflorescence,insertion,leaf,length,ovary,plant,position,seed,shape,shrub,size,spacing,staman,stem,symmetry,texture,theca,type
328	wfo-0001029646	success	141	95	70	71	25	0.496	0.1-0.6,0.5-0.8,0.7-2.2,1-4,1.5-2,1.5-4.9,10-15,2-3,3-14,4-5.5,5-15,6-8,7-15,acuminate,acute,apex,apically,attenuate,base,branched,calyx,cm,corolla,cyme,dehiscent,diameter,dichasial,dichasially,distal,elliptic,filament,finely,flower,free,globose,green,green-white,half,herbaceous,leaf,linear,lobe,long,mm,monochasial,mucilaginous,mucronate,narrowly,ovate,ovoid,pedicel,peduncle,perennial,perfect,petiole,plant,poricidally,proximal,pubescent,seed,simple,stellate,style,throughout,tone,tuber-bearing,unit,white,yellow-green,Â¼	0.5,3-6-foliat,abaxially,acumen,adaxially,apical,articulate,cell,commonly,covering,digestion,dorsally,eaf,ebracteate,edge,eed,emoval,enzyme,epiphytic,equaling,flat,folded,forked,generally,globo,ground,growing,hair-like,honeycomb,introrse,lateral,living,lon,lower,make,maturing,mos,mould,nflorescence,nther,oak,often,orolla,ovat,pattern,pine,plan,rarely,reveal,ruit,seudostipule,short,slit,specimen,stamen,stigma,straight,tall,tem,testal,thick,throughou,tree,typically,vary,viole,wall,wide,without,yellow,ympodial	3-6-foliate,anther,articulation,branching,colour,form,fruit,growth,height,inflorescence,length,number,ovary,pore,position,pseudostipule,shape,stem,structure,sympodial,texture,type,violet,wet,width
329	wfo-0001029652	success	160	92	68	92	24	0.425	0.5-1,0.5-4,0.8-1,1-2,1-3,1.5-2,2-2.5,2-4,2.5-3,3.5-4,3/4,4-4.5,anther,apex,attenuate,base,calyx,cm,conical,corolla,elliptic-ovate,filament,fruiting,glabrous,globose,golden,green,greenish-white,leaf,lobed,long-styled,margin,minor,minutely,mm,narrowly,occasionally,opposite,ovary,ovoid-reniform,pale,papillose,pedicel,petiole,pitted,pore,poricidal,pubescent,shaped,short-styled,shrub,simple,size,slightly,stigma,style,surface,tan,tear-drop,thickened,tip,trichome,tube,undulate,uniseriate,way,white,x	.25,.3,.5,0.75-1,1,2,25,6-15,7-9,abaxially,adaxially,along,anthesi,apar,ape,apical,arch,arching,ba,bark,bearing,berry,broadly,cone,curling,deciduous,deflexed,deltate,denser,dia,differing,difoliate,drying,eaf,edicel,eed,evenly,exserted,filiform,flower,free,geminat,golden-red,hard,heteromorphic,hispid,included,joining,lamina,lateral,like,lobe,lon,long,long-acuminate,lower,main,major,maturity,middle,midrib,minute,near,nflorescence,older,pair,papillo,pericarp,portion,projection,reddish-brown,reflexed,ruit,scar,series,slende,slender,soon,spaced,sparsely,stem,swollen,tall,time,tub,ud,unit,vein,widest,within,ympodial,young	0.25,0.5,abaxial,adaxial,branching,colour,diameter,form,fruit,growth,hair,height,heteromorphism,inflorescence,length,na,plant,position,seed,shape,symmetry,texture,type,ye
330	wfo-0001029673	success	159	127	106	53	21	0.667	.5,0.5-1,0.7-1.1,0.75-1,0.8-1,1-10,1-2,1.2-3.5,1.5-1.8,1.5-2,10-20,2-2.5,2-3,2-4,2.5,3-5,3/4,4-6,5.5-15,abaxial,abaxially,absent,adaxial,adaxially,age,anther,apex,apical,appearing,bark,basal,base,becoming,black,branch,branching,broadly,calyx,clavate,cm,corolla,deep,dendritic,densely,diameter,elliptic,exserted,filament,fork,fruit,fruiting,glabrous,globose,greyish,greyish-yellow,growth,later,lateral,leaf,length,lenticular,lobe,long,minutely,mm,narrowly,occasionally,ovary,overtopping,pair,pedicel,petal,petiole,pitted,pore,poricidal,prominent,pubescent,purple,pyramidal,reddish-brown,scar,secondary,shoot,shrub,sleeve,slit-like,small,sparsely,stem,stigma,strongly,style,surface,tapering,terminal,time,tip,tree,trichome,tube,vein,violet,winged,x,young	1-5,5-25,accrescent,acuminate,acute,along,anthesi,berry,blade,conical,decurrent,deflexed,deltoid,denser,dichasia,eaf,edicel,eed,ew,flower,free,greyish-yello,individual,inserted,lamina,like,lon,longer,lower,m.,monochasial,nflorescence,nodding,older,papillo,pericarp,planar,plurifoliate,portion,reflexed,ruit,slightly,somewhat,stamen,tall,thin,triangular,tub,ud,unit,wide,woody,ympodial	bud,colour,exsertion,form,hair,height,inflorescence,insertion,new,papillose,plant,position,prominence,seed,shape,size,staman,texture,venation,width,winging
331	wfo-0001029680	success	212	135	112	100	23	0.528	0.1,0.6â1.2,0.6â2.0,1.0â1.1,1.0â1.5,1.1â1.2,1.4â7.5,1.6â2.7,1.7â7,11â16,11â25,12,1â2,3.0â4.2,3.3â5.5,3â6,4.0â16,4.0â6.5,4.5â20,4.5â7.0,4â10,5,50,5â11,8â32,abaxially,acute,annual,anther,anthesi,apart,apex,articulated,base,becoming,bipinnate,blue,brown,calyx,clavate,cm,cylindrical,densely,diameter,divided,filament,flattened,fleshy,flower,fruit,glabrous,globose,green,hair,herb,indistinct,leaf,length,light,lobe,long,margin,mm,moderately,oblong,obovate,obtuse,ovate,pair,pale,pedicel,peduncle,pentagonal,petiole,pinnae,pinnate,pitted,pore,primary,pubescent,purple,rarely,red,ripe,rotate,shallowly,shaped,size,sometimes,sparsely,stem,stigma,straight,style,subglabrous,surface,tear-drop,time,tripinnate,tube,turning,violet,white,wide,winged,woody,x,â10,â12.5,â19,â3,â3.2	.0,0.4,0.5â1.5,0.6,0.9â1.0,1,1.0,1.0â1.8,1.4â2.5,1.5,1.8â3.8,10,1â3,1â6,1â8,2.2â4.2,2â20,3â22,4â30,5.5â8.5,7â10,absen,adaxiall,adaxially,ag,along,appressed,arequipa,arranged,asymmetrically,axe,axillary,ba,beyond,blade,borne,branched,cell,connivent,decreasing,decurrent,difoliate,eaf,eed,entire,equal,erect,extending,flange,forming,geminat,irregularly,lon,longitudinal,lower,m.,midrib,multicellular,narrow,nflorescence,node,occasionally,often,opening,orolla,parallel,pendant,perfect,plurifoliate,poricidal,prostrate,rapidly,ruit,running,secondary,shoot,side,simple,spaced,specimen,split,stone,tacna,tal,tamen,tem,terminal,tertiary,tip,unicellular,uniseriate,unit,usually,vary,wing,winge,yellow,ympodial,â46,â48	articulation,axi,branching,colour,corolla,decurred,form,growth,height,history,inflorescence,life,number,ovary,plant,ratio,seed,shape,spacing,staman,texture,type,width
332	wfo-0001029704	success	146	83	69	77	14	0.473	0-1.5,1-4,1.5-2.5,1.5-3,140-185,2-3,2-5,3-5,5,7-10,acuminate,acute,anther,apex,base,blue,branch,broadly,brown,cell,cm,composed,conical,corolla,cuneate,dark,ellipsoid,extra-axillary,few-flowered,filament,flower,fork,fruiting,glabrous,globose,green,lanceolate,leaf,lengthening,lobe,minutely,mm,mottled,obovate,occasionally,ovary,pedicel,peduncle,petiole,pinnatisect,pore,poricidal,pubescent,purple,reddish,reticulate,shrub,simple,single,slit,stellate,stigma,stone,striped,style,subdiscoidal,surface,tip,white	-17,-3,.5,0.5,1,1-2,1.5,10-14,1000-1200,15-25,2-2.5,3-4-celled,4,4-7,7-,9-20,acuman,along,also,anthesi,apparently,aspect,axi,berry,c.,calyx,cunate,cut,deeply,deflexed,dia,diam,eaf,eed,enlarged,erect,especially,exerted,flowering,gradually,halfway,less,lobed,long,lower,midrib,minute,moderately,nflorescence,obovoid,one,plurifoliat,record,rounded,ruit,shoot,short,sinus,sombre,sprawling,stout,straight,subglobo,swollen,trichome,tub,tube,twig,ud,unit,variable,variously,vein,within,x,ympodial,young	branching,colour,form,fruit,growth,height,inflorescence,length,plant,position,seed,shape,subglobose,texture
333	wfo-0001029727	success	260	71	49	211	22	0.188	-3,0.4-1,0.7-0.9,2.5-3.2,2.8-4,4.5,5.5-7,abaxial,adaxial,anther,base,berry,branched,climber,cm,cordate,corolla,filament,flattened-reniform,flower,glabrous,lateral,leaf,length,lobed,long,lower,margin,mm,orange-brown,ovate,per,petiole,pore,poricidal,prickle,rounded,seed,shape,shrub,simple,size,stellate-pubescent,stem,surface,tapering,terminal,violet,wide	-1/3,-10,.5,/3,0-15,0-2,0-20,0-30,0-4,0-40,0-5,0-8,0.1-5,0.15-0.2,0.15-0.3,0.2,0.2-0.5,0.2-2.5,0.3,0.4,0.5,0.5-1.2,0.5-3,0.7-1,1,1-,1-1.2,1-2,1-4,1.2-2,1.5-2.3,1.5-2.5,1.5-3,1.5-5.5,1.6-3,1/2-2/3,1/3-1/2,1/4,1/8-1/5,2-5,2.5,2.5-5.5,3-11,3-6,3-7,3/,4-7,4-merou,4-merous,4.5-,5-12,5-8,5-9,6-11,7-10,abaxially,acicular,acuminate,acute,age,almost,along,alternate,alyx,ame,anthesi,apar,apart,apex,apically,apparently,articulated,bark,blade,bristle,brown,c.,calyx,chartaceous,clavate,colourles,connivent,covered,cupular,curved,darker,deltate,deltoid,densely,developing,diameter,different,dimorphic,discolorous,divided,drying,eaf,edge,eed,elongating,equal,erect,except,extending,ferrugineous,filiform,filiform-acuminat,finely,fissure,free,geminate,increasing,inside,lengthening,less,like,lobe,lon,longer,m.,mature,mauve,middle,midpoint,midvein,minor,minutely,mixture,moderately,narrow-deltate,nflorescence,nther,obconical,oblong,occasional,older,one,open,orolla,oung,outside,pair,papillo,papillose,pedicel,peduncle,perfec,perfect,pit,pitted,plurifoliat,porrect,portion,prickl,prickly,primary,protruding,pubescent,raised,rarely,ray,red-brow,red-brown,reddish,reduced,regular,scandent,scar,series,sessile,shallowly,short,sinus,smooth,sometimes,spaced,spreading,stalk,stalked,stellate,stigma,straight,strongly,style,subentire,tamen,tearing,terete,tertiary,time,tip,toward,translucent,transverse,trichome,tube,unarmed,uneven,unit,upper,variable,variously,vary,vein,venation,visible,way,x,yellowish,ympodial,young	20-30,branching,colour,form,fruit,green,greyish,growth,hair,hirsute,inflorescence,na,needle-like,number,orientation,placement,position,symmetry,texture,type,white,zygomorphy
334	wfo-0001029731	success	246	178	146	100	32	0.593	.5,.6,0.1-0.8,1,1-2,1.5,1.5-2.5,1.5-3,2,2-3,2.5,3,3-4,4-5,4-9,6-7,7-11,8-9,accrescent,acquiring,acuminate,acute,almost,anther,apex,apically,bark,basally,base,beak,becoming,berry,black,branch,branched,branching,brown,bumpy,calyx,clavate,cm,conical,coriaceous,corolla,crinkled,cuneate,deltoid,dense,development,diameter,distributed,dorsal,drying,dull,early,elliptic,enlarge,entire,epiphyte,erect,evenly,faint,filament,finely,flattened,fleshy,fruit,fruiting,glabrous,hair,large,lateral,leaf,less,liana,like,linear,lobed,long,long-ellipsoid,longitudinal,longitudinally,main,margin,maturity,mauve,midvein,mm,narrowly,oblong,obovate,often,orange-brown,pair,papillae,papillose,part,pedicel,peduncle,pendulous,pericarp,petiole,pore,poricidal,primary,pyriform,rarely,reflexed,revolute,ribbed,ridge,ridged,rounded,scar,several,simple,slender,small,sometimes,sparsely,stem,stigma,stretched,stump,style,succulent,surface,terminal,thick,thickened,though,tip,trichome,tube,unit,usually,vein,venation,visible,white,wing,winged,woody,x,yellow,yellow-green	0.05,0.25-0.3,1-1.5,1-2.5,1/3,10-20,1994,2-6,2.5-4.5,3-10,31,4,6,abaxially,adaxially,age,along,alyx,anthesi,apar,apparently,arcy,articulated,basal,boundary,broadly,clearly,concolorous,connate,darker,delimited,delineated,different,dilated,domatia,dorsifixed,dry,eaf,elongating,equal,even,exserted,filiform,fine,flaring,flower,free,ground,iscoid,lamina,later,lengthening,lobe,lon,lower,mature,much,nflorescence,nther,obconical,obtuse,occasionally,orolla,perfec,persisting,plurifoliat,portion,prominent,protruding,rachi,raised,rakotozafy,reported,ruit,see,shallowly,shorter,sinus,slightly,smaller,smoot,straight,sunk,tearing,thinner,time,toward,tub,tuft,ud,vary,ventral,visibl,well-developed,wide,widely,wrinkling,ympodial,young,â	accrescence,apart,arrangement,articulation,bud,colour,connective,disc,form,glabrousnes,growth,inflorescence,length,lobing,ovary,pattern,persistence,plurifoliate,position,protrusion,reflexion,ribbing,ridging,shape,smooth,stellate,structure,sympodial,texture,thicknes,type,width
335	wfo-0001029741	success	137	122	99	38	23	0.723	.4,.5,0.5-1.5,0.8-3.5,0.9-1.2,1-1.5,1-3.5,1.1-1.3,1.5-4,1.5-6,10-50-flowered,2-2.5,2.2-9,2.5-7.8,3,9.5-22.5,?,acute,age,anther,anthesi,apex,attenuate,base,black,branched,calyx,capitate,closely,cm,completely,corolla,dark,dia,difoliate,dry,drying,early,elliptic,exserted,filament,flower,fruit,fruiting,furcate,glabrous,globose,green,growth,inflorescence,known,lateral,leaf,lenticellate,lighter,lobe,lobed,long,major,minor,minutely,mm,nearly,new,opposite,ovary,ovate,overlapping,papillose,pedicel,petiole,planar,pore,produced,prominent,raised,reddish-brown,scar,shaped,shrub,size,slender,spaced,stem,stigma,straight,style,tapering,tear-drop,tip,tree,tube,unit,usually,vein,weak,white,woody,x	1.5,accrescent,apiculate,becoming,berry,ca,caly,deflexed,deltoid,differing,divisio,eaf,edicel,eed,erect,free,geminat,glabrou,immature,lon,lower,main,middle,nflorescence,pair,papillo,poricidal,portion,proximal,quite,ruit,slightly,tall,ud,variable,widest,wood,ympodial	branching,bud,colour,diameter,division,exsertion,form,geminate,glabrousnes,height,length,lobing,number,overlap,plant,position,presence,seed,shape,spacing,structure,sympodial,texture
336	wfo-0001029744	success	113	83	65	48	18	0.575	0.3-0.6,0.5-1,2,2-4,5-8,50,8-10-flowered,8-11,abaxially,acute,adaxially,along,apart,apex,base,blunt,branch,calyx,cm,deltate,densely,denser,elliptic,entire,extreme,flattened,form,fruit,glabrous,golden,incrassate,lanceolate,leaf,lobe,long-acuminate,margin,minutely,mm,narrowly,oblanceolate,oblique,opposite,ovoid-reniform,pair,pedicel,petiole,pitted,primary,pubescent,revolute,scar,shape,shrub,simple,single-celled,slightly,sometimes,somewhat,surface,tip,trichome,uniseriate,vein,white,x	1,1.5,1.5-3.2,7-15,bark,beginning,brow,dendritic,difoliate,distinct,eaf,eed,examined,fide,flexuous,geminate,glabrescent,inflorescenc,lamina,leave,looping,lower,major,marginal,mature,minor,nflorescence,node,non-reproductive,occasionally,older,pale,pubescence,see,similar,small,smaller,smith,spaced,stem,thee,thin,ud,unicellular,unifoliate,unit,ympodial,young	bud,colour,density,flower,growth,height,inflorescence,length,number,plant,position,presence,seed,seen,size,spacing,texture,type
337	wfo-0001029746	success	179	137	118	61	19	0.659	0.3-2,0.5-1,0.7-1,1,1-1.3,1-1.5,1.2-1.5,2-2.5,2-4,2-8,3,3-4,8-10,8-11,age,anther,anthesi,apart,base,bearing,berry,blackish,broadly,brown,calyx,capitate,cell,centre,ciliate,cm,conical,cordate,corolla,crenate,cup-shaped,curved,dark,darker,densely,diameter,ellipsoid,elliptic,enlarged,entire,erect,exerted,filament,flattened,fleshy,fruit,fruiting,glabrous,gland-tipped,glandular,globose,greenish,herb,heteromorphic,hollow,horn,inflorescence,internodal,irregularly,leaf,lengthening,less,lobe,margin,mature,minutely,mm,narrowly,nodding,orange,ovary,ovate,ovoid,pale,papillose,pedicel,peduncle,petiole,pitted,pore,poricidal,principal,pubescent,purple,red,reddish,reflexed,scar,shallowly,simple,slightly,slit,somewhat,spaced,sparsely,spreading,stem,stigma,straight,strongly,style,subshrub,surface,testal,tip,triangular,trichome,tube,uniseriate,upward,vein,wall,widely,x	.5,1.5,2,2-7,3-4-pluri-foliate,3-4.5,3-6,4-9,6,6-7,abaxially,acuminate,acute,adaxially,apex,becoming,c.,color,crowded,eaf,edicel,eed,flower,flush,free,growing,lamina,lon,long,longer,longest,lower,markedly,maturit,mid-length,mixed,near,nflorescence,occasionally,pair,papillo,pericarp,plan,portion,primary,pubescen,rachi,ruit,shortest,single,slender,sparse,thin,third,ud,unit,upper,widest,woody,ympodial,â3	1.5-3,branching,bud,ciliation,colour,form,growth,height,length,maturity,orientation,plant,position,pubescence,seed,shape,size,texture,type
338	wfo-0001029769	success	142	88	63	79	25	0.444	.25,.5,0.5-1.5,1-3,1.5-2,1.5-2.5,2.5-3,2.5-8,3.5-4,5-8,6-17,7-8,8.5-17,acuminate,acute,anther,apex,bark,base,brown,calyx,capitate,cm,conical,corolla,curl-tipped,cyathiform,dark,elliptic,filament,flower,fruiting,glabrous,globose,golden,green,horizontally,internodal,leaf,lobed,long,mm,nearly,opposite,ovary,ovoid-reniform,pedicel,petiole,pore,pubescent,shaped,shrub,somewhat,sparsely,stigma,style,swollen,tear-drop,trichome,tube,unit,white,x	1-1.2,30-60-flowered,4,4-5,8-9,abaxially,adaxially,along,anthesi,apar,ape,archin,ba,bearing,berry,branch,brochidodromu,cerro,deflexed,deltoid,densely,dia,eaf,edicel,eed,exserted,filiform,free,fresh,hen,inglÃ©,lateral,less,like,lobe,lon,lower,main,margin,midrib,minutely,nflorescence,older,onto,pair,papillo,papillose,pitted,poricidal,portion,puberulent,reflexed,ried,ruit,scar,scattered,simple,smooth,spaced,stem,straight,surface,tall,three,time,tip,tub,two,ud,unevenly,unifoliat,uniseriate,vein,wide,widely,winged,woody,ympodial,young	0.5,30-60,arching,branching,colour,diameter,form,fruit,growth,hair,height,inflorescence,length,number,pattern,plant,position,seed,shape,size,structure,sympodial,texture,unifoliate,width
339	wfo-0001029780	success	204	151	127	77	24	0.623	1-1.2,1-10,1-2,11-24,120-210,15-22,15-45,2-2.5,2-2.8,2-3.5,2-5.5,20-60,3,3-6,3.5-7.3,4-6,4.5-6,5-7,5.5-13,50-70,600-950,8-12,?,abaxially,absent,acumen,adaxially,anther,apart,articulated,attenuate,blade,borne,brownish,cell,chartaceous,cm,condition,connivent,cordate,corolla,dark,densely,diameter,digestion,distal,dorsally,drying,edge,end,enzyme,filament,flat,flower,folded,forked,fresh,fruit,generally,glabrous,glandular,globose,green,greenish,half,head,herb,high,homostylous,honeycomb-shaped,interjected,invested,lanceolate,lateral,leaflet,length,lengthening,lobe,membranous,minute,minutely,mm,non-glandular,odd-pinnate,ovate,ovoid,pair,pale,pedicel,peduncle,petiole,pinkish,plant,pore,poricidal,puberulent,pubescent,rarely,removed,ripe,rotate,seed,short,singly,size,slit,stem,stigma,straight,streak,stripe,style,terminal,testal,tetralobulate,tip,trichome,tube,tuber,typically,unwinged,usually,wall,white,whitish,x,yellow	1.4-1.9,1.5-2,2-12,2.4-4.2,5-merou,5.5,acute,ag,along,alyx,apex,apparently,axe,axillary,base,berry,bud,capitat,ciliate,covering,cuneate,decumbent,eaf,eed,erec,especially,exceeding,except,geminat,glabrou,gland,greatly,green-white,hair,hair-like,hal,like,living,long,longer,lower,make,margin,midrib,mucilaginous,nflorescence,obtuse,often,orbicular,orolla,perfect,petiolulate,petiolule,plurifoliate,proximal,reduced,ruit,sessile,seudostipule,spaced,specimen,stamen,ste,stolo,subequal,subtending,tall,tamen,tem,thick,throughout,tri-,truncate,unit,vary,wet,ympodial	age,arrangement,articulation,branching,calyx,capitate,colour,connivence,form,growth,height,inflorescence,leaf,number,ovary,presence,pseudostipule,pubescence,shape,spacing,staman,stolon,symmetry,texture
340	wfo-0001029784	success	237	117	94	143	23	0.397	-12,-5,0.1-0.15,0.1-0.5,0.2-0.3,0.2-0.5,0.25-0.3,0.3-0.35,0.3-0.5,0.3-1,0.4-0.45,0.4-0.5,0.4-0.6,0.5,0.6-1,0.9-1.2,1-1.1,1-1.2,1-1.5,1-4,1.0-1.3,1.5-,1.7-2.6,2,2-2.5,2-4,3-,3-5,5-10,5-8,acuminate,acute,anther,apex,apical,appendage,articulation,base,berry,bract,brown,calyx,capitate,cm,column,corolla,dark,densely,diameter,distal,eglandular,filament,flower,fruit,fruiting,glabrous,globose,golden,green,half,herb,imparipinnate,inflorescence,interjected,interrupted,lateral,leaflet,lobe,mm,mostly,obovate,ovary,pale,pedicel,peduncle,pentagonal,perennial,petiolule,plant,primary,pubescent,simple,soft,sparsely,staminal,stem,sterile,stigma,style,terminal,trichome,unicellular,velvety,yellow	.1,.2,.5,0-4,0.1-,0.2,0.2-,0.3-0.4,0.4-,0.5-,0.5-1.5,0.7-1.2,1,1-,1-2,1-2-celled,1.2-2.5,1/3,2-,2-3-celled,2-4.5,2-foliate,2-locular,2.5-3.5,2/3,5-14,abaxial,abaxially,absent,abundant,adaxially,adpressed,along,angled,anthesi,appearance,arising,articulated,axi,basal,basicopically,beneath,broadly,cell,conical,crenate-serrate,crenation,decurrent,deeper,developed,distributed,due,eaf,edicel,eed,elliptic,enclosing,entire,evenly,exserted,giving,glabrescent,glandular,gree,hair-like,hal,halfway,head,included,internode,interspersed,irregularly,lamina,lanceolate,larger,like,live,lon,long,long-acuminate,loosely,lower,margin,markedly,maturing,multicellular,narrowly,nflorescence,node,northern,occasionally,often,orbicular,outgrowth,pair,paler,patent,petiole,population,present,proximal,pseudostipule,pubescence,rarely,reflexed,ripe,robust,ruit,scattered,secondary,sessile,silky,smaller,sometimes,somewhat,sparse,spreadin,stout,straight,stripe,strongly,surface,tem,tertiary,testa,thick,trailing,truncate,tube,ud,undulate,uniseriate,unit,unseriate,usually,vein,wall,white,wide,winged,woody,x,ympodial	0.2-1.2,0.4-1.2,0.4-2,0.5-2.5,1.2-3.5,2-14,arrangement,branching,bud,colour,form,growth,height,history,leaf,length,life,seed,shape,texture,thicknes,type,width
341	wfo-0001029785	success	223	112	96	127	16	0.43	0-2,0-3,0.1-0.5,0.8-1,1-1.2,1.2-3.2,1.5-3.6,1.8-3.5,1.8-7,10-26,2-4,3-6,3-8,3.5-5,3.8-7.2,4-10.5,5-16,5-9,6,8-11,abaxially,absent,adaxially,along,anther,blade,borne,brownish,chartaceous,cm,commonly,condition,corolla,dark,darker,denser,diameter,drying,end,flower,forked,fresh,fruit,glabrous,globose,green,greenish,hair,herb,homostylous,interjected,lanceolate,lateral,leaf,leaflet,long,margin,membranous,minute,mm,mottled,multiple-celled,non-glandular,odd-pinnate,outer,ovoid,pair,pedicel,peduncle,petiole,plant,pore,poricidal,pubescent,purple,purple-tinged,ripe,scale-like,seed,short,singly,size,slightly,sparsely,stem,style,terminal,tip,tuber,typically,unbranched,vein,violet,whitish,wide,x	0.3-2.2,0.4-4.9,1-10,1-2,1-5,3-4,5-merou,acumen,acute,ag,alyx,apart,apex,apparently,articulation,attenuate,axe,axillary,base,berry,broadly,bud,capitat,cell,clavate,connivent,cordate,covering,cuneate,decreasing,decumbent,digestion,distal,dorsally,eaf,edge,eed,elliptic,enzyme,erec,especially,exceeding,filament,flat,folded,geminat,generally,glabrou,greatly,green-white,hair-like,half,honeycomb-shaped,invested,larger,lengthening,like,living,lobe,lower,make,markedly,medium,middle,midrib,minutely,much,mucilaginous,nflorescence,oblique,obovate,obtuse,one-quarte,orbicular,orolla,ovate,pale,pentagonal,perfect,petiolulate,petiolule,plurifoliate,point,present,puberulent,quite,rarely,removed,rotate,rounded,ruit,sessile,seudostipule,shallowly,slit,sometimes,spaced,specimen,stamen,ste,stigma,stolo,straight,stripe,subglabrous,subtending,tall,tamen,tem,testal,thick,throughout,toward,tri-,truncate,tube,unequal,unit,unwinged,usually,variable,vary,wall,wet,white,yellow,ympodial	arrangement,branching,calyx,colour,form,glabrousnes,growth,height,inflorescence,length,ovary,presence,pseudostipule,shape,stolon,texture
342	wfo-0001029789	success	167	81	66	101	15	0.395	0-2,0.2-0.5,0.8-3.5,1-3,1.7-8.5,12,2-25,2-6,2-6.5,2.7-4.7,3-8.5,4-10,4-13,5-7,6-7,7-16.6,7-21,8-9,anther,blade,blue,chartaceous,clavate,cm,corolla,diameter,flower,forked,glabrous,green,hair,herb,homostylous,interjected,lanceolate,lateral,leaf,leaflet,light,lilac,long,membranous,minute,mm,odd-pinnate,ovary,pair,pedicel,peduncle,pentagonal,petiole,plant,pore,poricidal,pubescent,rachi,rotate,size,sparsely,stigma,style,subglabrous,terminal,tip,white,x	0.5-2.8,1-10,1-2,1.5-2,1.8-6.5,2-3,3-5,5-merou,6,abaxially,acumen,acuminate,acute,adaxiall,adaxially,ag,alyx,apart,apex,apparently,articulated,attenuate,axe,axillary,base,basiscopic,broadly,bud,capitat,connivent,dark,decreasing,decurrent,distal,dorsally,eaf,edge,eed,erec,exceeding,filament,flat,folded,formed,fruit,geminat,generally,greatly,hal,half,lant,lengthening,like,linear,lobe,long-attenuate,lower,lunate,maturing,minutely,mottled,narrowly,never,nflorescence,orbicular,orolla,ovate,perfect,petiolulate,plurifoliate,pubescen,purpl,rarely,sessile,seudostipule,short,side,simple,slightly,slit,spaced,stamen,star,ste,sterile,straight,subequal,subtending,tall,tamen,tem,tinged,toward,tri-,tube,typically,unit,usually,vary,yellow,ympodial	arrangement,branching,calyx,capitate,colour,form,growth,height,inflorescence,length,pseudostipule,shape,stem,symmetry,texture
343	wfo-0001029810	success	149	96	76	73	20	0.51	0.5-3,1-1.3,1-1.5,1-10,1-2,1-3,1.1-2.3,1.5-3,2-3,2.5-3,3-3.5,3-4,3-6,5-16,5-6,acuminate,acute,adaxially,along,anther,apex,apically,arachnoid,attenuate,base,calyx,capitate,cm,conical,corolla,dark,dendritic,dia,elliptic,filament,fruiting,glabrous,globose,green,inflorescence,internodal,leaf,lobed,long,mm,narrowly,nearly,occasionally,opposite,ovary,ovoid-reniform,pale,pedicel,petiole,pointed,pore,pubescent,reddish-brown,shaped,shining,shrub,size,slender,small,sparsely,stigma,style,tan,tapering,tear-drop,tree,trichome,tube,vein,white,wide	.25,.5,0.5-1,2-5,4-10,5-15-flowered,8-12,abaxially,anthesi,ape,bark,berry,brown,closely,compact,compressed,congested,deflexed,deltate,densely,differing,difoliate,drying,eaf,edicel,eed,ellipsoid,exserted,fleshy,free,geminat,glabrou,large,later,lateral,lenticel,less,like,lobe,lon,lower,main,major,margin,middle,minor,minutely,nflorescence,older,overlappin,papillo,papillose,pitted,planar,poricidal,portion,rest,ruit,scar,simple,spaced,stem,surface,tall,tip,tub,ud,unit,widest,woody,yellowish,ympodial,young	0.25,0.5,1.5,5-15,colour,diameter,flower,form,fruit,growth,height,length,number,plant,position,seed,shape,texture,type,width
344	wfo-0001029811	success	225	118	71	154	47	0.316	-3,0,0.3-1,0.5-2,1.5-6,15-23,20-100,5-9,abaxially,acicular,andromonoecious,anther,apex,articulated,base,berry,calyx,cell,chartaceous,cm,cordate,cuneate,dark,densely,elongating,equal,erect,filament,fruit,fruiting,glabrous,glandular,hair,herb,inflated,lateral,leaf,length,lobed,long,lower,margin,marking,mature,maturity,mauve,mm,moderately,pedicel,pendulous,per,perpendicular,petiole,plant,poricidal,prickle,prickly,shrub,simple,sometimes,sparsely,spherical,stellate,stellate-pubescent,stem,surface,tip,trichome,unbranched,unit,yellow	-6,-merous,.5,/3,0-30,0-35,0.1-0.3,0.1-0.4,0.2,0.2-0.6,0.3-1.5,0.8-1.5,1,1-1.5,1-2.5,1-3,1.3-1.7,1.5-2.5,1/,1/2-2/3,1/3,1/3-2/3,10-22,13-20,15-50,2-2.5,2-5,2-5.5,2.5-3,2.8-3.2,3-5,3-5.5,3-7,3.5-4.5,4-8,4.5-5,5,5-11,5-17,5-40,6-12,7-18,7-9,8-12,8-18,abaxial,adaxial,alyx,apar,apart,apically,apparently,bark,blade,broad-deltate,brown,connivent,cream,diameter,discolorous,distal,distance,drying,eaf,eed,elongate,extending,eye,faint,fewer,flattened,flattened-reniform,flower,free,green,green-brow,hermaphrodite,heterostylous,infructescence,less,lobe,lobing,long-acuminat,long-styled,longer,lowermost,midpoint,midvein,minute,multangulate,naked,narrow-deltate,nflorescence,obtuse,often,older,one,open,orange-brown,orolla,oung,outline,ovate,pair,pale,peduncle,pericarp,pit,plurifoliat,porrect,portion,prickl,primary,raised,ray,ruit,scandent,scar,secondary,sessile,short,short-styled,shorter,side,slightly,small,smooth,spaced,spreading,stalk,stalked,staminat,stout,straight,style,tamen,tapering,terete,tertiary,time,tube,unarmed,upper,usually,vary,vein,venation,visible,way,wide,woody,yellow-green,ympodial,young	appressed,articulation,bract,branching,breeding,broad-based,colour,connective,corolla,form,growth,height,heteromorphism,inflorescence,insertion,interjected,interpetalar,leaflet,na,needle-like,odour,orientation,pattern,placement,plurifoliate,pore,position,pseudostipule,rhizome,scale,seed,shape,smell,spot,staman,stone,structure,symmetry,sympodial,system,texture,tissue,tuber,type,vegetative,xylopodia,zygomorphy
345	wfo-0001029978	success	208	137	119	89	18	0.572	0.5-0.6,0.8,0.9-2.3,1-10,1-2,1.3-1.5,1.4-1.5,1.5-3.1,11-19,15-27,2-4,3-5,3.1-6.3,3.5-9.5,3.7-8.1,4-7,4.2-5.2,5,5-16.5,8-10,abaxially,adaxially,anther,base,berry,blade,brownish,cell,chartaceous,clavate,cm,coarsely,condition,conical,corolla,covering,dark,decreasing,diameter,dorsally,drying,edge,especially,filament,finely,flat,flower,folded,forked,fresh,fruit,glabrous,gradually,green,green-white,greenish,hair,hair-like,herb,homostylous,interjected,lanceolate,lateral,leaf,leaflet,lengthening,less,light,like,long,make,margin,medium,membranous,minute,minutely,mm,moniliform,mottled,mucilaginous,odd-pinnate,orbicular,ovate,ovoid,pedicel,peduncle,pentagonal,petiole,plant,pore,poricidal,puberulent,pubescent,purple,ripe,rotate,seed,simple,size,slit,stem,stigma,straight,style,subequal,terminal,testal,thick,throughout,tip,toward,tuber,wall,wet,whitish,wide,wing,x,yellow	0.3-0.4,0.3-0.7,0.7-1.9,1.8-5,3-7,3.2-2.5,4-11,5-merou,acumen,acuminate,ag,along,alyx,apart,apex,apparently,arranged,articulated,asymmetrical,attenuate,axe,axillary,basiscopic,bead,bud,capitat,ciliate,commonly,connivent,darker,digestion,distal,eaf,eed,elliptic,enzyme,erec,exceeding,fourt,geminat,generally,glabrou,half,honeycomb-shaped,larger,living,lobe,lower,middle,midrib,multiple,narrow,necklace,nflorescence,orolla,pair,perfect,petiolule,plurifoliate,pubescen,ray,removed,ruit,secondary,semierect,sessile,seudostipule,side,slightly,spaced,sparsely,specimen,stamen,ste,stolon,subsessile,subtending,symmetrical,tall,tamen,tem,tissue,tri-,tube,typically,unit,usually,vary,ympodial	age,arrangement,branching,capitate,ciliation,colour,form,growth,height,inflorescence,length,number,ovary,pseudostipule,shape,spacing,texture,width
346	wfo-0001029980	success	173	83	69	104	14	0.399	.1,0.1-0.25,0.25-0.5,0.25-1,0.5-1,0.5-2.5,0.5-5,0.7-1.3,1-1.5,1-1.7,1.2-2.5,2-5,2/3,5-50-flowered,acute,anther,appressed,base,berry,black,calyx,cm,conical,corolla,decurrent,deltoid,dia,drying,elliptic,filament,flattened-reniform,fruiting,glabrous,globose,green,greenish-white,leaf,lobe,lobed,long,mm,often,onto,opposite,ovate,pale,pedicel,petiole,plant,pore,rounded,shape,shaped,shrub,slender,slightly,somewhat,tan,tapering,tear-drop,trichome,tube,tuft,unicellular,uniseriate,way,white,winged,x	.5,0.5-1.2,0.8-1.2,0.9-4.5,1.5-2,1.5-6,2-6,3-4,3-9,5-10,6.4-17,abaxially,adaxially,anthesi,apar,apex,appearing,axil,ba,bark,bright,brown,bud,closely,curved,dark,deflexed,density,differing,difoliate,dried,eaf,edicel,eed,elevation,especially,exserted,five,free,geminat,gray,greatly,high,impressed,incrassate,knob,lateral,live,lon,lower,main,major,margin,material,middle,minor,minutely,near,nflorescence,node,older,one,orbicular,ovary,overlapping,pair,paler,papillose,pitted,poricidal,portion,prominent,proximal,puberulent,race,reflexed,ruit,scar,shiny,side,simple,size,small-capitate,soon,spaced,specimen,stem,stigma,straight,style,surface,tall,tip,ud,unit,varying,vein,venezuelan,whit,widest,woody,yellowish,ympodial,young	abaxial,colour,flower,form,fruit,growth,hair,height,inflorescence,length,position,seed,texture,type
347	wfo-0001029989	success	161	108	86	75	22	0.534	.2,.5,/2,0.25-0.5,0.5-1,0.5-1.5,1-2,1-2.5,1.3-2.3,1.5-2.5,10-14,2.5-3,3-5,3-8,3.5-8,4-4.5,5-6,7-20,abaxial,anther,apex,base,calyx,capitate,central,closely,cm,corolla,dendritic,densely,elliptic,exserted,filament,flattened,fruiting,glabrous,globose,golden,green,greenish-black,incrassate,inflorescence,internodal,lateral,leaf,lenticular,lobed,long,main,margin,minutely,mm,nearly,northern,occasionally,opposite,ovary,pair,pedicel,perÃº,petiole,pitted,population,pore,pubescence,pubescent,scar,shaped,shining,short-style,shrub,simple,small,spaced,sparsely,stigma,style,surface,tear-drop,tree,tree-like,trichome,tube,vein,way,white	1-1.5,1-4,5-10-flowered,abaxially,acute,adaxially,anthesi,bark,berry,branch,branched,broadly,brownish-re,collection,congested,conical,deflexed,deltoid,dense,described,dia,difoliate,dimaeter,discussion,drying,due,eaf,edicel,eed,erect,fleshy,free,geminat,gray,heteromorphic,inflorescenc,lamina,like,lobe,lon,lower,middle,nflorescence,nodding,older,overlappin,papillo,peru,peruvian,petal,petaloid,planar,poricidal,portion,probably,reddish,reddish-brown,rest,ruit,scattered,see,somewhat,stem,tall,tip,ud,unifoliate,unit,wide,widest,woody,x,yellow,ympodial,young	adaxial,branching,bud,colour,diameter,exsertion,form,fruit,growth,height,heteromorphism,length,overlapping,papillose,pattern,plant,position,seed,shape,type,width,ye
348	wfo-0001030000	success	155	140	109	46	31	0.703	-4,-5,-50,-7,0.5-1,0.5-14,0.5-3,1-10,1-2,1.5-,1.5-2,10-20,15-25,2-2.5,2-5,2.5-,25-30,3-16,3-4,3.5-5,30-50,4,4-4.5,4-5,abaxially,absent,acute,adaxially,also,apart,apex,apiculate,articulated,base,calyx,chartaceous,cm,connective,coriaceous,deltate,densely,dia,diameter,dilated,directed,distally,eglandular,ellipsoidal,equal,exceeding,flattened,flower,fruit,glabrous,globose,green,hair,immature,laterally,lobe,long,margin,mature,mm,moderately,oblong,obtuse,occasionally,orange,ovoid,pedicel,peduncle,perfect,pilose,pore,produced,puberulent,pubescent,purplish,rachi,radiu,rarely,shorter,shrub,slightly,small,sparsely,spotted,stellate,stigma,strongly,style,subcoriaceous,swelling,thecae,tinge,tip,tomentose,tree,truncate,umbrella-shaped,unbranched,unit,white,wide,x,yellow,yellow-brown,yellowish	-pilose,0.5-,1,1-,10-,2-3,2-4,2.5-3,2.5-3.5,3-,4-foliat,7-15,aggregate,ape,axe,biglandula,cell,ciliat,connivent,conspicuous,creamy-whit,cucullate,eed,leaving,lon,lower,narrowly,nflorescence,nther,orolla,pedicellar,pubescen,remnant,ruit,scar,smal,spaced,stamen,stone,tal,tem,triangular,tube,ud,vary,ympodial	4-foliate,abaxial,adaxial,anther,articulation,biglandular,branching,bud,ciliate,colour,corolla,creamy-white,direction,form,growth,height,inflorescence,length,number,ovary,plant,position,seed,shape,spacing,stem,structure,sympodial,texture,theca,type
349	wfo-0001030000	success	178	138	111	67	27	0.624	-5,-50,-7,-pilose,0.5-,0.5-1,0.5-13,0.5-14,0.5-3,1,1-10,1-2,1-5,1.5-,1.5-2,15-25,2-2.5,2-5,2.5-,2.5-3.5,25-30,3-16,3-4,3.5-5,4,4-4.5,4-5,abaxially,acuminate,acute,adaxially,also,apex,apiculate,articulated,basal,base,calyx,chartaceous,cm,connective,conspicuous,cordate,coriaceous,deltate,densely,dia,diameter,dilated,distally,eglandular,ellipsoidal,entire,flattened,fruit,glabrescent,glabrous,globose,green,hair,immature,leaving,lobe,long,margin,mature,mm,moderately,oblique,oblong,obtuse,occasionally,often,orange,ovate,ovoid,pedicel,pedicellar,peduncle,petiole,pilose,pore,puberulent,pubescent,purplish,rachi,radiu,rarely,remnant,scar,shrub,simple,small,sparsely,spotted,stellate,stigma,strongly,style,subcoriaceous,tinge,tip,tree,truncate,umbrella-shaped,unbranched,white,x,yellow,yellow-brown,yellowish	-2,-4,1-,1-1.5,10-,10-20,2-,2-3,2-4,2.5-3,3-,30-50,4-25,4-foliat,5-25,7-15,absent,aggregate,apart,ape,axe,biglandula,blade,cell,ciliat,connivent,creamy-whit,cucullate,directed,eaf,eed,elliptic,equal,exceeding,flower,laterally,lon,lower,narrowly,nflorescence,nther,orolla,perfect,pilo,produced,pubescen,ruit,shorter,slightly,smal,spaced,stamen,stone,swelling,tal,tem,thecae,time,tomentose,triangular,tube,ud,unit,vary,vein,wide,ympodial	abaxial,adaxial,anther,arrangement,articulation,biglandular,branching,bud,colour,corolla,creamy-white,form,growth,height,inflorescence,leaf,length,ovary,plant,position,seed,shape,size,stem,texture,theca,unknown
350	wfo-0001030004	success	177	113	92	85	21	0.52	0-0.5,0-1.5,0.2-1,0.8-1.1,1-1.5,1-2,1.2-2,1.5-2.5,15,2-20,3-3.5,3-4,3.5-5,4-15,5-25,9-30,across,acute,anther,bark,base,branched,branching,calyx,capitate,cm,corolla,crotaloid,dendritic,densely,dia,elliptic,exserted,filament,flattened-reniform,fleshy,fruiting,glabrous,globose,green,incrassate,inflorescence,later,lateral,leaf,lobed,long,loose,many,margin,minutely,mm,nearly,obovate,obovoid,onto,ovary,pale,pedicel,petiole,plant,plurifoliate,pore,prominent,pubescence,pubescent,scar,seed,sessile,shaped,shrub,small,sparsely,stem,stigma,strongly,style,surface,tan,tear-drop,terminal,time,translucent,tree,trichome,tube,variously,white,wide,winged,x,yellowish-green	.3,0.3-1,15-20,20-200-flowered,abaxial,abaxially,acuminate,adaxially,along,always,anthesi,apar,apex,appearanc,axillary,barely,basal,berry,blade,body,broadly,bushy,collection,cone,conical,decurrent,deltate,dense,denser,diamete,distal,drying,eaf,edicel,eed,erect,especially,flat,free,giving,greenish-yello,hard,juvenile,knob,lamina,large,like,lobe,lower,main,middle,much,nflorescence,occasionally,often,older,pair,papillate,papillo,pericarp,pitted,planar,poricidal,portion,possessing,rest,ruit,simple,spaced,stout,surpassing,tall,thick,thin,tip,tub,tuft,ud,unevenly,vein,widest,woody,yellowish,ympodia,young	apart,bud,colour,diameter,exsertion,form,fruit,greenish-yellow,growth,height,length,papillose,position,shape,size,spacing,structure,symmetry,sympodial,unit,width
351	wfo-0001030007	success	168	139	124	44	15	0.738	.05,.4,.5,0.1-0.5,0.2-1,0.8-1,1-1.5,1-15,1-2,1.5-5,1.6-2.2,15-20,2-4,2-7,3-5,3/4,4.5-5,7-10,7-9,acuminate,acute,along,anther,anthesi,apart,apex,base,becoming,beneath,berry,branched,brown,bud,calyx,campanulate,clavate,closely,cm,corolla,densely,dia,dry,elliptic,exserted,filament,flattened,fleshy,fruiting,glabrate,glabrous,globose,golden,golden-pubescent,green,incrassate,lateral,leaf,like,live,lobed,long,longer,main,major,margin,material,middle,midrib,minor,minutely,mm,oblique,obovoid,occasionally,older,one,onto,opposite,outline,ovary,pair,pale,papillose,pedicel,petiole,pitted,plant,pore,poricidal,pubescent,raised,reniform,rest,rounded,scar,shaped,short,shrub,slightly,small,soft,soon,spaced,sparsely,stem,stigma,style,surface,tear-drop,thick,tip,tree,trichome,tube,two,type,uniseriate,vein,way,white,widest,winged,x,young	0.5-1,6-10-flowered,abrupt,ba,bark,broadly,cork,dark,decurrent,deltoid,difoliate,edicel,eed,erect,free,geminateleaf,gre,hooded,impressed,inflorescenc,lobe,lon,lower,nflorescence,papillo,planar,portion,prominent,ruit,shorter,simple,slender,specimen,straight,tall,tapering,thickened,trunk,tub,ud,unit,widening,woody,ympodial	colour,corky,development,form,fruit,growth,hair,height,inflorescence,length,position,seed,shape,size,texture
352	wfo-0001030010	success	156	88	73	83	15	0.468	.5,.75,/4,0.5-5,0.9-1.1,1-1.3,1-1.5,1.2-1.5,1.5-2,10-15,2-7,2.5,20-40,4-4.5,5-7,anther,anthesi,area,attenuate,base,calyx,cm,corolla,cyathiform,deciduous,dia,filament,fleshy,fruit,fruiting,furcate,glabrous,globose,green,leaf,lobe,lobed,long,minutely,mm,nearly,obovate,often,opposite,ovary,ovoid-reniform,papillose,pedicel,persistent,petiole,pitted,pore,puberulent,reddish,shaped,shrub,simple,size,small,smooth,soon,stigma,style,surface,tear-drop,tiny,tree,trichome,tube,way,white,woody,x	0.7-1,1-2,10-50-flowered,11-12,2-2.2,3-5,7-10,acuminate,acute,apex,appearing,bark,basal,beneath,berry,brown,bud,closely,dark,decurrent,deflexed,deltate,differing,difoliate,distal,dry,eaf,edicel,eed,ellipsoid,exserted,f,free,geminat,glabrate,grey,hooded,lateral,lon,lower,m.,main,major,margin,materia,material,middle,midrib,minor,minute,near,nflorescence,occasionally,older,one,orange,overlappin,pair,planar,poricidal,portion,prominent,rather,ruit,scar,shin,slightly,spaced,stem,straight,styl,tall,tapering,tip,trunk,ud,uniseriate,unit,vein,widest,winged,ympodial,young	branching,colour,diameter,form,growth,hair,height,inflorescence,length,persistence,plant,position,seed,shape,texture
353	wfo-0001030023	success	171	115	85	86	30	0.497	0.5-1,1,1-8,1.5-7,10-25,2-3,2.5-3.5,20-30,3-4.5,3-5,4,4-12,5-6,6-7,7-9,acute,adaxially,apex,base,branched,calyx,cm,connective,cordate,cuneate,cylindrical,deeply,densely,diameter,dilated,directed,distally,ellipsoidal,elliptic,entire,especially,finely,flattened,fruit,glabrous,glandular-puberulent,globose,greenish-white,hair,highly,lanceolate,leaving,long,margin,membranaceous,mm,moderately,narrowly,near,oblique,oblong,occasionally,often,ovate,pedicel,pedicellar,peduncle,peltiform,petiole,pore,puberulent,pubescent,purplish-,rachi,radiu,remnant,short-acuminate,simple,somewhat,sparsely,stellate,stigma,style,subcoriaceous,tree,triangular,truncate,unit,x,young	-,0-100+,1-,1-2,1.5-2,10-,11-40+,12-18,13-20,2,30-50+,4-10,4-foliat,5,5-,5-16,6-26,abaxially,aggregate,apart,ape,apiculate,articulated,axe,basal,beyond,blade,capitat,cell,ciliate,color,connivent,denser,eaf,eed,exceeding,except,exserted,fleshy,flower,forked,glandular-puberulen,lobe,lon,loosely,lower,main,narrow,nflorescence,nther,obtuse,orolla,perfect,presen,present,probably,prominent,pubescen,pubescence,pubescent-pilo,ripe,ruit,shorter,slightly,small,spaced,stamen,stone,swelling,tal,tem,thecae,time,tip,tube,ud,unbranched,unknow,unknown,usually,vary,vein,villous,wide,yellowish,ympodial	10-50+,4-foliate,5-40+,abaxial,adaxial,anther,articulation,branching,bud,capitate,colour,corolla,form,growth,height,inflorescence,leaf,length,ovary,plant,pubescent-pilose,seed,shape,size,stem,structure,sympodial,texture,theca,type
354	wfo-0001030032	success	250	129	111	139	18	0.444	0.2-0.3,0.4-1.5,0.5,0.5-0.6,0.5-1,0.5-1.5,0.8-1.0,0.8-1.1,1-1.3,1-1.5,1.5-2,1.5-2.5,11-20,13-35,2-10,2-3-locular,2-3.5,2-4,2-5,3.0-3.5,3.5-12,30,4-5,4.3-5.0,6-11,60-80,7.5-10,8-10,8-10-celled,8-20,acuminate,acute,adaxial,anther,apex,articulated,articulation,base,branched,bright,brown,calyx,capitate,cm,completely,conical,corolla,decurrent,densely,diameter,elliptic,entire,fruit,fruiting,glabrous,golden,green,hair-like,imparipinnate,internode,interrupted,lateral,leaf,leaflet,length,lobe,long,many,margin,middle,mm,moderately,multicellular,oblanceolate,obovate,orbicular,outgrowth,ovary,pale,paler,pedicel,peduncle,petiole,pithy,primary,pseudostipule,pubescence,pubescent,rotate,rotate-stellate,seed,simple,sparsely,stem,stigma,style,terminal,thick,time,trichome,truncate,tube,unicellular,uniseriate,vine,wall,white,wide,woody,yellow,Â½-3/4	+,.05,.5,0.1-0.4,0.1-0.5,0.2,0.2-0.5,0.25-0.4,0.5-0.7,0.5-2,0.6-1.1,0.7-0.8,1-2-celled,1-3,1-celled,2,2-60,2-lobed,2.4-3.5,3,3-5,4-6-celled,4-celled,5-plurifoliate,7-16,abaxially,absent,abundant,adaxially,along,also,anthesi,apical,appearance,appendage,basal,basally,basiscopically,bent,border,branche,breaking,cell,clambering,column,conspicuou,dark,deltate,densest,desne,dry,eaf,ebracteate,edicel,eed,exserted,filament,flower,free,give,glandular,gree,greenish-brown,halfway,hea,head,herbarium,interjected,irregularly,lamina,large,larger,leave,like,longest,lower,markedly,midvein,mixed,much,nflorescence,node,oblique,occasionally,often,older,onto,opposite,pair,patent,petiolule,present,rachi,reflexed,rest,rough,round,ruit,secondary,set,shorter,silky,slightly,smaller,soft,sometimes,somewhat,sparser,specimen,splitting,spreading,stamen,staminal,sterile,straight,subopposite,surface,swollen,tall,tangled,tem,tertiary,testa,thickened,tiny,tip,touch,transparent,ud,unit,usually,vegetatio,vein,venation,weaker-walled,well-developed,winged,ympodial,younger	abaxial,arrangement,branching,bud,colour,form,growth,height,inflorescence,locule,pithines,plant,shape,size,staman,thicknes,type,width
355	wfo-0001030048	success	156	93	72	84	21	0.462	0.5-1.5,1-2,1.3-1.6,1.5-3.5,2-3,2-5,3-3.5,3-5,4-4.5,5-8,abaxial,acute,anther,apex,apically,arachnoid,base,berry,bi-colored,bi-lobed,blue,calyx,clavate,cm,conical,corolla,decurrent,densely,elliptic,felt-like,filament,fleshy,fruiting,glabrous,globose,green,internodal,leaf,lobed,matted,minutely,mm,nearly,onto,opposite,ovary,ovoid-reniform,pale,papillose,pedicel,petiole,pitted,pointed,pore,pubescent,reddish-brown,shaped,shiny,shrub,simple,small,somewhat,sparsely,stigma,strongly,style,tan,tear-drop,tree,trichome,tube,white	.5,1-1.5,1.2-2,1.5-7,10-16,4-15,5-10-flowered,5973,abaxially,adaxially,along,anthesi,ape,apparently,bark,becoming,broadly,brown,closely,completely,covered,deflexed,deltate,dia,difoliate,drying,eaf,edicel,eed,ellipsoid,exserted,fide,four-angle,free,geminat,glabrate,golden,greyish,impressed,inflorescenc,lamina,lateral,lightly,like,lobe,lon,long,lower,main,margin,middle,nflorescence,occasionally,older,overlappin,pair,papillo,planar,poricidal,portion,prominent,rather,rest,ruit,scar,solomon,spaced,stem,surface,tall,thick,thickened,tip,trifoliate,tub,ud,unit,vein,wide,widest,woody,yellowish,ympodial,young	0.5,1,1.5,adaxial,branching,colour,diameter,form,fruit,growth,hair,height,inflorescence,length,plant,position,seed,shape,texture,type,width
356	wfo-0001030053	success	141	110	89	52	21	0.631	0.5,0.5-1,1-1.3,1-13,1.3-3.5,1.8-2,10-20,2-2.5,2.5-3,3.5-4,7-9,<,abruptly,acuminate,acute,apex,apical,base,berry,branch,branched,brown,calyx,cell,cm,coriaceous,corolla,cyathiform,decurrent,diameter,elliptic,entire,fine,flattened,flower,fragrant,fruiting,glabrous,greenish,growth,inflorescence,irregularly,lobe,many,margin,minutely,mm,near,new,nipple,pair,pale,parallel,pedicel,peduncle,per,perfect,petiole,pitted,primary,rectangular,reniform,revolute,scar,secondary,shining,shiny,simple,sleeve,slightly,small,spaced,stem,strongly,surface,terminal,testal,time,tip,truncate,tube,turbinate,vein,venation,vine,white,woody,x,yellowish	1.5-5.5,100,4-,5,5-merou,7-11,abscission,aiding,alyx,anthesi,apart,apiculae,ark,around,articulated,bfeore,climbin,completely,eaf,eed,exserted,far,fide,filiform,frui,hyaline,leaving,lobed,long,lower,mentz,nflorescence,older,orolla,papilla,papillo,peg,pendant,plurifoliat,rim,shallowly,shin,spreadin,spreading,support,tem,tiny,twining,ud,unit,usually,ympodial	arrangement,articulation,bark,branching,bud,colour,form,fragrance,glabrousnes,leaf,length,number,papillose,position,seed,shape,shine,size,spacing,texture,type
357	wfo-0001030057	success	141	89	75	66	14	0.532	-2,1-2,2-3-celled,2-4,2-4.5,2-6,20-30,20-80,3-5,3.5-8,4-10,5.5-12,7-14,8,8-19,abaxially,absent,adaxially,base,blade,broadly,brownish,chartaceous,cm,condition,decreasing,diameter,drying,elliptic,extremely,flower,forked,fresh,fruit,globose,greatly,green,greenish,hair,herb,interjected,lateral,leaf,leaflet,like,long,lunate,membranous,mm,mottled,mucilaginous,odd-pinnate,ovate,ovoid,pedicel,peduncle,petiole,petiolule,plant,pubescent,purple,scale-like,seed,short,size,small,stem,subglabrous,suborbicular,terminal,toward,tuber,wet,whitish,x	1-10,2.1-4.1,4.3-8.2,acuminate,acute,apart,apex,apparently,articulated,axe,axillary,berry,borne,bud,cell,cordate,covering,cuneate,digestion,distal,eaf,eed,end,enzyme,erec,geminat,generally,glabrou,green-white,hair-like,half,high,honeycomb-shaped,larger,living,make,narrow,nflorescence,pair,perfect,plurifoliate,removed,ruit,seudostipule,singly,sometimes,spaced,specimen,ste,stolo,subtending,tall,tem,testal,thick,thir,throughout,tri-,truncate,typically,unit,unwinged,usually,wall,wing,ympodial	arrangement,branching,colour,form,growth,height,inflorescence,length,pattern,presence,present,pseudostipule,shape,texture
358	wfo-0001030057	success	197	163	141	56	22	0.716	-10,-2,.5-3.5,1-10,1-2,2-3-celled,2-4,2-4.5,2-6,20-30,20-80,3-5,3.5-8,4-10,5-10,5-6,5.5-12,7-14,8,8-19,abaxially,absent,adaxially,along,anther,apart,articulated,axillary,base,berry,blade,borne,brownish,bud,cell,chartaceous,ciliate,cm,condition,corolla,covering,decreasing,diameter,distal,dorsally,drying,edge,end,especially,extremely,filament,flat,flower,folded,forked,fresh,fruit,generally,glabrous,globose,greatly,green,green-white,greenish,greenish-yellow,hair,hair-like,half,herb,high,homostylous,interjected,lanceolate,lateral,leaf,leaflet,lengthening,like,linear,lobe,long,lunate,make,margin,membranous,middle,midrib,minutely,mm,mottled,mucilaginous,narrow,odd-pinnate,ovate-lanceolate,ovoid,pedicel,peduncle,pentagonal,petal,petiole,petiolule,plant,pore,poricidal,puberulent,pubescent,purple,rotate,scale-like,seed,short,singly,size,slit,small,star,stem,stigma,straight,striped,style,subglabrous,subtending,terminal,testal,thick,throughout,tip,toward,tube,tuber,typically,unwinged,usually,wall,wet,white,whitish,wing,x,yellow	2-3,2-5,2.1-4.1,4.3-8.2,5-merou,acumen,acuminate,acute,ag,alyx,apex,apparently,axe,broadly,connivent,cordate,cuneate,digestion,eaf,eed,elliptic,enzyme,erec,exceeding,geminat,glabrou,globo,honeycomb-shaped,larger,living,lower,nflorescence,orolla,ovate,pair,perfect,plurifoliate,removed,ruit,seudostipule,sometimes,spaced,specimen,stamen,ste,stolo,suborbicular,tall,tamen,tem,thir,tri-,truncate,unit,vary,ympodial	age,arrangement,articulation,branching,calyx,colour,form,growth,height,inflorescence,length,ovary,pattern,position,presence,pseudostipule,shape,spacing,stolon,symmetry,texture,third
359	wfo-0001030080	success	186	92	74	112	18	0.398	0.3-7,0.4-1.5,0.5-4,1-2,1.5-2,1.5-2.5,1.8-4.5,2-4,2.1-7.1,4-12,4-7,5-13.5,5-7,5.5-9.9,6.5-18.6,8-16,8-23,9.9-33,acuminate,anther,apex,blade,cm,coriaceous,corolla,dark,diameter,elliptic,filament,flower,forked,fruit,glabrous,green,greenish,herb,homostylous,lanceolate,lateral,leaf,leaflet,light,lobe,mm,moniliform,mottled,mucilaginous,odd-pinnate,ovate,ovoid,pair,pedicel,peduncle,petiole,plant,pore,poricidal,purple,pyriform,seed,size,stellate,strongly,style,terminal,throughout,tip,tube,tuber,wet,white,whitish,winged,x	1-3,1999,2-3,3-10,3-5,3.3-7.7,5-merou,abaxiall,abaxially,absent,acumen,adaxially,ag,along,alyx,apart,apparently,arranged,articulated,axe,axillary,base,bead,berry,brownish,bud,capitat,ccording,cell,clavate,condition,connivent,covering,cuneate,decreasing,decurrent,digestion,distal,dorsally,dot,drying,eaf,edge,eed,enzyme,erec,exceeding,flat,folded,fresh,geminat,generally,glabrescent,glabrou,green-white,hair,hair-like,hal,half,high,honeycomb-shaped,inconspicuous,interjected,larger,lengthening,like,linear,living,long,lower,make,medium,multiple,necklace,nflorescence,ochoa,onto,orolla,perfect,plurifoliate,rachi,removed,second,seudostipule,slightly,slit,sometimes,spaced,specimen,stamen,stigma,stolon,straight,subequal,subtending,tall,tamen,tem,testal,thick,tiny,toward,tri-,typically,unit,unknown,usually,vary,wall,width,yellow,ympodial	abaxial,adaxial,arrangement,branching,calyx,colour,form,growth,height,inflorescence,length,number,ovary,pseudostipule,shape,staman,stem,texture
360	wfo-0001030081	success	157	110	85	72	25	0.541	.5,0.5-1,0.5-1.5,0.5-2.5,1,1-2-celled,1-4,1.5,1.5-3,10-20,10-35,1st,2-4,2nd,3-10,4-6,5-12,5-15,acute,along,anther,apex,apically,base,berry,blade,brown,calyx,cell,center,chartaceous,ciliate,cm,densely,denser,diameter,dm,drying,edge,elliptic,elliptic-ovoid,entire,few-branched,filament,fine,flat,flower,fruit,geniculate,glabrous,globose,hair,herb,immature,lying,margin,maturing,membranaceous,mm,oblong,obtuse,parallel,pedicel,per,petiole,pointing,pubescent,radiating,raised,ridge,rotate,rounded,running,semitransparent,shallow,single-,sparsely,style,surface,two-celled,unbranched,vein,white,x,yellow	0.25-0.5,1-2,1-3,1-5,1.5-7,2-7,2-foliate,3-6,abaxially,absent,abundant,adaxiall,adaxially,axe,beyond,connected,cordate,decurrent,dehiscing,eaf,eed,emarginat,equal,explosively,exserted,frui,geminat,held,interpetalar,linear-lanceolate,lobe,long,longer,lower,maturit,mesocarp,moderately,nearly,nfloresence,notch,often,one,orolla,other,peduncle,placenta,pressure,pubescen,rachi,rarely,ruit,short,slightly,small,sometimes,stamen,stigma,straight,swollen,tal,tamen,tem,tissue,triangular,tube,unit,usually,vary,watery,wid,woody,ympodial	arrangement,branching,colour,corolla,decument,form,growth,height,inflorescence,leaf,length,number,orientation,ovary,plant,position,seed,shape,simple,staman,stem,symmetry,texture,type,unknown
361	wfo-0001030083	success	146	106	90	56	16	0.616	.5,.75,0.5-1,0.5-2,0.8-1,0.8-3,1-1.5,1-2,1.5-3,10-30,2,2-3,2-5-flowered,3-4,3/4,4-15,4-6,9-11,accrescent,acute,anther,anthesi,apex,base,broadly,calyx,cm,corolla,cup-shaped,decurrent,deeply,dia,drying,elliptic,flower,fruit,fruiting,glabrous,globose,green,greenish-white,internodal,lateral,leaf,lobe,lobed,long,long-acuminate,long-styled,main,membranous,minutely,mm,narrowly,onto,opposite,ovary,ovate,ovoid-reniform,pair,papillose,pedicel,petiole,pitted,pore,red-papillose,reflexed,shallowly,shaped,short-styled,shrub,slender,small-capitate,somewhat,stem,stigma,strongly,style,surface,tapering,tear-drop,thin,translucent,tube,vein,way,white,winged,woody,x	0.1,0.25-0.5,bark,beginning,berry,closely,dar,deciduous,deflexed,deltoid,dry,eaf,edicel,eed,elongate,exserted,fleshy,greyish-re,hyaline,inflorescenc,lon,lower,middle,near,nflorescence,older,overlapping,pale,paler,papillae,poricidal,prominent,proximal,raised,reddish-gold,ruit,scar,simple,single-stemmed,slightly,soon,spaced,specimen,straight,tall,tan,terminal,thickened,tip,tub,ud,unifoliat,unit,widest,ympodial,young	colour,dark,diameter,form,growth,hair,height,inflorescence,length,plant,position,seed,shape,size,texture,venation
362	wfo-0001030093	success	181	108	93	88	15	0.514	.5,0.1-0.3,0.2,0.2-0.5,0.5-1.1,0.6-1.5,0.75-1,1-1.5,1-12,1-5,1.3-4.5,2-2.5,2.5-11,3-4,4-6,5-50-flowered,acuminate,acute,anther,anthesi,apex,attenuate,base,beneath,branched,calyx,campanulate,clavate,cm,corolla,cuneate,densely,elliptic,filament,flower,fruiting,furcate,glabrous,globose,golden,green,greenish-white,growth,hirsutulous,leaf,lobed,long-styled,many,minor,minutely,mm,narrowly,nearly,obovate,occasionally,often,opposite,ovary,ovoid-reniform,pedicel,petiole,pitted,plant,pore,poricidal,puberulent,pubescent,shaped,shiny,short-styled,shrub,simple,size,slender,slightly,small,stigma,style,surface,tapering,tear-drop,terminal,time,tiny,tip,tree,trichome,tube,underside,uniseriate,vein,white,x	.2,0,0.2-1,3.5-12,5-8,7-30,7-9,8-9,apar,bark,becoming,berry,brownish-tan,case,closely,collection,commonly,continues,deflexed,deltoid,dia,differing,difoliate,eaf,edicel,eed,ellipsoid,erect,especially,evenly,except,expanded,exserted,forest,free,geminat,greyish-brow,guyanese,hyaline,impressed,inundated,lateral,like,lobe,lon,long,lower,main,major,margin,member,middle,new,nflorescence,older,one,onto,open,orbicular,pair,pale,paler,papillo,persisting,population,portion,present,quite,reflexed,remaining,ruit,scar,shoot,soon,southern,spaced,stem,straight,tall,thickened,tub,ud,unit,widest,woody,yellowish,ympodial,young	branching,colour,diameter,form,fruit,hair,height,inflorescence,length,number,papillose,position,seed,shape,texture
363	wfo-0001030145	success	153	136	109	44	27	0.712	-3,0.2-2,0.3-,0.5,0.5-1,0.5-4,1,1-1.5,1-2,1-2.5,1-3,1-5,1.5,1.5-2,1.5-4.5,1.5-7,10-12,2-3,2-4,2.5-6.5,3,3-10,3-4,3-5,4-5,4-8,6-40,8-11,abaxially,acute,adaxially,adpressed,aggregate,also,apart,apex,basal,base,calyx,campanulate,cell,cm,compound,connective,cuneate,cylindrical,deltate,densely,diameter,directed,distally,ellipsoidal,elliptic-ovate,entire,exceeding,fleshy,flower,forked,fruit,glabrous,glandular,globose,hair,herb,lanceolate,leaf,leaving,less,lobe,long,margin,mm,moderately,narrowly,near,obtuse,ovate-elliptic,pedicel,pedicellar,peduncle,petiole,pilose,pore,puberulent,rachi,radiu,reddish,remnant,shorter,shrub,simple,sinuate,slightly,somewhat,sparsely,stigma,stone,style,subcordate,subcoriaceous,ternately,thecae,triangular,truncate,tube,unbranched,unknown,violet,x	-2,4-foliat,absent,ape,articulated,axe,beyond,blade,chartaceous,color,dunal,eaf,eed,elliptic,exserted,fide,larger,lateral,leaflet,lon,lower,nflorescence,nther,orolla,presen,puberulen,ripe,ruit,slender,spaced,stamen,tal,tem,terminal,time,tomento,toward,truncat,ud,unit,vary,wide,yellow,ympodial	anther,articulation,axi,branching,bud,colour,corolla,direction,form,growth,height,inflorescence,length,na,number,ovary,plant,present,pubescence,seed,shape,size,spacing,stem,texture,theca,type
364	wfo-0001030146	success	210	131	112	98	19	0.533	.2,.5,0.2â0.4,0.5,0.5â1,0.6â0.7,0.9â1,1â1.1,1â1.5,2.5â9,20,3â4,3â6,40â50,4â30,5â8,9â9.5,>,abaxial,along,anther,apex,appearing,articulated,base,berry,branched,branching,bright,brown,brownish,c.,capitate,closely,cm,coriaceous,corolla,dark,densely,diameter,drying,echinoid,ellipsoidal,elliptic,entire,filament,flattened-reniform,free,fresh,fruiting,globose,golden,green,growth,inflorescence,leaf,length,lengthening,less,like,lobed,long,many,mm,multangulate,narrowly,new,olive,pale,part,pedicel,peduncle,peltate,per,persistent,petiole,plant,pore,poricidal,portion,pubescent,ray,reddish,regularly,ripe,scar,scurfy,short-stalked,simple,slit,small,spaced,stellate,stem,stigma,style,surface,tan,terminal,time,tip,tree,treelet,trichome,tube,undersurface,unevenly,upper,varying,way,white,â18	.1,0.6â2,1.2â1.5,1.5â2,16â20,20â30,2â5,4â4.5,5-merou,6.5â16,60+,6â7,8â15,abaxially,absent,acuminate,acute,adaxial,ag,almost,alyx,anthesi,apar,ark,axe,beig,beneath,calyx,cell,center,connivent,covered,cup-shaped,deeply,deltate,dense,dichasia,discolorous,eaf,edge,eed,elongate,erec,exserted,flower,fused,glabrous,gradually,halfway,ilament,impressed,lamina,layer,lobe,loosely,lower,margin,midpoint,minutely,narrowing,nflorescence,nodding,older,orolla,pair,papillose,perfect,pericarp,pitted,plurifoliate,primary,projection,pubescence,reflexed,revolute,rhachi,ruit,sessile,shiny,sparsely,stout,strongly,subtended,tall,tangled,tem,testal,thin,tiny,ud,unit,vary,vein,visible,wide,woody,yellow,ympodial	age,apart,articulation,bark,beige,bud,colour,form,fruit,hair,height,number,ovary,pattern,seed,shape,texture,type,width
365	wfo-0001030147	success	158	101	73	85	28	0.462	0.5-2,1-4,1-5,1.0-2.0,1.0-2.2,10-19,14-35,15-30,2-10,2-10.5,2-13,2-3,2-5,2.5-7.5,4-5.5,4.2-7.5,4.5-10,5-8,8-38,acute,apically,blue,branched,calyx,cm,conical,connate,corolla,cyme,deep,dehiscent,diameter,dichasial,dichasially,distal,filament,finely,flower,green,green-white,hair-like,herbaceous,interjected,lateral,leaf,leaflet,lobe,long-attenuate,medium,mm,monochasial,odd-pinnate,ovoid,pedicel,peduncle,perennial,perfect,petiole,plant,poricidally,proximal,pubescent,purple,rotate,seed,straight,style,terminal,tuber-bearing,unit,wall,yellow,Â¼	-8,0-5,2,3-,3-6-foliat,4-3.,5-7,abaxiall,abaxially,acumen,acuminate,adaxially,apex,apical,articulate,attenuate,base,cell,covering,cuneate,digestion,diminishing,dorsally,eaf,ebracteate,edge,eed,elliptical,emoval,enzyme,exceeding,flat,folded,forked,generally,globo,gradually,half,honeycomb,introrse,living,lon,long,lower,lunat,make,maturing,mucilaginous,narrowly,nflorescence,nther,oblique,obtuse,often,orolla,ovate,pair,pattern,petiolule,plan,reveal,rounded,ruit,sessile,seudostipule,short,size,slit,specimen,stamen,stigma,subequal,subsessile,tal,tem,testal,thick,throughou,throughout,tip,toward,typically,vary,wide,ympodial	3-6-foliate,4-31,anther,arrangement,articulation,bract,branching,colour,ebbrate,form,fruit,growth,height,inflorescence,length,lunate,number,ovary,pore,present,pseudostipule,shape,stem,structure,sympodial,texture,type,width
366	wfo-0001030151	success	175	107	83	92	24	0.474	-50,0.2-0.5,0.3-0.5,0.5-1,1-17,1-3,1.5-2.5,10-20,10-25,15-35,2-11,2-25,2-3,2-6,2-7-compound,3-14,3-5,3.5-32,4-5,5-6,6-9,abundantly,acuminate,acute,adaxial,apex,base,blade,blotch,calyx,chartaceous,cm,connective,cordate,cuneate,deltate,diameter,elliptic,entire,except,flower,fruit,glabrous,globose,hair,lanceolate,leaf,lilac-tinged,line,lobe,longitudinal,margin,membranaceous,mm,narrowly,near,oblique,oblong,obovate,often,pedicel,peduncle,petiole,pinnately,puberulent,pyriform,rachi,radiu,sand-punctate,shallowly,simple,sometimes,sparsely,stellate,stigma,stripe,style,tree,truncate,unbranched,white,x,yellow-green	-3,0.5,1,1-1.5,1-2,1-5,1.5-2,20-30,4-foliat,?,abaxially,absent,adaxially,aggregate,apart,ape,apiculate,around,articulated,axe,basal,beyond,cell,channe,ciliat,compound,connate,cylindrical,decurrent,directed,distally,eaf,eed,eglandular,exceeding,exserted,glabrate,glandular,glandular-puberulent,leaflet,leaving,less,lon,long,lower,nflorescence,nther,obtuse,orolla,pedicellar,perfect,pore,presence,probably,purplish,remnant,ring,ripe,ruit,sand-punctat,scattered,short,shorter,slender,slightly,small,somewhat,spaced,stalked,stamen,stone,surface,tal,tem,thecae,time,tip,toward,triangular,truncat,tube,ud,unit,unknow,vary,vein,veiny,white-puberulent,whitish,wide,yellow,ympodial	anther,articulation,branching,bud,channel,colour,corolla,form,growth,height,inflorescence,length,ovary,plant,punctation,seed,shape,size,stem,symmetry,texture,theca,type,width
367	wfo-0001030153	success	147	122	104	43	18	0.707	.1,.2,/3,0.2-1,0.8-0.9,1-1.5,1-10,1-2,1.3-1.5,1.3-1.9,2-8,2-lobed,2.5-4,3-4,3-50,5-6,6-8,absent,acuminate,acute,age,anther,anthesi,apart,apex,attenuate,bark,base,berry,branched,broadly,calyx,campanulate,clavate,cm,conical,corolla,dark,deltate,densely,diameter,distinct,domatia,ellipsoid,elliptic,enlarged,entire,exerted,filament,flower,fruiting,glabrous,globose,green,growth,irregularly,lanceolate,lengthening,less,lobe,margin,markedly,minutely,mm,narrowly,new,nodding,occasionally,older,ovary,pair,papillate,pedicel,peduncle,petiole,pit-like,plane,pore,poricidal,primary,rachi,revolute,ripe,scar,simple,slightly,slit,small,spaced,stem,stigma,strongly,style,surface,time,tip,tree,treelet,tube,vein,way,white,yellowish,young	0.8-1.3,1-1.2,1-2.5,1.5-2,3-5,3.5-10.5,abaxially,adaxially,ape,apiculate,apparently,axil,brittle,caly,dot,dry,eaf,erect,free,glabrou,impressed,internodal,known,lobed,lower,membranous,nflorescence,ot,paler,papillat,perfect,plurifoliat,portion,resinous,ruit,specimen,straight,terminal,thin,ud,unit,x,ympodial	abaxial,adaxial,branching,bud,colour,exertion,form,fruit,inflorescence,leaf,length,lobing,number,shape,spacing,texture,type,width
368	wfo-0001030167	success	141	114	70	71	44	0.496	.8,.9,0.6,12,5-merous,acuminate,acute,along,anther,apex,apically,base,calyx,chartaceous,ciliate,clavate,cm,contiguously,densely,diameter,enlarged,entire,extra-axillary,flattened,flower,fruit,glabrous,green,herbaceous,lanceolate,less,lobe,margin,maturity,membranaceous,membranous,minutely,mm,moderately,near,nearly,obtuse,ovate,ovoid,pedicel,peduncle,petal,petiole,pointed,rachi,reflexed,rounded,sand-punctate,simple,slightly,somewhat,sparsely,stellate,stigma,style,symmetrical,thinly,tip,tube,unbranched,unknown,vine,weakly,white,x	0.1â0.2,0.5â0.6,0.5â0.7,0.6â0.8,0.7â1.2,0.8â1,1.2â2.5,1.5â2,1.5â7,14â19,15â20,17â58,1â1.2,1â1.5,2â3,2â4.5,4.5â8,4â10,4â4.5,4â5,4â7,8â10,abaxially,accrescent,adaxially,alyx,apar,axe,berry,blade,branch,c.,ciliat,climbing,eaf,eed,fertile,filament,fruiting,gap,glabrou,immature,long,lower,m.,nflorescence,nternode,orolla,pair,penden,perfec,pinnate,plurifoliat,ruit,scar,secondary,seen,slender,spaced,subequal,tamen,tem,time,truncat,unit,vary,vegetation,vein,venation,wide,ympodial	0.1-0.2,0.5-0.6,0.5-0.7,0.7-1.2,0.8-1,1-1.2,1-1.5,1.2-2.5,1.5-2,1.5-7,15-20,2-4.5,4-10,4-4.5,4-5,8-10,apart,arrangement,branching,colour,corolla,form,growth,herbaceousnes,inflorescence,information,internode,leaf,length,merosity,ovary,perfect,position,punctation,seed,shape,size,spacing,staman,stem,symmetry,texture,truncate,type
369	wfo-0001030176	success	171	124	102	69	22	0.596	-6.25,.2,.7,0.4-1.5,0.5,0.5-2,0.7-1.4,0.7â0.8,1,1.2-2.5,1.5-2,1.6,1/3,2.25-3.25,2.5,2â3,3-5,3-lobed,3.75-5,6-8,accrescent,acute,adaxially,anther,apex,articulated,attenuate,basal,base,berry,bi-lobed,bilobed,broad,broadly,calyx,chartaceous,ciliate,cm,covering,cylindrical,decumbent,depressed-globose,diameter,especially,extra-axillary,few-branched,filament,flattened-reniform,flower,fruit,fruiting,glabrous,hair,herb,hermaphroditic,lanceolate-oblong,lateral,light,line,lobe,long,lower,major,margin,midrib,mm,near,nearly,node,oblong,often,ovate,pale,partially,pedicel,peduncle,petiole,plant,pore,prostrate,pubescent,rachi,rarely,ripe,rooting,rotate-stellate,simple,slightly,sometimes,sparsely,stigma,style,tip,tube,unbranched,vein,violet,white,x,yellow,yellow-orange,young	-1.4,-4.25,.75-1.5,0.6-0.9,1-2,1-5,1.2,1.5-2.5,1/6,2-3,2-foliate,2.5â7.5,2.5â9,4-9,5-merou,6â8,abaxially,adaxiall,alyx,angulate,apart,apparently,asymmetrically,axe,ba,blade,branch,capitat,connivent,contact,dehiscent,downward,eaf,eed,erec,forming,geminat,hold,interlobal,juic,lance-ovate,lon,longitudinall,mesocarp,minutely,nflorescence,numerous,orolla,patch,perfect,recurve,recurved,round,ruit,sinus,soil,somewhat,spaced,tamen,tem,terminal,time,triangular,unit,vary,white-puberulent,wide,winged,ympodial	abaxial,adaxial,arrangement,articulation,branching,capitate,colour,corolla,form,growth,habit,inflorescence,leaf,length,longitudinally,ovary,position,seed,shape,stem,texture,type
370	wfo-0001030180	success	135	118	88	47	30	0.652	.1,.5,.75,0.05-1,0.5-1,0.8-2,0.9-1.8,1-1.5,1.1-1.2,10-30-flowered,3-4,3-8,4.5-5,6,8.5-23,?,abruptly,anther,anthesi,apart,apex,appearing,attenuate,bark,base,calyx,clavate,cm,corolla,dark,decurrent,ellipsoid,erect,exserted,filament,fruit,fruiting,furcate,glabrous,globose,green,height,known,leaf,linear,lobe,lobed,long,long-acuminate,minute,minutely,mm,narrowing,nearly,occasionally,older,opposite,ovary,papillate,papillose,pedicel,petiole,planar,pore,prominent,puberulent,raised,rounded,scar,shaped,shrub,slightly,soon,stem,stigma,style,surface,tear-drop,terminal,tip,trichome,tube,uniseriate,unknown,vein,winged,yellowish,young	8-10,accrescent,apiculate,becoming,berry,clu,deflexe,deltoid,dia,eaf,edicel,eed,free,glabrate,immature,inflorescenc,interpetalar,lateral,lenticellat,lon,lower,main,middle,nflorescence,overlapping,pair,peduncl,plurifoliat,poricidal,portion,proximal,ruit,sinus,slender,spaced,sparsely,straight,thin,ud,unevenly,unit,white,widely,widest,woody,x,ympodial	2,arrangement,branching,bud,club,colour,deflexed,diameter,exsertion,flower,form,growth,hair,inflorescence,information,length,lenticellate,number,orientation,peduncle,plant,plurifoliate,position,prominence,seed,shape,spacing,texture,type,width
371	wfo-0001030189	success	188	144	115	73	29	0.612	-1/2,-4,/3,0-1,0-30,0.1-0.2,0.2-0.3,0.5-1.6,0.9-1.1,1,1-1.5,1-2,1-3-cellular,1-4-cellular,1.1-2.7,1.3-4.2,1.5-4.5,1.5-5,1/3,1/6-1/3,2-3,2-5.5,2.5-4,3.2-4.5,4-5.5,5-6,abaxially,anther,apex,appressed,articulated,bark,base,berry,branched,calyx,chartaceous,cm,connivent,cordate,curved,densely,diameter,dull,entire,equal,erect,evenly,flattened-reniform,flower,fruit,fruiting,glabrescent,glabrous,gland-tipped,gray,green,lateral,leaf,length,lobed,long,lower,margin,maturity,mauve,midpoint,mm,moderately,oblong,obtuse,often,older,orange,ovate,pedicel,peduncle,per,petiole,poricidal,porrect,purple,ray,red,rounded,scar,sessile,shrub,simple,slender,sometimes,spaced,sparsely,spherical,spreading,stalk,stalked,stellate,stellate-pubescent,stem,style,surface,tapering,terete,terminal,tip,trichome,unarmed,upper,variously,way,wide,yellow,yellow-green,young	.2,0-15,0.1,0.2-0.5,1-4-cellula,1.5-2,1/,2,3-4,4-13,5-,5-10,5-merous,6-10,6-12,8,8-10,8-18,acut,alyx,apar,apically,apparently,blade,concolorous,deltate,drying,eaf,eed,elliptic,elongating,faint,filament,foliaceous,free,frui,glabrescen,infructescence,lobe,longer,mature,nflorescence,one,open,orolla,oung,pair,perfec,pericarp,plurifoliat,portion,primary,recurved,red-brow,reflexed,ruit,scandent,shorter,smooth,somewhat,strongly,tamen,tertiary,time,tube,unarme,unit,vary,vein,venation,visible,woody,ympodial	0.2,1/4,apart,arming,articulation,branching,cellularity,colour,corolla,form,growth,hair,height,inflorescence,na,number,ovary,plant,position,red-brown,relative,seed,shape,size,staman,symmetry,texture,type,width
372	wfo-0001030219	invalid_json	191	137	82	109	55	0.429	0.5,1.5,3,5,60,abaxially,adaxially,anther,anthesi,apart,base,black,blue,brown,calyx,cm,cylindrical,deeply,diameter,difoliate,elliptic,filament,flattened,flower,fruit,glabrescent,glabrous,globose,green,hair,incised,indistinct,internode,lanceolate,leaf,lilac,lobe,long,longitudinal,margin,marking,mm,moderately,multicellular,number,oblong,opening,ovate,pair,pale,pedicel,peduncle,pentagonal,perfect,petiole,pitted,pore,pubescent,purple,rapidly,regularly,shallowly,shrub,simple,size,spaced,sparsely,split,stigma,straight,style,surface,time,tube,unicellular,uniseriate,unit,velutinous,wing,winged,woody,x	0.1â0.3,0.2â2.3,0.4â1.0,0.5â,0.7â1.1,0.8â3.0,0â,1.0â1.2,1.0â1.5,1.0â2.0,1.0â2.2,1.3â2.9,1.4â2.8,1.6â,10,15,1â2.5,2.0â2.5,2.0â3.2,2.0â5.5,2.4â6.0,2â,2â2.5,2â3,2â4.5,4.5â5.5,4.8â11.5,4â5,4â7,5â,5â8,6â,6â10,6â8,7â11,8â18,9â10,9â12,abaxiall,acut,acute,adaxiall,adnate,ag,along,anisophyllous,apex,apical,apparently,appearing,arising,arranged,articulated,axe,ba,basal,blade,bractâlike,branched,cell,chartaceous,clavat,concave,connivent,convex,decreasing,decurrent,densely,diamete,directed,distally,eaf,eed,equal,erect,geminat,lower,nflorescence,olive,opposed,oppositely,orolla,paler,perennial,present,procumbent,redâpurple,rounded,ruit,serrate,sessile,sid,side,smaller,stone,stripe,strongly,tal,tamen,tem,two,vary,white,wide,yellow,ympodial,â3.0,â7.0,â9.5	'',0.1-0.3,0.2-2.3,0.5-2.2,0.7-1.1,1.0-1.2,1.0-2.0,1.3-2.9,1.6-3.2,2-3,2-4.5,2-5,2.0-2.5,2.0-5.5,2.4-6.0,4-7,4.5-5.5,4.8-11.5,5-11,5-8,6-10,6-8,9-10,[,``,age,arrangement,articulation,branching,characteristic,clavate,colour,corolla,decurred,form,growth,height,inflorescence,length,opposite,ovary,plant,seed,shape,spacing,staman,stem,structure,sympodial,texture,type,value,width,{,}
373	wfo-0001030225	success	155	124	99	56	25	0.639	-1.5,-11,-30,-4,-45,-7,.5-2.5,0,0-20,0-5,1,1-4,1-6,1.5,1.5-2.5,10-15,10-30,2,2-18,2-2.5,2-3,2-6,3-11-compound,3-20,3-4,3-5,4-5,acuminate,acute,apart,apex,apically,articulated,basal,base,blade,calyx,campanulate,cm,conivent,connective,cordate,coriaceous,cuneate,cylindrical,deltate,densely,diameter,dilated,directed,distally,elliptic-ovate,entire,expanded,fleshy,flower,forked,fruit,glabrous,globose,laterally,leaf,less,lobe,long,margin,mm,moderately,oblong,obtuse,pedicel,peduncle,perfect,petiole,pinnately,pore,possibly,puberulent,purple,rachi,radiu,shallowly,shrub,simple,small,sparsely,stellate,stigma,strongly,style,succulent,time,tip,tree,truncate,unbranched,unknown,wide,x	.5,3-foliat,8-15,abaxially,absent,adaxially,ape,apical,ature,axe,beyond,bilobed,color,compound,eaf,eed,equal,especially,exceeding,exserted,glabrate,gland,immature,leaflet,leaving,lower,minutely,narrowly,nflorescence,nther,one,orolla,papillose,prominent,puberulen,scar,see,seen,slightly,somewhat,spaced,stalked,stamen,tal,tem,thecae,tomento,toward,triangular,tube,two,ud,unit,unknow,vary,ympodial	anther,articulation,branching,bud,colour,corolla,direction,form,growth,hair,height,inflorescence,length,number,ovary,plant,ratio,seed,shape,size,spacing,stem,texture,theca,type
374	wfo-0001030250	success	169	98	81	88	17	0.479	0.5-1,1-1.5,1-3,1.1-1.2,1.1-3.5,1.25-1.5,1.7-7,11.2-22,11.3,2-2.5,2.1-6,2.5-3.25,25,3.4-6.6,3.5-4,5-6,6-8,across,anther,apart,apex,bark,base,broadly,calyx,capitate,cm,conical,corolla,cup-shaped,dark,decurrent,dia,elliptic,elliptic-ovate,exerted,filament,glabrous,globose,green,greenish-white,greenish-yellow,inflorescence,lateral,leaf,lobe,long,long-acuminate,main,minor,minutely,mm,opposite,orbicular,ovary,ovoid-reniform,pair,pale,pedicel,petiole,pitted,pore,scar,sea-green,seed,shape,shaped,shrub,simple,size,soon,stem,stigma,style,surface,tear-drop,translucent-green,vein,white-lenticellate,winged,x	.5,/4,0-seeded,1.4-1.5,1.9-2.6,3-5,4-7,5-50-flowered,anthesi,appearing,arching,attenuate,beginning,beneath,berry,brown,bullate,carinate-hooded,consisting,cuneate,curved,deflexed,differing,difoliate,dry,eaf,edicel,eed,five,free,fresh,fruiting,geminat,glabrou,horizontally,inflorescenc,irregularly,lobed,lon,lower,major,maturity,middle,n,nflorescence,node,occasionally,older,one,orbiculate,paler,papillo,papillose,pendulous,pit,poricidal,portion,projection,prominent,proximal,raised,reflexed,rim,ruit,shallow,slender,slightly,smooth,spaced,specimen,spreading,straight,tall,tan,tapering,tip,translucent,tube,two,ud,unit,usually,way,white-lenticellat,wide,widest,woody,ympodial	0.5,abaxial,adaxial,bud,colour,exertion,form,fruit,glabrousnes,growth,height,length,plant,position,spacing,texture,venation
375	wfo-0001030271	success	195	111	91	104	20	0.467	0-2,0.15-0.75,0.7-9.5,0.9-2.5,1-2,1-2.5,1-3,1-7,1.4-2.1,1.9-6.6,15-61,2-2.7,2-4,2-6,2.4-5.6,3-10,3.4-7.5,4-22,4-7,5-8,5.6-12.3,6-15,anther,berry,blade,blue,brownish,clavate,cm,coloration,completely,condition,coriaceous,corolla,dark,deep,diameter,drying,filament,flower,forked,fresh,fruit,glabrous,green,greenish,herb,homostylous,interjected,lanceolate,lateral,leaf,leaflet,light,lilac,lobe,long,medium,mm,moniliform,mottled,mucilaginous,odd-pinnate,ovoid,pair,pedicel,peduncle,pentagonal,petiole,plant,pore,poricidal,purple,ripe,rotate,seed,size,spot,stigma,straight,style,terminal,tip,tube,tuber,vein,wet,white,whitish,wide,x	0.5-1.2,0.9-3.6,1-4,1-6,2-3,3-5,5-merou,abaxially,acumen,acute,adaxiall,adaxially,ag,along,alyx,apart,apex,apparently,arranged,articulated,asymmetric,attenuate,axe,axillary,base,basiscopic,bead,bud,capitat,cell,connivent,considerably,covering,decreasing,digestion,distal,dorsally,eaf,edge,eed,elliptic,enzyme,erect,exceeding,flat,folded,geminat,generally,glabrou,green-white,habi,hair-like,half,honeycomb-shaped,larger,lengthening,like,linear,living,lower,make,middl,multiple,necklace,nflorescence,orbicular,orolla,ovate,perfect,petiolulate,plurifoliate,removed,rosette,rounded,ruit,sessile,seudostipule,side,slightly,slit,sometimes,spaced,specimen,stamen,stolon,subtending,symmetric,tall,tamen,tem,testal,thick,throughout,tissue,toward,tri-,typically,unit,unwinged,usually,vary,wall,yellow,ympodial	abaxial,adaxial,arrangement,branching,calyx,capitate,colour,form,growth,hair,height,inflorescence,length,ovary,pseudostipule,shape,staman,stem,symmetry,texture
376	wfo-0001030272	success	179	108	87	92	21	0.486	-6,.5,/4,0-20,0.5-1.5,0.5-2,0.6-0.9,0.65-1,0.7-2.5,1.2-1.8,1.5-2.5,1/3,2.5-3,2.5-3.5,2.8-3.5,3.5-5,4-6,4-8,abaxially,acute,anther,apex,apically,base,berry,bright,calyx,cm,connivent,deltate,diameter,elliptic,elongating,evenly,flattened-reniform,flower,fruit,fruiting,glabrescent,glandular,green,hair,lateral,leaf,length,lobe,lobed,long,long-attenuate,margin,mature,maturity,mauve,membranous,minute,mm,multangulate,obtuse,orange-brown,pair,per,petiole,poricidal,porrect,primary,red,rounded,sessile,shrub,simple,sometimes,sparsely,spherical,spreading,stellate-pubescent,stem,style,tapering,terminal,tip,unarmed,unbranched,upper,vein,way,wide,young	.3,0.05-0.1,0.05-1.5,0.5-1,0.8-1.5,1,1-1.5,1-2.8,1.5-3,1/3-2/3,10-20,2-2.5,2-6.5,3-8,4-10,4-15,5-7,5-merous,acut,almost,alyx,ame,apar,apparently,articulated,ba,bark,blade,c.,concolorous,densely,difoliate,drying,eaf,eed,entire,equal,erect,filament,free,geminat,glabrescen,glabrous,gland,gra,infructescence,less,longer,lower,midpoint,moderately,narrow-deltate,near,nflorescence,older,one,open,orolla,oung,pedicel,peduncle,perfec,pericarp,portion,ray,red-brown,reduced,reflexe,ruit,scar,shallowly,shorte,slender,smooth,spaced,stellate,straight,surface,tamen,terete,tertiary,time,trichome,tube,unarme,undulate,unit,vary,venation,visible,woody,ympodial	abaxial,adaxial,branching,colour,corolla,form,growth,height,inflorescence,number,ovary,plant,position,prickle,reflexed,seed,shape,staman,texture,type,width
377	wfo-0001030287	success	150	126	99	51	27	0.66	-11,-40,-many,0-15,0.5-1,1,1-10,1-15,1-2,1-2.5,1-4,1-5.5,1.5-10,1.5-2.5,1966,2,2-,2-10,2-12,2-5,3-9,4-5,4-6,4.5-6,8-13,?,abaxially,acute,adaxially,apart,apex,axe,base,blade,bluish,calyx,chartaceous,cm,compound,cylindrical,deltate,dendritically,densely,diameter,directed,down,eglandular,ellipsoidal,elliptic-ovate,entire,fide,flattened,flower,forked,glabrous,glandular,hair,herb,lanceolate,leaf,lilac,lobe,long,margin,membranaceous,mm,moderately,narrowly,oblong,ovoid,pedicel,peduncle,petiole,pinnately,pore,puberulent,pubescent,purple,rachi,radiu,rugulose,scar,shrub,simple,slightly,smith,stellate,stigma,strongly,style,subcordate,subcoriaceous,tip,truncate,unbranched,unit,unknown,x,yellow	-foliat,.5-2.5,1-3,2.5-4,3,5-10,adaxiall,aggregate,articulated,basiscopically,branched,cell,color,connivent,decurrent,dendritic,dendritic-pubescen,distall,eaf,eed,gland,lateral,leaflet,leaving,lon,long-stalked,lower,nflorescence,nther,obtuse,often,orolla,pedicellar,presen,ruit,scattered,spaced,sparsely,sparser,stalked,stone,subcapitat,tal,tem,time,triangular,tube,upper,vary,wide,ympodial	-foliate,anther,articulation,branching,colour,corolla,dendritic-pubescent,direction,distally,form,fruit,growth,height,inflorescence,length,ovary,plant,seed,shape,size,spacing,stem,structure,subcapitate,sympodial,texture,type
378	wfo-0001030300	success	235	142	121	114	21	0.515	-0.9,-1,-7,.5,0.15-1,0.2-0.5,0.4-0.5,0.4-1.5,0.4-4.5,0.5-0.6,0.5-5,0.6-0.7,0.6-0.8,0.7-0.8,0.7-1.2,0.8-3,0.8-4,0.9-1,1,1-2,1-4,1.2-,1.4-2.4,1.5-,2-2.5,2-locular,2.2-7.5,3.5-13,4-11,6-15,9-12,abaxially,absent,almost,anther,apex,articulated,articulation,base,bent,bifid,bract,brittle,broadly,brown,calyx,capitate,cell,cm,coherent,cordate,corolla,crenate,curved,densely,developed,diameter,ellipsoidal,elliptical,elongate,entire,flower,fruit,fruiting,glabrous,globose,golden,green,hair-like,herb,imparipinnate,inflorescence,interrupted,irregularly,large,lateral,leaflet,lobe,margin,mm,moderately,node,obovate,occasionally,once-branched,orbicular,outgrowth,ovary,pale,papillae,partially,pedicel,peduncle,pentagonal,perennial,petiolule,plant,population,present,primary,pseudostipule,pubescent,rounded,simple,slightly,sparsely,spreading,stem,stigma,straight,strongly,style,terminal,testa,tube,wall,well,yellow,yellowish,yellowish-green,zygomorphic	0.1,0.1-0.15,0.2,0.2-1.5,0.5,0.5-1,0.5-4,0.7-1.5,0.8-1,1-1.3,1-2-celled,1-6,1-celled,1.5-2.5,2-2.1,2-3,2-4,2-foliate,3/4,4-celled,6-8-celled,abundant,acute,adaxial,adaxially,although,always,anthesi,apical,appearance,appendage,ba,basal,beyond,bracteate,column,crenat,deltate,diamete,distal,eaf,edicel,eed,eglandular,even,exserted,face,filament,finely,frequently,give,glandular,glutinous-viscose,gree,halfway,head,interjected,internode,introrse,lamina,larger,leave,less,like,lon,long,longer,markedly,midvein,minute,multicellular,narrowly,nflorescence,oblique,pair,petal,petiole,pith,pore,pubescence,reflexed,rest,ruit,secondary,silky,spathulate,spreadin,staminal,sterile,surface,tall,tem,tertiary,thick,tip,triangular,trichome,two,ud,underlying,unicellular,uniseriate,unit,united,upper,usually,vein,velvety,weak,wide,wider,winged,woody,ympodial	arrangement,branching,bud,colour,curvature,form,growth,hair,height,heteromorphism,history,leaf,length,life,seed,shape,staman,texture,thicknes,type,width
379	wfo-0001030311	success	182	97	75	107	22	0.412	.2,.5,0.5â0.8,0.5â1,0.6â1,0.8â1.2,1.2â7,1.5â2,1.5â5.5,1.5â8,1.8â2,15â22,1â1.2,1â1.5,1â2,1â2.5,2.2â2.5,2.2â3,2.5â9,2â2.5,2â6,3â5,3â7,5-pinnate,5â10,acuminate,acute,adaxial,anther,blade,brown,calyx,chartaceous,clavate,cm,deltoid,densely,diameter,entire,filament,flattened,flower,fruit,glabrous,green,half,lenticular,lobe,lower,margin,membranaceous,mm,orangish,ovoid-rhomboid,papillose,pedicel,peduncle,petiole,pubescence,pubescent,purplish,rachi,sparsely,stellate,stem,stigma,style,tan,terrestrial,trichome,tube,unbranched,vine,white,x	.5â1.8,0.1,0.1â0.2,0.3â1.5,0.4â2,0.5â2,0.5â2.5,0.6â2.4,0.8â4,0.8â4.5,1.5â3,1.5â6,1â3,2â10,<,abaxially,accrescent,adaxially,along,alyx,apar,apex,apical,appearance,axe,basal,base,berry,c.,capitat,ciliat,ciliate,color,cordate,cuneate,dense,distal,eaf,eed,elliptical,especially,extra-axillary,falcate,fallen,fruiting,giving,glabrou,granular,groov,groove,ground,hair,herbaceous,lanceolate,lateral,leaflet,like,log,lon,long,m.,membranous,midvein,minutely,nflorescence,nternode,oblique,obovate,obtuse,occasionally,orolla,pair,petiolulate,petiolule,plurifoliat,present,proximal,rhomboid,rounded,ruit,sand-punctate,scattered,sessile,short,shortly,side,slender,slightly,smaller,spaced,strongly,surface,tamen,tem,thick,thickened,thinner,tip,trailing,unit,upper,vary,vein,wide,wide-diameter,widely,ympodial	abaxial,branching,capitate,colour,corolla,form,glabrousnes,growth,habit,inflorescence,internode,leaf,length,ovary,plant,seed,shape,size,staman,texture,thicknes,type
380	wfo-0001030311	success	203	126	104	99	22	0.512	.2,.5,0.1,0.5-1,0.5-2,0.6-1,1-3,1.5-2,1.5-5.5,1.5-6,15-22,2-6,3-5,3-7,5-10,5-pinnate,<,abaxially,absent,acuminate,acute,adaxial,adaxially,anther,apex,apical,apparently,basally,base,blade,brown,chartaceous,cm,cordate,cuneate,densely,directed,distally,elliptical,entire,especially,flattened,flower,fruit,glabrous,granular,green,groove,hair,herb,interjected,large,lateral,leaflet,lenticular,long,longitudinal,lower,margin,membranaceous,minutely,mm,node,oblique,oblong,obovate,obtuse,opening,orangish,ovoid-rhomboid,pair,pedicel,peduncle,perfect,petiole,petiolule,pore,pubescent,purplish,rachi,rhomboid,rooting,rounded,short,shortly,side,simple,slightly,slit,sparsely,stellate,stem,stigma,style,surface,tan,trailing,unbranched,uniseriate,upper,vein,white,wide,x	.5-1.8,0-2.5,0.4-2,0.5-0.8,0.6-2.4,0.8-1.2,0.8-4,0.8-4.5,1-1.2,1-1.5,1-2.5,1.2-7,1.5-3,1.5-8,1.8-2,2-10,2-2.5,2.2-2.5,2.2-3,2224,5-merou,8031,[,],absen,accrescent,ag,aggregate,along,alyx,apart,appearance,articulated,axe,ba,basal,capitat,cell,ciliat,ciliate,clavate,color,connivent,deltoid,dense,diameter,dig,distal,eaf,eed,equal,falcate,fallen,filament,formation,g,geminat,gh,giving,groov,ground,half,like,lobe,log,lon,m.,midvein,nflorescence,occasionally,orolla,papillose,petiolulate,pittier,plurifoliate,present,proximal,ruit,scattered,sessile,sinple,slender,smaller,spaced,stone,strongly,tamayo,tamen,tem,thick,thickened,thinner,tip,tube,unit,vary,widely,yellow,ympodial	5-merous,age,arrangement,branching,calyx,capitate,colour,corolla,form,growth,habit,inflorescence,leaf,length,ovary,pubescence,seed,shape,staman,texture,type,ye
381	wfo-0001030335	success	153	137	112	41	25	0.732	.1,.25,.75,0-5,0.05-0.2,0.1-0.5,0.25-0.5,0.5-1,1-1.5,1-2,1-3-flowered,1.1-1.4,1.1.5,2-2.2,2-2.5,2-5,2.5-3,3/4,5-6,5-7,acute,along,anther,anthesi,apex,bark,base,berry,bi-lobed,bud,calyx,cm,conical,corolla,dark,deciduous,decurrent,densely,dia,dry,elliptic,filament,filiform,flattened,fruiting,gently,glabrous,globose,green,greyish-red,horizontally,lateral,leaf,lenticellate,lightly,lobe,lobed,long,main,material,minute,minutely,mm,narrowly,obovoid,often,older,opposite,ovary,ovoid-reniform,pair,pale,papillose,pedicel,petiole,pitted,pore,prominent,puberulent,pubescent,raised,reflexed,ripe,shaped,shrub,simple,slightly,soon,sparsely,spreading,stem,stigma,strongly,style,surface,tan,tapering,tear-drop,tip,trichome,tube,underside,uniseriate,unit,vein,way,white,winged,x,yellow,yellowish-green,young	.5,0.7-1,2-4.5,7-13,acuminate,aspec,ba,beneath,branch,deflexed,deltoid,eaf,edicel,eed,erect,except,expanded,exserted,free,geminate,giving,lamina,like,lon,lower,middle,nflorescence,occasionally,onto,papillo,poricidal,portion,puberulen,ruit,straight,tall,ud,unifoliat,widest,woody,ympodial	branching,colour,decurren,diameter,flower,form,fruit,growth,hair,height,inflorescence,length,mature,pattern,plant,position,seed,shape,size,structure,symmetry,sympodial,texture,unifoliate,wing
382	wfo-0001030336	success	266	101	82	184	19	0.308	0.5-0.7,1-3,acute,almost,anther,apex,articulation,base,basiscopically,bifurcate,bluntly,bracteate,bright,brown,cell,cm,corolla,crenate,curved,dark,darker,decurrent,deeply,densely,developed,eglandular,elliptic,entire,flushed,fruit,globose,green,greenish,hair-like,half,herb,imparipinnate,inflorescence,interrupted,lateral,leaf,less,lobed,long,lower,margin,markedly,midvein,node,oblique,obovate,occasionally,once-branched,orbicular,outgrowth,pedicel,perennial,petiole,present,proximal,pseudostipule,pubescent,purple,rotate,rounded,scattered,simple,slightly,stellate,stem,surface,ten,testa,trichome,truncate,uniformly,uniseriate,usually,velvety,wall,white,yellow	-1.5,-10,-19,-2,.5,0-,0.1-0.3,0.1-0.5,0.1-0.7,0.1-1,0.15-0.2,0.15-0.9,0.2,0.2-0.25,0.2-0.8,0.2-1,0.2-1.5,0.3-0.4,0.3-1.1,0.5,0.5-1,0.5-1.5,0.6-0.8,0.6-1.5,0.8-0.9,0.8-1.2,0.8-1.3,0.8-3,1,1-1.4,1-1.5,1-celled,1.0-1.4,1.5-,1.5-2,1.5-3.5,1.5-5,1.6-7,1.7-2.3,1.8-3.0,1/4-1/3,10,2-4,2-9,2-foliate,2-locular,2/3,3-5,4,4-,4-10,4-celled,6,8-16,8-20,8-celled,absent,adpressed,amongst,anthesi,apical,appearance,appearing,appendage,articulated,basal,bent,berry,bract,branch,calyx,capitate,clavat,coat,column,completely,conical,cordate,diamete,diameter,distal,divided,eaf,edicel,eed,elongate,entir,erect,essentially,exserted,extremely,filament,first,flower,fruiting,giving,glandula,glandular,grayish,halfway,head,interjected,internode,investing,lanceolate,large,larger,largest,leaflet,leave,like,lobe,lon,longer,loosely,maturity,mere,middl,minute,minutely,mixed,mm,mostly,narrowing,narrowly,nflorescence,often,ovary,pair,pale,papillate,part,peduncle,petiolule,population,primary,puberulent,rachi,range,reflexed,rest,ruit,secondary,sessile,shaggy,shorter,shrub,silky,sinus,small,soft,sometimes,southern,sparse,spreadin,spreading,staminal,sterile,stigma,straight,stripe,strongly,style,surrounding,tall,tem,terminal,tertiary,thick,tip,tube,two,ud,unicellular,unit,united,upper,way,weak-walled,wide,winged,woody,ympodial,young	arrangement,branching,colour,form,growth,hair,history,length,life,mature,middle,orientation,placement,position,prickle,seed,shape,texture,type
383	wfo-0001030342	success	155	117	89	66	28	0.574	.2,.5,0.1â0.2,0.3â1.2,0.5â1,0.5â3,0.8â1.5,1-5,1-6.5,1.5,1.5â13,1.5â2,1.5â5,10â25,1â1.5,1â2.5,2â2.5,2â4,3-pinnate,3â12,4â5,5-merous,abaxially,accrescent,acuminate,acute,adaxially,anther,apex,apical,apiculate,base,blade,broadly,calyx,chartaceous,cm,cordate,cuneate,deltoid,diameter,elliptical,entire,extra-axillary,filament,flower,fruit,fruiting,glabrous,greenish,lateral,leaf,leaflet,lenticular,lobe,margin,membranous,minutely,mm,oblique,obtuse,ovoid-rhomboid,pedicel,peduncle,petiole,petiolule,pubescent,rachi,revolute,rhomboid,rounded,slightly,smooth,stellate,stem,stigma,style,surface,trichome,truncate,tube,unbranched,undulate,unit,vine,white,wide-diameter,x,yellowish	0.5â5,0.8â4,1.2â3,1.5â7.5,1â1.2,1â3,1â5.5,1â6,1â7,2â,3,4â8,6â7,abundant,along,alyx,apar,axe,berry,brown,c.,capitat,ciliat,cylindrical,dense,eaf,eed,flattened,glabrou,herbaceous,lanceolate,light,like,lon,long,lower,m.,mottled,nflorescence,nternode,often,orolla,perfec,plurifoliat,pointed,proximal,pubescen,rarely,ruit,sand-punctate,scattered,side,slender,spaced,sparsely,tamen,tem,terrestria,tip,truncate-acuminat,vary,vein,wide,widely,ympodial,â7	2â7,accrescence,branching,capitate,colour,corolla,form,growth,habit,inflorescence,internode,length,number,ovary,perfect,plant,plurifoliate,position,revulsion,seed,shape,size,staman,structure,sympodial,terrestrial,texture,type
384	wfo-0001030342	success	153	110	92	61	18	0.601	-7,.2,.5,0.5-3,1-1.5,1-3,1-5,1-6.5,1.2-3,1.5-13,1.5-2,1.5-5,10-25,2-2.5,2-3,3,3-12,3-pinnate,4-5,6-7,abaxially,absent,acuminate,acute,adaxially,anther,apex,apical,apiculate,basally,base,blade,broadly,brown,calyx,chartaceous,cm,cordate,cuneate,cylindrical,deltoid,elliptical,entire,flower,glabrous,hair,herb,interjected,lanceolate,lateral,leaf,leaflet,lenticular,light,lobe,longitudinal,margin,membraceous,mm,oblique,oblong,obtuse,opening,pedicel,peduncle,petiole,petiolule,pore,pubescent,rachi,rarely,rhomboid,rounded,sagittate,simple,slender,slit,smooth,stellate,stigma,style,surface,terrestrial,tip,truncate,tube,unbranched,undulate,uniseriate,white,x,yellow	0.5-1,0.5-5,0.8-4,1-1.2,1-5.5,1-6,1-7,1.5-7.5,2-,4-8,5-merou,abundant,accrescent,ag,along,alyx,apart,apparently,articulated,axe,ba,capitat,ciliat,connivent,diameter,directed,distally,eaf,eed,equal,extra-axillary,filament,fruit,fruiting,geminat,long,lower,minutely,nflorescence,node,orolla,perfect,plurifoliate,proximal,pubescen,revolute,rooting,scattered,side,slightly,spaced,tamen,tem,trailing,truncate-acuminat,unit,vary,vein,wide,widely,ympodial	age,arrangement,capitate,colour,corolla,form,growth,inflorescence,length,number,ovary,seed,shape,size,staman,stem,texture,type
385	wfo-0001030353	success	227	86	70	157	16	0.308	0,0.5-0.9,1-7,1/2-2/3,20-200,3.5-4,5,acute,anther,apart,apex,base,berry,brown,calyx,cm,conical,connivent,cuneate,curved,deltate,ellipsoid,elongating,equal,evenly,flattened,flattened-reniform,flower,fruit,fruiting,green,lateral,leaf,length,lobed,long,lower,margin,maturity,mauve,mm,multangulate,per,petiole,poricidal,prickle,reflexed,sessile,shape,shrub,simple,small,somewhat,spaced,spreading,stalked,stem,straight,subentire,surface,tapering,terminal,tip,tree,trichome,unbranched,way,weakly,yellow,young	-0.2,-1.5,-1/2,-2,-3,-5,-6,-merous,.1,.2,.5,.7,0-15,0-2,0-6,0.1-0.2,0.1-0.3,0.15-0.3,0.5,0.8,0.8-1.2,1,1-2,1-3,1-6,1.2-1.8,1.8-2.2,1.8-3,1/,1/3,1/5,1/6,1/6-1/4,10-15,11-16,2-10,2-7,2.5-4,2.8-3.7,3-4,3-5.5,4-,4-4.5,4-5,5-6,6,6-15,6-8,7-10,8-15,abaxial,abaxially,adaxial,almost,alyx,andromonoecious,apar,apically,apiculat,apparently,articulated,bark,blade,broad-deltate,c.,chartaceous,densely,development,diameter,discolorous,distal,distance,drying,eaf,eed,elliptic,erect,extending,filament,free,glabrescent,glabrous,half,hermaphrodite,heterostylous,infructescence,less,lobe,long-styled,longer,lowermost,mature,midpoint,midvein,moderately,narrow-deltate,nflorescence,older,one,open,orange-brown,orolla,oung,pair,patch,pedicel,peduncle,pendulous,pericarp,plant,plurifoliat,pointed,porrect,portion,prickly,primary,ray,red-brown,reddish-green,retaining,rounded,ruit,scar,short-styled,shorter,side,smooth,sometimes,sparsely,stalk,staminat,stellate,stellate-pubescent,stout,strongly,style,tamen,terete,tertiary,throughout,time,tube,unarme,unarmed,unit,upper,vary,vein,venation,visible,warty,whit,white-gray,wide,wo,woody,ympodial	branching,colour,corolla,form,growth,heteromorphism,inflorescence,na,number,orientation,placement,position,seed,staman,symmetry,type
386	wfo-0001030407	success	182	123	100	82	23	0.549	.2,.5,0.7-3.2,1-10,1-2,1.5-5,12-14,12-15,2-5,2-6.7,2-7,3-10.5,3-6.5,3.5-9.5,30-60,4-5,5,6.5-18.5,7-8,abaxially,adaxially,anther,apart,berry,blade,brownish,cell,chartaceous,ciliate,cm,condition,conical,corolla,covering,densely,diameter,dorsally,drying,edge,end,filament,flat,flower,folded,forked,fresh,fruit,glabrous,green,green-white,greenish,hair,hair-like,herb,homostylous,lanceolate,lateral,leaf,leaflet,lengthening,light,like,long,make,margin,middle,minute,mm,mottled,mucilaginous,odd-pinnate,one,ovoid,pedicel,peduncle,pentagonal,petiole,placed,plant,pore,poricidal,proximal,pubescent,purple,ripe,seed,size,slit,style,terminal,testal,thick,throughout,tip,tuber,typically,wall,wet,whitish,x	1-3,1-4,2-2.5,3-4,3-9,5-merou,6-7,absent,acumen,acuminate,ag,alyx,apex,apparently,articulated,axe,axillary,base,bud,capitat,connivent,decreasing,digestion,distal,eaf,eed,elliptic-lanceolate,enzyme,especially,exceeding,geminat,generally,glabrou,gradually,half,honeycomb-shaped,interjected,larger,living,lobe,lower,nflorescence,obtuse,orolla,ovate,pair,perfect,petiolule,plurifoliate,pubescen,ray,removed,round,ruit,secondary,semierec,seudostipule,spaced,specimen,stamen,ste,stigma,stolo,subequal,subsessile,subtending,symmetrical,tall,tamen,tem,thir,toward,tri-,tube,unit,unwinged,usually,vary,white,wide,yellow,ympodial	age,arrangement,articulation,branching,colour,form,growth,hairines,height,inflorescence,length,number,ovary,placement,pseudostipule,shape,spacing,stem,stolon,symmetry,texture,third,width
387	wfo-0001030420	success	170	148	122	48	26	0.718	-2,-20,-30,-35,-9,-pubescent,0.5-,0.5-1,0.5-4,0.5-8,1,1-1.5,1-2,1-3,1-4,1-6,1-7.5,1.5-3,1.5-5,10-,10-25,15-25,2-,2-14.5,2-3,2-5,2-9,3-lobed,4-7,5-,5-15,5-6,6-7,abaxially,absent,acuminate,acute,adaxially,aggregate,also,apart,apex,basal,base,beyond,calyx,cell,chartaceous,cm,connective,connivent,cordate,cylindrical,deltate,densely,diameter,eglandular,eglandular-puberulent,ellipsoidal,elliptic-ovate,elongated,entire,equal,flower,forked,fruit,glabrate,glabrous,glandular-,glandular-puberulent,hair,lanceolate,leaf,leaving,lobe,lobed,long,margin,mm,moderately,narrowly,nearly,obtuse,often,ovate,pedicel,pedicellar,peduncle,petiole,pilose,pinnately,puberulent,pubescent,pubescent-pilose,purple,rachi,radiu,rarely,remnant,shorter,shrub,simple,small,sparsely,stamen,stellate,stigma,stone,style,subcoriaceous,thecae,tip,tree,triangular,truncate,tube,unbranched,unknown,unlobed,vein,x,yellow	-4,1-,1/2,2-6,3-7,4-foliat,7-19,7-22,7/8,ape,articulated,axe,blade,color,dark,directed,distally,divided,eaf,eed,eglandular-pilo,exserted,lon,lower,midrib,nflorescence,nther,orolla,perfect,pore,presen,puberulent-pubescent,pubescent-pilo,ripe,ruit,sinus,spaced,tal,tem,time,tomento,truncat,ud,unit,vary,wide,yello,ympodial	anther,articulation,branching,bud,colour,corolla,eglandular-pilose,exsertion,form,growth,height,inflorescence,length,lobing,na,ovary,plant,present,seed,shape,size,spacing,stem,texture,theca,type
388	wfo-0001030426	success	158	99	69	89	30	0.437	-30,0.3-7,0.4-0.7,1-4,1-4.2,1.7-3.2,10,15-25,2,2.5-4,2.5-6,3-12,3-6,4-6.5,6-11.5,6-8,9,apically,branched,cm,connate,corolla,cyme,dehiscent,diameter,dichasial,dichasially,distal,ebracteate,filament,flower,glandular,globose,green,green-white,hair-like,heart-shaped,herbaceous,interjected,lateral,leaf,leaflet,mm,monochasial,odd-pinnate,ovoid,pair,pedicel,peduncle,perennial,perfect,petiole,pilose,plant,poricidally,proximal,seed,spot,stellate,straight,style,terminal,throughout,tuber-bearing,unit,wall,white,yellow,Â¼	0.3-8,1.5-3,1.5-6.5,2-3,3-4,3-6-foliat,4-10,abaxially,absen,acumen,acute,adaxially,apex,apical,apiculate,articulate,base,calyx,caudate,cell,covering,decurrent,digestion,diminishing,dorsally,eaf,edge,eed,elliptic-lanceolate,emoval,enzyme,exceeding,flat,folded,forked,generally,globo,gradually,half,honeycomb,introrse,lanceolate,larger,linear,linear-lanceolate,linear-oblong,living,lobe,lon,long,lower,make,maturing,mucilaginous,nflorescence,nther,oblique,oblong,obtuse,often,orolla,pattern,pinnatifi,plan,rachi,reveal,rounded,ruit,second,sessile,seudostipule,short,size,slit,specimen,stamen,stigma,stripe,tal,tem,testal,thick,toward,typically,vary,whit,wide,without,ympodial	3-6-foliate,absent,anther,arrangement,articulation,bract,branching,colour,form,fruit,growth,height,history,inflorescence,length,life,number,ovary,pinnatifid,pore,present,pseudostipule,shape,stem,structure,sympodial,texture,type,width,ye
389	wfo-0001030430	success	171	131	82	89	49	0.48	.2,.5,0.4,5,abundant,acute,anther,anthesi,apart,apex,base,blue,brittle,brown,calyx,capitate,cell,clavate,cm,cylindrical,decurrent,densely,diameter,elliptic,few-seeded,filament,flattened,fleshy,flower,fruit,glabrous,globose,green,hair,leaf,lobe,lobed,long,longitudinal,margin,mm,moderately,multicellular,oblong,occasionally,opening,ovate,pair,pale,pedicel,peduncle,pentagonal,perennial,perfect,petiole,pitted,pore,present,pubescent,purple,regularly,rounded,shallowly,shaped,shrub,simple,slit,stigma,stone,straight,style,subglabrous,surface,tear-drop,time,tube,uniseriate,violet,white,woody,x,yellow	0.25,0.3,0.5,0.5â12,0.6,0.6â0.8,0.6â1.0,0.8â3.0,0.8â5.6,0.9â1.0,0â20,1.0â1.2,1.0â1.5,1.0â2.0,1.2â2.0,1.3â8.0,1.4â1.5,1.5â1.7,1.6â1.8,1.8â5.0,12â20,12â30,1â3,1â9,2.0â3.0,2.0â4.2,2â3,3.0â4.5,30â200,3â17,3â24,3â4,3â5,3â8,5.5â12,5â10,5â6,6â10,abaxially,adaxiall,adaxially,ag,apical,appressed,articulated,axe,axillary,ba,basal,blade,borne,branched,bud,chartaceous,connivent,convex,dentate,diamete,eaf,eed,equal,erect,especially,geminat,indumentum,lon,lower,m.,nflorescence,orolla,poricidal,ruit,serrate,shoot,side,spaced,tal,tamen,tem,terminal,tip,toward,unifoliate,unit,vary,wide,ympodial,â2.7,â40	0-20,0.5-12,0.8-5.6,1-3,1.0-1.2,1.0-2.0,1.2-2.0,1.3-8.0,1.4-1.5,1.6-1.8,12-20,12-30,2-3,2.7,3-17,3-4,3-5,3-8,30-200,40,5-10,5-6,abaxial,adaxial,age,arrangement,articulation,branching,colour,corolla,form,growth,height,history,inflorescence,length,life,number,ovary,plant,ratio,seed,shape,size,spacing,staman,stem,texture,type
390	wfo-0001030441	success	178	161	134	44	27	0.753	+,.5,0.5,0.5-0.75,0.5-3,1,1-1.4,1-1.5,1-2-celled,1.2-1.4,1.5-2,10-40,2,2-10,2-5.5,2.5,3-4,30,4-5,5-14,5-7,5-7.5,6-11,<,>,acuminate,acute,anther,anthesi,apart,apex,articulated,attenuate,base,berry,branched,bright,c.,calyx,capitate,cell,closely,cm,corolla,decurrent,deltate,diameter,ellipsoid,elliptic,entire,exerted,eye,filament,flattened,flexuous,flower,fruiting,glabrous,glandular,globose,green,growth,hair,irregularly,juicy,lateral,leaving,lengthening,lobe,lobed,long,lower,making,many,margin,membranous,midvein,minutely,mm,narrowly,new,occasionally,onto,open,pair,pale,pedicel,peduncle,peg,per,perfect,pericarp,petiole,plant,pore,poricidal,primary,pubescent,red,reniform,ridged,ripe,scar,shiny,short,shrub,simple,slightly,slit,spaced,spot,stellate,stem,stigma,strongly,style,surface,thin,time,tip,triangular,trichome,tube,undulate,uniseriate,upper,usually,vein,vine,violet,wall,way,white,yellow	0.5-1,2-3,5-6,5-merou,ag,along,alyx,ark,brow,distall,eaf,eed,free,glabrou,glandula,ilament,impressed,lon,markedly,nflorescence,older,orolla,otherwise,papillat,papillose,plurifoliat,portion,reflexed,ruit,scandent,shrubby,small,somewhat,spreadin,spreading,tem,terminal,trailing,ud,unit,vary,wide,woody,ympodial	5-merous,age,arrangement,articulation,bark,branching,brown,bud,colour,distally,exertion,form,fruit,height,inflorescence,leaf,length,number,ovary,papillate,ridging,seed,shape,texture,thicknes,type,width
391	wfo-0001030444	success	196	159	129	67	30	0.658	0-24,0.15-0.8,0.8-2,1,1-10,1-2,1-4,1.1-2.7,1.2-1.8,11-45,2-3,2-8,2.3-3.6,2.4-3.8,3-10,3-5,3.7-6.8,4-17,4-39,4-7,5.3-9,6.1-12.8,7.1-17.5,9.4-20.1,acumen,acuminate,acute,anther,apart,apex,asymmetric,attenuate,axillary,base,berry,blade,blue,brownish,bud,cell,ciliate,clavate,cm,condition,coriaceous,corolla,dark,deep,diameter,digestion,distal,dorsally,dot,drying,edge,elliptic,enzyme,filament,flat,flower,folded,forked,fresh,fruit,generally,glabrous,green,greenish,half,herb,high,homostylous,honeycomb-shaped,interjected,lanceolate,lateral,leaf,leaflet,lengthening,light,lilac,lobe,margin,medium,mm,moniliform,narrow,odd-pinnate,orbicular,ovate,ovoid,pedicel,peduncle,pentagonal,petiole,petiolulate,plant,pore,poricidal,purple,removed,ripe,rotate,rough,rounded,seed,sessile,shortly,size,slit,sometimes,stigma,straight,style,subtending,symmetric,terminal,testal,tip,touch,tube,tuber,unwinged,usually,wall,white,whitish,wing,x	1-5,2-6,5-merou,abaxiall,abaxially,adaxially,ag,along,alyx,apparently,arranged,articulated,axe,basiscopic,bead,capitat,connivent,covering,decreasing,eaf,eed,erec,exceeding,geminat,general,glabrou,green-white,hair-like,hal,larger,like,linear,living,long,lower,make,mucilaginous,multiple,necklace,nflorescence,orolla,pair,perfect,plurifoliate,ruit,seudostipule,side,spaced,specimen,stamen,stolon,subequal,tall,tamen,tem,thick,throughout,tissue,toward,tri-,typically,unit,vary,wet,wide,yellow,ympodial	5-merous,abaxial,adaxial,age,arrangement,articulation,attachment,branching,calyx,capitate,colour,form,growth,height,inflorescence,length,merosity,number,ovary,position,presence,pseudostipule,roughnes,shape,spacing,staman,stem,symmetry,texture,width
392	wfo-0001030445	success	226	122	100	126	22	0.442	0.2-0.4,0.6-2.2,0.6-3.5,1-1.3,1-7,1.1-4.3,1.6-2,10-14,14,15-35,2.1-5.2,2.2-2.9,4.1-8.7,4.2-10,5-125,5.2-7.1,5.9-15,5.9-8.3,7.5-16,8.2-18,abaxial,abaxially,accrescent,acuminate,acute,apart,apex,articulated,bark,base,black,branch,branched,bud,calyx,cm,corolla,decurrent,deltoid-reniform,diameter,drying,elliptic,elliptical,entire,erect,ferruginous-granular,ferruginous-tomentose,flower,fruit,fruiting,glabrate,globose,green,greyish-tan,hair,intermediate,lateral,leaf,lobe,long,main,many,margin,midrib,mm,oblong-lanceolate,obovate,orangish-tan,orbicular,pedicel,peduncle,petiole,porrect-stellate,pubescence,pubescent,rachi,relatively,reniform,reticulate-punctate,shrub,side,simple,slightly,small,somewhat,stellate,subcampanulate,sulcate,surface,thicknes,thin,time,tomentose,tree,tube,vein,x,yellowish,yellowish-tan,young	.1,.5,/5-2/3,0.1-0.7,0.2,0.2-0.5,0.2-0.7,0.3,0.4,0.5,0.7,0.8,1,1.3,1.3-1.8,1.3-2,1.5-2.1,1.7-2.4,1.8-3.5,10-16,2.2-3.5,2.4-4.7,3-5.4,3.1-5,3.4-5.6,3.5-4.2,5-merou,6.1-9.1,8.1-10,adaxially,ag,along,alyx,anther,appressed,around,axillary,berry,blade,blunt-tippe,blunt-tipped,brown,brownish-yellow,bulbous-based,capitate,concentrated,cylindrical,directed,distally,eaf,earl,edge,eed,elongated,exserted,ferruginous,filament,free,geminate,glabrescen,glabrous,high,homostylous,inserted,lackin,lengthening,lobed,lon,longitudinal,lower,m.,midvein,mostly,multangulat,multangulate,nflorescence,oblong,obscured,obtuse,older,open,orange,orolla,ovate,ovate-lanceolate,plurifoliate,pore,poricidal,porrect-stellat,pseudoterminal,ray,resorption,rounded,ruit,runk,semi-spherical,sessile,slit,soon,spaced,sparse,sparsely,splitting,stalk,stamen,stem,stigma,stout,style,suture,tamen,thick,thick-textured,thin-,tip,tissue,tomentum,unarme,unit,vary,vestigial-rayed,way,white,wide,yellow,ympodial	adaxial,arrangement,articulation,branching,colour,form,glabrescent,growth,height,inflorescence,length,orientation,plant,seed,shape,size,spacing,sulcation,texture,trunk,type,width
393	wfo-0001030447	success	276	82	65	211	17	0.236	.2,.5,0,0.4-0.7,0.5-0.65,0.5-10,0.5-3,0.7-1,0.8-3.5,1.5-7,2-4,2.5-10,3-4.5,6-16,6.5-9,7-8,anther,base,berry,calyx,chartaceous,clavate,cm,corolla,cuneate,cupular,diameter,filament,flattened-reniform,flower,fruit,fruiting,globose,lateral,leaf,length,lobed,margin,mm,moderately,obconical,oblique,orange-brown,orange-red,ovate,pale,pedicel,peduncle,per,petiole,prickle,rachi,rounded,shallowly,shrub,stellate,stellate-pubescent,stigma,straw-yellow,style,tapering,tube,white,yellow,yellow-orange	.3,/5,0.1,0.1-0.3,0.15-0.3,0.2,0.2-0.4,0.4-0.9,0.5,0.8-1.7,1,1-1.5,1-10,1-2,1-2.5,1-3,1-5,1-6,1.5,1.5-2.5,1.8-2.5,1/3,1/3-1/2,1/3-2/3,1/4-1/3,2.2-2.8,2.5-6.5,3,3-5,30-45Â°,4-8,5,5-15,5-merou,6,6-10,6-7,6-8,6-9,8,abaxially,accrescent,acute,adaxially,age,always,alyx,apar,apart,apex,apical,apically,apparently,armed,articulated,axe,bark,beyond,blade,branche,broad-deltate,c.,cell,characteristically,covering,curved,dark,deltate,densely,development,difoliate,discolorous,distance,divided,drying,eaf,eed,elongating,equal,erect,exserted,extending,filiform,fine,finely,finger-hair,flat,flattened,free,geminat,gently,glabrescent,glabrous,herbaceous,infructescence,irregula,irregular,lengthening,less,lobe,long,long-ovoi,long-styled,longer,longitudinal,lower,mature,maturity,midpoint,midvein,minute,mostly,narrow-deltate,nflorescence,oblong,obtuse,often,older,one,open,opening,orange,orange-translucent,orolla,oung,outline,pair,papillo,pendulous,perfect,pericarp,persisting,pit,point,pore,poricidal,porrect,portion,primary,pronounced,prostrate,pubescent,purple,raised,ray,red-brown,reduced,rest,ri,ridge,ridged,ruit,scar,sessile,shallow,shiny,short-styled,shorter,shortly,side,simple,sinus,slender,slit,small,smooth,sometimes,somewhat,spaced,sparse,sparsely,spherical,spreading,stalk,stalked,stem,stout,straight,stump,subsessile,surface,tamen,terete,terminal,tertiary,thick,thin,throughout,time,tip,toward,translucent,trichome,ud,unarmed,unbranched,unequal,unit,usually,variously,vary,vein,venation,visible,weakly,wide,widest,woody,x,ympodial,Ã	colour,form,growth,hair,height,inflorescence,number,ovary,papillose,plant,position,seed,shape,staman,symmetry,texture,width
394	wfo-0001030453	success	127	73	55	72	18	0.433	.25,.5,/4,0.8-1.5,1-1.3,1-1.5,1.5-1.6,1.5-2.5,3-3.5,4-5,9-14,acuminate,acute,anther,apex,arachnoid,arachnoid-pubescent,attenuate,base,broadly,calyx,clavate,cm,corolla,cup-shaped,divided,elliptic,filament,floccose,glabrous,known,leaf,minutely,mm,narrowly,occasionally,opposite,ovary,pedicel,petiole,pore,pubescent,reddish,shaped,shiny,shrub,simple,sparsely,stigma,style,surface,tear-drop,tube,way,white	0.25-0.5,9-12,abaxially,adaxially,along,anthesi,axi,bark,closely,dark,deflexed,delicate,deltate,dendritic,densely,dia,eaf,edicel,eed,ellipsoid,especially,exserted,fine,flat,free,glabrate,know,later,lateral,less,lobe,lon,long,lower,main,margin,middle,midrib,minute,near,nearly,nflorescence,older,overlappin,pair,papillat,papillose,planar,poricidal,portion,reddish-brow,rounded,ruit,scar,slender,soon,spaced,stem,straight,strongly,tall,tip,trichome,tub,ud,unifoliat,unit,vein,wide,widest,ympodial,young	abaxial,colour,diameter,form,fruit,growth,hair,height,inflorescence,length,papillate,plant,position,pubescence,seed,shape,texture,width
395	wfo-0001030486	success	141	107	86	55	21	0.61	.5,0.8-2.2,1-1.5,1-5,1.1-1.4,1.5-2,1/2,1/4,10-14.5,2-3,2-5.5,3-3.5,3/4,4-4.5,4-6.5,4.5-5,6-7,acute,anther,anthesi,apex,bark,basal,base,calyx,clavate,closely,clustered,cm,conical,corolla,deflexed,dia,difoliate,distal,ellipsoid,elliptic,f,filament,fleshy,fruiting,glabrous,globose,green,internodal,later,leaf,lobed,long,minor,minutely,mm,older,opposite,ovary,overlapping,ovoid-reniform,pale,papillose,pedicel,petiole,pitted,pore,scar,shaped,shrub,size,slightly,small,spaced,stem,stigma,style,surface,tapering,tear-drop,treelet,tube,unit,usually,way,white,woody,x,yellow-green,young	1.7-2,10-12,3-5,5-8-flowered,abaxially,adaxially,ba,beneath,berry,brown,completely,dark,deltate,differing,dry,drying,eaf,edicel,eed,erect,exserted,free,fresh,geminat,inflorescenc,lateral,lobe,lon,lower,m.,main,major,margin,material,middle,nflorescence,pair,papillo,planar,poricidal,portion,reddish,ruit,shin,simple,stout,tall,tan,thickened,tip,tub,ud,vein,widest,ympodial	5-8,bud,colour,exsertion,flower,form,fruit,geminate,growth,height,inflorescence,length,number,plant,position,seed,shape,shiny,structure,sympodial,texture
396	wfo-0001030489	success	196	153	131	65	22	0.668	-6.5,.5-2.8,0.25-0.4,0.5-3,0.75-0.9,0.9-1.1,1-3,1.2-1.6,1.6-2.1,1/3-1/2,100,2.1-2.9,3-6,3-8,4-8,4.5-9,5,5-6,7-15,abaxially,abruptly,adaxially,anther,apart,apex,apical-lateral,apparently,appressed,appressed-pubescent,attenuate,axe,bark,base,berry,blunt-tipped,branch,branched,broadly,brown,bud,calyx,chartaceous,cinereous,cm,conical,corolla,cylindrical,deltoid,densely,diameter,dichotomously,echinoid,elliptic,elongate,entire,filament,fleshy,flower,fruit,glabrate,glabrous,globose,greenish,growth,hair,high,honeycombed,introrse,large,lateral,leaf,length,long-acuminate,longitudinal,main,margin,midvein,minute,minutely,mm,mostly,multangulate,narrowly,oblong,obtuse,ovate-lanceolate,pale,pedicel,peduncle,perfect,petiole,pore,porrect-stellate,probably,puberulent,pubescent,pulverulent,rachi,reniform,reticulate-punctate,ripe,sessile,short,short-stalked,shrub,side,simple,slit,small,smooth,somewhat,sparse,stellate-pubescent,stellate-rotate,stigma,style,subcampanulate,subglobose,suborbicular,testa,tomentose,tree,turn,unarmed,vein,way,white,x,yellow,yellowish,young	.5-3,.75-5.25,0.6-0.9,1-1.3,1-3.75,1.1-1.3,1.2-1.5,1.7-2,1.75-2,1.9-2.6,1/5-1/2,12-24,6-8,absen,acuminate,acute,adaxiall,ag,anthesi,articulated,axillary,ba,becoming,blade,closely,continued,dehiscing,due,eaf,echinoi,eed,free,inserted,lobe,lobed,long,long-exserted,lower,nflorescence,older,orolla,ovate,plurifoliate,pseudo-terminal,pulverulen,ruit,runk,several,slender,spaced,sparingly,stem,subcapitat,tamen,terete,thick,time,toward,tube,unarme,unit,usually,vary,wide,ympodial	age,arming,arrangement,branching,colour,dehiscence,form,height,inflorescence,lobing,ovary,plant,seed,shape,spacing,sparing,staman,subcapitate,texture,thicknes,trunk,type
397	wfo-0001030509	success	220	112	93	127	19	0.423	-6,0-100,0-5,0.3-2.5,0.5-1.5,0.8-1.2,0.8-4,1-1.5,1-2,1-4,1.3-2,2-2.5,2-3,2-4.2,2-4.5,2-6,2.8-3,2/3-3/4,4.5-8,5-merous,8-16,andromonoecious,anther,bark,base,becoming,berry,calyx,chartaceous,cm,connivent,densely,diameter,discolorous,drying,entire,equal,erect,filament,flower,fruit,fruiting,glabrescent,gray,half,herb,herbaceous,heterostylous,inflated,lateral,leaf,length,lobed,long,maturity,mauve,mm,moderately,orange,orange-brown,ovate,pedicel,peduncle,per,petiole,plant,poricidal,porrect,prickle,prickly,purple,shrub,simple,sparsely,spherical,stalked,stellate,stellate-pubescent,stem,style,surface,tapering,terminal,tip,trichome,tube,unarmed,upper,variously,way,wide,woody,yellow	-10,-2,/3,0,0-0.3,0-15,0-3,0.1,0.1-0.2,0.1-0.25,0.1-0.3,0.2,0.6-1,1,1-3,1-6,1.5-2,1.7-2,1/,1/3-2/3,1/4,3-10,3-4,4.5-10,4.5-12,5-10,7-15,7-9,abaxially,alyx,apar,apart,apex,apical,apically,apparently,articulated,blade,broad-deltate,brow,cordate,cream,cuneate,curved,dark,difoliate,distal,distance,eaf,eed,elongating,extending,eye,flattened-reniform,free,geminat,glabrous,gland,globular,green,hermaphrodite,infructescence,lobe,long-acuminat,long-styled,longer,lower,lowermost,margin,marking,mature,midpoint,midvein,naked,narrow-deltate,narrow-oblong,nflorescence,obtuse,occasional,occasionally,often,older,one,open,orolla,oung,pair,pale,pendulous,pericarp,perpendicular,portion,primary,ray,reduced,rounded,ruit,scar,short-styled,shorte,shorter,side,slender,smooth,sometimes,spaced,spreading,stalk,staminat,straight,subsessile,tamen,terete,tertiary,time,unarme,unbranched,unit,usually,vary,vein,venation,visible,weakly,yellow-green,ympodial,young	brown,colour,corolla,form,growth,hair,height,inflorescence,number,ovary,position,presence,seed,shape,size,staman,texture,type,width
398	wfo-0001030516	invalid_json	172	146	103	69	43	0.599	0.4-1.5,1-4,1-7,1.1-4.1,1.5-2,1.8-2.4,2-12,2-3,2-4,3-8,4-22,4-6,4-7,4.2-10.7,6-15,8-9,9-22,9-32,acute,apical,apically,base,branched,calyx,cm,connate,corolla,cyme,darker,dehiscent,diameter,dichasial,dichasially,diminished,distal,dorsally,edge,exceeding,filament,flat,flower,folded,gland,globose,gradually,green,green-white,hair,hair-like,herbaceous,interjected,introrse,lateral,leaf,leaflet,light,lobe,long,long-attenuate,maturing,mm,monochasial,mucilaginous,odd-pinnate,often,outline,ovoid,pedicel,peduncle,pentagonal,perennial,perfect,petiole,pilose,plant,poricidally,proximal,puberulent,pubescent,rotate,seed,short,short-stalked,size,slightly,slit,sometimes,spreading,stamen,straight,stripe,style,terminal,throughout,toward,triangular,tuber-bearing,type,unit,wall,wide,yellow,Â¼	1-2.5,1.1-3.5,1.7,2-2.,3-6,3-6-foliat,3-9.8,4-4,abaxially,acumen,acuminate,adaxially,apex,articulate,cell,cordate,covered,covering,cuneate,decurrent,densely,digestion,eaf,ebracteate,eed,elliptical,emoval,enzyme,first,forked,generally,globo,half,honeycomb,less,living,lon,longer,lower,lunat,make,nflorescence,nther,oblique,orolla,ovate,pair,pattern,plan,rarely,reveal,ruit,second,sessile,seudostipule,short-petiolate,specimen,stigma,tal,tem,testal,thick,time,triangulat,typically,vary,whit,ympodial,â	'','type,2-21,3-6-foliate,[,],``,anther,arrangement,articulation,bract,branching,characteristic,colour,connection,dehiscence,direction,ebbrate,fork,form,fruit,growth,height,inflorescence,length,lunate,number,ovary,perfection,presence,present,property,pseudostipule,shape,stem,structure,sympodial,texture,value,white,width,{,}
399	wfo-0001030551	success	167	106	88	79	18	0.527	-30,0-2,1-10,1-2,1-3.5,1-4,1-5,10-20,2,20-25,3-12,4-5,5-6,abaxially,abruptly,absent,acute,adaxially,adpressed,also,apex,basal,base,blue,broad,campanulate,cell,chartaceous,cm,connective,cordate,densely,directed,distally,ellipsoidal,entire,et,exceeding,fading,fruit,globose,hair,lanceolate,laterally,leaving,lobe,long,margin,martinelli,mm,moderately,narrowed,oblong-fusiform,obtuse,often,ovate,ovate-elliptic,ovoid,pedicel,pedicellar,peduncle,petiole,pore,puberulent,puberulent-pubescent,pubescent-pilose,rachi,remnant,ripe,round,seen,shorter,shrub,simple,slightly,small,sparsely,stellate,stone,style,subcoriaceous,thecae,truncate,unbranched,unknown,violet,x,yellowish	-12,-5,0.5-1,0.6-1.5,1,1-,1-2.5,1.5-,1.5-2.5,10-40,13.,2-3,2-6,2.5-4,2.5-5,3-,3-5,3-8,4-,4-7,4-foliat,5-17,9-20,acuminate,aggregate,apart,ape,articulated,axe,beyond,bilobe,blade,calyx,clavate,color,concave,dia,diameter,dilated,eaf,ed,equal,exserted,fleshy,flower,glabrous,glandular-puberulent,lon,lower,narrow,narrowly,nflorescence,nther,orolla,papillose,perfect,pilose,puberulen,pubescent-pilo,radiu,ruit,spaced,stamen,stigma,tal,tem,time,tip,tomento,triangular,triangular-elliptic,tube,ud,unit,unknow,vary,wide,widening,ympodial	138,anther,articulation,bud,colour,corolla,form,growth,height,inflorescence,leaf,length,plant,position,seed,shape,texture,type
400	wfo-0001030570	success	173	118	91	82	27	0.526	0.3-0.5,0.5-1,1-1.5,1-2,1-3,1-8,1.5,2-3,2-7-lobed,2-8,3-6,3.5-5,4-5,abaxially,acuminate,acute,apex,articulated,basal,base,calyx,campanulate,cm,connective,connivent,cordate,cylindrical,diameter,dilated,directed,distally,eglandular,ellipsoidal,elliptic-oblong,entire,exceeding,flattened,forked,fruit,glabrous,glandular-puberulent,globose,green,hair,lanceolate,leaf,leaving,lobe,lobed,long,margin,mm,narrowly,near,obtuse,occasionally,ovate,ovoid,pedicel,pedicellar,petiole,pilose,pinnately,pore,pubescent,purplish,radiu,rarely,remnant,rounded,rugose,shorter,simple,slightly,sometimes,sparsely,stellate,stigma,style,submarginally,thecae,tree,triangular,truncate,unbranched,unit,unknown,unlobed,white,x,yellow	-1,.3-0.5,0-,0.5-,1,1-,1-4,1-5,1.5-2.5,1/2,10-17,10-25,15-20,15-35,2-2.5,2-4,2-5,2-7,2.5-22,20-30,3-10,3-5,4-25,4-7,4-foliat,4/5,5-,8-,absent,adaxially,aggregate,apart,ape,apiculate,axe,beyond,blade,cell,color,divided,eaf,eed,exserted,fleshy,flower,glabrat,lon,lower,midrib,nflorescence,nther,often,orolla,peduncle,perfect,pilo,presen,punctate,purpl,rachi,ripe,ruit,sinus,small,somewhat,spaced,stamen,stone,subcoriaceous,tal,tem,time,tip,tomento,truncat,tube,ud,unequal,vary,vein,wide,ympodial	4-foliate,abaxial,adaxial,anther,articulation,bract,branching,bud,colour,corolla,form,growth,height,inflorescence,length,na,ovary,plant,position,seed,shape,stem,structure,symmetry,sympodial,texture,type
401	wfo-0001030581	success	187	149	112	75	37	0.599	.5,1,1-4-celled,2,abaxial,acute,adaxial,adaxially,aggregate,along,angle,angled,anther,anthesi,appressed,articulated,basal,base,berry,black,bright,calyx,capitate,cell,central,clustered,cm,conical,corolla,decurrent,densely,denser,diameter,ellipsoid,elliptic,entire,filament,flattened-reniform,fruit,fruiting,glabrous,globose,green,growth,herb,inflorescence,intermodal,lacking,later,lateral,leaf,less,like,live,lobe,long,margin,markedly,maturity,minutely,mm,near,new,occasionally,often,once-branched,outline,ovary,ovate,pedicel,peduncle,pentagonal,per,petiole,pitted,plant,portion,pubescent,purplish,rachi,reflexed,ridge,ripe,scar,shallow,shiny,simple,somewhat,sparsely,spreading,stellate,stem,stigma,stone,strongly,style,surface,tangled,terete,testal,third,translucent,trichome,tube,turning,uniseriate,upper,vein,white,woody,yellow,yellowish	.3,0.2â0.8,0.4â0.6,0.4â1.6,0.5,0.5â0.7,0.5â2.5,0.6â0.7,0.7â0.8,0.9â1,1.2â1.5,1.8â8,1â2,1â2-celled,1â2.5,1â4-celled,20â50,2â3-celled,35â45,3â4,3â5,4.5â12,4â7,4â9,5-merous,5â6,5â8,9,abaxially,apar,apex,becoming,beyond,branched,cone,difoliate,drop,eaf,eed,exserted,florescence,flower,free,geminat,halfway,individual,leave,lobed,lon,lower,minute,narrowly,pair,papillate,perfect,primary,reflexe,remaining,rounded,ruit,shorter,slightly,spaced,sprawlin,straight,tall,tem,ud,unit,usually,wide,winged,ympodial,â15,â5	0.2-0.8,0.3,0.4-0.6,0.4-1.6,0.5-2.5,0.6-0.7,0.7-0.8,0.9-1,1-2.5,1.2-1.5,1.8-8,15,2-3-celled,20-50,3-4,35-45,4-7,4-9,4.5-12,5,apart,articulation,branching,bud,colour,form,hair,height,length,number,position,present,seed,shape,spacing,type,width
402	wfo-0001030583	success	166	106	95	71	11	0.572	.5,0.2-1,0.3-1,0.4-2.7,0.5-1,0.8-1,0.9-3.5,1-1.5,1-8,1/2,2.5-3,3-4,3/4,5-6,abaxially,acute,adaxially,along,anther,apex,base,calyx,cell,closely,cm,conical,corky,corolla,cultivated,dark,deep,dendritic,densely,dia,elliptic,especially,filament,flattened-reniform,flower,form,fruit,fruiting,glabrous,globose,green,immature,incrassate,leaf,live,lobe,lobed,long,long-rectangular,long-triangular,margin,midvein,minor,minutely,mm,narrowly,occasionally,opposite,orange-red,outline,ovary,overlapping,pedicel,petiole,pitted,plant,pore,pubescent,ripe,rounded,scar,shaped,shrub,simple,size,small-capitate,spaced,spathulate,stem,stigma,style,surface,tear-drop,testal,trichome,tube,uniseriate,way,white,x,yellow	.2,0.1-0.5,0.7-4.5,1,1-2,1.5-4,2.5,2.5-9,4-6,5-7,6-7,abaxial,anthesi,ba,bark,berry,brow,crisped,cultivar,deflexed,differing,difoliate,dry,eaf,edicel,eed,ellipsoid,enlarged,erect,free,frui,geminat,golden,included,irregular,lateral,leave,like,lon,lower,main,major,nflorescence,often,older,pair,pale,papery,papillo,papillose,pericarp,planar,poricidal,portion,prostrate,rest,ruit,small,soon,specimen,stout,tall,tan,thin,tip,ud,unit,vein,woody,ympodial,young	0.1-1,colour,growth,hair,height,inflorescence,length,number,position,seed,shape
403	wfo-0001030605	success	144	136	113	31	23	0.785	.4,.5,0.1,0.3-0.5,1,1-4,1/3-1/2,12-19-flowered,2,2-3,2.5,7,abaxially,acute,adaxially,almost,anther,anthesi,apart,apex,apical,area,attenuate,base,beginning,branch,branched,brown,calyx,cinereous,cm,commonly,conical,coriaceous,corolla,covered,cylindrical,dark,dendritic-echinoid,densely,dia,difoliate,dry,ellipsoid,exerted,filament,fruiting,glabrate,glabrous,globose,gold,green,growth,inflorescence,internodal,leaf,less,light,lobe,lobed,long,margin,material,minutely,mm,nearly,new,obovate,obtuse,occasionally,olive,opposite,otherwise,ovary,ovate,overlapping,ovoid-reniform,papillate,pedicel,peduncle,petiole,pitted,pore,pubescent,rarely,reflexed,revolute,rounded,scar,scattered,shaped,shiny,shrub,simple,slender,slightly,smooth,soon,sparsely,stigma,style,surface,tear-drop,thickened,tinged,tip,trichome,tube,unifoliate,way,white,woody,x	1.5-2,1.5-5.5,1.7,5-12.5,along,ape,beneath,berry,deflexed,drying,eaf,edicel,eed,entire,free,geminat,inflorescenc,lower,midrib,nflorescence,papillosefruit,poricidal,portion,somewhat,sparesly,tub,ud,unit,vein,yellow,ympodial	arrangement,branching,bud,colour,density,diameter,distance,entirely,exertion,flower,form,fruit,geminate,length,number,papillose,position,seed,shape,size,texture,type,ye
404	wfo-0001030624	success	170	125	103	67	22	0.606	.5,0.5,0.5-1.5,0.9-1,1-3,1.2-1.8,1.2-2,1.5-2,2-10,2-3,25-40-flowered,3-3.5,3.5-4,4.5-8,anther,anthesi,apart,attenuate,axil,bark,base,beginning,branch,calyx,clavate,cm,corolla,decurrent,difoliate,distal,dry,ellipsoid,elliptic,end,except,exserted,extreme,falcate,filament,flattened-reniform,fruiting,glabrate,glabrous,glandular,globose,green,greyish,hyaline,incrassate,large,later,lateral,leaf,lobed,longitudinally,main,margin,material,minor,minutely,mm,narrowly,near,nearly,older,opposite,outer,ovary,papillose,pedicel,petiole,pitted,planar,pore,puberulent,round,scar,shining,short,shrub,size,slightly,small,soon,stem,stigma,style,surface,tip,tree,trichome,trunk,tube,tuft,uniseriate,unit,vein,white,x,yellowish,yellowish-green,yellowish-grey,young	.25,0.5-1,2,2.5-5.5,3,6-13,7-9,acute,apex,apiculate,appearing,ba,berry,caly,cell,deflexed,dia,differing,dimorphic,eaf,edicel,eed,erect,expanded,free,furcate,geminat,inflorescenc,like,lobe,lon,long,lower,major,middle,midrib,nflorescence,occasionally,one,pair,pale,poricidal,portion,prominent,raised,remaining,rugo,ruit,simple,slender,somewhat,spaced,square,straight,tall,tapering,thickened,three,ti,two,ud,unevenly,wall,widest,woody,yellow,ympodial	bud,colour,diameter,exsertion,flower,form,fruit,geminate,growth,height,inflorescence,length,number,plant,position,rugose,seed,shape,spacing,structure,sympodial,texture
405	wfo-0001030638	success	177	89	75	102	14	0.424	0.5-1,0.5-1.5,0.7-1.5,1-1.2,1-1.5,1-2,1.4-1.7,1.5-2,1.6-2.2,2-3,2-5,2-7-flowered,2.5-4,3-10,3-13,4-6,8,8-11,8-9,acute,anther,apex,apically,base,broadly,bud,calyx,cm,corolla,cup-shaped,deflexed,elliptic,filament,flattened,fruit,fruiting,geminate,glabrous,glandular,globose,green,inflorescence,large,later,leaf,lobed,minor,mm,nearly,obovate,opposite,ovary,pair,papillose,pedicel,petiole,poricidal,red,red-glandular,seed,shape,shrub,size,stigma,style,tapering,terminal,thickening,tip,tree,tube,vein,white,x,young	0.1,0.5,0.5-0.7,0.5-2,along,anthesi,appear,appearing,axi,axil,ba,bark,beginning,beneath,berry,blade,branched,closely,conspicuously,corky,cucullate,deltoid,densely,dia,differing,difoliate,dry,eaf,eed,entire,erect,exfoliating,extending,fleshy,free,geminat,glabrate,gre,impressed,irregular,known,lamina,lateral,less,like,lobe,lon,long,lower,main,major,margin,material,middle,minutely,near,nflorescence,occasionally,often,older,one,open,overlapping,ovoi,pale,paler,papillae,papillo,persistent,planar,pore,portion,present,prominent,rather,reddish,rest,roundish,rugose,ruit,scar,shaped,simple,soon,spaced,speciman,stem,straight,surface,tall,tear-drop,thick,thickened,transversely,trichome,uniseriate,unit,usually,wall,widest,woody,ympodial	2,colour,diameter,flower,form,growth,hair,height,length,plant,position,symmetry,texture,width
406	wfo-0001030661	success	183	123	102	81	21	0.557	.5,0,0.5-0.6,0.5-0.75,0.5-2,0.7-0.8,1-1.2,1-1.5,1.5-2,1.5-7,4-15,5-10,5-5.5,acute,anther,apex,articulated,attenuate,base,berry,branch,branched,brown,capitate,cell,clustered,cm,corolla,densely,diameter,ellipsoid,elliptic,entire,filament,flattened,flower,fruiting,glabrous,globose,group,growth,inflorescence,lateral,leaf,lengthening,lobed,lower,many,margin,mature,membranous,minute,minutely,mm,narrowly,occasionally,otherwise,pale,pedicel,peduncle,per,perfect,petiole,pitted,platform,pore,poricidal,pubescent,rectangular,red,reddish,reniform,scar,shrub,simple,sleeve,slit,small,sparsely,stellate,stem,stigma,style,surface,terminal,testal,time,tinged,tip,tree,trichome,tube,uniseriate,upper,usually,violet,way,white,x,yellowish,Â½,Â¾	-24,.2,1-,1-.,1-1.3,1-1.4,1.2-7,12-16,2-,2-2.5,3-20,3-3.5,3-4,4-6,5-merou,50-100+,ag,along,alyx,anthesi,ark,brow,calyx,conical,connivent,dar,deltate,denser,drying,eaf,eed,em,erec,erect,exserted,extending,free,glabrescent,glabrou,ilament,insertion,lamina,lobe,lon,long,loosely,midrib,near,never,new,nflorescence,nodding,older,onto,orolla,pair,papillo,pericarp,planar,plurifoliat,point,portion,primary,ruit,scattered,shiny,slender,slightly,spreading,strongly,tangled,thin,twinin,ud,unit,vary,vein,winged,woody,yellow,ympodial	1-5,5-merous,age,articulation,bark,branching,bud,colour,form,fruit,height,length,number,ovary,papillose,plant,position,seed,shape,texture,type
407	wfo-0001030676	success	220	147	128	92	19	0.582	-3.9,0.4,1,1-1.2,1-3,1.1-1.4,1.3-1.5,11-14,14-17,16,2.2-5.7,3-5,3-6,4-6,7-10,7-8,8-10,abaxially,abruptly,adaxially,angled,anther,anthesi,apart,apex,apical-lateral,appressed-tomentose,bark,base,berry,blunt-tipped,branch,branched,brown,bud,calyx,chartaceous,cm,conical,corolla,crown,cylindrical,deltoid,densely,diameter,dichotomously,echinoid,elongate,entire,exserted,filament,finely,flat-topped,fleshy,flower,fruit,glabrescent,glabrous,globose,granular-tomentose,green,greenish,grooved,growth,hair,honeycombed,initially,introrse,large,leaf,length,lengthen,lined,longitudinal,longitudinally,margin,minutely,mm,moderately,mostly,multangulate,nearly,oblique,oblong,oblong-elliptic,obtuse,often,opening,openly,pedicel,peduncle,petiole,pore,probably,pubescent,rachi,reniform,reticulate-punctate,ridged,ripe,scabrous,scattered,sessile,short-attenuate,short-stalked,shrub,simple,slit,small,somewhat,spreading,stellate,stellate-pubescent,stigma,strongly,style,subglobose,suborbicular,terete,testa,tomentose,tube,velutinous,white,whitish,x,yellow,yellowish	-1.6,-2.5,-8.5,/10-1/5,0-100,0.6-1.2,1.1-1.9,1.2-1.3,1.7-2,1/4,19-35,2.1-2.3,2.1-2.6,2.4-3.1,2.5-5.5,2.75-3.25,3-3.5,4-6.5,7-9,8-12,acute,along,apparently,appearing,articulated,axillary,ba,becoming,blade,closely,continued,dehiscing,due,eaf,echinoi,eed,except,forming,free,glabrescen,high,horizontal,inserted,lackin,lamina,lateral,lobe,lobed,long,lower,main,midvei,midvein,minute,nflorescence,occasional,older,orolla,ovate,ovate-lanceolate,parallel,perfect,plurifoliate,pseudo-terminal,pulverulent,rather,ray,ruit,runk,side,spaced,sparsely,stem,subcampanulate,subcapitat,tamen,tending,thick,thin,time,tip,tree,tuft,unarme,unit,usually,vary,vein,way,wide,ympodial,young	articulation,branching,colour,dehiscence,form,height,inflorescence,insertion,ovary,plant,seed,shape,spacing,staman,subcapitate,texture,thicknes,trunk,type
408	wfo-0001030686	invalid_json	182	154	127	55	27	0.698	.5,.5-1,0.5-1,1-1.1,1-1.2,1-2,1.2-1.5,1.5-2,1.5-4.5,1.6-3,15,1972,2-2.5,2-3,2-6.5,2.5-4,2.5-8,3-3.5,5-12,5-6,?,abaxially,aborted,abruptly,acuminate,acute,adam,age,anther,anthesi,apart,apex,bark,basal,base,berry,bifid,black,branched,brittle,brown,c.,calyx,centre,cm,conical,corolla,dark,darker,deeply,densely,denser,diameter,different,dry,drying,elliptic,empty,entire,exerted,fide,filament,flattened,form,fragrant,fruit,fruiting,glabrous,globose,golden,half,leaf,lengthening,lepidote,lilac,lobe,long,many,margin,maturity,midrib,minutely,mm,oblique,orange,ovary,pale,paler,papillae,papillose,pedicel,peduncle,pericarp,petiole,pitted,plant,pore,poricidal,pubescent,purple,scar,seed,shallow,shallowly,shiny,simple,slit,sparsely,spreading,stellate,stem,stigma,strongly,style,surface,thin,time,tip,tree,trichome,tube,uniformly,usually,way,x,yellow,â	.2,1-1.5,5-25,5-30,8-9,adaxially,beneath,breast,bu,closely,cup-shaped,difoliate,discolorous,eaf,edicel,eed,erect,flower,free,geminat,glabrescen,height,heteromorphic,internodal,lamina,leaf-opposed,less,lobed,lower,midvein,nflorescence,noddin,older,overlapping,pair,planar,portion,primary,pubescen,rachi,ruit,scarious,short,slightly,somewhat,space,spaced,styl,tissue,ud,unit,vein,visible,woody,ympodial	'',0.5,[,``,arrangement,branching,bud,characteristic,colour,density,fragrance,glabrescent,growth,heteromorphism,inflorescence,length,lobing,position,pubescence,shape,size,spacing,texture,thicknes,value,{,}
409	wfo-0001030709	success	217	138	115	102	23	0.53	-9,0-,0-20,0-30,0.1-0.2,0.2-0.5,0.3-1.5,0.4,0.7-1,1-1.2,1-1.6,1-4.5,1.3-1.4,1.6-2.1,1.9-2.8,1/4,10-14,10-50,2-6,2-8,2.3-3,4-5-merous,5-10,5-20,5-6,6-21,6-7,8-11,8-15,abaxially,acuminate,acute,almost,ame,anther,apex,articulated,base,berry,branched,bright,c.,calyx,chartaceous,cm,conical,connivent,cordate,diameter,dull,elliptic,elongating,equal,erect,flattened-reniform,flower,fruit,fruiting,inflorescence,lateral,leaf,length,lobe,lobed,long,margin,maturity,mauve,midpoint,mm,moderately,occasionally,orange-brown,pedicel,peduncle,per,perfect,perpendicular,petiole,poricidal,porrect,prickle,purple,ray,red-green,red-orange,seed,short-styled,shrub,simple,size,slender,sparsely,spherical,stalk,stalked,stellate,stellate-pubescent,stem,straight,style,surface,tapering,terminal,tip,trichome,truncate,unarmed,upper,usually,variously,venation,wide,yellow,yellow-green	-2,-5,0,0.15-0.5,0.8-4,0.9-1.5,1-6,1.4-2,1/2-2/3,1/3-1/2,1/4-1/3,2-4,2-5,2/3-3/4,3-,5-7,5-9,6-10,6-8,7-8,7-9,adaxially,alyx,apar,apart,ape,apically,apparently,bark,blade,broad-deltate,brow,cuspidate,deltate,discolorous,distance,drying,eaf,edge,eed,extending,filament,finely,free,glabrescent,glabrous,increasing,infructescence,lanceolate,lengt,lobing,lon,long-acuminat,longer,lower,mature,middle,midvein,narrow-deltate,nflorescence,often,older,one,open,orolla,oung,pair,pendulous,pericarp,pit,pitted,plurifoliat,portion,prickl,prickly,primary,reflexed,retrorse,rounded,ruit,scar,secondary,shorter,side,smooth,sometimes,spaced,spreading,tamen,terete,tertiary,time,toward,tube,unit,vary,vein,visible,way,weakly,woody,ympodial	articulation,branching,colour,corolla,form,growth,hair,height,heteromorphism,na,number,ovary,plant,position,presence,present,shape,staman,symmetry,texture,type,width,young
410	wfo-0001030714	success	178	130	115	63	15	0.646	-3,.2,.5,/3,0.1-0.3,0.5,0.5-0.8,0.5-1.9,0.7-0.8,1-1.2,1-1.3,1-2.5,1.2-1.5,1.2-4,1/3,2-2.5,20,3-3.5,>,abaxial,acuminate,acute,adaxially,age,along,anther,apex,bark,basal,base,becoming,beneath,berry,blue,blue-black,branching,calyx,clavate,cm,conical,cordate,corolla,dark,densely,diameter,ellipsoid,elliptic,entire,especially,except,filament,flattened,fruit,glabrous,globose,greyish,growth,leaving,lengthening,liana,lobe,lobed,long,many,margin,membranous,midrib,minute,minutely,mm,narrowly,new,ob-ellipsoid,ob-elliptic,oblique,ovary,pale,paler,papillate,pedicel,peduncle,peg,per,petiole,pitted,pore,poricidal,pubescent,quadrate,reniform,ripe,scar,shape,simple,slightly,slit,spaced,sparsely,stellate,stem,stigma,style,surface,time,tip,trichome,truncate,uniseriate,vein,vine,violet,way,widely,x,yellow	0.3-0.4,0.8-1,1-1.5,1.4-3.5,1.5-2,2-2.6,3-7,5-100,5-6,7-17,abaxially,aid,anthesi,apar,articulating,campanulate,climbin,cup,denser,eaf,eed,exserted,fide,flower,free,grading,gradually,gree,herbaceous,howard,joined,leaf-opposed,like,lower,narrow,nflorescence,nodding,node,occasionally,older,overall,pair,papillat,pedice,perfect,planar,plurifoliat,portion,primary,prominent,ruit,strongly,submarginal,tapering,terminal,thickened,tub,tube,twining,ud,unit,woody,ympodial	apart,arrangement,articulation,bud,colour,form,green,hair,inflorescence,leaf,length,number,seed,size,texture
411	wfo-0001030733	success	130	104	79	51	25	0.608	.5,/4,0.5-1,1-1.2,1-1.5,1-2,1.7-2.7,2-2.5,3-4,3-5,4.5-5,6-7,6-9,abaxially,adaxially,anther,apex,base,bi-lobed,broadly,brown,calyx,capitate,clearly,closely,cm,conical,corolla,dark,densely,ellipsoid,elliptic,embryo,exserted,filament,fruiting,glabrous,globose,green,later,lateral,leaf,middle,minutely,mm,moderately,narrowly,opposite,ovary,ovoid-reniform,pair,pedicel,petiole,pore,pubescent,scar,shaped,shrub,simple,smooth,spaced,stem,stigma,strongly,style,surface,tear-drop,testa,treelet,trichome,tube,uniseriate,vein,visible,way,white,widest,x,young	1.5-5,4-15,5-8-flowered,?,acuminate,acute,along,anthesi,ape,bark,berry,coriaceous,decurrent,deltate,denser,dia,eaf,eed,elongate,erect,free,grayish-brow,lamina,like,lobe,lobed,lon,long,lower,main,margin,nflorescence,older,onto,overlappin,papillo,planar,poricidal,portion,rounded,ruit,somewhat,sparsely,tall,thick,tip,ud,unifoliat,unit,woody,ympodial	5-8,bud,colour,diameter,exsertion,flower,form,fruit,growth,height,inflorescence,length,lobing,number,overlapping,papillose,part,plant,position,seed,shape,spacing,texture,type,visibility
412	wfo-0001030772	success	155	130	111	44	19	0.716	-2,.05,.2,.25,.5,0.2-0.8,0.25-0.5,0.5-1,0.75-1,0.9-1,0.9-3.1,1-2,1-2.5,1.2-5,1.4-1.6,1.5-2,2-7,3-3.5,3-5,4.2-6.5,5-10-flowered,8-10,9-15,acuminate,acute,anther,anthesi,apex,attenuate,bark,base,becoming,beneath,bud,calyx,capitate,closely,cm,corolla,dark,deflexed,dia,ellipsoid,elliptic,extreme,filament,fruit,fruiting,gently,glabrous,globose,green,grey,later,lateral,leaf,lenticellate,lobe,lobed,long,long-acuminate,main,methyl,minor,minutely,mm,nearly,node,occasionally,opposite,ovary,overlapping,ovoid-reniform,pair,pale,paler,papillose,pedicel,per,petiole,pitted,pore,ripe,rounded,salicylate,scar,shape,shaped,shining,shrub,size,slender,slightly,spaced,stem,stigma,strongly,style,surface,swollen,tapering,tear-drop,tip,trichome,tube,uniseriate,vein,white,wintergreen,x,young	5-6,archin,ba,beginning,berry,branch,differing,difoliate,eaf,edicel,eed,erect,free,geminat,impressed,inflorescenc,large,lon,long-triangular,lower,major,margin,middle,nflorescence,older,one,papillo,poricidal,portion,prominent,reflexed,ruit,simple,smelling,soon,straight,tall,tan,ud,unit,usually,widest,woody,ympodial	arching,branching,colour,diameter,flower,form,growth,height,inflorescence,length,number,odour,pattern,plant,position,seed,spacing,texture,venation
413	wfo-0001030781	invalid_json	213	160	128	85	32	0.601	0-5,1-10,1-12,1-2,1.5-2,1.5-9,1.6-2.2,10-40,15-35,2-20,2.5-14,2.5-3.5,3-4,4-15,5-6,5-7,6-7,7.5-9,abaxially,adaxially,along,anther,apart,borne,broadly,brown,brownish,cell,chartaceous,cm,condition,corolla,covering,dark,deep,densely,diameter,distal,dot,drying,elliptic,end,especially,filament,finely,flower,forked,fresh,fruit,generally,glabrous,glandular,globose,gray-green,green,green-white,greenish,hair,hair-like,half,herb,homostylous,lanceolate,lateral,leaf,leaflet,lengthening,light,like,lobe,long,make,membranous,midrib,minutely,mm,mucilaginous,obovate,odd-pinnate,ovate,ovate-lanceolate,ovoid,pair,papillose,pedicel,peduncle,pentagonal,pilose,plant,pore,poricidal,puberulent,pubescent,purple,rarely,rotate-pentagonal,scattered,seed,simple,singly,size,slit,small,sometimes,somewhat,sparsely,stem,stigma,straight,style,subovoid,terminal,testal,thick,throughout,tip,tube,tuber,typically,unwinged,usually,violet,wall,wet,white,whitish,wide,x	0.2-4,0.5-6,0.5-8,1-1.5,1-4,1-8,1.5-12,2-3,3-6,5-8,5-merou,abruptly,acumen,ag,alyx,apex,apiculate,apparently,articulated,axe,axillary,base,berry,blade,bud,caly,capitat,ciliate,connivent,cuneate,decreasing,decurrent,digestion,dorsally,eaf,edge,eed,enzyme,erect,exceeding,flat,folded,geminat,glabrou,gradually,high,honeycomb-shaped,interjected,larger,living,low-growin,lower,margin,narrowed,nflorescence,orbicular,orolla,perfect,petiole,petiolulate,plurifoliate,pointed,rachi,removed,rounded,ruit,sessile,seudostipule,short,slightly,spaced,specimen,stamen,ste,stolo,subtending,tall,tamen,tem,toward,tri-,unit,vary,yellow,ympodial	'',5-merous,[,``,abaxial,adaxial,age,arrangement,branching,calyx,capitate,characteristic,colour,form,growth,height,inflorescence,length,number,ovary,pilosity,presence,pseudostipule,shape,spacing,staman,stolon,texture,type,value,{,}
414	wfo-0001030782	success	198	123	102	96	21	0.515	0-7,0.4-1.5,1-2,1-3,1-6,1.3-1.6,1.5-2,1.6-4.6,11-47,12-30,15,2,2.2-4,3-10,4-11.6,4-6,4.6-26,5-20,6-8,7-15.6,abaxially,adaxially,anther,blade,broadly,brownish,cell,clavate,cm,condition,coriaceous,corolla,covering,dark,deep,diameter,drying,elliptic,filament,flower,forked,fresh,fruit,glabrescent,glabrous,globose,green,greenish,hair,hair-like,herb,homostylous,interjected,lanceolate,lateral,leaf,leaflet,light,lilac,lobe,long,make,medium,mm,moniliform,mottled,mucilaginous,odd-pinnate,ovate,ovoid,pair,pentagonal,petiole,plant,pore,poricidal,prominently,purple,rachi,ripe,rotate,scarce,seed,short,size,stigma,straight,style,terminal,testal,thick,tip,tube,tuber,usually,wall,wet,white,whitish,wide,winged,x	0-1,1-5,1.2-3.9,1.5-7.5,13-22,2-3,2.4-11.5,3-5,5-merou,abaxiall,acumen,acuminate,acute,ag,along,alyx,apart,apex,apparently,arranged,articulated,asymmetric,attenuate,axe,axillary,base,basiscopic,bead,berry,bud,capitat,connivent,cuneate,decreasing,digestion,distal,dorsally,eaf,edge,eed,enzyme,exceeding,flat,folded,geminat,generally,glabrou,green-white,hal,half,high,honeycomb-shaped,inconspicuous,lengthening,like,living,lower,multiple,necklace,nflorescence,orbicular,orolla,pedicel,peduncle,perfect,petiolulate,plurifoliate,removed,rounded,ruit,second,sessile,seudostipule,side,slit,smaller,sometimes,spaced,specimen,stamen,stolon,subequal,subtending,tal,tamen,tem,throughout,tissue,totally,toward,tri-,typically,unit,vary,yellow,ympodial	5-merous,abaxial,adaxial,arrangement,branching,calyx,capitate,colour,form,growth,height,inflorescence,length,number,ovary,pseudostipule,shape,staman,stem,texture,type
415	wfo-0001030802	success	171	101	81	90	20	0.474	.5,0,0.5-0.75,0.5-1,0.5-1.5,0.75-1,0.9-1,1,1-1.5,2-3,2.5-3,3-4,acuminate,acute,anther,apex,base,bud,calyx,campanulate,cm,cordate,corolla,deeply,deflexed,densely,dia,difoliate,exerted,filament,flattened-reniform,fruit,fruiting,glabrous,gland,glandular,globose,heart-shaped,incrassate,internodal,leaf,length,lobe,long,long-triangular,margin,markedly,minutely,mm,ovary,ovoid,pale,papillate,papillose,pedicel,per,persistently,petiole,pitted,plant,pore,pubescent,red,shaped,shrub,simple,single-celled,somewhat,stigma,style,subshrub,surface,tear-drop,trichome,tube,unifoliate,uniseriate,white,x,yellow,yellowish	.3,.5mm,0.25-0.4,0.7-1cm,1-1.1,1-1.2,2-2.5,2-5,3-3.5x,3-6,4-5mm,4-6,5-10-flowered,abaxially,abrupt,adaxially,along,anthesi,appearing,bark,basal,becoming,beginning,beneath,berry,brown,cucullate,denser,dry,eaf,edicel,eed,ellipsoid,evenly,except,exudate,filiform,free,geminat,glandurla,halfway,hanging,inflorescenc,invest,irregularly,lamina,later,lateral,line,live,lobed,lower,m.,main,material,midvein,near,nflorescence,obconic,older,pair,palmate,poricidal,portion,prominent,pubescen,raised,reddish,ruit,scar,slender,soon,spaced,specimen,stem,stigm,straight,strongly,tapering,tip,tipped,trichoem,ud,unit,variable,vein,widely,woody,ympodial,young	3-3.5,4-5,arrangement,branching,colour,deflexion,development,diameter,form,glandularity,growth,height,inflorescence,number,persistence,position,seed,shape,size,type
416	wfo-0001030809	success	154	81	59	95	22	0.383	0.5-1,1-1.25,1-1.5,1.2-1.4,1.4-1.5,1.5-3.5,2-2.5,4.5-5,6-8,8,acute,anther,apex,base,berry,branched,calyx,clavate,cm,corolla,curl-tipped,dia,elliptic,falcate,filament,fruit,fruiting,glabrous,globose,golden,known,large,leaf,lobed,mature,mm,nearly,opposite,ovary,ovate,pedicel,petiole,pore,pubescent,round,several,simple,size,small,stigma,style,terminal,time,tomentose,tree,trichome,tube,uniseriate,white	.5,0.2,1.5-2.4,2.3-5.5,20-60-flowered,5-8,9.9-12,across,along,also,anthesi,apar,appearing,bark,beneath,broadly,caly,campanulate,curved,dark-papillo,deciduous,deflexed,deltoid,dense,densely,difoliate,distally,eaf,edicel,eed,ellipsoid,erect,especially,evenly,exserted,free,geminat,green,hair,hidden,interpetalar,lateral,leave,like,lobe,lon,long,long-papillose,lower,main,major,markedly,membranous,middle,midrib,minor,minutely,nflorescence,older,one,overtopping,planar,poricidal,portion,present,ruit,scar,scattered,shinin,shining,shoot,sinus,slender,slightly,soon,spaced,stem,straight,tall,tapering,three,tip,triangular,two,ud,underside,unequal,unit,vein,wide,widest,x,yellow-brown,ympodial,young	1.5,2,2.5,20-60,branching,colour,dark-papillose,flower,form,growth,height,inflorescence,information,length,number,plant,position,seed,shape,texture,type,width
417	wfo-0001030810	success	191	107	67	124	40	0.351	0.2,0.3,5,abaxially,adaxially,anther,base,bipinnate,blue,brown,calyx,clavate,cm,colour,dark,densely,diameter,divided,elliptical,erect,filament,flattened,fleshy,flower,fruit,glabrous,globose,green,hair,leaf,long,margin,mm,moderately,multicellular,oblong,older,pair,pale,pedicel,peduncle,pentagonal,pinnae,pinnate,pitted,pore,primary,pubescent,shallowly,shaped,shrub,simple,size,stem,stigma,style,subglabrous,surface,tear-drop,time,tomentose,tube,unicellular,uniseriate,violet,woody,x	0.2â0.3,0.4,0.5â,0.5â0.8,0.6â1.0,0.7â1.4,0.8â5.5,0.95â2.0,0â,1,1.0â1.5,1.0â2.0,1.0â3.0,1.1â2.0,1.1â2.2,1.2â1.5,1.5â1.9,1â2,1â3,1â5,2.9â4.5,20â100,2â3,2â4,3.0â5.0,3.3â5.5,3.3â8.5,3.5â4.6,3â19,4â14,4â5,4â7,5â15,5â30,5â32,6â10,6â22,7â10,7â11,8â10,absen,accrescent,acute,adaxiall,ag,along,anthesi,apart,apex,articulated,axe,axillary,ba,blade,borne,branched,cell,chartaceous,connivent,cylindrical,decreasing,denser,eaf,eed,elliptic,equal,especially,geminat,greyish,half,hig,indumentum,irregular,leafy,lobe,lon,longitudinal,lower,m.,midrib,midvein,narrow,nflorescence,obtu,occasionally,opening,opposed,orolla,oung,perfect,petiole,plurifoliate,poricidal,rarely,reflexed,rounded,ruit,secondary,shiny,shoot,side,slit,sometimes,spaced,sparsely,stone,straight,tamen,tardily,tip,unit,unknown,vary,white,wide,wing,yellow,ympodial,â2.5,â3,â3.4,â4.5,â5.0,â8	0.2-0.3,0.6-1.0,0.8-5.5,1-2,1.0-1.5,1.0-2.0,1.1-2.2,1.2-1.5,1.5-1.9,2.5,2.9-4.5,20-100,3,3.3-5.5,3.3-8.5,3.5-4.6,4-14,4-5,4-7,5.0,6-22,7-10,8-10,arrangement,articulation,branching,corolla,form,growth,height,inflorescence,length,number,ovary,plant,seed,shape,staman,texture,young
418	wfo-0001030822	success	146	105	90	56	15	0.616	.2,0.1-0.2,0.4-1,0.5-1.5,1-1.2,1-1.5,11-15.5,2-2.5,2-3.8,2-5,3-3.5,3-5,3.5-7,5-6,5-7,8-9,abaxially,acute,adaxially,anther,apex,attenuate,base,calyx,clavate,closely,clustered,cm,corolla,decurrent,dia,elliptic-obovate,exserted,filament,flattened-reniform,flower,fruiting,glabrous,globose,green,incrassate,inflorescence,internodal,later,leaf,lobed,long,long-ellipsoid,major,margin,minor,minutely,mm,near,nearly,occasionally,older,opposite,ovary,pair,pale,papillose,pedicel,petiole,pitted,pore,red-papillose,revolute,scar,shaped,shiny,shrub,size,spaced,sparsely,stem,stigma,strongly,style,surface,tan,tear-drop,tip,tube,usually,vein,white,x,yellowish-brown,young	0-0.5,0.4,0.8-1,0.9-1,1.5-2,anthesi,ba,beneath,berry,broadly,completely,cucullat,cucullate,cup,deflexed,deltate,differing,difoliate,eaf,edicel,eed,erect,filiform,fleshy,free,geminat,inflorescenc,lateral,lobe,lon,lower,main,middle,minute,nflorescence,onto,open,papillo,perhaps,planar,poricidal,portion,present,ruit,simple,slightly,somewhat,tall,tapering,ud,unit,widest,winged,woody,yellowish,ympodial	bud,colour,diameter,exsertion,form,fruit,growth,hair,height,length,plant,position,seed,shape,texture
419	wfo-0001030871	success	248	113	95	153	18	0.383	0.3-4,0.4-1.8,0.7-1.3,1-1.3,1-18,1.3-2,1.5-6,1.8-2.6,2-8,2.8-4.5,3-32,3-4.4,3-6,3.5-14,30,5-33,5-7,6-40,abaxially,adaxially,anther,apical-lateral,bark,berry,blunt-tipped,branch,branched,brown,bud,calyx,campanulate,chartaceous,cm,corolla,dark,deltoid,dendritic-echinoid,diameter,echinoid,elliptic,extend,fleshy,flower,fruit,glabrescent,granular-tomentose,grayish,green,greenish,growth,hair,honeycombed,introrse,large,leaf,length,longitudinal,mm,mostly,multangulate,oblong,occasionally,ovate,pale,pedicel,peduncle,petiole,pore,porrect-stellate,probably,purple,rachi,reniform,reticulate-punctate,ripe,rotate-stellate,scabridulous,shrub,simple,slit,stellate-tomentose,stem,suborbicular,testa,time,tomentose,tree,unarmed,velutinous,violet,white,x,yellow,yellowish,young	.2-3,.8-3.5,.9-1.2,/30-1/5,0-120,0.2-0.4,0.6-1.5,0.7-2.5,1.3-3,1.4-2.7,1.5-3,1.8-3.5,1/2,1/2-3/4,1/4,1/4-1/3,11,2-3,3-5,4.5-6.5,4.8-9.5,7-12,9-13,abruptly,accrescent,acuminate,acute,adaxial,ag,along,anthesi,apart,apex,apparently,appressed,appressed-tomentose,articulated,attenuate,axe,axillary,ba,base,becoming,blade,capitat,closely,conical,continued,decurrent,dehiscing,dendritic-echinoi,dendritic-multangulate,densely,directed,distal,due,eaf,earl,early,echinoi,eed,elongate,entire,equal,erect,evident,exserted,filament,free,fruiting,glabrescen,glabrous,held,high,inserted,lateral,lobe,lobed,long,long-,long-stalked,longer,lower,m.,main,margin,midvein,minute,mixed,multangulat,narrowly,nearly,nflorescence,nodding,obtuse,often,older,open,orbicula,orbicular,orolla,ovate-lanceolate,overlapping,partly,perfect,plait,plurifoliate,present,prominent,pubescent,rather,ray,reflexed,relatively,ruit,runk,sessile,short,short-,short-stalked,side,small,sometimes,somewhat,soon,spaced,sparingly,sparsely,splitting,stamen,stigma,striate,strongly,style,subglobose,sulcate,suture,tamen,terete,terminal,thick,thick-stalked,thin-stalked,toward,tube,unarme,unit,usually,vary,vein,way,wide,ympodial	30-120,age,arrangement,branching,colour,form,height,inflorescence,number,plant,prickle,seed,shape,size,texture,thicknes,trunk,type
420	wfo-0001030872	success	166	105	84	82	21	0.506	.5,0.8-2,1-1.2,1-1.5,1-2,1.2-1.5,1.2-3,1.5-2,1.5-5,12-18,2-5,4-6,4-6-flowered,5-6,5.5-7,6-12.5,acuminate,acute,anther,apex,area,bark,base,black,brown,calyx,closed,closely,cm,completely,corky,corolla,dark,dia,difoliate,ellipsoid-ovoid,elliptic,erect,filament,fruiting,glabrous,globose,green,leaf,lenticel,lenticellate,like,minor,minutely,mm,nerve,oblique,opposite,ovary,ovate,pair,papillose,pedicel,petiole,pore,primary,rather,red-glandular-puberulent,rounded,scar,shaped,shining,size,small,spaced,stem,stigma,strongly,style,tear-drop,tip,tree,treelet,tube,unit,white,woody,x,young	0.5,0.5-1,0.8-1,3-7,adaxial,age,along,anthesi,appearing,beginning,berry,broadly,caly,center,consisting,crateriform,cucullate,darker,deflexed,deltoid,densely,dry,eaf,edicel,eed,exserted,fleshy,free,full,geminat,glabrate,hooded,incurved,inflorescenc,known,large,less,live,lobe,lobed,lon,long,lower,major,margin,material,middle,nearly,nflorescence,older,one,overlapping,pale,paler,petal,planar,poricidal,portion,prominent,proximal,puberulent,raised,reddish-glandular,reddish-glandular-puberulent,relative,rest,ridge,ruit,shorter,side,simple,slightly,soon,specimen,straight,styl,tall,tapering,thickened,ud,widest,ympodial	bud,colour,diameter,flower,form,fruit,geminate,growth,hair,height,inflorescence,length,placement,plant,position,prickle,shape,state,structure,sympodial,texture
421	wfo-0001030882	success	144	75	60	84	15	0.417	0.5-0.75,0.5-1.1,0.8-1.1,0.9-1.1,1-1.3,1-1.5,1-4,1.6-2,3-3.5,accrescent,acuminate,anther,apex,attenuate,base,calyx,capitate,cm,conical,corolla,crenulate,deflexed,elliptic,filament,fruit,fruiting,glabrous,globose,green,leaf,lightly,lobe,lobed,margin,minutely,mm,narrowly,opposite,ovary,ovoid-reniform,pedicel,petiole,pitted,pore,poricidal,shaped,shrub,simple,slightly,small,stigma,style,surface,tan,tear-drop,tip,tree,tube,white,woody	.1,.5,0.5-1,0.75-1,0.8-2.4,2,2-5.4,2-6,2.2-4.6,3/4,6.5-15.6,8-12,?,anthesi,bark,beginning,beneath,berry,closely,deltoid,dia,differing,difoliate,eaf,edicel,eed,erect,exserted,extreme,free,geminat,inflorescenc,lateral,lon,long,lower,main,major,middle,minor,nearly,nflorescence,occasionally,older,one,overlapping,ovoid,pair,pale,paler,papillo,papillose,peelin,planar,portion,prominent,raised,ruguse,ruit,scar,short,size,slender,soon,spaced,stem,straight,tall,tapering,terminal,thick,thickened,transversely,truncate,tub,ud,unit,vein,way,widest,x,yellowish,ympodial,young	5.5,colour,diameter,form,growth,height,inflorescence,length,modification,orientation,plant,position,seed,shape,texture
422	wfo-0001030883	success	179	118	97	82	21	0.542	-3,.05,.1,.5,0.5-3,0.5-5,1-1.3,1-4,1.5-2,1.5-3.5,18-44.5,2-5,20-50-flowered,3-4,3/4,5-6,9.5-27.5,acuminate,acute,anther,apart,apex,bark,base,brown,calyx,clavate,cm,corolla,dark,deflexed,difoliate,dry,elliptic,filament,fruit,fruiting,furcate,geminate,glabrous,glandular,globose,green,hard,imbedded,inflorescence,leaf,little,live,lobe,lobed,long-acuminate,massive,material,minute,minutely,mm,oblique,occasionally,opposite,ovary,ovate,ovoid-reniform,pale,papillate,papillose,pedicel,petaloid,petiole,pitted,placenta,plant,pore,puberulent,pulp,russet,scar,seed,shaped,shrub,size,sometimes,stem,stigma,stout,strongly,style,surface,tan,tear-drop,time,trichome,uniseriate,unit,way,white,x	1-1.1,1-1.2,1-1.5,10-18,3-3.5,accrescent,across,anthesi,appearing,approximatately,arching,becoming,berry,branched,bu,cell,collapsed,collection,dia,differing,eaf,edicel,eed,epidermal,erect,evenly,finely,fleshy,free,geminat,hollow,laminar,large,later,lateral,lenticellat,less,like,living,lon,long,lower,main,malodorous,markedly,middle,midrib,narrowly,nflorescence,older,pair,papillo,perpendicular,poricidal,portion,present,proximal,quite,rather,reflexed,reticulate,ruit,slender,slightly,soon,spaced,straight,tall,tapering,thick,tip,triangular,tube,two,ud,upper,vein,wall,widest,woody,ympodial,young	branching,bud,colour,deflexion,diameter,flower,form,glandularity,growth,height,length,lenticellation,number,placement,position,shape,spacing,structure,sympodial,texture,type
423	wfo-0001030884	success	218	112	64	154	48	0.294	0.4-3,1-1.5,4.5-5,abruptly,acute,anther,apex,base,berry,broad-based,c.,calyx,decurrent,di-,equal,filament,fruiting,geminate,green,greenish,growth,inflorescence,lateral,leaf,leafy,length,lobed,lower,margin,mature,mm,occasionally,pedicel,petiole,plant,pore,poricidal,present,prickle,pubescent,reflexed,sagittate,shallowly,shrub,simple,slender,spherical,spreading,stellate,stem,stiff,strongly,surface,tapering,tip,treelet,trichome,trifoliate,unicellular,unit,way,weakly,white,winged	.2,.5,.7,0.3,0.3-0.5,0.5,0.5-1.2,0.8-1,0.9-5,1,1-1.2,1-3,1.5,1.5-2,1.5-2.5,10,100,2,2-5,4-13,4-5,5,5-30,5-6,5-merous,5.5-7,6-10,6-25,6-8,7-8,9-11,>,abaxial,abaxially,adaxial,adaxiall,along,also,alyx,andromonoeciou,anthesi,apar,arme,articulated,bark,basal,blade,brown,capitate,cm,conical,connivent,curved,dark,densely,diameter,differing,directed,discolorous,distal,eaf,eed,elliptic,extend,extending,flower,flowering,free,glabrous,glandular,gray-tinged,gree,half,herbaceous,heterostylous,infructescence,like,lobe,long,long-stalked,long-styled,long-triangular,magnification,midpoint,midrib,minute,minutely,mixture,moderately,new,nflorescence,node,older,one,onto,open,orolla,oung,outlin,ovary,ovoid-reniform,pair,pale,papillat,peduncle,per,porrect,portion,prickly,primary,principal,ray,red,reddish,reflexe,regularly,rest,ruit,scar,scattered,sessile,shap,short,short-stalked,short-styled,similar,size,spaced,sparsely,stellate-pubescent,stigma,still,style,tall,tamen,tannish,time,tube,unarmed,uniformly,uniseriate,upward,usually,vary,varying,vein,visible,wide,wing,without,woody,yellow,ympodial,young	andromonoecious,appressed,articulation,bract,branching,breeding,cell,colour,connective,corolla,dense,form,fruit,hair,height,heteromorphism,inflated,insertion,interjected,interpetalar,leaflet,marking,na,needle-like,odour,orientation,paired,pattern,placement,position,pseudostipule,rhizome,scale,shape,smell,spot,staman,stone,structure,symmetry,sympodial,system,texture,tissue,tuber,type,vegetative,xylopodia
424	wfo-0001030899	success	146	117	88	58	29	0.603	0.3-0.5,0.5-1,1,1-2,1-3,1.5-2,10-13,10-20,2,2-3,2-3.5,2.5-3.5,20-25,3-12,3-4,3-5,3.5-4,4-5,5-10,5-6.5,6.5-31,7-27,8-11,?,acuminate,apex,base,bronze,calyx,chartaceous,cm,connective,cordate,coriaceous,deeply,densely,diameter,directed,ellipsoidal,end,entire,extrorse,flattened,flower,fruit,glandular-puberulent,globose,green,inside,less,light,lobe,long,margin,mm,narrowly,obconical,oblong,obtuse,outside,ovate,ovoid,pedicel,peduncle,perfect,petiole,pore,puberulent,pubescent,purple,rachi,radiu,remnant,shrub,simple,slightly,splotch,stellate,stigma,stripe,style,triangular,tube,unbranched,upward,white,x,yellow	-45,.5-2,0.5,1-1.5,1-6,3-foliate,abaxially,absent,acute,adaxially,aggregate,apart,ape,articulated,axe,basal,beyond,blade,cell,connivent,desc,dilated,distally,eaf,eed,ex,exceeding,exserted,glabrous,leaving,lon,lower,mucronate,nflorescence,nther,orang,orolla,pedicellar,peltifor,presen,puberulen,ruit,shorter,spaced,stamen,stone,strongly,tal,tem,thecae,time,tomento,ud,unit,vary,vein,wide,ympodial	anther,arrangement,articulation,branching,bud,colour,corolla,form,growth,hair,height,inflorescence,leaf,length,na,orange,ovary,peltiform,plant,seed,shape,size,spacing,stem,symmetry,texture,theca,tomentose,type
425	wfo-0001030902	success	159	121	92	67	29	0.579	-2,-20,0.6-1.5,1-2,1-6,1.5-13,1.5-2,1.5-2.5,10-15,15-50,2,2-3,2-5,2.5-4,3-20,3.5-4,30-50,4,4-22,4-6,4-7,5-7,5-9,absent,acuminate,acute,adaxially,angled,apart,apex,apically,base,branched,brown-pilose,calyx,cm,connective,cordate,cylindrical,dark,deltate,densely,diameter,dilated,directed,distally,eglandular,ellipsoidal,entire,flattened,fleshy,flower,forked,fruit,glabrescent,glabrous,globose,hair,laterally,lobe,long,margin,mature,mm,oblong,obtuse,occasionally,orange,ovate,pedicel,peduncle,perfect,petiole,pore,present,purple,rachi,radiu,rarely,reddish,remnant,simple,somewhat,stellate,stigma,style,subcoriaceous,tree,truncate,unbranched,x,yellow	-5,0-15,1.5-,2.5,3-13,3-4,4-foliat,6-24,8-14,abaxially,aggregate,along,ape,apiculate,articulated,axe,basal,beyond,blade,brow,cell,connivent,eaf,eed,equalling,exceeding,except,exserted,glabrat,glandular,glandular-puberulen,leaving,lon,lower,narrowly,nflorescence,nther,orolla,pedicellar,pinkish,presen,puberulence,purplish,ruit,shorter,slightly,small,spaced,sparse,sparsely,stamen,stone,subcapitat,tal,tem,thecae,time,tip,tomento,triangular,tube,ud,unit,vary,vein,wide,ympodial	abaxial,adaxial,anther,articulation,branching,brown,bud,colour,corolla,form,glabrate,growth,height,inflorescence,leaf,length,na,ovary,plant,presence,seed,shape,spacing,stem,subcapitate,symmetry,texture,theca,type
426	wfo-0001030914	success	186	125	100	86	25	0.538	/4,0-0.25,0.5-1,0.7-1,0.8-1.3,1-1.5,1-2,1.2-1.5,1.5-2,1.5-3,1.5-8,2-10,2-2.5,2.5-11,2.5-3,3-4,5-17,5-25-flowered,7-8,acute,anther,anthesi,attenuate,bark,base,bud,calyx,campanulate,capitate,closely,cm,corolla,dark,deflexed,densely,difoliate,ellipsoid,elliptic,evenly,exserted,filament,flower,fruiting,furcate,glabrous,globose,golden,inflorescence,later,leaf,lemon-yellow,length,many,minor,minutely,mm,obovate,occasionally,onto,opposite,ovary,ovoid-reniform,pale,papillose,pedicel,petiole,pitted,planar,plant,pore,puberulent,pubescent,reddish-brown,rounded,scar,shape,shaped,short-styled,shrub,simple,size,small,soon,spaced,sparsely,stigma,style,surface,tear-drop,time,tree,trichome,trunk,tube,uniseriate,unit,way,white,winged,x	.1,.5,0.1-0.5,0.8-1,3.5-17,7-10,9-35,along,apex,beneath,berry,blade,constriction,decurrent,deltoid,dia,differing,distal,dry,eaf,edicel,eed,equal,erect,even,free,geminat,glabrate,green,greyish-brow,individual,lateral,like,live,lobe,lobed,lon,long,long-styled,lower,main,major,margin,middle,narowly,nflorescence,often,older,one,otherwise,overlappin,pair,papillo,poricidal,portion,prominent,quite,raised,rest,ripe,ruit,slender,slightly,sometimes,specimen,stem,straight,tall,tan,tapering,thick,third,ti,tip,tub,ud,usually,variable,vein,weight,widest,within,woody,yellow,ympodial,young	0.1,branching,colour,deflexion,diameter,exsertion,form,fruit,geminate,greyish-brown,growth,hair,height,lobing,narrowly,number,overlap,overlapping,position,seed,spacing,structure,symmetry,sympodial,type
427	wfo-0001030918	success	230	83	68	162	15	0.296	0-25,0-4,1/2-2/3,3-7,5.5-7,abaxial,acicular,acute,adaxial,anther,apex,base,berry,branched,calyx,chartaceous,connivent,cuneate,dull,elliptic,elongating,equal,flattened,flattened-reniform,flower,fruit,fruiting,glabrescent,lateral,leaf,length,lobed,long,lower,margin,maturity,mauve,mm,moderately,obtuse,orange,orange-brown,pale,per,perpendicular,petiole,poricidal,prickle,pubescent,purple,red,reflexed,seed,shrub,simple,sometimes,somewhat,sparsely,spherical,spreading,stellate-pubescent,stem,surface,tapering,terminal,tip,way,yellow	-12,-2.3,-3.2,-4,-4.5,-40,-5,-6,-9,.5,.7,0-10,0-20,0-6,0.1,0.1-0.25,0.2-0.4,0.25-0.45,0.3-1.5,0.5-0.7,0.5-2,0.5-2.5,0.6,0.6-2.5,0.7-1.2,0.7-1.7,1,1-1.5,1-1.8,1-2,1-4,1.5-2,1.5-2.5,1.5-5.5,1/2-3/4,1/3,1/3-,1/3-1/2,1/4-1/3,2-10,2-2.5,2-25,2-3,2-4,2-7,2-8,2.8-3,2/,3-15,3-4,3-6.5,3.5-6,4-7,5-7,5-8,5-merous,6-8,7-10,abaxially,alyx,ame,apar,apart,apically,apparently,articulated,bark,blade,brow,c.,caudat,cell,cm,curved,dark,deltate,densely,diameter,difoliate,discolorous,distance,drying,eaf,elongated,erect,evenly,extending,faint,filament,free,geminat,glabrous,green,green-brown,infructescence,lobe,lobing,longer,mature,midpoint,midvein,mixture,narrow-deltate,nflorescence,oblong,occasionally,older,one,open,orolla,oung,outline,pair,pedicel,peduncle,pendulous,perfec,pericarp,pit,porrect,portion,prickl,prickly,primary,raised,ray,red-brown,reduced,ruit,scandent,scar,secondary,sessile,side,slender,small,smooth,spaced,stalk,stalked,stellate,straight,strongly,style,tamen,terete,tertiary,time,trichome,tube,unit,upper,usually,vary,vein,venation,visible,weakly,wide,woody,ympodial,young	branching,colour,corolla,form,growth,heteromorphism,inflorescence,number,orientation,placement,position,shape,staman,texture,type
428	wfo-0001030943	success	167	136	113	54	23	0.677	.5,1-1.2,1-1.5,1.1,1.5-2,1.8-2.2,1/2,12-15,2-6,3,3-4,3/4,4-4.5,7-13.5,7-8,8-10,abaxial,abaxially,absent,acuminate,acute,adaxial,adaxially,age,along,anther,anthesi,apex,bark,base,becoming,bi-lobed,black,branching,calyx,cm,corolla,decurrent,deflexed,dendritic,densely,diameter,drying,echinoid,elliptic,erect,exserted,filament,flattened,fruiting,glabrous,globose,golden,golden-yellow,growth,horizontal,im,large,lateral,leaf,lenticular,long,main,minute,minutely,mm,narrowly,nodding,outline,ovary,overtopping,pair,pale,pedicel,petiole,pitted,pore,poricidal,pubescent,purplish-black,raised,reddish-brown,scar,scattered,secondary,shoot,showy,shrub,sleeve,slit-like,small,somewhat,sparsely,stem,stigma,strongly,style,surface,terminal,time,tip,tree,tree-like,trichome,tube,vein,violet,way,woody,x,yellow,yellowish-white,young	0,0.5-1,0.5-3,10-25,4-5,4-6,apical,basal,belo,berry,branch,conical,cupulate,dark,denser,eaf,edicel,eed,elongate,ew,fide,flower,free,glabrat,inserted,lobe,lobed,lon,lower,m.,monochasia,nflorescence,often,older,papillo,pearce,per,pericarp,planar,plurifoliate,portion,ruit,slightly,stamen,tall,tapering,thin,triangular,tub,ud,unit,upper,wide,ympodial	bud,colour,deflexion,exsertion,form,fruit,glabrate,hair,height,inflorescence,insertion,length,lobing,new,papillose,plant,position,seed,shape,size,texture,venation,width
429	wfo-0001030959	success	164	93	69	95	24	0.421	0.5-1.5,0.7-1.2,1-2,1-7,1.2-1.8,10-15,2.5-5,4-6,4-8,5-6,5-9,abaxially,anther,apex,bark,base,branched,brown,brown-green,cm,color,connivent,cuneate,diameter,elliptic,flower,fresh,glabrescent,glabrous,glandular,hair,inflorescence,known,lateral,leaf,length,lobed,long-acuminate,margin,membranous,minute,mm,numerous,older,one,open,pedicel,peduncle,perpendicular,petiole,poricidal,present,prickle,shrub,simple,sparsely,stellate,stellate-pubescent,stem,straight,straw,style,subentire,tapering,time,tip,toward,unarmed,yellow	.05,.2,.8,/5,0.5,1-10,1.5-2,1.5-3.5,1/5-1/10,2-4,2.5-4,2.5-4.5,5-merous,6-8,9-12,almost,alyx,ame,apar,apart,apically,apparently,armed,articulated,blade,c.,concolorous,curved,deltate,densely,difoliate,distributed,drying,eaf,eed,equal,erect,evenly,filament,free,geminat,gently,glabrou,green-brow,know,less,like,lobe,long,long-acuminat,longer,lower,midpoint,narrow-deltate,nflorescence,orolla,oung,pair,part,perfec,porrect,portion,prickl,prickly,primary,prominent,ray,ruit,scar,scrambling,secondary,sessile,several,short,side,slender,spaced,spreading,surface,tamen,terete,tertiary,trichome,tube,unit,usually,vary,vein,venation,visible,way,whole,wide,ympodial,youngest	0.2,0.8,armament,articulation,branching,calyx,colour,corolla,form,fruit,green-brown,growth,number,opening,orientation,ovary,pore,seed,shape,spacing,staman,texture,type,width
430	wfo-0001030982	success	215	143	125	90	18	0.581	-2-2.5,.1,0.05,0.05-0.5,0.1-0.15,0.2-3,0.5,0.5-0.9,0.5-1,1-1.5,1.5-2,2/3,3-8,6-8,acuminate,acute,adaxially,anther,anthesi,apex,base,beneath,berry,broadly,brown,brownish,bud,calyx,capitate,central,channelled,chartaceous,closely,cm,conical,corolla,cuneate,dark,deflexed,deltate,diameter,drying,ellipsoid,elliptic,enlarged,entire,exerted,filament,flattened-reniform,fleshy,flower,foliage,form,fresh,fruit,fruiting,glabrous,globose,green,growth,hilum,isostylous,larger,later,leaf,less,lobe,lobed,margin,maturity,minutely,mm,new,olive,one,opposite,ovary,ovate,packed,pale,papillate,papillose,pedicel,peduncle,petiole,pitted,poricidal,portion,prominently,pubescent,reddish,reflexed,rest,rhizomatous,sagittate,scar,seed,separated,simple,sinuate,situated,size,slightly,somewhat,sparsely,stem,stigma,strongly,style,subshrub,surface,testa,tetramerous,tip,trichome,tube,uniseriate,vein,veined,way,weakly,white,x,yellowish,young	.2,.5,0.1,0.3-2,0.5-3,1,1-8,1.5,1.5-3,3-21,4-12,4-5,abaxially,age,angular,anisophyllous,ape,appressed,ba,caducous,ciliate,conic,cream,cucullate,curved,differing,difoliate,distall,distally,distichou,dry,eaf,edicel,eed,extension,external,free,geminate,glabrescent,glandular,glandular-papillose,golden-green,greenish,impressed,inconspicuously,internal,lengthening,like,live,long,lower,major,materia,material,midvein,minor,mostly,near,nflorescence,oblique,obovate,occasionally,often,overlappin,pair,papillae,papillat,planar,plant,pore,primary,projection,prominent,puberulent,revolute,ruit,shoot,sigmoidally,slit,stamen,straight,stripe,tightly,time,transverse,tub,ud,unit,vegetative,ympodial	abaxial,channeling,colour,deflexion,dried,exertion,inflorescence,length,number,overlapping,packing,position,reflexion,rhizome,shape,staman,texture,type
431	wfo-0001030989	success	177	110	91	86	19	0.514	.5,0.5-1,12-15,15-27.5,2-3.5,3-20,3-5.5,3-7.5,4-5,4-8,5,5.5-7.9,6-13,6-6.5,abaxially,adaxially,anther,axillary,berry,blade,brownish,bud,cell,chartaceous,cm,condition,conical,connivent,corolla,covering,densely,diameter,distal,drying,end,flower,forked,fresh,fruit,generally,green,green-white,greenish,hair-like,half,herb,homostylous,interjected,lanceolate,lateral,leaf,leaflet,lengthening,light,long,make,minute,mm,mucilaginous,occurring,odd-pinnate,ovoid,petiole,plant,pore,poricidal,pubescent,ripe,rotate,seed,singly,size,slit,sparsely,stem,subtending,terminal,testal,thick,throughout,tip,tuber,typically,unwinged,usually,violet,wall,wet,whitish,wide,x	1-1.5,1-10,1-2,3-4,4-7,5-merou,9-10,acuminate,ag,alyx,apart,apex,apparently,articulated,axe,base,capitat,ciliate,decreasing,digestion,dorsally,eaf,edge,eed,enzyme,erec,especially,filament,flat,folded,geminat,glabrou,glabrous,gradually,hair,honeycomb-shaped,larger,like,living,lobe,lower,margin,nflorescence,obtuse,orbicular,orolla,ovate,ovate-lanceolate,pair,pale,pedicel,peduncle,perfect,petiolule,plurifoliate,present,proximal,pubescen,ray,removed,ruit,secondary,semierect,seudostipule,spaced,specimen,ste,stigma,stolo,style,subequal,subsessile,symmetrical,tall,tamen,tem,thir,toward,tri-,triangular,tube,unit,vary,wider,yellow,ympodial	5-merous,age,arrangement,branching,calyx,colour,form,growth,height,inflorescence,length,number,occurrence,position,pseudostipule,shape,stolon,texture,type
432	wfo-0001030991	invalid_json	204	143	116	88	27	0.569	.5,0,0.1,0.2,0.5,0.5-0.7,0.5-1.5,0.7-1.2,1-1.5,1-2.2,3-,3-5-lobed,5-5.5,9-11,<,abaxially,absent,acuminate,acute,adaxially,along,anther,apex,apparently,appressed,ascending,attenuate,base,berry,brown,bulbous,capitate,cell,cm,connivent,corolla,densely,diameter,ellipsoid,ellipsoidal,elliptic,elongate,enlarged,entire,filament,flattened,flower,fruiting,furcate,fusiform,glabrous,globose,growth,herb,inflorescence,lanceolate,lateral,leaf,leaf-opposed,lengthening,like,lobed,loosely,lower,margin,minute,minutely,mm,narrowly,nearly,new,occasionally,pedicel,peduncle,per,perfect,petiole,pinnatifid,pitted,pore,poricidal,pubescent,rectangular,red,reniform,ripe,scattered,short,shrub,simple,sleeve,slightly,slit,small,somewhat,spreading,stellate,stem,stigma,style,surface,terminal,testal,tip,trichome,uniformly,uniseriate,upper,variably,vein,violet,white,winged,woody,x,yellowish	0.2-0.7,0.3-0.4,0.5-1,0.5-3.5,0.6-0.8,1-1.6,1-2.5,1-7,1.5,10-20,2-plurifoliat,2.5-10,2.5-3,2/3,4-10,5-merou,adaxiall,ag,alyx,angled,anthesi,arising,ark,articulated,basal,calyx,color,conical,different,distally,drying,eaf,eed,exerted,eye,filiform,free,frui,glabrescen,grey,ilament,incised,leave,less,lobe,long-triangular,midrib,nflorescence,nodding,often,older,orolla,outline,packed,pair,papillo,part,particularly,pendant,pericarp,platfor,pointing,portion,primary,pseudoumbel,reflexed,rest,rootstoc,ruit,scar,shallowly,shiny,sparsely,strongly,suffrutescent,tangled,tem,thin,tightly,tube,twinin,ud,unit,vary,weak,weight,ympodial,young	'',.5-1,5-merous,[,``,age,articulation,bud,characteristic,colour,form,fruit,hair,height,length,number,ovary,papillose,plant,position,rootstock,seed,shape,type,value,{,}
433	wfo-0001031005	success	231	146	129	102	17	0.558	.5,/3-1/2,0.1,0.8,0.9,1-1.5,1-2,1-2.5,1-3,2-3.2,2.3-3,2.5,3-4,3-6.5,5-7,6-12,abaxially,accrescent,acuminate,acute,adaxially,almost,anther,anthesi,apex,apically,apparently,attenuate,bark,base,berry,black,blue,brachyblast,branch,branched,branching,brown,calyx,capitate,chartaceous,clearly,clustered,cm,common,conical,corolla,cupular,dark,dendritic,diameter,dilated,domatia,drying,elliptic,evenly,eye,filament,fine,flat,flattened,flexuous,flower,form,fruit,fruiting,glabrous,greenish,known,leaf,length,liana,like,lobed,long,longitudinally,main,membranous,midvein,mm,naked,network,oblong,obovate,occasionally,often,older,orange-brown,ovoid,pair,pedicel,peduncle,petiole,pore,poricidal,primary,prominent,pubescent,purple,rachi,raised,ray,ridged,seed,short,smooth,sometimes,somewhat,sparsely,stem,stigma,strongly,style,surface,terete,terminal,tertiary,thick-chartaceous,tip,toward,trichome,unarmed,usually,vein,venation,visible,white,x,young	.4,0-0.5,0.3-0.5,0.5-1.5,1,1.5-2.5,1.5-4,10,2.5-4,3-10,4-6,5,5-8,5Â°,abaxial,age,along,alyx,apar,articulated,clum,concolorous,curved,datum,deeply,delineated,deltoid,dendritic-pubescent,denser,density,detaching,developing,discolorous,divided,eaf,ellipsoi,elongated,entire,equal,extending,fertilisation,forming,free,immature,increasing,inside,junction,lateral,leave,lengthening,linear,lobe,loop,lower,m.,margin,minute,much,nflorescence,nther,obscure,occasional,onl,orolla,ou,outside,ovate,pendulous,perfec,pericarp,plurifoliat,pointed,portion,protruding,region,rest,ruit,scar,secondary,side,simple,slender,smaller,smoot,soon,spread,spreading,standing,stump,surrounding,tangling,tearing,thin,tube,ud,uneven,unit,vary,weakly,well-developed,wide,ympodial	arrangement,articulation,bud,colour,ellipsoid,growth,inflorescence,number,ovary,pattern,perfect,position,presence,prickle,shape,texture,type
434	wfo-0001031007	success	207	145	126	81	19	0.609	.5,0.2,0.5-1,0.5-10,0.75-1.5,1,1-1.2,1-1.5,1-3.5,1.2-1.5,1.5-2,1.6-2,4-6,4.5-5,5,50-100,7-10,<,acute,alfway,almost,along,anther,apex,articulated,base,becoming,beginning,berry,bifid,black,branched,branching,brown,c.,calyx,capitate,chartaceous,clustered,cm,completely,connivent,corolla,cuneate,dark,dendritic,densely,diameter,drying,ellipsoid,elliptic,entire,extending,filament,flattened-reniform,fleshy,flower,fruit,fruiting,glabrous,globose,growth,herbarium,inflorescence,irregularly,lamina,leaving,lengthening,lilac,lobe,lobed,long,loose,loosely,lower,many,margin,midvein,minutely,mm,narrowly,near,new,occasionally,often,outline,papillate,pedicel,peduncle,peg,per,perfect,petiole,pore,poricidal,prominent,pubescent,reddish,revolute,sagittate,scar,shrub,simple,sleeve,slightly,slit,spaced,sparsely,specimen,stellate,stellate-pentagonal,stem,stigma,style,surface,tangled,terminal,time,tip,trichome,tube,upper,usually,vein,vine,x	0.5,1.3-,1.9-3,1/3,11-14,15,2.5-,2.5-5,3-4,4-7,5-12,5-merou,5.5-6,6,8-10,abaxiall,abruptly,ag,alyx,anthesi,apar,apparently,ark,broad,broadly,campanulate,cell,cup-shaped,deltate,dilated,dull,eaf,eed,exserted,free,geminat,glabrescen,glabrou,ilament,impressed,intramarginal,junction,lax,looping,m.,markedly,matte,multi-celled,narrowing,nflorescence,nodding,older,orolla,pale,papillat,pericarp,pitted,planar,plurifoliate,portion,primary,rat,round-rectangular,ruit,shiny,slender,splitting,spreading,stout,strongly,testal,thin,tiny,twining,ud,unit,vary,way,woody,yellow,ympodial	5-merous,abaxially,age,apart,articulation,bark,bud,colour,form,hair,leaf,length,number,ovary,position,seed,shape,texture,type
435	wfo-0001031007	success	206	148	125	81	23	0.607	.5,0.2,0.5-1,0.5-10,0.75-1.5,1,1-1.2,1-1.5,1-3.5,1.2-1.5,1.5-2,1.6-2,15,3-4,4-6,4.5-5,5,5.5-6,6,7-10,<,acute,alfway,almost,along,anther,anthesi,apex,articulated,bark,base,becoming,beginning,berry,bifid,black,branching,broad,brown,c.,calyx,capitate,chartaceous,clustered,cm,completely,corolla,cuneate,dark,dendritic,densely,diameter,dilated,drying,ellipsoid,elliptic,entire,exserted,extending,filament,flattened,fleshy,fruit,fruiting,glabrous,globose,growth,herbarium,inflorescence,irregularly,lamina,leaving,lilac,lobe,long,loose,lower,many,margin,markedly,mm,narrowly,near,new,occasionally,often,papillate,pedicel,peduncle,peg,per,petiole,poricidal,prominent,pubescent,reddish,reniform,revolute,sagittate,scar,shrub,simple,sleeve,spaced,sparsely,specimen,stellate,stellate-rotate,stem,stigma,strongly,style,surface,tall,tangled,terminal,time,tip,trichome,tube,upper,usually,vein,vine,wide	0.5,1.3-,1.9-3,1/3,11-14,2.5-,2.5-5,4-7,5-12,5-merou,50-100,8-10,abaxially,abruptly,adaxial,ag,alyx,apar,apparently,branched,broadly,campanulate,cell,cup-shaped,deltate,dull,eaf,eed,flower,free,glabrescen,glabrou,ilament,impressed,intramarginal,junction,lax,lengthening,lobed,looping,m.,matte,midvein,minutely,multi-celled,narrowing,nflorescence,nodding,older,orolla,outline,pale,papillat,perfect,pericarp,pitted,planar,plurifoliat,pore,portion,primary,rat,round-rectangular,ruit,shiny,slender,slightly,slit,splitting,spreading,stout,testal,thin,tiny,twinin,ud,unit,vary,way,woody,ympodial	apart,articulation,bud,colour,exsertion,form,glabrescent,hair,height,leaf,length,lobing,na,number,ovary,papillae,plant,seed,shape,symmetry,texture,type,width
436	wfo-0001031036	success	150	101	79	71	22	0.527	.2,.25,0.8-1.2,1-1.3,1-2.5,1.2-1.5,1.5-3,10-20-flowered,12-15,2-2.5,2.2-3.7,3-4,3.5-5.5,4.5-6.5,5-6,acuminate,acute,anther,apex,base,bi-lobed,brown,closely,cm,corolla,crisped,dark,decurrent,deflexed,ellipsoid,elliptic,erect,exserted,filament,flattened-reniform,fruiting,glabrous,globose,green,leaf,margin,middle,minor,minutely,mm,oblique,older,opposite,ovary,pedicel,petiole,pitted,pointed,pore,sagittate,scar,shaped,shiny,shrub,simple,size,slightly,spaced,stem,stigma,strongly,style,surface,tear-drop,thickened,tip,trichome,tube,uniseriate,white,widest,winged,x,young	.5,0.5-1,0.8-1,3-5,7-8,abaxially,adaxially,along,angle,anthesi,arising,axil,ba,becoming,berry,broadly,calyx,conical,dia,differing,difoliate,dry,drying,eaf,edicel,eed,enlarged,filiform,fleshy,free,fresh,geminat,greenish-white,knob-like,lamina,lateral,lobe,lobed,lon,long,lower,main,major,material,nearly,nflorescence,onto,overlappin,pair,papillo,papillose,perhaps,planar,poricidal,portion,rounded,ruit,short,sinus,soon,spathulate,tall,tapering,tub,ud,unit,usually,vein,woody,yellowish,ympodial	abaxial,adaxial,bud,colour,exsertion,flower,form,fruit,growth,hair,height,inflorescence,length,number,overlapping,plant,position,seed,shape,spacing,texture,width
437	wfo-0001031064	success	179	121	97	82	24	0.542	.0-2.5,.05,.5,0,0.5-0.7,1-1.2,1-2,1-3,1.2,1.7-4.2,10-12,10-12.5,2.5-3,3-5.5,3-7,3.5-4,4-5-celled,5-10.5,5-6,6-16,anther,anticlinal,basal,base,berry,bright,cell,cm,completely,conical,conspicuous,corolla,dark,densely,diameter,elongate,epidermal,filament,fleshy,fruit,fruiting,glabrous,globose,green,half,highly,inflorescence,irregular,lateral,leaf,leaflet,lenticel,lobed,long,lower,margin,minutely,mm,nearly,nodding,node,obovate,occasionally,ovary,ovate,ovoid-reniform,pair,papillate,pedicel,per,petiole,pinnate,poricidal,projection,pubescent,purple,rachi,scattered,short-pubescent,shrub,simple,sinuous,somewhat,sparsely,stem,stigma,style,terminal,thickening,tip,translucent,trichome,uniseriate,white,winged,without,x	.5-1,0-15,0.5,0.5-0.8,1,1.5-2,10-17,2,3,7-16,8-10-celled,abaxially,acroscopic,acuminate,adaxially,along,anthesi,apex,arising,attenuate,axil,bearing,blade,broader,calyx,clavat,commentary,deltate,denser,distal,dr.,eaf,edicel,eed,erec,exserted,flower,free,irregularly,lamina,leave,lightly,like,lobe,lon,lost,minute,narrower,near,nflorescence,often,open,petiolule,planar,portion,prominent,pubescen,rugose,ruit,scar,see,side,single,sinus,slender,smaller,splitting,strongly,surface,swollen,tal,tem,time,tub,tube,ud,unifoliat,unit,usually,vein,wand-like,ympodial	abaxial,adaxial,arrangement,branching,bud,clavate,colour,dry,erect,feature,form,growth,hair,height,length,number,orientation,plant,pore,seed,shape,size,texture,type
438	wfo-0001031071	success	186	92	72	114	20	0.387	0-10,0.2-0.8,1-2,1.5-2.2,2-5,2-8,2.1-3,2.4-3.4,3-10,3.8-5.4,4-25,4-6,5-9.4,6-8,7-16.5,7-8,8-28,anther,blade,blue,brownish,cm,color,condition,coriaceous,corolla,dark,deep,diameter,drying,filament,flower,forked,fresh,fruit,glabrous,globose,green,greenish,herb,homostylous,interjected,lanceolate,lateral,leaf,leaflet,lilac,medium,mm,moniliform,mottled,odd-pinnate,ovoid,pair,pedicel,peduncle,petiole,plant,pore,poricidal,purple,seed,size,spot,star,style,terminal,tip,tuber,white,whitish,x	0.4-2,1-1.5,1-3,1-7,2-3,3-5,3-6,5-merou,5.7-8.8,abaxiall,abaxially,acumen,acute,adaxially,ag,along,alyx,apart,apex,apparently,arranged,articulated,asymmetric,attenuate,axe,axillary,base,basiscopic,bead,berry,bud,capitat,cell,clavate,connivent,covering,decreasing,digestion,distal,dorsally,eaf,edge,eed,elliptic,enzyme,erec,exceeding,flat,folded,geminat,generally,glabrou,green-white,hair-like,half,honeycomb-shaped,lengthening,like,living,lobe,long,lower,make,middl,mucilaginous,multiple,narrowly,necklace,nflorescence,orbicular,orolla,ovate,pentagonal,perfect,petiolulate,plurifoliate,removed,ripe,rotate,round,ruit,sessile,seudostipule,short,side,slightly,slit,spaced,specimen,stamen,stigma,stolon,straight,subequal,subtending,tall,tamen,tem,testal,thick,throughout,tissue,toward,tri-,tube,typically,unit,usually,vary,wall,wet,winged,yellow,ympodial	abaxial,adaxial,arrangement,branching,calyx,colour,form,growth,hair,height,inflorescence,length,number,ovary,position,pseudostipule,shape,staman,stem,texture
439	wfo-0001031097	success	174	104	77	97	27	0.443	0.45,1,1-4,1-4.5,1.6-5.5,1.8-2.5,13-30,2-3,2-3.3,2-4,3-5,3.7-8.4,4-6,4-7,5-11,5-12,5-9,8-11,9-21,abaxial,abaxially,adaxially,apically,branched,calyx,cm,connate,corolla,cyme,darker,deep,dehiscent,diameter,dichasially,distal,filament,flower,forked,green,green-white,herbaceous,interjected,lateral,leaf,leaflet,light,medium,mm,odd-pinnate,ovoid,pair,pedicel,peduncle,pentagonal,perennial,perfect,petiole,plant,poricidally,proximal,puberulent,pubescent,purple,rarely,rotate,seed,strigose,style,terminal,throughout,tuber-bearing,typically,unit,violet,violet-blue,yellow,Â¼	0.5,1-3,1.5,1.8-2.6,3-6-foliat,3.5-6,acumen,acuminate,acute,along,apex,apical,articulate,base,cell,covering,cuneate,decurrent,dichasial,digestion,diminishing,dorsally,dotted,eaf,ebracteate,edge,eed,elliptical,emoval,enzyme,exceeding,flat,folded,frequently,generally,globo,gree,hair-like,half,highly,honeycomb,interpetalar,introrse,lighter,living,lobe,lon,long,lower,lunat,make,margin,maturing,monochasial,mottled,mucilaginous,narrow,nflorescence,noticeably,nther,oblique,obovate,often,orolla,ovate,pattern,petal,petiolulate,petiolule,plan,rachi,rapidly,reveal,ruit,sessile,seudostipule,short,side,size,slit,sometimes,specimen,stamen,stigma,straight,tal,tem,testal,thick,tissu,toward,vary,vbase,wall,wide,without,ympodial	2,3-6-foliate,adaxial,anther,arrangement,articulation,branching,colour,connective,form,fruit,growth,height,inflorescence,length,lunate,number,ovary,pore,pseudostipule,shape,stem,structure,sympodial,texture,type,width
440	wfo-0001031101	success	197	145	122	75	23	0.619	-1,-16,-20,-30,-5,-8,/2,0.05-0.2,0.1-0.2,0.1-0.3,0.3-0.5,0.5-0.8,0.5-3,0.6-0.8,0.8-,1-,1-2,1-2.3,1-3,1.3-2,1.3-2.5,1.4-1.7,1/4-1/2,10-30,2-2.8,2-5,2-6,2.5-,2.5-3.8,3-10,3-15,3.5-4.5,4-10,4.5-9,6-10,8-15,abaxial,acuminate,adaxial,almost,ame,anther,apex,apical,bark,base,berry,bright,c.,calyx,cm,concolorous,connivent,diameter,drying,dull,entire,evenly,filiform,flattened-reniform,flower,fruiting,glabrescent,glabrous,glandular,green,hair,lateral,leaf,length,lobe,lobed,long,long-acute,margin,maturity,mauve,membranous,midpoint,minute,mm,moderately,multangulate,obtuse,orange-brown,orange-red,ovate,pale,pedicel,peduncle,per,petiole,poricidal,porrect,ray,red,rounded,scar,sessile,shrub,simple,sparsely,spherical,stalked,stellate,stellate-pubescent,stem,straight,style,surface,tapering,terete,terminal,tip,trichome,umbel,unarmed,way,white,wide,yellow,young	/2-equal,0.7-0.8,1.5-3,1/3-1/2,2-4,2.5-3.5,3-8,4-5-merous,4-7,5-20,5-6,abaxially,alyx,apar,apically,apparently,articulated,ba,blade,branched,deltate,difoliate,eaf,eed,elongating,equal,erect,filament,free,frui,geminat,green-brown,herbaceous,infructescence,long-acuminat,longer,lower,mature,narrow-deltate,near,nflorescence,often,older,one,open,orolla,oung,pair,pendulous,perfec,pericarp,portion,primary,red-brow,resembling,ruit,scandent,smooth,spaced,spreading,stalk,stellate-pubescen,tamen,tertiary,time,tube,unarme,unit,variously,vary,vein,venation,visible,yellow-green,ympodial	apart,arming,articulation,colour,corolla,form,fruit,growth,height,inflorescence,number,ovary,plant,position,red-brown,seed,shape,size,spacing,staman,texture,type,width
441	wfo-0001031114	success	208	98	76	132	22	0.365	0.5,0.7-1.5,0.8-1.2,1-10,1-7,1.5-4,2-17,2-3,2-4,2-7,3-10,3-4,4-10,6-7,articulated,base,becoming,berry,branched,brown,calyx,chartaceous,cm,dark,densely,diameter,discolorous,elliptic-ovate,entire,especially,first,flattened,fleshy,flower,fruit,globose,green,hair,highly,homostylous,leaf,leaf-opposed,light,long,margin,mm,multangulate,outline,ovate,pedicel,peduncle,petiole,porrect,pubescent,purple,rachi,reniform,ripe,rugulose,shrub,simple,small,sparsely,stellate,stellate-pubescent,stem,strongly,subcoriaceous,surface,thickened,toward,tree,white,white-pubescent,x,yellowish	.1,.2,.5,0-0.3,0.3-0.5,0.5-1,1-1.5,1-2,1-4.5,1-8,1.5-2.5,10-15,2.5-3,2/3,25-50,3-5,3-7,4-5,4-8,4.5-6,5-10,5-8,5-merou,7-15,abaxially,absen,accrescent,acuminate,acute,adaxiall,adaxially,ag,alyx,anther,apart,apex,apparently,axe,ba,blade,capitat,connivent,covering,cylindrical,deltate,differentiated,directed,distal,distally,dried,eaf,echinoid,eed,equal,erect,filament,free,frui,fruiting,geminate,glabrous,impressed,interpetalar,introrsely,juic,lacking,large,like,lobe,long-stalked,longitudinal,lower,major,membanaceous,midpoint,minor,nearly,nflorescence,nodding,oblong,obtuse,often,one,opening,orolla,paired,part,perfect,pericarp,plurifoliate,pore,prominent,ray,rounded,ruit,sessile,short,short-,short-stalked,side,slightly,slit,somewhat,spaced,stalk,ste,stigma,straight,style,subcucullate,subcuneate,subtending,tall,tamen,tem,thin,time,tip,tissue,triangular,truncate,tube,unarme,unit,vary,vein,white-stellate,whitish,wide,without,yellow,ympodial	5-merous,abaxial,adaxial,articulation,branching,colour,corolla,form,growth,height,inflorescence,length,membranaceous,plant,position,prickle,seed,shape,size,texture,type,unarmed
442	wfo-0001031116	success	191	92	77	114	15	0.403	.5,.8,/4,0.7-1,1/2,10-14,15-25,2.7-3.2,3.5-4,30-100,4-7,5,abaxial,acuminate,adaxial,anther,apex,base,berry,branching,calyx,caudate,cm,connivent,diameter,dull,elliptic,elongating,equal,evenly,flattened-reniform,flower,fruit,fruiting,glabrescent,green,hair,lateral,leaf,length,lobed,margin,mature,maturity,mauve,minute,mm,moderately,obovate,obtuse,orange-brown,orange-red,per,petiole,poricidal,primary,reflexed,rounded,secondary,sharply,shortly,shrub,simple,small,sparsely,spherical,stellate-pubescent,style,surface,tapering,tip,tree,unarmed,upper,way,yellow,young	-10,.2,0,0.05-0.15,0.1,0.3-0.5,0.4-0.7,0.7-0.9,1,1-5,1/3-2/,1/6-1/4,2-5,30-50,4-10,5-15,5-merous,8-11,9-13,abaxially,almost,alyx,ame,apar,apart,apically,apparently,arachnoid,articulated,attenuate,bark,blade,bristle,broad-deltate,brow,c.,clearly,collapsed,densely,dirty-white,discolorous,drying,eaf,eed,elongated,epidermi,erect,filament,flat,flexuous,fragile,free,glabrous,glaucous-green,infructescence,less,lobe,long,longer,lower,membranous,midpoint,multangulate,narrow-deltate,nflorescence,obtu,often,older,one,open,orolla,oung,pair,pedicel,peduncle,perfec,pericarp,perpendicular,plurifoliat,portion,ray,recurved,red-brown,ruit,scar,sessile,single,slender,smooth,soft,sometimes,spaced,stalk,stalked,stellate,stem,straight,subentire,tamen,terete,tertiary,time,trichome,tube,unarme,unit,vary,vein,venation,visible,weakly,wide,woody,ympodial	colour,corolla,form,growth,heteromorphism,inflorescence,number,ovary,position,seed,shape,staman,texture,type,width
443	wfo-0001031128	success	213	71	51	162	20	0.239	1.5-3,20-50,anther,apex,base,berry,branched,branching,calyx,cm,cuneate,elliptic,elongating,equal,evenly,flattened-reniform,flower,fruit,fruiting,green,hair,inflorescence,lateral,leaf,length,lobed,long-acuminate,margin,mauve,membranous,mm,multangulate,pale,per,petiole,poricidal,purple-black,red,red-brown,sessile,short-attenuate,shrub,simple,spherical,stalked,tapering,terminal,tip,trichome,white,yellow-green	-10,-100,-4.5,-6.5,/4,0,0-30,0.05-0.2,0.05-0.25,0.2,0.2-0.4,0.3-0.8,0.5-0.7,0.5-0.8,0.5-1.5,0.5-5,0.6-1,0.8-1.7,1,1-,1-1.6,1.2-2,1.5-3.5,1/,1/6-1/3,10-20,10-35,2-5,2-9.5,2.3-,2.5-10,2.5-3.5,20-60,3-4,3.5-4.5,4-5-merous,4-7,5-,5-15,5-19,5-30,8-12,8-23,abaxial,abaxially,acute,almost,alyx,apar,apart,ape,apically,apparently,articulated,bark,blade,bristle,brown,concolorous,connivent,deltate,densely,diameter,drying,dull,eaf,eed,elongated,entire,erect,eye,filament,filiform,flexuous,free,glabrescent,glabrous,gland,glandular,gra,infructescence,less,lobe,lon,long,long-acuminat,longer,lower,mature,maturity,midpoint,minute,moderately,multangualte,naked,narrow-deltate,near,nflorescence,occasionally,often,older,one,open,orange-brown,orolla,oung,pair,pedicel,peduncle,perfect,pericarp,perpendicular,plurifoliat,portion,primary,ray,recurved,reduced,reflexed,ruit,scar,secondary,shallowly,short-styled,side,single,smooth,soft,spaced,spreading,stalk,staminate,stellate,stellate-pubescent,stem,straight,style,surface,tamen,terete,tertiary,time,tube,unarme,unarmed,undulate,unit,usually,variously,vary,vein,venation,visible,way,weakly,whitish,wide,woody,yellow,yellow-brown,ympodial,young	1-6.5,10,2.3-4.5,colour,corolla,form,growth,height,heteromorphism,number,plant,pore,position,seed,shape,staman,symmetry,texture,type,zygomorphy
444	wfo-0001031135	success	189	130	109	80	21	0.577	0-2,1-1.5,1-10,1-3,1-4,1.5-2,1.5-3,1.5-9,10-20,2,2-,2-2.5,2-4,3-4,3-5,3.5-12,5-30,5-9-pinnate,abaxially,acuminate,acute,adpressed,aggregate,also,apex,basal,base,broad,calyx,campanulate,cell,cm,compound,connective,cordate,cuneate,cylindrical,darker,deltate,densely,diameter,dilated,directed,distally,eglandular-pubescent,ellipsoidal,elliptic,entire,fading,flattened,flower,fruit,fusiform,glandular-,green,hair,laterally,leaf,leaving,light,lobe,lobed,long,longitudinal,margin,mm,moderately,narrowed,obconical,oblong,obtuse,often,ovate,ovoid,pedicel,pedicellar,peduncle,peltiform,petiole,pilose,pink,pinnately,pinnatifid,pore,puberulent,purple,rachi,radiu,remnant,ripe,shrub,simple,sparsely,stigma,stone,stripe,strongly,style,tip,tree,truncate,unbranched,unlobed,violet,white,whitish,x,yellow-green,yellowish	-7,0.5-2,0.7-2,1-,1-2.5,2-23,2-3,2-3.5,2-5,2.5-28,3-10,4-5,4-foliat,5-11,7-15,absent,adaxially,along,apart,ape,articulated,axe,basiscopically,beyond,biglandula,blade,chartaceous,color,coriaceous,decurrent,deflexed,eaf,eed,ellipsoida,equal,especially,exceeding,exserted,frequently,glabrous,interstitial,irregularly,lateral,leaflet,lon,lower,midrib,nflorescence,nther,oblique,occasionally,orolla,papillose,perfect,pilo,present,pubescent,ruit,shorter,slightly,small,smaller,spaced,stamen,subcoriaceous,tal,tem,thecae,time,tomento,toward,triangular,tube,ud,unit,unknow,upper,vary,wide,ympodial	anther,articulation,biglandular,branching,bud,colour,corolla,form,growth,height,inflorescence,length,ovary,plant,seed,shape,size,stem,theca,type,unknown
445	wfo-0001031144	invalid_json	231	168	146	85	22	0.632	-11,-13,.2,.5,0.5,0.8-1.4,1-,1-1.5,1-4,2-,2-3,2-6,2-9,2.5-3,2/3,25,3-7,3.5-10,4,4-20,4-4.5,6,7-10,acuminate,acute,adaxially,anther,anthesi,apart,apex,appearing,around,articulated,asymmetric,away,base,berry,branch,bright,broadly,brown,calyx,capitate,cell,closer,cm,commonly,connivent,cordate,corolla,curved,densely,diameter,divaricate,ellipsoid,elliptic,elongate,entire,exserted,filament,flattened-reniform,form,four,fruiting,glabrous,globose,groove,growth,inflated,inflorescence,later,lateral,leaf,leaflet,leaving,less,lobed,long,longest,loosely,lower,many,margin,minute,minutely,mm,near,new,number,oblique,occasionally,open,pair,pale,pedicel,peduncle,pentagonal,per,petiole,pinnately,pinnatifid,pitted,pore,poricidal,pubescent,red,reddish,ripe,scar,seed,shiny,simple,sleeve,slightly,small,sparsely,stem,stigma,strongly,style,surface,tan,terete,terminal,testal,tiny,tip,together,triangular,trichome,truncate,tube,uniseriate,upper,usually,vine,violet,wall,way,white,wing,woody,x,yellow,yellowish,Â½	0.2,1.1-2.5,100,2,3-4.5,4-6,5,5-9,5-merou,<,ag,alyx,apicula,apiculae,ark,axi,basal,basiscopically,blac,branche,brow,corresponding,cupped,drying,eaf,eed,elongating,extending,flattened,flower,free,geminat,ilament,irregularly,lamina,larger,lengthening,like,lobe,longer,markedly,membranous,mere,nflorescence,often,older,one,orolla,outline,papillo,peg,pendant,perfect,pericarp,plurifoliate,portion,primary,progress,quite,rim,ruit,slit,smaller,sometimes,spaced,spreading,stellate-rotate,tangle,tem,thin,third,tuft,twinin,twining,two,ud,unequal,unit,variable,vary,vein,weight,widest,wood,ympodial	'',[,``,articulation,bark,branching,bud,characteristic,colour,fruit,hair,length,lobing,ovary,papillose,shape,size,spacing,type,value,{,}
446	wfo-0001031152	success	232	162	133	99	29	0.573	-1.5,-10,0-100,0.2-0.3,0.2-1.5,0.3-1.3,0.3-3,1-1.5,1-3,1-6,1.1-2.2,1.2-1.8,1.4-2.6,1.5-3.5,1/2-3/4,11,13-27,2-5,2.5-7.5,2.7-3.7,2.8-4,4-19,4-6,4-7,4-8,5-6,8-20,abaxially,acuminate,acute,adaxially,anther,apart,apex,apical-lateral,articulated,attenuate,basal,base,blunt-tipped,branch,branched,brown,bud,bullate,chartaceous,cm,conical,corolla,deltoid,densely,diameter,entire,exserted,extend,few-rayed,filament,flower,fruit,globose,granular-tomentose,greenish,growth,hair,honeycombed,inserted,introrse,lanceolate,large,lavender,leaf,length,lilac,lobe,long,long-,longitudinal,margin,mixed,mm,mostly,multangulate,narrowly,oblanceolate,oblong,occasionally,openly,orbicular,ovate,pale,partly,pedicel,peduncle,persistently,petiole,plurifoliate,pore,porrect-stellate,probably,pubescent,rachi,rather,reniform,reticulate-punctate,ripe,rotate-stellate,scabrous,sessile,short-,shrub,simple,slit,sparingly,stamen,stellate-pubescent,stigma,stout-stalked,style,suborbicular,terete,testa,thick-stalked,time,tomentose,tree,tube,unit,variously,violet,x,yellow,yellowish,young	-5.5,.4,/100-1/16,1.1-3,1.3-4,1.5-3,1/2-2/3,2.7-4.5,2.7-6,3.7-7,6.5-10,9-13,accrescent,ag,along,anthesi,apparently,axe,axillary,ba,becoming,berry,blade,blister,calyx,capitat,closely,continued,decurrent,dehiscing,directed,due,eaf,earl,eed,evident,fleshy,free,fruiting,glabrescen,glabrous,green,high,lackin,lateral,less,lobed,longer,lower,m.,main,midvein,moderately,multangulat,nearly,nflorescence,obtuse,one,open,orolla,perfect,pitted,ray,reddish,reddish-brown,relatively,ruit,runk,short-stalked,side,slightly,somewhat,soon,spaced,sparsely,splitting,stelliform,stem,stipitate-glandular,strongly,surface,suture,swelling,tamen,terminal,thick,thin,thin-,thin-stalked,touching,toward,unarme,unarmed,usually,vary,vein,way,wide,ympodial	age,arrangement,articulation,branching,capitate,colour,form,glabrescent,height,inflorescence,insertion,mentioned,number,ovary,plant,position,seed,shape,size,spacing,staman,structure,symmetry,sympodial,texture,thicknes,trunk,type,width
447	wfo-0001031202	success	198	103	87	111	16	0.439	0-0.5,0-1,0.6-1.1,0.8-1,1-1.5,1-1.7,1-5,15-40,2-3,2-8,2.5-3.5,2.5-4,2/3,3.5-4,6-25,9-20,anther,anthesi,apart,base,berry,broadly,bud,calyx,capitate,cm,completely,complex,corky,corolla,cup-shaped,deflexed,dia,dry,enclosed,erect,filament,fleshy,flower,fruit,fruiting,furcate,glabrous,globose,golden,inflorescence,leaf,many,margin,material,minutely,mm,obovate,ovary,overtopping,ovoid-reniform,pedicel,petiole,pitted,plant,puberulent,pubescent,quite,raised,scar,shape,shaped,shrub,size,slightly,small,stigma,style,surface,tear-drop,terminal,thickened,time,tree,variable,way,white,whitish,winged,woody,x,young	.1,.5,0.1-0.3,0.5,0.5-1,1.5-2,1.5-2.5,1.5-9,2.5-13,20-100-flowered,9-11,abrupt,accrescent,acute,along,apex,apiculate,axi,bark,beneath,condition,cordate,decurrent,deltoid,densely,differing,difoliate,distal,due,eaf,edicel,eed,exserted,extremely,free,frui,geminat,glabrate,green,greenish-white,greyi,hard,irregularly,large,later,lateral,like,live,lobe,lobed,lon,long,long-ellipsoid,long-styled,longer,lower,main,major,middle,minor,minute,narrowing,nflorescence,occasional,occasionally,often,older,one,opposite,orbicular,pair,pale,paler,papillo,papillose,planar,pore,poricidal,portion,prominent,reddish-brown,rounded,ruit,scattered,sessile,shoot,short-styled,slender,spaced,sparsely,specimen,stem,straight,tall,tan,tapering,thick,thicker,third,tip,trichome,tub,tube,ud,uniseriate,unit,usually,vein,weight,widest,ympodial	20-100,branching,colour,form,growth,hair,height,length,lobing,number,position,relationship,seed,spacing,texture,type
448	wfo-0001031207	success	219	89	70	149	19	0.32	0-20,0.1-0.2,0.2-0.3,0.3-0.5,0.5-1,0.6-0.9,0.85-1.4,0.9-1.6,1-5,1/4-1/3,2-3,2.1-2.3,2.8-3,5-8,abaxially,ame,anther,berry,branched,c.,chartaceous,cm,densely,diameter,dull,evenly,flattened-reniform,flower,fruit,fruiting,green,herb,lateral,leaf,length,lobed,maturity,mauve,midpoint,mm,moderately,orange-brown,ovate,pale,pedicel,per,petiole,poricidal,prickle,prickly,ray,red,shrub,sometimes,spherical,spreading,stalk,stellate,stellate-pubescent,stem,style,tapering,terminal,tip,trichome,upper,white,yellow,yellow-green,young	-0.4,-1/2,-11,-4,-5,-7,-8,.1,/5,0,0-0.5,0-10,0.1-0.3,0.1-0.5,0.2,0.25-0.5,0.6-1.2,0.7-2,0.8,1,1-3,1-4,1.4-2,1.5-5,1/,1/3,1/3-equal,2-4,2.5-,3-5,3.5-7,5-merous,6-8,6.5-8,9,acuminat,acute,alyx,apar,apart,apex,apically,apparently,articulated,bark,base,blade,bristle,bristly,broad-deltate,brow,calyx,cell,concolorous,cordate,curved,dark,difoliate,discolorous,distance,drying,eaf,eed,elongated,elongating,equal,erect,extending,eye,filament,filiform,free,geminat,gently,glabrescent,glabrous,gray,herbaceous,infructescence,lanceolate,less,like,lobe,long,longer,lower,margin,mature,midvein,multangulate,naked,narrow-deltate,nflorescence,oblong,obtuse,occasionally,older,one,open,orolla,oung,outline,pair,peduncle,pendulous,perfec,pericarp,perpendicular,persistent,pit,porrect,portion,prickl,primary,raised,reflexed,rounded,ruit,scandent,scar,sessile,shorter,side,simple,small,smooth,spaced,stalked,straight,subentire,surface,tamen,terete,tertiary,time,toward,tube,unarmed,unit,usually,variously,vary,vein,venation,visible,way,weakly,wide,ympodial	branching,colour,corolla,form,growth,hair,height,inflorescence,number,ovary,plant,position,presence,seed,shape,staman,texture,type,width
449	wfo-0001031218	success	154	122	89	65	33	0.578	-5,0.5-1,1-2,1-3,10-19,15-25,2-2.5,2-22,2-3,3,3-14,3-5,4-5,4-7,4-8,40,5-7,5.5-7,6-10,6-7,6-9,acuminate,apex,apiculate,base,beyond,branched,calyx,cm,connective,cordate,coriaceous,cylindrical,dark,densely,diameter,directed,distally,eglandular-pilose,ellipsoidal,entire,flattened,fruit,glabrous,glandular-puberulent,globose,greenish-purple,hair,introrse,lanceolate,lavender,lobe,long,margin,minutely,mm,mottled,oblique,obtuse,orange,ovate,ovate-elliptic,ovoid,pedicel,pedicellar,peduncle,petiole,pore,puberulent,pubescent,purple,rachi,radiu,remnant,ripe,simple,sometimes,sparsely,stamen,stellate,stigma,style,subcoriaceous,tip,tree,unit,violet,x,yellow	0.5,1-4,2.5-3,4-28,4-foliat,40-100+,5-37,8-17,8-20,abaxially,acute,adaxially,aggregate,apart,ape,articulated,axe,basal,blade,cell,connivent,eaf,eed,eglandular,equal,especially,exceeding,exserted,flower,glabrou,glandular,leaving,less,lon,lower,moderately,narrowly,nflorescence,nther,orolla,papillo,perfect,presen,present,purpl,ruit,shorter,slightly,small,spaced,stone,succulent,tal,tem,thecae,time,tomento,toward,triangular,truncat,tube,ud,vary,wide,ympodial	4-foliate,abaxial,adaxial,anther,articulation,branching,bud,colour,corolla,exsertion,form,growth,height,inflorescence,leaf,length,na,ovary,papillose,plant,position,seed,shape,size,spacing,stem,structure,symmetry,sympodial,texture,theca,truncate,type
450	wfo-0001031225	success	163	138	116	47	22	0.712	.5,/3,0.2,0.2-0.75,0.5,0.7-6,0.75-1,0.8-1,1-1.7,1-3,1-5,1.5-5,2,2.5-3,3-9,3/4,5-50-flowered,5-6,7-9,9-16,acute,along,anther,anthesi,apart,apex,bark,base,beginning,broadly,bud,calyx,characteristic,closely,cm,corolla,cup-shaped,decurrent,differentiated,difoliate,dry,ellipsoid,elliptic,exserted,filament,fragrant,fruiting,furcate,glabrate,glabrous,globose,green,growth,inflorescence,leaf,less,like,lobe,lobed,long,major,margin,minor,minute,minutely,mm,much,narrowly,often,older,opposite,ovary,ovate,ovoid-reniform,pale,papillose,pedicel,petiole,pitted,plant,pore,poricidal,pubescent,red-papillose,reflexed,rest,scar,shape,shaped,shrub,size,slightly,small,soon,spaced,specimen,stem,stigma,strongly,style,surface,sweetly,tan,tear-drop,tip,tree,trichome,tube,unevenly,uniseriate,unit,vein,way,white,x,young	.25,0.1-0.75,0.5-1,1-1.5,6-8,berry,conspicuous,darker,deltoid,dia,differing,eaf,edicel,eed,erect,flattene,free,geminat,greyish-brow,inflorescenc,lateral,live,lon,lower,main,middle,nflorescence,one,outline,pair,papillo,portion,prominent,proximal,raised,rhomboidal,rounded,ruit,slender,straight,swelling,tall,tapering,ud,widest,woody,ympodial	0.25,branching,colour,diameter,flattened,flower,form,fragrance,fruit,geminate,greyish-brown,hair,height,length,na,number,position,seed,structure,symmetry,sympodial,texture
451	wfo-0001031231	success	175	145	125	50	20	0.714	-2,0.5-1.5,1-1.5,1-2,1-3,1-4,1.5-2,13,2-3,2-4,2.5-3,25-35,37/2,37/3,4-8,5-7,8-10,80-110,acuminate,acute,adherent,almost,anther,apex,aromatic,aspect,axillary,base,beyond,blunt,branch,branched,brown,calyx,campanula,campanulate,cell,clonal,cluster,cm,colour,corolla,dark,declinate,dia,discoidal,ellipsoid,entire,equal,erect,exerted,expanded,facetted,filament,flower,fork,glabrous,globose,green,greyish,habit,hair,juvenile,lasting,leaf,len,lengthening,less,lobe,long,loosely,marbled,mature,mauve,minute,mm,oblong,occasionally,often,ovary,pedicel,pedicellate,pentagonal,petal,pinnatisect,plant,pore,poricidal,projecting,purple,rarely,rh,ripe,ripening,rotate,rounded,rugose-ruminate,seed,sessile,several,shallow,shrub,simple,slightly,slit,small,soft,sometimes,stigma,stone,stout,style,succulent,surface,tinged,tip,toward,unit,usually,variable,vigorous,violet,wooded,x,year	.5,3-4,absent,acumen,along,anthesi,axi,basal,becoming,berry,bluntly,developed,eaf,eed,elliptic,exceeding,except,fleshy,flowering,folded,general,glandular,gree,herbarium,interacuminal,lanceolate,lon,lower,margin,midrib,nflorescence,pedice,peduncle,plurifoliat,readily,recurve,ruit,shed,short,sinus,specimen,stonrgly,tissue,translucent,triangular,tub,ud,well,without,ympodial	branching,bud,clonality,form,fruit,growth,height,inflorescence,length,number,plurifoliate,position,shape,size,strongly,structure,sympodial,texture,tube,type
452	wfo-0001031252	success	170	114	92	78	22	0.541	0.2-1.5,0.3-1.1,1-2,1-3,12-20,2-3,2.8-3.6,3-10,3-6,5-8,5-9,5.5-6.5,7-18,acute,anther,apex,attenuate,axillary,base,berry,brownish,bud,cell,ciliate,clavate,cm,condition,connivent,coriaceous,corolla,covering,cuneate,dark,deep,diameter,drying,elliptic,entire,filament,flower,forked,fresh,fruit,glabrous,globose,green,green-white,greenish,hair-like,herb,homostylous,lanceolate,lateral,lobe,make,margin,medium,mm,moniliform,mottled,mucilaginous,ovate,ovoid,petiole,plant,pore,poricidal,purple,ripe,rotate,rounded,seed,serrate,simple,sometimes,stigma,straight,stripe,style,subtending,terminal,testal,thick,throughout,tip,tube,tuber,unwinged,wall,wet,white,whitish	0.4-3,1.3-1.9,1.75-5.2,16-33,2.5-7,3-5,5-17,5-merou,abaxially,absent,acumen,adaxiall,adaxially,ag,along,alyx,apart,apparently,arranged,articulated,axe,bead,blade,capitat,digestion,distal,dorsally,eaf,edge,eed,enzyme,erec,exceeding,flat,folded,geminat,generally,glabrou,hal,half,high,honeycomb-shaped,interjected,leaflet,lengthening,light,like,linear,living,long,lower,multiple,necklace,nflorescence,orolla,pedicel,peduncle,perfect,plurifoliate,removed,ruit,seudostipule,slit,spaced,specimen,stamen,stolon,tall,tamen,tem,tri-,typically,unit,usually,vary,x,yellow,ympodial	5-merous,arrangement,branching,calyx,capitate,colour,connective,form,growth,height,inflorescence,leaf,length,number,ovary,position,pseudostipule,shape,staman,stem,texture,type
453	wfo-0001031257	success	206	132	115	91	17	0.558	-12,-22.5,-5,-6,0.7-1,0.75-2.5,1-1.2,1-1.3,1.1-1.2,1.5-1.7,10-16,11.5-15,2-4.5,3.5-5.7,4-10,5-8.5,7.5-9,abundant,anther,anthesi,antrorse,ascending,attenuate,basal,base,berry,blue-violet,bud,calyx,campanulate,cell,cm,coarsely,coat,connectival,corolla,cuneate,curved,dark,dentate,diameter,directed,dorsally,edentate,ellipsoidal,embryo,epidermal,erect,filament,flexuous,glabrous,glandular,globose,hair-like,herb,herbaceous,hollow,honey-combed,lamina,lateral,leaf,length,light,little,lobe,long,longer,longitudinal,longitudinally,margin,midvein,mm,opening,outward,ovate,pair,papillate,patent,petiole,pore,poricidal,prolongation,purple,ridged,ring,robust,secondary,seed,serrate,shrub,simple,slit,somewhat,spur-like,stem,stigma,strand,style,subglobose,thickened,thickening,tip,tooth,trichome,tube,unequal,upward,vein,ventrifixed,viscid,wall,white,within,x,yellow	0,0.4,0.5,0.5-0.8,1.5,1.5-2,1/10,2-,3,3.5-,4-4.5,4.5-,5,5-,6-12,6-celled,7-,8,8-celled,abaxially,accrescen,acuminate,adaxially,ag,aggregate,apex,bicellular,branch,broad,cotyledon,cuticle,deep,densely,diamete,difoliate,eaf,eed,elliptical,endosperm,finely,foliage,free,fruiting,geminat,half,head,high,inconspicuous,inserted,like,lon,long-stalked,lower,many-seeded,narrowly,non-glandular,odorles,orolla,pericarp,portion,pubescent,rarely,reduced,ree,rest,ruit,saddle-shape,scarce,scarcely,separated,short-stalked,shorter,single-celled,sinus,slightly,small,smooth,solitary,stalk,stone,striate,tem,thecae,time,trans-ovoidal,triangular,unit,vary,verrucate,viscid-pubescen,ympodial	3.5-4.5,4.5-12,age,arrangement,branching,colour,form,fruit,growth,hair,height,ovary,pattern,plant,saddle-shaped,shape,size
454	wfo-0001031270	success	234	94	78	156	16	0.333	+,0.4-1.5,0.5-1,1-4,10-12,100,2-3,3-10,5-10,6-50,7-12,9-10,>,accrescent,anther,base,berry,bipinnatifid,bright,calyx,capitate,clavate,cm,conical,deeply,depressed-spherical,elliptic,flower,fruiting,glandular,growth,herb,inflorescence,investing,lateral,leaf,leaf-opposed,length,lobe,lobed,long,long-styled,margin,membranous,mm,obovate,ovoid,pale,per,petiole,pinnatifid,plant,pore,poricidal,red,reflexed,reniform,ripe,shallowly,short-styled,shrub,simple,slightly,small,spherical,stellate,stigma,strongly,style,tan,tapering,tightly,tip,truncate,uniseriate,white,wide,yellowish	.5,1,1-1.2,1-3,1.2-1.6,1.5,1.5-2,1/3,10,2-2.5,2-20,2-4,2-7,2.5-3,3-20,3-5,4-5,5,5-15,5-6,5-merous,6-17,8,abaxial,abaxially,acute,adaxial,adaxiall,along,alyx,anthesi,apart,apex,arme,articulated,associated,bark,basal,beginning,blade,brow,brown,c.,cell,celled,colored,connivent,consistently,curved,densely,diameter,differentiated,difoliate,directed,distal,eed,ellipti,entire,equal,erect,few-rayed,filament,free,frui,geminat,glabrous,gland,glandular-pubescent,green,heavily,heterostylous,infructescence,later,leafy,like,live,lon,longer,loosely,lower,midpoint,midvein,minute,minutely,mixture,multangulate,multiseriate,narrowly,new,nflorescence,occasionally,often,older,orolla,oung,outline,pair,papillo,pedicel,peduncle,pericarp,pitted,portion,prickle,prickly,primary,pubescent,rachi,ray,reddish,rest,rounded,ruit,scar,scattered,secondary,sessile,shallow,shining,short-stalked,single,sinuate,size,slender,sparsely,spreading,stalk,staminat,stem,straight,straw-colored,surface,tall,tamen,terete,testal,thin,thus,tissue,trichome,tube,unit,upward,usually,vary,varying,vein,way,well,wice,wid,wing,woody,yellow,ympodial,Â½	arrangement,branching,colour,corolla,form,fruit,hair,height,number,ovary,position,seed,shape,staman,texture,type
455	wfo-0001031283	success	52	41	24	28	17	0.462	-0.25,0.1-0.15,0.4-0.5,0.5-0.7,0.7,2.2-2.8,30-40,brown,calyx,cell,cm,diameter,hair-like,lateral,mm,obovate,outgrowth,pale,pleasant,pubescent,shrub,smelling,testa,wall	.7-2.3,acute,apex,appearance,base,eed,elongating,erect,fide,fruit,give,lo,lobe,long,markedly,moore,narrowly,silky,small,somewhat,sprawling,spreadin,surface,tall,thick,wide,winged,woody	1.7-2.3,colour,form,growth,hair,height,leaf,length,odour,plant,seed,shape,spreading,texture,thicknes,type,width
456	wfo-0001031287	success	147	74	53	94	21	0.361	0.5-1.5,0.9-1,1,1-1.2,1-1.3,1-1.5,1.5-2,3-4,4-5,4.5-5,abaxially,adaxially,anther,anthesi,apex,attenuate,base,calyx,cm,conical,corolla,dendritic,elliptic,filament,fruiting,glabrous,globose,green,greenish-white,internodal,leaf,lobed,minutely,mm,nearly,ovoid-reniform,pale,pedicel,petiole,pore,pubescent,shaped,shoot,short,shrub,simple,tan,tear-drop,trichome,tube,white,winged,x	.5,1-5,1.5-5.5,2-2.5,3-5,4-6,5-14,6-10-flowered,6-7,acute,apar,ape,axil,bark,bearing,berry,bi-lobed,branch,connective,coriaceous,dark,deflexed,deltate,densely,dia,difoliate,divergently,eaf,edicel,eed,ellipsoid,elongate,enlarged,erect,exserted,fleshy,free,frui,geminate,knob,lamina,later,lateral,lobe,lon,long,lower,main,many,margin,membranous,middle,nflorescence,occasionally,older,onto,ovary,pair,papillo,papillose,pitted,planar,plurifoliate,pointed,poricidal,portion,red-papillose,reddish-brow,reflexed,rounded,ruit,scar,sinus,small,somewhat,spaced,stem,stigma,strongly,style,surface,thick,thin,tip,tub,tuft,ud,unevenly,unit,vein,widest,woody,ympodial,young	0.5,1.5,abaxial,branching,colour,diameter,form,fruit,growth,hair,height,inflorescence,length,plant,position,seed,shape,size,symmetry,texture,type
457	wfo-0001031300	success	219	81	66	153	15	0.301	-4,-6,0-20,0.2-0.4,0.5-1.5,0.5-2,0.7-0.9,1-2,2-3,2-6,2.5-3.2,6-8,anther,apex,berry,branched,brown-green,calyx,chartaceous,cm,dull,elongating,flattened-reniform,flower,fruit,fruiting,glabrous,gray-green,hair,lateral,leaf,length,lobed,long,margin,maturity,membranous,mm,near,oblanceolate,orange,orange-brown,pale,per,petiole,poricidal,porrect,prickle,red,shrub,simple,sparsely,spherical,stellate,stellate-pubescent,stem,style,surface,tapering,tip,trichome,uniradiate,white,yellow,yellow-green,yellow-orange	-2.2,-5,.5,/4,0-15,0-3,0-8,0.1,0.1-0.5,0.1-0.6,0.15-0.7,0.2-0.5,0.2-0.7,0.2-1,0.3,0.3-0.6,0.3-1.3,0.5-0.9,0.5-18,0.6-0.8,0.6-1,0.6-1.2,0.7-1.2,0.8-1.5,1-4,1-5,1.2-1.7,1.3-2,1.5-3.5,1/2-3/4,1/3-1/2,1/6-1/4,10-30,2-,2-4,2-5.5,2.2-2.3,2.2-2.7,3-,3-4,4,4.5-6,5-15,5-merous,abaxially,absent,acute,also,alyx,apar,apart,apically,apparently,articulated,attenuate,ba,bark,base,blade,brow,bulbous,caudat,cell,concolorous,connivent,creeping,curved,deltate,densely,diameter,difoliate,distance,drying,eaf,eed,equal,erect,extending,eye,filament,filiform,flattened,free,geminat,geniculate,glabrescent,herbaceous,highly,infructescence,lobe,lon,longer,lower,mature,midpoint,midvein,minute,moderately,naked,nflorescence,oblong,obtuse,older,one,open,orange-green,orolla,oung,outline,pair,pedicel,peduncle,pendulous,perfec,pericarp,pit,portion,prickl,prickly,primary,pubescent,raised,rarely,ray,reduced,rounded,ruit,scar,sessile,side,small,smooth,spaced,spreading,stalk,stalked,tamen,terete,tertiary,thin,time,tube,unit,vary,vein,venation,visible,way,weakly,wide,wider,winged,ympodial	branching,colour,corolla,form,growth,inflorescence,number,ovary,placement,position,seed,shape,texture,type,width
458	wfo-0001031310	success	203	152	129	74	23	0.635	.5,0-3,0-4,1-10,1-3,1-6,1.5-4,15-40,2-3,2.5-5.5,2.5-8.5,3-10,4-10,4-12,4.5-4.8,5-7,5.5-21,abaxially,absent,adaxially,along,anther,apart,apex,attenuate,base,berry,blade,blue,blue-purple,broadly,brown,brownish,cell,chartaceous,ciliate,cm,condition,connivent,corolla,covering,cuneate,decurrent,diameter,distal,drying,elliptic,especially,extremely,filament,flower,forked,fresh,fruit,generally,glabrous,globose,green,green-white,greenish,hair,hair-like,half,herb,high,homostylous,lanceolate,lateral,leaf,leaflet,lengthening,less,light,like,long,make,margin,membranous,midrib,minutely,mm,mottled,mucilaginous,multicellular,narrowly,obtuse,odd-pinnate,ovate-elliptic,ovoid,pair,pale,pedicel,peduncle,petiole,petiolule,pilose,plant,pointed,pore,poricidal,puberulent,pubescent,purple,seed,simple,size,slightly,slit,small,sometimes,somewhat,sparsely,stem,stigma,straight,streak,style,terminal,testal,thick,throughout,tip,tuber,unwinged,wall,wet,white,whitish,x	0.5-3,1-2,1-5.5,5-6,5-merou,6-7,acumen,acuminate,ag,alyx,apparently,articulated,axe,axillary,borne,bud,caly,conspicuously,decreasing,digestion,dorsally,eaf,edge,eed,end,enzyme,erect-decumben,exceeding,flat,folded,geminat,glabrou,gradually,honeycomb-shaped,interjected,larger,living,lobe,lower,nflorescence,orolla,ovate,ovate-lanceolate,perfect,plurifoliate,rachi,removed,rosette-forming,rotate,ruit,seudostipule,shortly,singly,spaced,specimen,stamen,ste,stolo,subellipsoi,subrosette-forming,subtending,tall,tamen,tem,tissue,toward,tri-,tube,typically,unit,usually,vary,yellow,ympodial	age,arrangement,articulation,branching,calyx,colour,connivence,form,growth,height,inflorescence,length,number,ovary,pilosity,presence,present,pseudostipule,shape,spacing,staman,subellipsoid,texture
459	wfo-0001031316	success	207	100	82	125	18	0.396	-2,0.3-1,0.4-0.8,0.5-2,0.8-1.2,0.9-1.3,1.2-2.1,1.3-3.5,2-20,2-3,2.5-8,3.5-3.8,3.8-5,4-7,4-9,5-8,6-20,abaxial,abaxially,acuminate,acute,adaxial,anther,apex,base,berry,blue-mauve,branched,bright,calyx,cm,connivent,cream,dark,diameter,dull,entire,flattened-reniform,flower,fruit,fruiting,glabrescent,glabrous,green,hair,lateral,leaf,length,lobe,margin,marking,maturity,mm,moderately,multangulate,obtuse,orange,orange-brown,ovate,pale,pedicel,per,petiole,porrect,purple,sessile,shrub,simple,sometimes,sparsely,spherical,stalked,stellate,stellate-pubescent,stem,style,surface,tapering,terminal,unarmed,yellow,young	.1,/3,0.05-0.1,0.05-0.15,0.1-0.2,0.4-0.6,0.6-1,0.8-1.8,1-5,1.5-,1.5-2,1.5-3.5,1.5-5,1/3-1/2,1/3-2/3,2-4,3-10,3-8,4,5-10,5-15,5-6,5-merous,8-11,8-12,8-25,almost,alyx,ame,apar,apically,apparently,articulated,bark,becoming,blade,broad,c.,colored,concolorous,contrast,curved,densely,difoliate,discolorous,drying,eaf,eed,elongating,erect,eye,fifth,filament,foliaceou,four,free,geminat,glabrou,gray,held,herbaceous,infructescence,inward,lobed,long,long-acuminat,longer,lower,lowermost,mature,membranous,midpoint,minute,naked,narrow-deltate,nflorescence,older,one,open,orolla,oung,pair,peduncle,pendulous,perfec,pericarp,poricidal,portion,primary,ray,red-brow,red-brown,reflexed,ruit,scar,slender,smooth,spaced,spreading,stalk,stellate-pubescen,strongly,tamen,terete,tertiary,time,tip,trichome,tube,unarme,unequal,unit,usually,variously,vary,vein,venation,visible,way,white,white-green,whitish,wide,yellow-green,ympodial	branching,colour,corolla,form,growth,height,heteromorphism,inflorescence,number,ovary,plant,position,seed,shape,staman,type,width,ye
460	wfo-0001031333	success	194	153	129	65	24	0.665	.5,0.1-0.5,0.5,1-1.5,1-4,1.5,1.5-1.7,1.5-2,1/2,2.5-3,3-4,3/4,50,7-10,7-9,>,?,abaxially,acuminate,acute,adaxially,adjacent,almost,anther,anthesi,apart,apex,appearing,articulated,base,berry,bilobed,branched,broadly,brown,calyx,capitate,clustered,cm,conical,densely,denser,diameter,ellipsoidal,elliptic,entire,exserted,filament,flattened,flower,glabrescent,glabrous,globose,golden,green,greenish,growth,half,immature,inflorescence,lengthening,like,lobe,lobed,long,lower,many,margin,membranous,mere,minute,minutely,mm,narrowly,near,new,nodding,occasionally,outline,ovate,pale,pedicel,peduncle,pentagonal,per,perfect,petiole,pitted,pore,poricidal,pubescent,pubescent-papillate,quadrate,reniform,rest,scar,simple,sinus,slit,somewhat,sparsely,splitting,stellate,stem,stigma,striped,strongly,style,surface,tangled,testal,thickened,time,tip,triangular,trichome,truncate,tube,twining,undulation,unevenly,uniseriate,upper,vein,venation,vine,way,whitish,x	+,1-5,1.2-2,2,2-3,2.7-7,30-40,5-7,5-8,5-merou,<,adaxiall,ag,alyx,ark,branche,cell,collection,composed,crea,cupped,eaf,eed,free,fruting,glabrescen,high,ilament,lamina,leaving,less,m.,matte,nflorescence,older,orolla,pair,papillat,peg,penden,pericarp,planar,plurifoliat,portion,primary,rhachi,ruit,slightly,small,soon,ste,tem,terminal,thin,trailing,ud,undersurface,unequal,unit,vary,white,woody,yellow,yellowish,ympodial	5-merous,age,articulation,bark,branch,branching,bud,colour,corolla,cream,form,fruit,fruiting,hair,leaf,length,mature,number,ovary,papillate,seed,shape,texture,type
461	wfo-0001031333	success	194	137	116	78	21	0.598	.5,0.1-0.5,0.5,1-1.5,1-4,1-5-2,1.5,1.5-1.7,2,2.5-3,3-4,50,7-10,7-9,>,?,abaxially,acuminate,acute,adaxially,adjacent,anther,apart,apex,articulated,bark,base,berry,bilobed,branched,broadly,brown,calyx,capitate,clustered,cm,corolla,cream,densely,diameter,ellipsoid,elliptic,entire,exserted,filament,flattened,fruiting,glabrescent,glabrous,globose,golden,green,greenish,growth,half,high,immature,inflorescence,lamina,leaving,lengthening,like,long,lower,many,margin,membranous,minute,minutely,mm,narrowly,near,new,outline,ovate,pale,pedicel,peduncle,peg,per,petiole,pitted,pore,poricidal,pubescent,pubescent-papillate,reniform,rest,rotate-stellate,scar,simple,slit,small,somewhat,spaced,sparsely,stellate,stem,stigma,strongly,style,surface,tangled,testal,time,tip,triangular,trichome,truncate,tube,uniseriate,vein,vine,white,whitish,wide	+,1-5,1.5-2,1/2,2-3,2.7-7,3,3/4,30-40,5-7,5-8,5-merou,<,adaxiall,ag,almost,alyx,anthesi,appearing,branche,cell,composed,conical,cupped,denser,eaf,eed,flower,free,glabrescen,ilament,less,lobe,lobed,m.,matte,mere,nflorescence,nodding,occasionally,older,orolla,pair,papillat,penden,perfect,pericarp,planar,plurifoliat,portion,primary,quadrate,rhachi,ruit,sinus,slightly,soon,splitting,striped,terminal,thickened,thin,trailing,tub,twinin,ud,undersurface,undulation,unequal,unevenly,unit,upper,vary,venation,way,woody,yellowish,ympodial	age,arrangement,articulation,branch,branching,bud,colour,exsertion,form,fruit,hair,leaf,length,maturity,number,ovary,papillate,seed,shape,texture,width
462	wfo-0001031359	success	166	120	99	67	21	0.596	.02,.25,.5,/4,0.5-1,0.5-6,0.75-1,1-4,1.2-1.6,1.2-2.5,1.5-2,1.6-2.8,1.9-2.3,12-21,2.5-3,3-3.5,3.6-8.8,5-angled,5.3-7.5,6-7,anther,anthesi,apart,attenuate,bark,base,beginning,beneath,berry,bi-lobed,brown,calyx,cm,corolla,dark,dia,dull,elliptic,filament,flattened-reniform,fruiting,glabrous,globose,green,incrassate,leaf,live,lobed,long,major,margin,minor,minutely,mm,narrowly,near,nearly,obovoid,opposite,outline,ovary,paler,papillae,papillose,pedicel,petiole,pit,pitted,planar,plant,pore,reflexed,ripe,round,rusty,scar,shaped,shiny,shrub,simple,size,slender,slightly,stem,stigma,style,surface,tan,tapering,tear-drop,trichome,tube,tuft,uniseriate,way,white,x,yellow,yellow-orange	1.1-1.6,1.3-1.6,5-30-flowered,5-7,acuminate,angle,apex,apiculate,appearing,axil,ba,broadly,curled,deflexed,differing,difoliate,distal,dried,eaf,edicel,eed,evenly,extending,free,geminat,inflorescenc,internodal,interpetalar,lamina,lateral,lobe,lon,lower,main,membraneous,middle,nflorescence,occasionally,often,older,one,originating,pair,papillo,poricidal,portion,ridged,ruit,sinus,somewhat,spaced,specimen,straight,strongly,tall,tip,triangular,tub,ud,undulate,unit,vein,white-lenticellat,widest,woody,ympodial,young	abaxial,branching,bud,colour,diameter,form,fruit,growth,hair,height,inflorescence,length,na,position,seed,shape,spacing,symmetry,texture,type,white-lenticellate
463	wfo-0001031362	success	138	96	77	61	19	0.558	.2,.3,.5,0.5-1,0.7-1,1-1.1,1-1.5,1.5-2,2-2.5,3-6,?,along,anther,anthesi,attenuate,bark,base,brown,calyx,closely,cm,conical,corolla,dendritic,densely,denser,dia,filament,flattened-reniform,free,fruiting,glabrous,globose,golden,incrassate,internodal,lanceolate,leaf,like,lobed,long,margin,minutely,mm,nearly,opposite,orange-red,ovary,packed,pale,papillose,pedicel,petiole,pitted,pore,pubescent,red,rest,shaped,shrub,simple,small-capitate,sparsely,stem,stigma,style,subshrub,surface,tan,tear-drop,tip,trichome,tube,vein,white,x,young	0.4-0.5,1-3,1-3-flowered,1-4,3-4,abaxially,acute,adaxially,apex,appearance,berry,branch,bushy,cell,eaf,edicel,eed,ellipsoid,erect,exceeding,exserted,flattened,giving,golden-brow,inflorescenc,lamina,lateral,lobe,lon,long-triangular,lower,main,middle,nflorescence,nodding,older,outline,overlappin,pair,papillo,pericarp,planar,plurifoliat,poricidal,portion,pubesent,rectangular,rounded,ruit,scar,shiny,slender,somewhat,spaced,straight,thin,ud,unit,widest,woody,ympodial	abaxial,adaxial,branching,colour,density,diameter,form,fruit,golden-brown,growth,hair,inflorescence,length,pattern,position,seed,shape,size,texture
464	wfo-0001031400	success	161	109	84	77	25	0.522	0.25-0.8,0.4-1.7,0.6-1.8,0.7-6,0.8-1.1,1-4,1.2-2,1.5-5,10-11,2-3,2-5,2-9,4-,4-13,4-17,4-6.5,5-12.5,6-23,7-25,7-28,abaxial,apical,apically,branched,cm,connate,corolla,cyme,dark,deeply,dehiscent,diameter,dichasially,distal,filament,flower,forked,globose,green,green-white,hair-like,herbaceous,interjected,introrse,lateral,leaf,leaflet,lobe,long,maturing,mm,odd-pinnate,often,ovoid,pedicel,peduncle,perennial,petiole,plant,poricidally,proximal,puberulent,seed,short,side,size,slit,stellate,straight,structure,style,subglabrous,terminal,throughout,tip,tone,tuber-bearing,unit,violet,wall,white,wide,yellow,Â¼	-3,1,1-,2,3-6-foliat,4-7,abaxially,abruptly,absen,acumen,acute,adaxially,apex,apiculate,articulate,base,calyx,cell,covering,cuneate,decurrent,dichasial,digestion,diminishing,dorsally,eaf,ebracteate,edge,eed,emoval,enzyme,exceeding,flat,folded,forming,generally,globo,half,honeycomb,linear,linear-lanceolate,living,lon,lower,lunat,make,monochasial,mucilaginous,nflorescence,nther,oblique,oblong,occasionally,orolla,pair,pattern,perfect,plan,rachi,reveal,ruit,sessile,seudostipule,specimen,stamen,stigma,stripe,tal,tem,testal,thick,toward,trilobe,typically,vary,without,ympodial	3-6-foliate,absent,anther,arrangement,articulation,branching,colour,form,fruit,growth,height,inflorescence,length,lunate,number,ovary,pore,present,pseudostipule,shape,stem,sympodial,texture,type,width
465	wfo-0001031401	success	182	114	98	84	16	0.538	0.5,0.6-1.2,0.8-1.2,1,1-1.4,1-1.5,1-6,1.1-3,1.5-2,1/2,2-2.4,2-5,2.5-4,3,3.5-4,3/4,5,5-7,5-9,7-9,abaxial,adaxial,anther,bark,base,bi-lobed,black,branching,brown,cm,corolla,dark,deflexed,dendritic,densely,diameter,drying,elliptic,filament,finely,flattened,fruit,fruiting,glabrous,globose,golden,golden-yellow,growth,leaf,lenticular,less,lobed,minutely,mm,narrowly,new,nodding,occasionally,ovary,pair,pedicel,per,petiole,pore,poricidal,prominently,puberulent,pubescent,purplish-black,pyramidal,raised,reddish-brown,roundish,scar,secondary,shiny,shrub,small,somewhat,sparsely,stem,stigma,strongly,style,tapering,time,tip,tree,tree-like,trichome,tube,vein,violet,way,white,winged,x,yellow	8-10,abaxially,acute,adaxially,age,along,anthesi,apex,apical,appearing,attenuate,axi,basal,becoming,berry,blade,branch,calyx,clearly,conical,deciduous,deltoid,denser,dichasial,differentiated,eaf,ecuador,ecuadorian,edicel,eed,ew,exserted,flower,fork,free,impressed,inserted,lateral,lobe,long,long-triangular,lower,m.,matted,mesophyll,monochasia,near,nflorescence,noddin,node,often,older,outline,overtopping,papillo,pericarp,pitted,planar,plurifoliate,portion,pubescen,rounded,ruit,shoot,short,sleev,slit-like,sometimes,specimen,stamen,ste,surface,tall,terminal,thin,tub,ud,unit,usually,visible,wide,woody,ympodial,young	bud,colour,form,height,inflorescence,length,number,papillose,plant,seed,shape,size,texture,type,venation,width
466	wfo-0001031480	success	237	106	87	150	19	0.367	0.1-0.3,0.1-0.4,0.4-0.8,0.5-2,0.6-0.8,1-1.3,1-1.5,1-2,1-3,1.5-2.2,1.7-2.2,1.8-3,2-2.7,3-10,3-7,4-6,5-8,5-merous,6-13,6-8,abaxial,acute,adaxial,anther,apex,bark,base,berry,branched,branching,bright,calyx,cm,cuneate,densely,diameter,dull,ellipsoid,entire,equal,flattened-reniform,flower,fruit,fruiting,glabrescent,glandular,hair,lateral,leaf,length,lobed,long,margin,mauve,midpoint,mm,moderately,obtuse,orange-brown,ovate,pale,pedicel,per,persistent,petiole,plant,prickle,prickly,purple,ray,red,shallowly,shrub,simple,spherical,stalk,stellate-pubescent,stem,style,terminal,thick-chartaceous,trichome,truncate,unarmed,wide,yellow,young	-0.25,-2,/3,0,0-0.5,0-1,0-2,0-30,0-5,0.1,0.15-0.3,0.2-0.35,0.4,0.5-,0.7,0.8,0.8-1,1-4,1/2,1/3,1/4,1/6-1/5,2-,2-3,2-5,2-6,3,3-6,3.5-7,4-5,6-30,7-8,8-12,abaxially,acuminat,alyx,andromonoecious,apar,apart,apically,apparently,articulated,ba,blade,broad-deltate,cell,cream,curved,dark,deltate,difoliate,discolorous,distal,distance,drying,eaf,eed,elongate,elongating,erect,extending,eye,faint,filament,flattened,free,geminat,glabrous,green,hermaphrodite,heterostylous,inconspicuous,infructescence,lobe,long-styled,longer,lower,lowermost,marking,mature,maturity,midvein,minutely,naked,near,nflorescence,often,older,one,open,orolla,oung,outline,pair,peduncle,pendulous,pericarp,pit,poricidal,porrect,portion,primary,pubescent,raised,red-brow,red-brown,red-green,red-yellow-green,reduced,reticulate,rounded,ruit,scandent,scar,sessile,short-styled,shorter,side,slender,slightly,small,smooth,somewhat,spaced,sparsely,spreading,stalked,staminat,stellate,straight,surface,tamen,tapering,terete,tertiary,time,tip,tube,unarme,unit,upper,variously,vary,vein,venation,visible,way,weakly,woody,ympodial	0.1-0.7,20-30,colour,corolla,form,growth,height,inflorescence,number,ovary,position,presence,seed,shape,size,staman,texture,type,width
467	wfo-0001031483	success	154	98	82	72	16	0.532	.5,/2,0.5,0.5-2,1,1-2,1.2-1.4,1.7-5.5,11-20.5,2-2.5,2-3,3-4,3-8-flowered,6-10,7-10,acuminate,acute,almost,anther,apart,apex,attenuate,base,clavate,cm,corky,corolla,dia,evenly,filament,filiform,flower,fruiting,fusiform,glabrous,green,indistinct,internode,larger,lateral,leaf,less,linear,lobed,long,main,markedly,minutely,mm,oblanceolate,obovate,obovoid,opposite,ovary,ovoid-reniform,pair,pale,papillose,pedicel,petiole,pore,poricidal,scar,shape,shaped,shrub,simple,slightly,spaced,stem,stigma,style,subshrub,tapering,tear-drop,tip,turbinate,vein,way,white,wing,x	0,1.1-2.5,1/3,2.5-3.2,across,anew,anthesi,ba,bearing,beginning,beneath,berry,blade,ca,caly,calyx,continuous,cork,decurrent,deflexed,deltoid,difoliate,distal,dry,eaf,edicel,eed,end,exserted,free,fresh,geminat,indistinc,lea,lenticellate,lobe,lower,major,minor,nflorescence,oblong,often,orbiculate,paler,papillo,per,planar,pointed,portion,prominent,quite,raised,rounded,ruit,short,short-triangular,slender,somewhat,soon,straight,strongly,tall,tan,third,tube,ud,unit,variable,widest,winged,woody,ympodial	bud,colour,form,fruit,growth,height,inflorescence,length,lenticel,plant,position,present,seed,size,texture,venation
468	wfo-0001031492	success	175	129	109	66	20	0.623	.5,/4,0.7-1.3,0.9-1.1,08,1-1.3,1-1.5,1.3-2,1.5-2.5,10-15,2-10,2-5,3-4,3-5,4-10,4-4.5,6-8,8-11,8-9,abaxially,absent,acuminate,acute,age,anther,apex,attenuate,bark,base,becoming,bi-lobed,bitter,branching,cm,corolla,dark,decurrent,dendritic,densely,diameter,drying,dull,echinoid,elliptic,filament,flattened,flower,fruit,fruiting,glabrous,globose,golden,grey,growth,juice,leaf,lenticular,lightly,lobed,long,lower,medium,minutely,mm,narrowly,ovary,pair,pedicel,per,pericarp,petiole,pitted,pore,poricidal,prominent,pubescent,purplish-black,pyramidal,reddish-brown,remaining,scar,scattered,shiny,short,shrub,size,sleeve,slit-like,somewhat,sparsely,stem,sticky,stigma,style,surface,thin,time,tip,tree,tree-like,trichome,tube,upper,vein,violet,way,winged,woody,x	0.5,1.5-1.8,2-3,20,adaxially,anthesi,apical,appearing,axe,ba,basal,beneath,berry,calyx,conical,dbh,deciduous,deltoid,denser,distinguishable,eaf,edicel,eed,erect,ew,exserted,free,inserted,lamina,lateral,lobe,m.,monochasia,nflorescence,nodding,occasionally,older,overtopping,papillo,planar,plurifoliate,portion,predominantly,rather,ruit,scarcely,secondary,shoot,slightly,sometimes,stamen,ste,strongly,sunken,tall,tapering,terminal,tub,ud,undersurface,unit,upturned,wide,ympodial,young,younger	bud,colour,consistency,form,height,inflorescence,insertion,length,new,number,papillose,plant,presence,prominence,seed,shape,texture,thicknes,type,width
469	wfo-0001031503	success	142	107	83	59	24	0.585	-10,-15,-30,-7,0.3-3,0.5-1,0.5-4,1-2.5,1-3,1-5,1-7,1.5-2,1.5-3,1.5-8,10-19,2-3,2.5-10,3-4,3-5,3-6,6-7,7-10,acuminate,acute,angled,apart,apex,base,branched,calyx,chartaceous,cm,cuneate,cylindrical,decurrent,deltate,densely,diameter,directed,distally,elliptic,entire,flower,forked,glabrous,globose,hair,lanceolate,lobe,margin,mm,moderately,obtuse,often,orange,ovate,pedicel,peduncle,petiole,pore,puberulent,pubescent,rachi,radiu,rarely,reddish,ripe,rounded,rugose-pubescent,shrub,simple,slightly,sparsely,stellate,stigma,style,subclavate,truncate,unbranched,unequal,white,x,yellow	-25,-6,1-,1.5-7,1.7-3.5,3-15,5613,6-many-foliat,7-15,abaxially,abruptly,absen,adaxially,aggregate,articulated,axe,ba,blade,cell,connivent,curled,distall,eaf,eed,eglandular,except,fide,gland,long,lower,mostly,narrowed,narrowly,nflorescence,nther,occasionally,orolla,perfect,present,ruit,spaced,stalked,stone,subcapitat,tal,tem,time,tip,toward,triangular,tube,uniseriate,unit,usually,vary,vein,venturi,wide,ympodial	abaxial,adaxial,anther,articulation,branching,colour,corolla,direction,form,fruit,growth,height,inflorescence,leaf,length,ovary,plant,seed,shape,spacing,stem,subcapitate,texture,type
470	wfo-0001031586	success	167	64	52	115	12	0.311	-2,0.1-1,0.5-1,1-1.2,1-1.5,1-2,1.3-5,1.4-2.5,1.5-2,2,3-11,5-6,anther,base,calyx,capitate,cm,corolla,cream-colored,deltate,dia,elliptic,filament,flower,glabrous,green,greenish,inflorescence,leaf,lobe,lobed,mm,nearly,opposite,pale,pedicel,petiole,pore,ridged,rounded,shaped,shiny,shrub,simple,size,stigma,style,tear-drop,tube,white,x,yellow	.25,0.5-0.8,1,2-2.5,5-10,7-10-flowered,abrupt,absent,acute,anthesi,apart,apex,apparently,appearing,attenuate,bark,becoming,beneath,borne,branch,bright,broadly,bud,campanulate,closer,completely,conical,cucullate,deflexed,differing,difoliate,distance,drying,eaf,edicel,eed,ellipsoid,exerted,exfoliatin,fleshy,free,fresh,geminate,globose,gree,inflorescenc,know,known,later,lateral,leave,long,lower,main,major,margin,material,may,minor,minutely,mucro,near,new,nflorescence,notched,occasionally,older,olive,one,onto,open,ovary,overtopping,pair,paler,papillate,papillose,planar,poricidal,portion,present,prominent,raised,remaining,ruit,scar,shap,shin,slender,small,sometimes,somewhat,soon,spaced,sparsely,stem,straight,surface,swollen,tall,tapering,thick,thickened,tip,trichome,truncate,trunk,ud,uniseriate,unit,vein,widely,yellowish,ympodial,young	7-10,colour,form,growth,height,length,number,plant,position,shape,texture,type
471	wfo-0001031587	success	142	101	83	59	18	0.585	.5,0.8-1,1-1.5,1.5-2,1.7-2,10-15,12-16,17-30,2-9-celled,2/3,5,6-7,6-8,abaxially,acute,adaxially,anther,apex,attenuate,bark,base,bi-lobed,calyx,clavate,closely,cm,cone,corolla,deflexed,dendritic,densely,elliptic-ovoid,exserted,filament,fleshy,furcate,glabrous,globose,golden-red,included,inflorescence,leaf,lobe,lobed,major,minor,minutely,mm,oblique,occasional,older,ovary,pale,papillate,pedicel,perpendicular,petiole,pore,pubescent,rarely,reddish-grey,scar,shape,shaped,simple,size,soft,somewhat,spaced,stem,stigma,style,tear-drop,thick,thickened,tree,trichome,tube,uniseriate,verrucose,way,x,young	2,2-2.5,3-4,7-9,along,anthesi,apart,axi,broadly,conical,decurrent,deltate,denser,dia,differing,drying,eaf,edicel,eed,elliptic,erect,evenly,fide,free,irregular,know,known,lamina,later,lateral,like,long,loose,lower,lowered,main,middle,mostly,ocasionally,overlappin,pair,papillo,parallel,persisten,poricidal,portion,rect,rest,ruit,steinbach,surface,tall,tip,tub,ud,vein,white,widest,winged	bud,colour,deflexion,diameter,exsertion,form,growth,hair,height,inclusion,length,occasionally,overlapping,papillose,persistent,plant,texture,thicknes
472	wfo-0001031589	success	222	80	61	161	19	0.275	0-30,0.1-0.5,1/3-1/4,2-10,2.8-4,8-14,anther,articulated,base,berry,bright,brown-green,calyx,chartaceous,cm,connivent,dull,elliptic,elongating,equal,flattened-reniform,flower,fruit,fruiting,gray-green,lateral,leaf,length,lobed,long,long-obovate,margin,mauve,membranous,mm,orange-brown,pedicel,per,petiole,poricidal,porrect,prickle,sessile,shrub,simple,solitary,sometimes,spherical,stalked,stellate,stellate-pubescent,stem,straight,surface,tapering,tip,trichome,way,white,yellow,yellow-green	-0.5,-15,-6,-6.5,.5,/6,0,0-1,0-10,0-3,0.1,0.15-0.3,0.2-0.4,0.2-0.5,0.2-3,0.4,0.5-1,0.55-0.7,0.6-1.2,0.7,0.8-2.3,0.9-1.3,0.9-1.6,1,1-1.8,1-5,1.2-1.5,1.5-5,1.7-2.5,1.8-2.9,1/3,1/3-1/2,10-30,2-,2-3.5,2.5-4.5,2.5-6,3-4,3-5,3/4,4-6.5,4/5,5-8,5-merous,6-8,8-30,abaxially,acute,alyx,ame,apart,apex,apically,apparently,attenuate,bark,blade,broadly,brow,c.,caudat,cell,concolorous,cream,dark,deltate,densely,density,diameter,difoliate,discolorous,distance,drying,eed,erect,extending,eye,filament,free,geminat,glabrescent,glabrous,green,higher,infructescence,lengt,lobe,lon,longer,lower,marking,mature,maturity,midpoint,midvein,moderately,multangulate,naked,narrow,narrow-cuneate,nflorescence,oblong,obovate,occasionally,often,older,orange-green,orolla,oung,outline,pair,pale,part,pendulous,perfec,pericarp,pit,plant,portion,prickl,prickly,primary,raised,ray,reflexed,rounded,ruit,scandent,shiny,shorter,side,small,smooth,somewhat,spaced,sparsely,spreading,stalk,stout,style,subentire,subsessile,tamen,terete,tertiary,time,tube,unit,upper,vary,vein,venation,visible,weakly,whole,wide,winged,woody,yellow-orange,ympodial,young	articulation,branching,colour,corolla,form,growth,hair,heteromorphism,inflorescence,number,orientation,placement,position,seed,shape,staman,symmetry,texture,type
473	wfo-0001031609	success	154	116	89	65	27	0.578	0.4-3,0.5-3,1-10,1-6,1.3-3,1.5-2,1.5-3,10-25,2,2-,2-3,2.5-4,20-25,3-24,3-5,3-9-lobed,4,4-5,4-6,4.5-60,8-20,acute,apex,around,articulated,base,brownish,calyx,campanulate,cm,connective,cuneate,dark,deltate,dia,diameter,dilated,directed,distally,ellipsoidal,elliptic,elliptic-ovate,entire,flattened,fleshy,flower,forked,fruit,glabrous,globose,green,inflorescence,laterally,leaf,lobe,lobed,margin,mm,obconical,obovate,obtuse,orange,pedicel,peduncle,petiole,pinnately,pore,puberulent,rachi,radiu,reticulate,ripe,shallowly,shrub,simple,small,stellate,stigma,strongly,style,succulent,tree,triangular,truncate,tube,unbranched,unlobed,x,yellow	.5,/4,0-30,0.5-1,3-foliat,5-25,5/6,abaxially,absen,absent,adaxially,aggregate,ape,apiculate,axe,barely,beyond,bilobe,blade,branch,brow,cell,connivent,conspicuous,contiguous,divided,eaf,eed,emerging,equal,exceeding,exserted,glabrou,leaving,long,lower,midrib,minutely,nearly,nflorescence,nther,occasionally,orolla,papillose,pedicellar,point,rounded,ruit,scar,sinus,stamen,stone,succulen,tal,tem,thecae,time,tip,tomento,two,ud,unit,vary,wide,ympodial	10-30,anther,articulation,bilobed,branching,brown,bud,colour,corolla,form,growth,height,length,lobing,number,ovary,plant,pubescence,reticulation,seed,shape,size,stem,succulence,texture,theca,type
474	wfo-0001031615	success	154	138	116	38	22	0.753	.5,0.5,0.5-1,0.8-1,0.9-1.1,1-1.6,1.3-1.8,1.5,1.5-5,11-15.5,2-3,2-4.2,3.8-6.1,4-6.5,5-20-flowered,5-6,8-10,acuminate,acute,anther,anthesi,apex,attenuate,axil,bark,base,bilobed,brown,calyx,capitate,closely,cm,corolla,decurrent,deep,deflexed,deltoid,dia,difoliate,distal,elliptic,expanded,exserted,filament,fruit,fruiting,furcate,glabrous,glandular,globose,green,incrassate,inflorescence,interpetalar,lateral,leaf,less,lobe,lobed,long,main,major,margin,minor,minutely,mm,nearly,occasionally,older,opposite,ovary,packed,pair,paler,papillose,pedicel,petiole,pitted,pore,portion,reflexed,scar,scarcely,shaped,shrub,simple,sinus,size,slender,slightly,small,somewhat,stem,stigma,style,subumbellate,surface,tapering,tear-drop,terminal,thickened,thin,tree,trichome,tube,tuft,unicellular,uniseriate,unit,urceolate,vein,white,winged,woody,x,young	0,6-8,arising,ba,becoming,berry,caly,dark,dark-papillo,differing,eaf,edicel,eed,flattened-reniform,free,geminat,impressed,lamina,lon,lower,maroo,middle,minute,nflorescence,one,overlappin,papillae,per,poricidal,prominent,ruit,shiny,straight,tall,tip,ud,widest,ympodial	bud,colour,dark-papillose,diameter,exsertion,flower,form,geminate,growth,hair,height,length,lobing,maroon,placement,plant,position,seed,shape,structure,sympodial,texture
475	wfo-0001031618	success	184	98	81	103	17	0.44	-2,0-3,1-1.5,2-3,3-4,4-5,40-60,90-110,acute,anther,apex,axil,base,branch,calyx,capitate,cell,cm,corolla,cuneate,cyme,darker,discoidal,ellipsoid,elliptic,equal,exerted,facetted,filament,finely,glabrous,glandular,green,greyish,hair,lanceolate,lavender-purple,leaf,less,long,marbled,maturity,minute,mm,narrowly,oblong,obovoid,often,ovary,ovoid,pale,pedicel,peduncle,petiole,pinatisect,pore,poricidal,purple,reddish-brown,reticulate,ripe,rotate,rounded,rugose,scorpioid,shrub,simple,somewhat,stem,stigma,stone,stripe,strongly,succulent,surface,tapering,terete,tinged,tip,unequal,variable	0.5-1.5,1-7,1.5-2,1.5-3.5,10-18,10-lobed,13,2-2.5,3,3-8,5,5-12,acuman,almost,also,anthesi,appearance,appearing,aspect,becoming,berry,beyond,blunt,bluntly,broadly,c.,clonal,cluster,column,conical,covering,cut,developed,dia,eaf,eed,emarginate,enlarged,erect,except,extending,fleshy,floral,flower,fork,forked,frui,general,giving,greatly,gree,growing,habit,half,interacuminal,lasting,lengthening,lobe,lobed,lon,loosely,lower,mauve,may,mid-vein,midrib,nflorescence,occasional,occur,ovate-lanceolate,pal,pedicellate,petal,plurifoliat,point,rarely,rhachi,ruit,sessile,several,shallowly,side,single,sinus,slit,soft-wooded,sometimes,specimen,stout,styl,tissue,triangular,tub,ud,unit,vigorous,way,well,x,year,ympodial,young,younger	bud,colour,form,fruit,growth,height,inflorescence,length,number,plant,position,seed,shape,style,symmetry,texture,tube
476	wfo-0001031646	success	171	128	106	65	22	0.62	-7,-pinnate,.2,.5,0.2-0.8,0.5-2,0.8-1.5,1-1.8,1-10,1.2-2.5,1.5-3.5,1.5-4,15-25,2-10,2-2.5,2-3,2.5-10,20,3.5-4,4-18,4-20,4-5,5,5-6,5-7,5-7.5,7-8,8-15,acuminate,acute,anther,apart,apex,articulated,base,blade,blue,branched,brown,calyx,chartaceous,cm,cuneate,cylindrical,darker,densely,diameter,directed,ellipsoidal,elliptic-lanceolate,entire,flattened,flower,fruit,fruiting,glabrous,globose,green,hair,highly,homostylous,hyaline,immature,leaf,leaflet,light,lobe,long,margin,maroon,mature,mm,multicellular,oblique,obliquely,oblong,obtuse,ovate-lanceolate,pedicel,peduncle,petiolule,pore,pubescent,rachi,red,rotate-pentagonal,rounded,rugulose,scandent,shortly,shrub,simple,size,small,smooth,stem,stigma,style,surface,tip,tube,uniseriate,vine,violet,x,yellow	1-6,18-38,1962,4-8,4-foliate,5-merou,abaxially,absen,absent,accrescent,acut,adaxially,aggregate,alyx,apical,apparently,axe,ba,basally,berry,cell,ciliat,climbing,connivent,correll,covered,decreasing,distall,eaf,eed,elliptic,equal,fide,filament,geminat,glandular,high,interjected,lateral,lower,nflorescence,orolla,ovate-lanceolat,part,perfect,petiole,present,pubescen,pubescence,ruit,seudostipule,slightly,spaced,spreading,stone,stout,tamen,tawny,tem,toward,tree,truncat,unit,vary,ympodial	abaxial,adaxial,arrangement,articulation,branching,ciliate,colour,corolla,distally,form,growth,inflorescence,length,ovary,pseudostipule,seed,shape,spacing,staman,symmetry,texture,truncate
477	wfo-0001031651	success	201	79	62	139	17	0.308	/3,/5,0-20,0.3-0.8,0.3-1.5,4-6,abaxial,adaxial,anther,articulated,base,berry,branched,calyx,chartaceous,cm,cordate,densely,dull,elliptic,elongating,entire,flattened-reniform,fruit,fruiting,herb,lateral,leaf,length,lobed,long,margin,mature,maturity,mm,obtuse,orange-brown,ovate,pedicel,per,petiole,poricidal,prickle,prickly,purple,red,rounded,shrub,simple,sometimes,spherical,spreading,stellate-pubescent,stem,subentire,tapering,terminal,tip,way,weakly,white,yellow	-2,-3,-3.5,.1,.6,.7,0.1,0.1-0.15,0.1-0.2,0.1-0.25,0.15-0.2,0.2-0.5,0.3-0.5,0.6-1,0.6-1.3,0.7-1,1,1-1.7,1-2,1-4,1.2-2,1.2-3,1.3-1.6,1.5-2,1/5,1/6-1/4,2-10,2-3,2-3.5,2/3-3/,3-5,4-5,4.5-7,5-merous,abaxially,absent,acuminat,acute,alyx,ame,apar,apart,apex,apically,apparently,bark,blade,brown,c.,cell,concolorous,curved,dark,deltate,diameter,difoliate,discolorous,drying,eaf,eed,equal,erect,eye,faint,filament,filiform,flower,free,geminat,glabrescent,glabrous,gra,gray,herbaceous,infructescence,lanceolate,lobe,longer,lower,midpoint,naked,nflorescence,oblong,older,one,open,orolla,oung,outline,pair,peduncle,pendulous,perfec,pericarp,persistent,pit,porrect,portion,prickl,primary,raised,ray,red-green,reflexed,ruit,scandent,scar,shorter,small,smooth,spaced,stalk,stalked,stellate,straight,style,subsessile,surface,tamen,terete,tertiary,thick,thick-stalked,time,toward,trichome,tube,unarme,unarmed,unit,upper,variously,vary,vein,venation,visible,wide,yellow-green,ympodial	articulation,branching,colour,corolla,form,growth,height,inflorescence,number,plant,position,seed,shape,symmetry,texture,type,zygomorphy
478	wfo-0001031656	success	154	115	95	59	20	0.617	.5,/4,0.5,0.5-1,1-2.5,1.5-2,1.5-5,10-20,2.5-3.5,3-3.5,3-5,4-9,5-ribbed,6-8,acuminate,acute,anther,anthesi,apex,bark,base,calyx,capitate,closely,cm,corolla,dia,drying,ellipsoid,elliptic,enclosing,filament,fleshy,fruit,fruiting,glabrous,globose,green,greyish,known,leaf,lobe,lobed,long-acuminate,lower,matte,mature,minor,minutely,mm,oblique,often,older,opposite,ovary,ovate,paler,pedicel,persistent,petiole,planar,plant,pore,portion,rather,red-papillose,reddish,reflexed,rib,rounded,scar,sessile,shaped,shiny,shrub,size,slightly,somewhat,spaced,stem,stigma,style,surface,tear-drop,terminal,thick,thickened,tip,transversely,upper,way,white,woody,x,young	1-1.5,1-2,1.2-1.5,5-7,also,arising,ba,berry,bright,cork,densely,differing,difoliate,directly,eaf,edicel,eed,erect,extremely,flower,free,geminat,hooded,lateral,live,lon,long,main,major,margin,middle,minute,nflorescence,node,one,pair,pale,papillo,papillose,peelin,poricidal,prominent,proximal,ridged,ruit,specimen,straight,strongly,swollen,tall,top,tube,ud,unit,vein,visible,wide,widest,ympodial	bud,colour,corky,diameter,form,function,growth,hair,height,inflorescence,information,length,peeling,persistence,position,seed,shape,texture,thicknes,type
479	wfo-0001031667	success	153	98	70	83	28	0.458	0.6-1,0.6-1.5,1-1.5,1-4,1.4-3,1.5-2,10-13,12-35,2-5,2.5-5,3-13,3-5,5-15,5-9,6-10,8-13,8-15,apically,branched,calyx,cm,connate,corolla,cyme,dark,dehiscent,diameter,dichasial,dichasially,distal,filament,flower,globose,green,herbaceous,interjected,irregularly,lateral,leaf,leaflet,lobed,long,mm,monochasial,mucilaginous,odd-pinnate,ovoid,pedicel,peduncle,perennial,perfect,petiole,pilose,plant,poricidally,proximal,seed,size,spot,stellate,straight,stripe,style,terminal,tuber-bearing,unit,white,wide,yellow,Â¼	2-3,2-6,3-6-foliat,3-8,4-1.,abaxially,abruptly,acumen,acuminate,acute,adaxially,apex,apical,apiculate,articulate,base,caudate,cell,cordate,covering,cuneate,digestion,diminishing,dorsally,eaf,ebracteate,edge,eed,elliptic-lanceolate,emoval,enzyme,exceeding,flat,folded,forked,generally,globo,green-white,hair-like,half,honeycomb,introrse,lanceolate,living,lobe,lon,lower,lunat,make,maturing,nflorescence,nther,oblique,oblong,often,orolla,pair,pattern,petiolate,petiolule,plan,reveal,rounded,ruit,sessile,seudostipule,short,slit,specimen,stamen,stigma,tal,tem,testal,thick,throughout,toward,typically,vary,wall,whit,without,ympodial	3-6-foliate,4-10,anther,arrangement,articulation,bract,branching,colour,ebbrate,form,fruit,growth,hair,height,inflorescence,length,lunate,number,ovary,pore,pseudostipule,shape,stem,structure,sympodial,type,wet,width
480	wfo-0001031672	success	157	90	48	109	42	0.306	1-5,1.5-5,4.5-5,9-lobed,abaxially,adaxially,apex,base,calyx,cell,chartaceous,cm,connective,cordate,densely,directed,distally,fruit,glandular-puberulent,globose,green,greenish-brown,hair,leaf,margin,mm,narrowly,near,ovate,ovoid,pedicel,petiole,pilose,pore,present,puberulent,simple,sparsely,stellate,stone,subcoriaceous,tree,triangular,truncate,unbranched,unit,whitish,yellow	0,0-2,0.3-0.5,0.5,0.5-1,0.5-1.5,1,1-,1-1.5,1-10,1-2,1.5-2,1.5-2.5,1.5-3.5,10-20,15-20,15-50,2-12,2-28,3-4-foliat,3/4,4,4-34,4/5,5-6,6,absent,acuminate,acute,aggregate,apart,ape,apiculate,articulated,aublet,axe,basal,beyond,blade,ciliat,cylindrical,diameter,divided,eaf,eed,entire,exceeding,exserted,fide,flattened,fleshy,flower,glabrous,lanceolate,leaving,lobe,lobed,lon,long,lower,mature,membranaceous,midrib,moderately,nflorescence,nther,obtuse,occasionally,often,one,orolla,pedicellar,peduncle,perfect,pilo,pinnately,presen,pubescent,purple,rachi,radiu,remant,represented,rounded,ruit,shorter,sinus,slightly,small,spaced,stamen,stigma,style,tal,tem,thecae,time,tip,toward,truncat,tube,ud,unlobed,vary,white,wide,x,yello,ympodial	3-4-foliate,anther,articulation,berry,bract,branching,breeding,colour,corolla,filament,form,fruiting,growth,height,heteromorphism,inflorescence,insertion,length,lobing,marking,modification,na,odour,orientation,placement,plant,position,prickle,pseudostipule,rhizome,shape,spot,staman,structure,symmetry,sympodial,system,texture,tuber,type,xylopodia,zygomorphy
481	wfo-0001031684	success	161	77	64	97	13	0.398	.5,/4,0.4-1.5,0.5-0.7,0.5-0.8,0.75-1,1-1.2,1-5,2-9,3-3.5,3-30,4-17,acute,anther,base,branched,calyx,cm,corolla,curly,decurrent,densely,elliptic,filament,filiform,fruiting,globose,green,inflorescence,internodal,irregularly,leaf,like,lobed,long,mm,obconic,occasionally,opposite,ovoid-reniform,pale,pedicel,petiole,pore,pubescent,rest,shaped,short,shrub,size,slender,slightly,small,tan,tapering,tear-drop,tipped,tree,trichome,tube,uniseriate,way,white,x	.25,.75,0.1,0.5-1,0.7-1,10-100,2,5-7,acuminate,along,anthesi,apar,apex,bark,bearing,beneath,berry,black,borne,causing,clavate,deflexed,denser,dia,differing,difoliate,drying,eaf,edicel,eed,elongated,except,expanded,exserted,extremely,flower,free,geminate,glabrous,gre,greatly,lateral,less,lobe,lon,long-triangular,lower,main,major,middle,midrib,minor,minutely,nflorescence,older,one,ovary,pair,papillo,papillose,persistently,pitted,planar,poricidal,portion,present,previously,pulled,raised,reflexe,reflexed,ruit,scar,single,siz,soon,spaced,sparsely,stem,stigma,straight,style,surface,tall,time,tip,ud,unevenly,unifoliate,unit,varying,vein,widely,widest,winged,ympodial,young	branching,colour,form,fruit,growth,hair,height,length,plant,position,seed,shape,texture
482	wfo-0001031695	success	185	124	103	82	21	0.557	0.5-1,1-2,1-9,1.5-8,10-35,2-3,2.5-5,20-30,3-17,3-19,3-7,30-40,4-10,4-5,4-6,5-20,6-10,6-20,?,abaxially,abruptly,acuminate,adaxially,aggregate,also,apex,apically,base,branched,calyx,campanulate,cell,chartaceous,cm,color,connective,cordate,cylindrical,dark,deep,densely,diameter,dilated,directed,ellipsoidal,entire,flattened,flower,fruit,glabrescent,glabrous,glandular-puberulent,green,greenish,hair,immature,lanceolate,laterally,lavender,leaf,lilac,lobe,lobed,margin,mm,moderately,mottled,narrowly,oblique,oblong,occasionally,ovate,pedicel,peduncle,petiole,pilose,pilose-hirsute,pore,present,puberulent,puberulent-pubescent,pubescent,purple,purplish,rachi,radiu,ripe,shrub,simple,slightly,sometimes,sparsely,stigma,stone,stripe,style,subcoriaceous,tree,triangular,unbranched,unknown,x,yellow	0.5-2,1,1-3,1.5-2,1/2,1/3,10-,10-15,15-20,2-4,2-5,3-,3-10,4-foliat,5,5-7,6-8,7-,acute,apart,ape,apiculate,articulated,axe,basal,beyond,blade,broadened,capitat,connivent,d,divided,eaf,eed,eglandular,eglandular-pilose,exceeding,exserted,fleshy,glabrate,hard,lateral,leaving,lon,long,lower,midrib,nflorescence,nther,obtuse,often,orolla,ovoid,pedicellar,perfect,pilo,pilose-hirsut,presen,remnant,rounded,ruit,shorter,sinus,slight,small,somewhat,spaced,stamen,swelling,tal,tem,thecae,time,tip,tomento,tube,unequal,unit,unlobed,vary,wide,ympodial	anther,arrangement,articulation,branching,capitate,colour,corolla,form,growth,height,inflorescence,length,number,ovary,plant,seed,shape,size,stem,texture,theca
483	wfo-0001031698	success	58	47	28	30	19	0.483	2-2.5,2.5,2.5-3,4-4.5,base,cm,difoliate,flattened,fruiting,glabrous,incrassate,leaf,margin,minutely,mm,paler,papillae,pedicel,pitted,reddish-brown,reniform,shrub,strongly,surface,unit,winged,x,yellowish	'',``,ape,bark,branch,decurrent,deflexed,dia,dull,eaf,eed,elliptic,fide,geminat,green,long,maguire,older,otherwise,pale,persistin,repandly,rugose,stem,stout,tall,wing,woody,ympodial,young	1,apex,branching,colour,diameter,form,geminate,growth,hair,height,length,pattern,plant,seed,shape,size,structure,sympodial,texture
484	wfo-0001031707	success	178	110	92	86	18	0.517	.5,/4,0.5-1,1-1.2,1-1.3,1-1.5,1.5-1.7,1.5-6,16-20,2-3,2-4,2-6,4-5,8-12,80-140,9-15,acuminate,acute,almost,anther,anthesi,apex,apically,attenuate,axillary,base,basiscopically,brown,calyx,capitate,cell,cm,conical,corolla,densely,diameter,elliptic,enlarged,epidermal,erect,filament,flap-like,flat,flattened,flower,fruiting,glabrous,globose,green,greenish,lanceolate,leaf,leaflet,less,lobed,long,mm,narrowly,oblique,obovate,occasionally,open,ovary,pair,pedicel,per,petiole,petiolule,pink,pinnate,pointed,poricidal,pubescent,reddish,regular,round,sagittate,simple,slightly,sparsely,stigma,style,thickening,tip,trichome,tube,type,uniseriate,vine,way,white,x	-3,1-3,1.2-1.8,1.2-2,1.5-2,1/3,2,2-10,24,3,4-6,5-10-celled,6-7,abaxially,absent,adaxially,along,apical,axil,basal,bearing,berry,c.,cateniform,clavat,climbing,conspicuously,cucullate,dense,distal,distinct,drying,eaf,edicel,eed,endrophilum,exserted,fleshy,four-lobed,free,high,horizonta,inflorescenc,lateral,like,lobe,lon,lower,margin,minutely,narrower,nflorescence,papillate,penden,planar,plant,portion,primary,quadrate,quite,raised,rest,ruit,scar,scattered,smaller,smooth,somewhat,spaced,stout,strongly,surface,tem,terminal,ternate,time,tub,ud,unifoliat,unit,usually,vein,white-lenticellate,widely,woody,ympodial	arrangement,cateniforme,clavate,colour,form,fruit,growth,horizontal,inflorescence,length,number,orientation,position,seed,shape,size,stem,texture
485	wfo-0001031723	success	228	101	84	144	17	0.368	0.6-1,1/3-1/2,10-30,2/3-3/4,3-10,4-6,abaxial,abaxially,adaxial,anther,apex,base,berry,branching,brown,calyx,chartaceous,cm,conical,dark,dull,elongating,entire,equal,evenly,flattened-reniform,flower,fruit,fruiting,glabrescent,glabrous,green,hair,lateral,leaf,length,lobed,margin,marking,mature,maturity,mauve,minute,mm,moderately,multangulate,one,open,orange,orange-brown,ovate,pale,per,perpendicular,petiole,poricidal,prickle,primary,red,reflexed,secondary,sessile,shrub,simple,sometimes,sparsely,spherical,stalked,stellate,stellate-pubescent,straight,style,tapering,terminal,time,tip,unarmed,way,weakly,white,whitish,yellow,yellow-green,young	-1.5,-1/2,-15,-16,-2,-5,-6,-6.5,-8,-merous,0,0.05-0.2,0.1-0.2,0.1-0.3,0.1-0.5,0.15,0.2-1,0.4,0.4-,0.4-0.9,0.4-1,0.55-0.9,0.7-1,0.8-1.5,1-,1-2,1-2.5,1-3,1-5,1.2-2,1.5-,1.5-10,1.5-2.5,1/4-1/3,1/6-,15-45,2-,2-3.5,2-5.5,2-7,2.5-4.5,2.5-5,2/3,3-15,4-,4-10,4-11,4-20,4-5,5-40,5-9,8-20,acuminate,acut,acute,alyx,ame,apar,apart,apically,apparently,articulated,ba,bark,blade,branched,brow,c.,connivent,cuneate,curved,deltate,densely,diameter,discolorous,drying,eaf,eed,elongated,erect,eye,filament,filiform,finely,free,gently,gland,gland-tipped,glandular,gray,herbaceous,inflated,infructescence,lobe,long,longer,lower,midpoint,naked,narrow-deltate,near,nflorescence,obtuse,older,orolla,oung,pair,pedicel,peduncle,perfec,pericarp,plurifoliat,porrect,portion,prickly,ray,recurved,rounded,ruit,scar,smooth,spaced,spreading,stalk,stem,strongly,subentire,surface,tamen,terete,tertiary,trichome,tube,unarme,unit,usually,variously,vary,vein,venation,visible,wide,woody,ympodial	8-15,colour,corolla,form,growth,heteromorphism,inflorescence,number,orientation,ovary,placement,position,seed,shape,staman,texture,type
486	wfo-0001031729	success	161	105	79	82	26	0.491	-2,0.5-1,0.5-4,1-1.5,1-2,1.0-1.3,1.5-2,2-2.5,2-3,2.5-5,3-4,5-6,5-7,abruptly,acuminate,anther,apex,apiculate-deltate,attenuate,base,branch,branched,calyx,cell,cm,conical,corolla,dark,darker,deltate,diameter,elliptic,elongate,filament,flattened,flower,fruit,fruiting,glabrous,globose,green,greenish,later,lobe,lobed,markedly,mm,mottling,nearly,obovate,occasionally,outline,ovary,ovate-reniform,pale,papillate,pedicel,peduncle,per,petiole,pink,pointed,purplish,quadrate,reddish,shrub,sinuate,smooth,somewhat,stem,stripe,surface,tan,testa,time,tube,white,x,young	-0.5,-45,..,0.5,0.6-,1-2.5,1.5,10-20,11-30,12-13,2.5-,3-celled,3.5-4,4.1-16,5-,50,8-9,along,anthesi,apicula,beneath,branc,brittle,brow,c.,cucullate,curve,dry,drying,eaf,edicel,eed,erec,flattened-capitat,glandular,gradually,less,long,lower,membranous,middle,minute,minutely,narrowly,never,nflorescence,noddin,open,outer,pair,papillae,papillose,pericarp,planar,plurifoliat,point,primary,regularly,ruit,scar,scattered,short,single,single-stemmed,small,stigma,striate,thin,thing,tip,toward,triangular,trichome,tuft,ud,unit,usually,vein,wall,wand-like,widening,ympodial	0-0.5,0.6-2.5,1,5-20,arrangement,branching,brown,bud,colour,curved,erect,form,glabrousnes,growth,height,inflorescence,leaf,length,nodding,number,orientation,plant,plurifoliate,seed,shape,texture
487	wfo-0001031738	success	231	101	81	150	20	0.351	0.7-1.1,1.5-4,1/3,1/4-1/3,20-200,4-6,5,6-15,abaxial,acute,adaxial,anther,apart,apex,auriculate,base,berry,branched,calyx,chartaceous,cm,connivent,cordate,curved,dark,densely,dull,elongating,equal,evenly,flattened-reniform,flower,frequently,fruit,fruiting,gray,green,lateral,leaf,length,lobed,long,lower,margin,mature,maturity,mm,orange,orange-brown,ovate,pale,per,petiole,poricidal,prickle,prickly,shrub,simple,small,sometimes,spaced,spherical,stellate,stellate-pubescent,stem,straight,style,surface,tapering,terminal,tip,tree,truncate,unarmed,upper,weakly,white,yellow,yellow-green,yellowish,young	-15,-5,-6,-merous,.5,0,0-2,0-3,0.1-0.25,0.2-0.3,0.25-0.8,0.3-1,0.7-1,0.9-2.1,1-1.5,1-1.8,1-3,1-4,1.4-1.7,1.5-,1/,1/2-2/3,1/3-2/3,1/6-1/4,10-15,15-40,2-,2-4,2.3-3,3-4,3-6,3-7,3.5-3.8,3.5-4.5,4,4-10,4-5,4-8,5-8,7-12,7-12.5,8-10,8-18,abaxially,acuminat,adaxially,almost,always,alyx,andromonoecious,apar,apically,apparently,articulated,bark,blade,cell,deltate,diameter,discolorous,distal,distance,drying,eaf,eed,erect,extending,filament,flattened,free,glabrescent,glabrous,held,hermaphrodite,heterostylous,infructescence,inside,lobe,lobing,long-styled,longer,lowermost,midpoint,midvein,multangulate,narrow-deltate,nflorescence,oblong,obovate,often,older,one,open,orolla,oung,outline,pair,pedicel,peduncle,pericarp,pit,plant,plurifoliat,poorly,porrect,portion,prickl,primary,prominent,pubescent,raised,ray,reflexed,resin,rounded,ruit,scar,secondary,sessile,short-styled,shorter,side,smooth,sparsely,spreading,stalk,stalked,staminat,sticky,stout,strongly,tamen,terete,tertiary,time,trichome,tube,unit,usually,variously,vary,vein,venation,visible,way,white-brow,wide,woody,yellow-orange,ympodial	branching,colour,corolla,form,growth,heteromorphism,inflorescence,number,orientation,ovary,placement,pore,position,seed,shape,staman,symmetry,texture,type,zygomorphy
488	wfo-0001031752	success	172	159	129	43	30	0.75	-10,-100,-44,-47,-6,-pubescent,0.5-1,1,1-2,1-3,1-4,1.5-10.5,1.5-3,1.5-3.5,15-25,15-40,2-2.5,2-3,2-5,20-35,3-4,3-7,3.5-15,3.5-5,5-8,abaxially,acuminate,acute,adaxially,apart,apex,apiculate,basal,base,calyx,chartaceous,ciliate,cm,connective,connivent,cuneate,cylindrical,darker,deltate,densely,diameter,directed,distally,ellipsoidal,elliptic,entire,equal,exceeding,flattened,fleshy,flower,fruit,fusiform,glabrate,glabrescent,glabrous,gland,glandular-puberulent,green,immature,lanceolate,leaving,less,light,linear,lobe,long,margin,membranaceous,mm,moderately,narrowly,near,nearly,oblong,obtuse,often,older,ovate,ovoid,pedicel,pedicellar,peduncle,perfect,petiole,pink,pore,present,puberulent,pubescent,purplish,rachi,radiu,remnant,ripe,rounded,rugose,shrub,simple,slightly,small,sparsely,stalked,stellate,stigma,stripe,style,subcordate,subcoriaceous,swelling,thecae,tip,tomentose,tree,triangular,truncate,tube,unbranched,unit,white,wide,x,yellow,young	-3,0.5-1.5,1-,1-1.5,1.5-2,1.5-2.5,3-11.5,3-4-foliat,5-23,5-6,8-15,9-16,aggregate,ape,articulated,axe,beyond,blade,cell,ciliat,eaf,eed,exserted,glandular-puberulen,lon,lower,nflorescence,nther,olde,orolla,presen,purpl,ruit,spaced,stamen,stone,tal,tem,time,truncat,ud,vary,ympodial	3-4-foliate,abaxial,adaxial,anther,articulation,branching,bud,colour,corolla,form,growth,hair,height,inflorescence,leaf,length,number,ovary,plant,purple,seed,shape,size,spacing,stem,structure,sympodial,texture,theca,type
489	wfo-0001031756	success	186	87	68	118	19	0.366	-5,.5,/2,0,0.5-1,0.6-1.2,0.8-1,1-3,1.5-2,1.8-2.5,3-15,accrescent,anther,apart,apex,bark,base,berry,branched,calyx,chartaceous,cm,color,densely,diameter,enclosing,entire,equal,evenly,flattened-reniform,flower,fruit,fruiting,fully,glabrescent,glabrous,green,known,leaf,lobed,margin,mature,mauve,mm,orange-brown,ovate,pale,per,perpendicular,petiole,poricidal,prickle,shoot,short,shrub,simple,spaced,spherical,stellate-pubescent,stem,style,tapering,terminal,tip,way,white,yellow-green,young	-1,.1,.8,0-2,0-5,0.02-0.2,0.1,0.15-0.25,0.2,0.4-1.6,0.5-1.3,0.6-1.6,0.7-1.7,00,1-1.8,1-2,1-4,1.5-3.5,1/2,1/3,10,2-6,3-5,3-7,4-5,4.5,5-merous,6-9,7-10,9-14,abaxially,acut,alyx,apar,apically,apparently,articulated,blade,broad-deltate,concolorous,conical,connivent,cordate,curved,deltate,drying,eaf,eed,elongating,erect,eye,filament,finely,free,glabrou,gray,herbaceous,inflated,infructescence,invested,lobe,long,longer,lower,midpoint,moderately,naked,nflorescence,older,one,open,orolla,oung,pair,pedicel,peduncle,pendulous,perfec,pericarp,pitted,plurifoliat,porrect,portion,prickl,prickly,primary,ray,red-brown,rounded,ruit,scandent,scar,sessile,shorter,slender,small,smooth,sparsely,spreading,stalk,stalked,stellate,straight,surface,tamen,terete,time,trichome,truncate,tube,unarmed,unit,variously,vary,vein,visible,wide,ympodial	branching,colour,corolla,form,growth,heteromorphism,inflorescence,length,number,orientation,ovary,placement,position,seed,shape,staman,texture,type,width
490	wfo-0001031786	success	209	126	104	105	22	0.498	.4,0-20,0-3,0-5,0.1-0.4,0.2-2.5,0.5-1.5,0.7-1.6,0.7-4,0.8-1.2,1-3,1-6,1.2-1.6,1.5-1.9,1.5-2.5,2-3,2-7,2-8,4-5,6-8,abaxially,acute,almost,anther,apex,articulated,bark,base,berry,branched,calyx,chartaceous,cm,connivent,cuneate,curved,dark,deep,densely,diameter,elliptic,eye,flattened-reniform,flower,fruit,fruiting,glabrous,herb,lateral,leaf,length,lobe,lobed,long,margin,maturity,mauve,membranous,minute,mm,naked,orange,ovate,pair,pale,pedicel,peduncle,per,petiole,poricidal,porrect,prickle,prickly,red,red-brown,reflexed,sessile,shrub,side,simple,sometimes,sparsely,spherical,spreading,stalked,stellate,stellate-pubescent,stem,stigma,straight,style,surface,tapering,tertiary,tip,trichome,truncate,variously,venation,visible,weakly,white,wide,yellow-orange	-5,.5,/2,/3,0,0-2,0.1,0.2-0.3,0.25-0.5,0.7-1,0.8,1,1-2,1-4,1/3-1/2,2-13,2.5-3.5,3-4,3-5.5,5-7,5-merous,8-12,acut,alyx,ame,apar,apart,apically,apparently,becoming,blade,c.,cell,clavat,concolorous,deltate,distance,drying,eaf,eed,elongating,equal,erect,evenly,extending,filament,filiform,flattened,free,glabrescent,gray,gray-brow,green,herbaceous,inconspicuous,infructescence,lon,longer,lower,mature,midpoint,midvein,nflorescence,obtuse,older,one,open,orange-brown,orolla,oung,outline,pendulous,perfec,pericarp,pit,plurifoliat,portion,prickl,primary,raised,ray,rounded,ruit,scandent,scar,shiny,shorter,slightly,small,smooth,spaced,stalk,tamen,terete,thick,time,tube,unarmed,unit,vary,vein,way,woody,ympodial,young	articulation,branching,clavate,colour,corolla,form,gray-brown,growth,hair,height,inflorescence,number,ovary,plant,presence,seed,shape,size,staman,texture,type,width
491	wfo-0001031793	success	188	110	92	96	18	0.489	-4,0,1-1.5,1-2,1-8,1.5-4,10-15,13-20,15-20,2-3,2-5,26,3-8,40,8-11,acuminate,aging,almost,anther,apex,armed,articulated,base,berry,black,branched,broadly,brown,brownish,capitate,chartaceous,cm,cuneate,densely,diameter,elliptic,evident,extra-axillary,flattened,flower,forked,fruit,globose,hair,inflorescence,leaf,lobe,long,many,margin,minutely,mm,mucilaginous,oblong-lanceolate,orange-yellow,orbicular-ovate,ovate,pedicel,peduncle,per,perfect,petiole,pore,porocidal,prickle,pubescent,rachi,reddish,reticulation,rounded,scarcely,scattered,shallow,shrub,simple,size,small,sparsely,stellate,stellate-pubescent,stem,stigma,style,tip,tree,trichome,unbranched,well-developed,white,x,yellow,yellow-brown	.5,1,1-3,1.5-2,1/3,1/4,1/5,20,3-4,3/4,4,5-merous,7,absent,abundant,accrescent,acumen,acute,adult,alyx,apparently,aspect,axe,ba,bilobe,blade,branche,broad,calyx,central,cut,difoliate,distal,eaf,eed,elongatin,erec,erect,extreme,ferrugineous,filament,fruiting,geminat,general,glandular,homostylou,interpetalar,larger,linear,lobing,lon,lower,main,maturing,midpoint,midrib,mostly,nflorescence,oblique,obtuse,often,older,orolla,porrect,principal,reduced,ruit,rusty,sessile,side,similar,single,sinus,smaller,stellate-pubescen,stipitate,stout,surface,tall,tamen,tem,testa,thickened,tissue,triangular,triangular-acuminat,tube,unarmed,unit,upward,usually,uvenile,vary,way,woody,ympodial	articulation,bilobed,branching,colour,corolla,form,growth,height,juvenile,length,ovary,pattern,plant,position,seed,shape,texture,type
492	wfo-0001031829	success	138	84	68	70	16	0.493	.25,.5,0.7-1,1,1-2,1.3-1.5,1.5-2.5,2-4,3/4,4-4.5,absent,adaxial,anther,anthesi,apex,base,berry,broadly,calyx,capitate,cm,conical,corolla,crystalline,densely,epidermi,erect,filament,fruiting,glabrous,globose,green,growth,inflorescence,large-celled,leaf,leathery,lobed,long,margin,minutely,mm,often,opposite,ovary,papillose,pedicel,petiole,pore,poricidal,pubescent,revolute,shaped,shrub,simple,somewhat,sparsely,stigma,style,surface,tear-drop,thick,tip,trichome,tube,uniseriate,way,white	0.5-2.1,1.5-2,1.5-3.5,1.5-4.5,3-5-flowered,4-8.5,7-10,abaxially,acute,adaxially,along,ape,apiculae,bae,bark,branched,deflexed,denser,dia,differing,difoliate,drying,eaf,edicel,eed,elliptic,exserted,free,geminat,glabrat,greenish-brown,immature,known,lateral,like,lobe,lon,lower,main,major,minor,minute,nflorescence,occasionally,older,overlappin,packed,pair,papillo,planar,portion,quadrate,ruit,scar,size,soft,stem,tall,tapering,tub,tuft,ud,unit,vein,waxy,woody,x,yellowish,ympodial,young	0.5,abaxial,colour,diameter,form,fruit,hair,height,length,orientation,plant,position,presence,shape,texture,type
493	wfo-0001031832	success	232	136	112	120	24	0.483	0.1-0.3,0.2-1.5,0.3-0.8,0.3-3,0.7-1.6,0.7-2,0.8-1.2,1-12,1.2-2,1/2-3/4,14,2-4,2-6,3-6.5,3-7,4-20,4-7,5-21,8-25,9,abaxially,acuminate,adaxially,anther,apart,apex,apical-lateral,attenuate,bark,base,blunt-tipped,branch,branched,brown,brownish,bud,bullate,calyx,chartaceous,cm,conical,corolla,deltoid,diameter,entire,extend,ferrugineous,few-rayed,filament,flower,fruit,glabrescent,globose,granular-tomentose,greenish,growth,hair,honeycombed,indument,introrse,lanceolate,large,leaf,length,longitudinal,margin,mm,mostly,multangulate,oblanceolate,oblong,pale,pedicel,peduncle,persistent,petiole,pore,porrect-stellate,probably,pubescence,rachi,rather,reniform,reticulate-punctate,ripe,rotate-stellate,rough,scabrous,sessile,short-stalked,shrub,simple,slit,smooth,somewhat,soon,splitting,stigma,style,subcampanulate,suborbicular,terete,testa,time,tree,violet,way,white,x,yellow,yellowish,young	-8,.5-1,/50-1/10,0-150,0.2-0.6,0.7-1.5,1.1-2.4,1.2-1.6,1.2-2.5,1.3-4.2,1.5-4,1.7-4,1.8-4,2-3.6,2.5-6.5,2.8-4.8,3.5-7,5.5-10,7-10,accrescent,acute,ag,anthesi,apice,apparently,articulated,axe,axillary,ba,basal,becoming,berry,blade,blister,capitat,closely,connate,continued,dark,decurrent,dehiscing,directed,due,eaf,eed,evident,exserted,fleshy,forming,free,fruiting,glabrescen,glabrous,green,half,high,inserted,lackin,lateral,line,lobe,lobed,long,long-,longer,lower,m.,main,midvein,minute,mixed,nearly,nflorescence,obovoid,obtuse,occasionally,older,orbicular,orolla,ovate,partly,perfect,pitted,plurifoliate,porrect-stellat,pubescent,ray,relatively,ruit,runk,short-,side,sometimes,spaced,sparingly,sparse,stamen,stellate-pubescent,stem,stipitate-glandular,surface,suture,swelling,tamen,terminal,thick,thick-stalked,toward,translucent,tube,unarme,unarmed,unit,usually,vary,vein,weakly,whitish,wide,ympodial	20-150,age,arrangement,branching,capitate,colour,dehiscence,form,height,inflorescence,lobing,number,ovary,persistence,plant,seed,shape,size,spacing,staman,texture,thicknes,trunk,type
494	wfo-0001031834	success	150	107	85	65	22	0.567	0.5,0.5-1,0.5-3,0.5-3.5,0.6-1.4,0.8-1,0.8-1.3,0.9-1.4,1,1.5,1.5-4,1.9-6.5,2.9-7,2/3,6-7,6.5-14,acuminate,acute,anther,anthesi,apex,apically,attenuate,base,calyx,cm,corolla,deflexed,dia,difoliate,expanded,filament,flattened-reniform,fruit,fruiting,glabrous,globose,green,greenish-yellow,hooked,incrassate,leaf,less,lobe,lobed,long,margin,minor,minute,minutely,mm,opposite,ovary,ovate,pale,papillose,pedicel,petiole,pitted,pore,scar,shaped,shrub,simple,slender,slightly,stem,stigma,straight,style,surface,tan,tapering,tear-drop,tip,trichome,tube,uniseriate,unit,way,white,woody,x,yellow,young	.5,1.6-2,accrescent,across,apar,apiculate,appear,berry,bi-cellular,borne,campanulate,covered,deciduou,deciduous,decurrent,deltoid,depression,eaf,edicel,eed,eye,few-flowered,free,geminat,glabrou,hook,lamina,larger,leaving,like,lon,lower,major,markedly,middle,mound-like,multicellular,naked,nflorescence,often,papillo,persistent,planar,poricidal,portion,proximal,pubescent,ruit,scabrous,short,small,soon,spaced,sparsely,speck,tall,tufted,ud,unevenly,uni-,upper,usually,vein,widest,ympodial	apart,attachment,branching,bud,colour,decurrenct,form,growth,hair,height,inflorescence,length,plant,position,seed,shape,size,spacing,structure,sympodial,texture,width
495	wfo-0001031842	success	161	97	77	84	20	0.478	.5,.75,0.1-0.5,0.5-1,0.5-2,0.6-1,1,1-1.5,1-1.8,1-3.5,1.5-2,10-20,10-30-flowered,2-10,2-3,2.5-3,3-8,4.5-6,7-9,acute,anther,apart,attenuate,base,bi-lobed,brown,capitate,cm,corolla,cup-shaped,dark,decurrent,deeply,dia,dry,ellipsoid,elliptic,filament,flattened-reniform,fruiting,glabrous,globose,green,incrassate,later,leaf,long,margin,minor,mm,onto,opposite,ovary,paler,pedicel,petiole,pitted,pore,shaped,shiny,shrub,size,somewhat,specimen,stem,stigma,strongly,style,surface,tear-drop,terminal,tree,trichome,uniseriate,white,x,young	.1,.4,0.7-1,10-12,2.5-6,3/4,9-15,anthesi,apex,axil,ba,bark,bearing,beginning,beneath,berry,calyx,cusp,deflexed,densely,differing,difoliate,eaf,edicel,eed,exserte,exsertion,free,geminat,inflorescenc,irregularly,lateral,leaf-opposed,lobe,lobed,lon,lower,main,major,middle,minutely,near,new,nflorescence,often,older,one,overtopping,pair,pale,papillo,papillose,poricidal,portion,prominent,pubescent,quadrate,reddish,reddish-resinous,reflexed,ruit,scar,shoot,simple,slender,soon,spaced,sparsely,straight,tall,tapering,time,tip,tube,tuft,ud,unit,vein,way,widest,woody,yellowish,yellowish-whit,ympodial	bud,colour,diameter,flower,form,fruit,glabrousnes,growth,height,inflorescence,length,number,plant,position,seed,shape,spacing,symmetry,texture,type
496	wfo-0001031843	success	245	158	133	112	25	0.543	.5,0-4,0.5-1,0.5-1.5,0.6-1.2,0.7-2,0.8-2,1-7,1.2-2,1.5,1/6-1/4,2-3,2.5,3-4,4-12,6-9,abaxially,adaxially,almost,along,anther,anthesi,apically,appressed,attenuate,bark,basal,base,berry,branch,branched,branching,brown,calyx,canaliculate,capitate,cm,completely,conical,corolla,cupular,curved,dark,deeply,diameter,dilated,discoid,distributed,drying,dull,equal,erect,evenly,filament,fine,finely,flat,glabrous,green,honeycomb,leaf,length,liana,lobed,long,longitudinally,main,margin,midvein,mm,multiseriate,network,oblique,oblong,obovate,orange,orange-brown,orange-yellow,pair,part,partly,pattern,pedicel,peduncle,pericarp,petiole,pitted,pore,poricidal,primary,prominent,pubescent,raised,rarely,red,reddish,ridged,scar,seed,shallowly,shiny,shortly,shrub,side,simple,slender,slightly,sometimes,sparsely,spheroidal,stem,stigma,straight,stump,style,surface,terminal,tertiary,thick-chartaceous,thin,tip,trichome,tube,twice,unarmed,unit,vein,venation,violet,visible,white,x,young	.2,.3,.6,0.2-2,0.4-0.5,0.7-1.2,1-2,1.2-2.2,1.5-2,1.8-2.5,1mm,2-4,3-7,45-60Â°,5-10,5-12,accrescent,acuminate,age,always,alyx,apar,apex,apice,apparently,around,articulated,becoming,black,broadly,caudate,clearly,collapsing,cuspidate,delineated,deltoid,dendritic,density,detaching,discolorous,domatia,eaf,eed,ellipsoi,entire,even,eye,fertilisation,flexuous,flower,forming,free,fruiting,hand,inner,largely,leave,len,lengthening,lignified,like,lobe,loop,looping,lower,m.,much,naked,never,nflorescence,nther,obscure,older,opening,orolla,outline,ovate,papillo,pendulous,perfec,pit,plurifoliat,portion,present,pronounced,protruding,rachi,recurve,reveal,ribbed,rounded,ruit,see,sinus,small,smaller,smooth,soon,spreading,strongly,surfac,tearing,thickened,tuft,ud,variable,vary,weakly,wide,wider,without,ympodial	apart,armament,arrangement,articulation,colour,form,fruit,growth,inflorescence,lobing,number,ovary,papillose,plurifoliate,position,prominence,shape,size,spacing,structure,sympodial,texture,thicknes,type,visibility
497	wfo-0001031852	success	155	86	58	97	28	0.374	-8,0.1-1,1-4,1-4.2,1-9,1.3-2.5,1.4-3,2-3,2-5.5,2.6-9.5,3-9,3.5-10,4-10,4-5,4-6,5-15,9-11,branched,calyx,cm,conical,connate,corolla,cyme,dehiscent,diameter,dichasially,filament,flower,forked,green,hair-like,herbaceous,interjected,lanceolate,lateral,leaf,leaflet,light,mm,odd-pinnate,ovoid,pedicel,peduncle,perennial,petiole,plant,pubescent,seed,size,stellate,style,terminal,tuber-bearing,unit,wall,white,yellow	0.5-1.3,0.5-3,1-,1.5-3,12-35,3-4,3-6-foliat,4-,7-,abaxially,abruptly,absen,acumen,acuminate,acute,adaxially,apex,apical,apically,apiculate,articulate,attenuate,base,cell,covering,decurrent,dichasial,digestion,diminishing,distal,dorsally,eaf,ebracteate,edge,eed,elliptic,elliptic-lanceolate,emoval,enzyme,exceeding,flat,folded,generally,globo,green-white,half,honeycomb,introrse,living,lobe,lon,long,lower,lunat,make,maturing,monochasial,mucilaginous,nflorescence,nther,oblique,oblong,often,orolla,ovate-elliptic,pair,pattern,perfect,plan,poricidally,proximal,rachi,reveal,ruit,sessile,seudostipule,short,shortly,slit,specimen,stamen,stigma,straight,tal,tem,testal,thick,throughou,throughout,toward,typically,vary,white-crea,wide,without,ympodial,Â¼	3-6-foliate,7-35,absent,anther,apicidally,arrangement,branching,colour,form,fruit,growth,height,inflorescence,length,lunate,number,ovary,pore,present,pseudostipule,shape,stem,structure,sympodial,texture,type,white-cream,width
498	wfo-0001031864	success	140	110	86	54	24	0.614	.2,.25,.5,0.2-0.5,0.5-13.5,0.5-4,0.7-0.8,0.8-1,1-1.2,1-1.8,1-2,1-5,1-6.5,1.2-1.5,1.5-10,1.5-2.5,15-60,2-3,2.5-6,3-3.5,3-pinnate,5-9,7.5-8,abaxially,acuminate,acute,adaxially,anther,apex,blade,calyx,chartaceous,ciliate,clavate,cm,deltoid,dense,densely,diameter,entire,extra-axillary,filament,fine,flattened,fleshy,flower,fruit,glabrous,hair,lenticular,like,lobe,long,margin,middle,mm,near,ovoid-deltoid,papillose,pedicel,peduncle,petiole,pointed,pubescence,pubescent,rachi,rotate,scattered,short,slender,slightly,sparsely,stem,stigma,style,surface,tip,trichome,tube,unbranched,unknown,vine,violet,wide-diameter,widely,x	0.4-3,0.6-3.5,0.6-4,1-3,1.5,2,5-15,5-merous,accrescent,alyx,apar,apical,apiculate,axe,base,berry,c.,capitat,color,cuneate,eaf,eed,emarginate,fruiting,glabrou,herbaceous,lateral,leaflet,lon,lower,m.,minutely,moderately,nflorescence,nternode,oblique,orolla,perfec,petiolule,plurifoliat,pubescenc,rounded,ruit,sand-punctate,spaced,tamen,tem,terrestria,truncate,typical,unit,vary,vein,ympodial	abaxial,adaxial,branching,capitate,colour,corolla,form,growth,habit,inflorescence,internode,leaf,length,number,ovary,plant,position,seed,shape,size,staman,terrestrial,texture,type
499	wfo-0001031864	success	148	142	114	34	28	0.77	.2,.25,.5,0.4-3,0.5-13.5,0.5-4,0.6-3.5,0.6-4,1-1.2,1-1.8,1-2,1-3,1-5,1-6.5,1.2-1.5,1.5-2.5,15-60,2-3,2.5-6,3-3.5,3-5-celled,3-pinnate,5-15,5-9,7.5-8,abaxially,absent,accrescent,acuminate,acute,adaxially,anther,apart,apex,apical,apiculate,articulated,basally,base,blade,blue-purple,calyx,center,ciliate,clavate,cm,cordate,cuneate,deltoid,dense,densely,diameter,directed,distally,emarginate,entire,extra-axillary,fine,fleshy,flower,fruiting,glabrous,hair,herb,interjected,large,lateral,leaflet,lenticular,lobe,long,longitudinal,margin,minutely,mm,near,node,oblique,oblong,opening,papillose,pedicel,peduncle,perfect,petiolule,pore,pubescence,pubescent,rachi,rooting,rotate,rounded,scattered,short,simple,slender,slightly,slit,somewhat,sparsely,stigma,style,surface,thick,tip,trailing,truncate,tube,unbranched,uniseriate,unknown,widely,woody,x	1.5,2,5-merou,ag,alyx,apparently,axe,ba,capitat,color,connivent,eaf,eed,equal,etiole,filament,fruit,geminat,lower,m.,nflorescence,orolla,plurifoliate,pubescenc,spaced,tamen,tem,terrestrial,unit,vary,weakly,wiry,yellow,ympodial	5-merous,abaxial,adaxial,age,articulation,capitate,colour,corolla,form,glabrousnes,growth,habit,inflorescence,leaf,length,number,ovary,petiole,plant,position,seed,shape,size,spacing,staman,stem,texture,type
500	wfo-0001031871	success	185	129	108	77	21	0.584	0.4-2,0.6-1.2,1-2,1.5-11,1.5-2,1.5-2.1,1.6-2.7,2-4,3-10,3.5-4,33-40,36-44,4-6,4-7,5.4-12.3,6-12,6-7,6.5-20.5,7-9,7.5-23,abaxially,adaxially,anther,blade,brownish,cell,chartaceous,clavate,cm,condition,connivent,corolla,covering,dark,deep,diameter,distal,dot,drying,end,filament,flower,forked,fresh,fruit,generally,glabrous,globose,green,green-white,greenish,hair,hair-like,half,herb,homostylous,interjected,lanceolate,lateral,leaflet,lengthening,lobe,long,make,medium,mm,mottled,mucilaginous,narrowly,odd-pinnate,one,ovoid,pair,pedicel,peduncle,petiole,placed,plant,pore,poricidal,purple,ripe,rotate,seed,short,size,slit,stigma,straight,style,subglabrous,terminal,testal,thick,throughout,tiny,tip,tube,tuber,typically,usually,wall,wet,white,whitish,wide,winged,x	1.4-2.1,14-22,2-3,2.9-6,3-4,3-5,5-merou,acumen,acute,adaxiall,ag,alyx,apart,apex,apparently,articulated,asymmetric,attenuate,axe,axillary,base,basiscopic,berry,bud,capitat,digestion,dorsally,eaf,edge,eed,elliptic,enzyme,erec,exceeding,flat,folded,geminat,glabrou,hal,high,honeycomb-shaped,linear,living,lower,nflorescence,orbicular,orolla,ovate,perfect,petiolulate,plurifoliate,pubescent,removed,round,rounded,ruit,sessile,seudostipule,side,sometimes,spaced,specimen,stamen,stolo,subequal,subglabrou,subtending,symmetric,tall,tamen,tem,tissue,tri-,unit,vary,yellow,ympodial	age,arrangement,branching,calyx,capitate,colour,form,growth,height,inflorescence,leaf,length,ovary,placement,pseudostipule,shape,staman,stem,stolon,symmetry,texture
501	wfo-0001031876	success	140	68	52	88	16	0.371	.1,.5,0.5,0.8-1,1,1-1.5,1-1.6,1.5-2.2,acute,anther,anthesi,base,beneath,berry,bright,calyx,cm,corolla,decurrent,elliptic,filament,fruiting,glabrous,globose,granular,greenish-yellow,leaf,less,lobed,minutely,mm,nearly,oblanceolate,oblique,opposite,ovary,papillose,pedicel,petiole,poricidal,prominent,raised,shrub,simple,slightly,stigma,style,tip,tube,venation,white,yellow	0-flowered,1-4,27-35,3,5,9-15,?,across,apex,apiculate,arc,arising,ba,bark,bearing,closely,convergence,corky,cup-like,dia,differing,eaf,edicel,eed,erect,family,flower,free,glabrou,green,immature,irregularity,known,lateral,lenticellat,lightly,lobe,long,long-acuminate,lower,main,major,margin,melastomataceae,member,middle,minute,nflorescence,often,otherwise,overlappin,pair,parallel,perpendicular,persistent,point,pore,portion,present,primary,recurved,reflexed,resemble,ruit,running,scar,secondary,shaped,slender,spaced,stem,straight,styl,tall,tapering,tear-drop,time,ud,unifoliat,unit,vein,wide,widest,winged,woody,x,ympodial,young	branching,colour,diameter,form,fruit,growth,height,inflorescence,length,modification,plant,position,shape,texture,type,width
502	wfo-0001031877	success	216	141	120	96	21	0.556	+,.5,0.3-,0.3-1,0.3-1.2,0.5,0.5-1,0.6-1.2,1-1.5,1-3,1-3.5,1-4,1.1-,1.5,1.5-1.9,1.8-5,2-,2.5,3.5-4,6-10,6-8,acuminate,acute,adaxially,angled,anther,apex,articulated,basally,base,berry,bright,brown,capitate,cell,clavate,cm,connivent,corolla,deep,deltate,densely,diameter,ellipsoid,ellipsoidal,entire,exposed,filament,flattened,flower,fruit,glabrous,globose,greenish,growth,hastate,later,lateral,lengthening,line,lobed,loosely,margin,mature,minute,minutely,mm,nearly,new,pale,pedicel,peduncle,per,perfect,pericarp,petiole,pitted,plump,pore,poricidal,prominently,pubescent,purple,rectangular,red,reddish,reniform,ripe,scar,scrambler,seed,shiny,short,silky,simple,sinuate,sleeve,slightly,slit,somewhat,sparsely,stellate,stem,stigma,style,surface,terminal,testal,thin,tinged,tip,trichome,tube,uniseriate,usually,vine,wall,weak,white,x	.3,0.2,0.8-0.9,1,1.5-2,2,3-5,3-6,5-merou,abaxially,abruptly,adaxiall,ag,along,alyx,anthesi,apar,apparently,ark,ascending,basal,calyx,conical,deflexed,distal,dried,eaf,eed,enlarged,erect,especially,exserted,eye,fleshy,free,fruiting,furcate,green,ilament,impressed,internal,irregularly,lamina,like,linear,lobe,long,long-acuminate,lower,material,midvein,nflorescence,occasionally,often,older,orolla,outline,pair,papillate,papillo,parallel,part,plant,plurifoliat,pointing,portion,primary,pubescence,purplish,reflexed,rest,rounded,ruit,semi-woody,shorte,slender,sometimes,spaced,spreadin,strongly,subshru,tem,triangular,truncate,twinin,ud,uniformly,unit,upper,vary,vein,visible,woody,yello,ympodial,young	5-merous,age,apart,articulation,bark,bud,colour,exposure,form,hair,inflorescence,leaf,length,number,ovary,shape,size,spacing,thicknes,type,yellow
503	wfo-0001031880	success	180	126	106	74	20	0.589	.5,0.5-1,0.7-0.8,1,1-1.3,1-1.5,1-2,2-3,2.5-8,3-3.5,3-4-pluri-foliate,3-foliate,3-lobed,4,5-6,7-9,age,anther,anthesi,apart,base,berry,broadly,brown,calyx,capitate,cell,cm,conical,cordate,corolla,crenate,cup-shaped,curved,dark,densely,diameter,elliptic,enlarged,entire,filament,flattened,fleshy,fruit,fruiting,glabrous,gland,glandular,globose,green,herb,hollow,inflorescence,internodal,irregularly,leaf,lengthening,lobe,margin,markedly,minutely,mm,narrowly,nodding,orange,ovary,ovate,ovoid,pale,papillose,pedicel,petiole,pitted,pore,poricidal,pubescent,purple,red,reddish,reflexed,scar,shallowly,simple,slightly,slit,spreading,stem,stigma,straight,strongly,style,subshrub,surface,testal,tip,toothed,triangular,trichome,truncate,tube,unit,upward,wall,woody,x,yellow	0.5-2,1.5,2,2-4,2-9,4-8,5,6-9,abaxially,acuminate,acute,adaxially,apex,basal,bearing,becoming,c.,ciliate,color,crowded,eaf,edicel,eed,ellipsoid,erect,exerted,flower,flush,free,gland-tipped,growing,heteromorphic,horn,lamina,less,lon,long,longest,lower,mature,maturit,mid-length,middle,near,nflorescence,pair,papillo,peduncle,pericarp,plan,portion,primary,pubescen,rachi,ruit,shortest,single,slender,sometimes,spaced,sparse,sparsely,terminal,thin,ud,unicellula,uniseriate,unlobed,upper,vein,widely,widest,ympodial,â5	1.5-5,arrangement,branching,colour,form,growth,height,length,maturity,plant,position,seed,shape,size,spacing,structure,sympodial,texture,type,unicellular
504	wfo-0001031881	success	168	108	95	73	13	0.565	.5,0.4-1,0.5-0.7,0.5-1,1-1.3,1-1.5,1-7,1.2-6,1.5-2.5,1/3,10-30,2,2-9,3-19,3.5-4,3/4,5-6,7-14,acute,anther,apex,attenuate,base,beneath,branch,branched,broadly,brown,calyx,campanulate,capitate,cm,corolla,dark,deltoid,densely,dia,distal,dry,elliptic,erect,filament,fleshy,fruit,fruiting,glabrous,globose,golden,golden-pubescent,green,inflorescence,leaf,lightly,lobe,lobed,major,material,minor,minutely,mm,obovate,opposite,orbicular,ovary,ovoid-reniform,papillose,pedicel,petiole,pore,poricidal,puberulent,pubescent,rounded,shape,shaped,shrub,simple,size,small,sparsely,stem,stigma,style,tear-drop,tip,tree,trichome,tube,uniseriate,usually,way,white,winged,x,young	0.1-0.5,0.2,0.2-0.6,10-12,absent,along,anthesi,apar,apparent,axil,ba,bark,bud,constriction,decurrent,deflexed,differing,difoliate,drying,eaf,edicel,eed,either,ellipsoid,evenly,exserted,free,geminat,golden-puberulent,greyish-brow,incrassate,inflorescenc,junction,lateral,like,lon,long,lower,main,margin,maturity,middle,midrib,minute,nflorescence,occasionally,older,one,pair,papillo,pitted,planar,portion,puberulen,rest,ruit,scar,slender,slightly,somewhat,soon,spaced,straight,strong,surface,tall,tapering,ud,unit,vein,widest,woody,ympodial	branching,colour,diameter,form,growth,height,length,orientation,plant,position,seed,texture,type
505	wfo-0001031886	success	169	122	102	67	20	0.604	-1.2,-25,-9,.5,0,0.5-1,1-1.5,1-4,1.2-2.5,2-2.5,2-3,2-4,2-5,2.0-2.5,3-6,3.0,4,4-15,5-6,5-ridged,6-20,acuminate,anther,anticlinal,apex,attenuate,axillary,basal,base,bright,broadly,brown,calyx,capitate,cell,cm,commonly,completely,conical,corolla,deltate,diameter,distinctly,dry,elliptic,epidermal,filament,fleshy,flower,fruit,glabrous,green,greenish,irregular,lanceolate,lateral,leaflet,lobe,long,minutely,mm,near,node,occasionally,open-conical,ovary,ovoid-reniform,papillae,pedicel,per,petiole,pinnate,poricidal,portion,projection,raised,reddish,rugose,scattered,seed,shape,shrub,similar,simple,sinuous,somewhat,sparse,specimen,stigma,strongly,style,surface,thickening,tip,triangular,trichome,tube,uniseriate,white,wintergreen,without,x	-4,0.1,1.5-2,10-40,2,20-30,5-10,6-8,9-10,abaxially,abruptly,absent,adaxially,along,anthesi,arising,axil,beak,bearing,berry,bud,clavat,eaf,earl,edicel,eed,either,em,equal,erec,exserted,free,fruiting,half,le,lobed,lower,margin,narrowed,nearly,nflorescence,noddin,oblique,pair,papillate,papillose,petiolule,primary,purple,rachi,reflexed,ripe,ruit,scar,single,smaller,smelling,terminal,time,tub,ud,unifoliat,unit,usually,vein,woody,ympodial	arrangement,branching,clavate,colour,feature,form,growth,inflorescence,leaf,length,nodding,number,odour,orientation,pore,position,size,stem,texture,type
506	wfo-0001031895	success	160	113	99	61	14	0.619	-1.5,0.5-1,1-1.5,1.5-2,1.5-3,1.5-6,2-2.5,2.5-3,3-4,3-8,3.5-6,4-5,4.5-16.5,5,5-6,6-7,6-9,acute,anther,apex,attenuate,bark,base,beneath,berry,bluish,broadly,calyx,capitate,cm,conical,corolla,cup-shaped,dark,deltate,densely,diameter,ellipsoid,elliptic,entire,erect,exerted,exfoliating,filament,fleshy,flower,fruiting,glabrous,globose,green,growth,immature,leaf-opposed,leaving,lobe,lobed,margin,matte,minutely,mm,occasionally,once-branched,ovary,overlapping,ovoid,pair,pale,papillate,pedicel,peduncle,peeling,peg,perfect,petiole,pitted,poricidal,reniform,revolute,shiny,shrub,simple,slightly,small,somewhat,stem,stigma,strongly,style,tan,thick,tip,tree,tube,vein,violet,way,white,x,Â¼-1/2	0.5,0.5-2,3-10,4,5-8,age,anthesi,apparently,articulating,blac,campanulate,cell,completely,drying,eaf,eed,emarginated,enlarging,erec,expand,fragrant,free,glabrou,inflorescenc,intensely,irregular,leafy,lengthening,less,lower,new,nflorescence,older,papillat,part,patch,pericarp,planar,plurifoliat,pore,portion,primary,reddish,ruit,scar,shoot,short,sinuate,slender,slit,stout,straight,surface,terminal,testal,thin,tub,ud,unit,woody,ympodial	articulation,bud,colour,form,fruit,inflorescence,leaf,length,position,seed,shape,size,texture,type
507	wfo-0001031897	success	264	156	141	123	15	0.534	.1,.5,.8,0-1,0.1-0.5,0.15,0Â°,1-2.5,1.3-2,2-4,2/3,4-5,5-6,6-9,8,abaxial,abaxially,accrescent,adaxially,almost,along,anther,anthesi,apically,articulated,attenuate,bark,base,bendy,berry,black,brachyblast,branch,branched,brown,calyx,chartaceous,clavate,clustered,cm,conical,connate,coriaceous,corolla,covering,cuneate,curved,dendritic,densely,developing,diameter,dilated,distributed,divided,dorsifixed,dry,drying,dull,elliptic,entire,epiphyte,equal,erect,evenly,extending,eye,faint,filament,filiform,free,fruit,fruiting,glabrous,green,grey,hair,lamina,lanceolate,leaf,least,light,lobe,lobed,long,longitudinal,longitudinally,main,margin,mauve,midvein,mm,multicellular,naked,never,obconical,oblong,occasionally,one,orange-brown,ovoid,pair,pedicel,pendulous,petiole,poricidal,primary,protruding,pubescent,raised,rarely,reddish,revolute,ribbed,ridge,ridged,shrub,simple,slightly,smooth,sometimes,sparse,sparsely,stem,stigma,style,sunk,terete,terminal,thick,tip,trichome,unarmed,usually,vein,venation,visible,weakly,white,winged,x,young	0.2-0.4,0.4-1.1,0.5-1,0.5-3,0.6,0.8-1.5,1,1-1.5,1-2,1.1,1.5,1.5-8,1.7-3,13,462.,absent,acute,adaxial,age,alyx,apar,apex,apparently,appearing,appendage,arising,aristate,axillary,boiteau,cell,clearly,concolorous,condensed,dark,datum,dehiscing,delineated,dense,developed,development,domatia,dorsal,eaf,earliest,ed,enlarged,even,except,fine,flower,foliaceous,immature,indistinc,inner,inside,known,larger,lateral,lengthening,like,linear,looped,lower,m.,margi,membranous,minute,minutely,multiseriate,nflorescence,nther,oblon,obtuse,occasional,orange,orolla,outside,ovate,overlapping,papillose,part,partly,peduncle,perfec,pericarp,persisting,plant,plurifoliat,pointed,pore,portion,prominent,pronounced,reach,ruit,scar,secondary,see,seen,shoot,short,side,sinus,slender,smaller,smoot,stump,subulate,surface,tearing,tertiary,thin,toward,tube,ud,unbranched,unicellular,unit,vary,well-developed,wide,wrinkle,ympodial	arming,arrangement,branching,characteristic,colour,form,growth,inflorescence,length,ovary,pattern,position,shape,texture,type
508	wfo-0001032157	success	136	92	73	63	19	0.537	.5,.75,0.25,0.5-1,0.6-1,0.75-1,1-3,1.9-2.2,2-3,2-5,2.2,5-15-flowered,7-9,acute,anther,anthesi,apart,base,becoming,beneath,bi-lobed,calyx,cm,completely,corolla,crystalline,decurrent,deflexed,deltoid,dry,elliptic,filament,fruiting,glabrous,globose,golden,green,incrassate,leaf,less,live,lobe,lobed,margin,minor,minutely,mm,nearly,opposite,ovary,ovoid-reniform,paler,papillose,pedicel,petiole,pitted,plant,pore,reflexed,scar,shaped,shiny,shrub,size,slightly,stigma,style,surface,tear-drop,tip,tube,white,x	3-6,5-8,5-9,9-17,apex,bark,beginning,berry,caly,dia,differing,difoliate,eaf,edicel,eed,evenly,exserted,free,frui,geminat,glabrou,inflorescenc,lateral,living,lon,long,longitudinal,lower,main,major,middle,nflorescence,obscure,older,one,pair,papillo,peeling,persistent,poricidal,portion,raised,reddish,rounded,ruit,simple,slender,soon,spaced,stem,straight,strip,tall,tapering,translucen,ud,unit,vein,widest,woody,yellowish,ympodial,young	colour,deflexion,diameter,flower,form,fruit,glabrousnes,growth,height,inflorescence,length,lobing,number,position,reflexion,seed,shape,spacing,texture
509	wfo-0001032161	success	146	78	61	85	17	0.418	.5,0.4-1.2,0.8-1,1-3,1.2-1.3,1.4-2,2-7,2.5-3,3.5-4,?,anther,anthesi,area,base,berry,cm,coriaceous,corolla,dendritic,drying,elliptic,filament,fruiting,glabrous,globose,golden,green,inflorescence,internodal,leaf,lobed,margin,merely,minute,minutely,mm,mustard,nearly,opposite,ovary,ovoid-reniform,papillose,pedicel,petiole,pitted,plant,pore,revolute,shaped,shrub,simple,stigma,style,surface,tear-drop,trichome,tube,uniseriate,white,x,yellow	0.5-1,0.7-4,0.75-1,1-1.5,1-11,2-8-flowered,abaxially,acute,adaxiall,adaxially,apex,apical,ba,bark,beneath,branched,brownish-blac,calyx,closely,color,conical,dark,deflexed,delicate,deltate,densely,dia,difoliate,eaf,edicel,eed,ellipsoid,exserted,filiform,free,giving,hanging,lamina,later,like,lobe,long,lower,many,middle,nflorescence,obovate,occasionally,older,overlappin,pale,pericarp,persistent,plurifoliate,poricidal,portion,projection,pubescent,quadrate,reflexed,rest,ruit,scar,shiny,shoot,short,spaced,sparsely,stem,strongly,styl,sulcate,tall,tan,thin,tip,tub,ud,unit,usually,vein,widest,yellowish,ympodial,young	abaxial,adaxial,branching,colour,diameter,form,fruit,growth,hair,height,length,position,seed,shape,size,texture,type
510	wfo-0001032165	success	197	108	90	107	18	0.457	0.25-0.5,0.75-1,1-2,1.5-4,2.5-3.5,3-4,3-6,4-6,5-6,8-9,acute,anther,bark,base,berry,brown,bud,calyx,capitate,center,closely,cm,corolla,dark,deciduous,decurrent,densely,dia,dry,ellipsoid,elliptic,exserted,exsertion,filament,fruiting,globose,golden,golden-puberulent,golden-pubescent,green,greyish-brown,inflorescence,later,leaf,lobed,long,margin,markedly,minor,minute,minutely,mm,nearly,node,obovate,occasionally,once-furcate,onto,orbicular,ovary,overlapping,ovoid-reniform,pedicel,petiole,plant,pore,puberulent,purplish,ripe,scar,shape,simple,spaced,specimen,stem,stigma,strongly,style,tear-drop,terminal,time,tinged,tree,trichome,tube,uniseriate,white,winged,x,young	.25,.5,0.1,0.1-0.3,0.3-1,1-1.2,1-1.5,10-25,2-2.5,3.5-8.5,5-15,5-30-flowered,5-7,5-9.5,abaxial,adaxial,along,anthesi,apex,apparent,appearing,ba,beginning,beneath,broadly,continued,cucullate,cup-shaped,deltoid,denser,differing,difoliate,distal,due,dull,eaf,edged,edicel,eed,end,entire,erect,even,expansion,free,geminat,glabrous,immature,inflorescenc,lateral,less,like,live,lobe,lon,lower,main,major,medial,middle,midrib,near,nflorescence,older,one,opposite,pair,pale,paler,papillo,papillose,pitted,planar,poricidal,portion,presence,prominent,rather,rest,ridge,rounded,ruit,shaepd,single,size,slender,slightly,slow,small,smoot,stout,straight,stripe,surface,swollen,tall,tapering,thickened,tip,tub,ud,unit,vein,widest,woody,yellowish,ympodial	5-30,branching,colour,diameter,flower,form,fruit,growth,hair,height,length,number,position,seed,shaped,smooth,symmetry,texture
511	wfo-0001032167	success	163	75	48	115	27	0.294	1-2,1-2-celled,10-35,4-6,acute,anther,apex,base,berry,cell,chartaceous,ciliate,elliptic,elliptic-ovoid,entire,forming,fruit,glabrous,globose,growth,hair,herb,lower,margin,membranaceous,mm,moderately,netlike,oblong,obtuse,pedicel,per,petiole,projection,pubescent,purple,raised,rotate,rounded,seed,staman,surface,twisted,unbranched,wall,white,x,yellow	.5,0.5-1,0.5-1.5,0.5-2.5,0.75-3,1,1-2.5,1-3,1-5,1-7,1.5,10-20,12-20,2-4,2-7,2-foliate,3-6,3-7,4-10,5-15,7-10,abaxially,absent,abundant,adaxiall,adaxially,along,appressed,axe,blade,brown,calyx,closely,cm,common,connected,cordate,curved,decurrent,dehiscing,dense,densely,denser,diameter,dm,drying,eaf,eed,emarginat,explosively,few-,filament,flat,flattened,flower,frui,geminat,geniculate,growt,held,immature,interpetalar,larger,linear-lanceolate,lobe,long,longer,lowermost,lying,many-branched,maturing,maturit,mesocarp,near,nearly,new,nfloresence,notch,often,older,one-celled,orolla,peduncle,placenta,pressure,pubescen,rachi,ruit,semitransparent,shorter,slightly,small,smaller,sometimes,sparsely,stamen,stigma,straight,style,tal,tamen,tem,tissue,triangular,tube,two-celled,unit,upper,usually,vary,vein,watery,wid,woody,ympodial	arrangement,articulation,branching,colour,corolla,form,heteromorphism,inflorescence,insertion,leaf,length,mature,mentioned,modification,number,pore,position,present,prickle,shape,simple,stem,symmetry,texture,trichome,type,zygomorphy
512	wfo-0001032176	success	177	142	124	53	18	0.701	.5,0,0.42,0.5-0.7,0.5-1,0.8-1,0.8-6,1-1.2,1-10,1.5-1.6,1.5-2.5,1.5-6,1/2,3-3.5,3-4,3-7,5-6-celled,6,6-10,7,adaxially,along,anther,anthesi,apex,apical,basal,base,beak,becoming,berry,branched,calyx,cell,cm,conical,copiously,corolla,cucullate,densely,denser,diameter,drying,ellipsoid,elliptic,epidermal,equal,especially,exserted,filament,filiform,fruiting,glabrous,globose,green,greenish,grey-brown,greyish,herb,lateral,leaf,leaflet,lengthening,like,lobe,lobed,long,long-papillose,lower,margin,minute,minutely,mm,nearly,nodding,node,obovate,occasionally,onto,ovary,ovoid-reniform,pair,papillose,pedicel,per,petiole,pinnate,pore,poricidal,projection,pubescent,quadrate,rachi,reflexed,rest,rooting,rounded,seed,simple,sinuous,size,slightly,slit,smaller,somewhat,soon,sparsely,stem,stigma,strongly,style,terminal,thickening,tip,trichome,truncate,tube,uniseriate,vein,wall,white,winged,without,x	0.5,0.5-0.75,100,2-3,2.5-10,3-15,adhering,apart,arising,attaining,attenuate,axil,axillary,capitat,cateniform,containing,creeping,eaf,edicel,eed,fallen,flower,free,hangin,inflorescenc,lengt,log,nflorescence,obtuse,often,open,pale,petiolule,portion,ruit,scar,separate,single,spaced,strait,tem,tightly,time,tree,trunk,tub,ud,ultimate,unevenly,unifoliat,unit,whit,ympodial	arrangement,branching,bud,capitate,cateniforme,colour,exsertion,form,fruit,growth,inflorescence,length,number,plant,pubescence,shape,straith,winging
513	wfo-0001032187	success	139	108	89	50	19	0.64	-11,-4,-4.2,-5,-9,0.1â1.4,0.5,0.5-,0.5â1,0.6â1.3,1.1â3.2,1.3â1.8,1.6â2.1,1.8â2,1.8â2.8,22,24.6â26.3,2â9,3.1â3.5,3â3.2,3â4,5-merous,5â7,7â11,9,acuminate,acute,anther,apex,appressed,aromatic,base,berry,blade,brown,brownish,cm,corolla,cyme,dark,dull,eglandular,elliptic,entire,filament,forked,glabrescent,globose,green,hair,herb,hooked,leaf,light,long,margin,mature,mm,obovate,occasionally,ovate,pedicel,peduncle,pentagonal,per,persistent,petiolate,petiole,plant,pollen,protruding,purple,rarely,simple,soft,sometimes,stage,stellate,stem,straight,style,sub-glabrous,texture,tinged,truncate,yellowish,Â±,Âµm,Ã	-2.1,100,1â1.7,adherent,alyx,angular,ape,branch,broadly,changing,consisting,di-foliate,dia,eaf,eed,equal,erect,flowered,fully,geminat,granule,hite,hydrated,lobe,lower,many,marked,nflorescence,numerous,penden,perfec,predominantly,presen,ridge,ruit,running,sclerotic,short,small,sparse,spreading,tooth,triangular,unit,well,widest,wing,yellow,ympodial,Â±1	arrangement,calyx,colour,diameter,flower,form,fruit,growth,height,inflorescence,length,number,perfect,seed,shape,size,type,white,width
514	wfo-0001032206	success	216	118	74	142	44	0.343	-20,accrescent,acute,anther,apex,articulated,base,berry,branched,calyx,chartaceous,cm,connivent,covering,cream,cuneate,dark,deltate,diameter,equal,flattened-reniform,flower,foliaceous,fruit,fruiting,glabrescent,glabrous,green,lateral,leaf,length,lobed,long-styled,margin,marking,mature,maturity,mauve,midvein,mm,moderately,obtuse,orange-brown,ovate,pale,pedicel,peduncle,per,petiole,plant,poricidal,prickle,purple,rarely,reflexed,short-styled,shrub,sometimes,spherical,stellate,stellate-pubescent,stem,straight,style,surface,tapering,tip,toward,trichome,truncate,usually,white,yellow,young	-0.8,-2,-5,..,.2,.5,0,0.2,0.2â0.4,0.2â0.5,0.5â1,0.8â1.2,00â200,0â20,0â30,0â5,1,1.1â1.2,1.2â2.2,1.5â2,1.5â2.5,1/3,1/4â1/2,1/4â1/3,1/6,10â80,11â22,1â2,1â2.3,1â3,1â4,2.5â3.3,2.7â3.5,2â2.5,2â3,2â8,3.5â9,30â80,3â4,4.5â5.8,4â6,5-merous,5â15,5â20,5â6,5â8,5â9,6â10,6â15,6â8,7â10,8â20,abaxially,adaxially,alyx,andromonoecious,apar,apart,apically,apparently,approximately,armed,bark,blade,bluntly,broad-deltate,brow,clearly,concolorous,curved,discolorous,distal,distance,drying,eaf,eed,elliptic,erect,extending,filament,flattened,free,functionally,gently,green-brown,hermaphroditic,heterostylous,infructescence,lengt,lobe,lobing,long,longer,lowermost,mal,midpoint,nflorescence,often,older,one,open,orolla,ower,pair,pendent,pendulous,pericarp,plurifoliat,porrect,portion,primary,ray,scar,secondary,sessile,side,slender,smooth,spaced,sparsely,spreading,stalk,stalked,stout,tamen,tertiary,time,tube,uit,unarmed,ung,unit,variously,vary,vein,venation,visible,weakly,wide,woody,yellow-orange,ympodial	0.5-1.5,0.8-1.2,00-200,1-2,1-2.3,1-3,1.1-1.2,1.2-2.2,1.5-2.5,1/4-1/2,1/4-1/3,11-22,2-2.5,2-3,2.5-3.3,2.7-3.5,3-4,3.5-9,4.5-5.8,5-15,5-20,5-6,5-9,6-15,8-20,articulation,branching,colour,corolla,form,growth,hair,height,heteromorphism,inflorescence,number,ovary,position,seed,shape,staman,texture,type,width
515	wfo-0001032209	invalid_json	257	147	122	135	25	0.475	0.5-1,1-2,1-2-celled,1-6,1.5-2,1.5-6,10-13,2,2-3,2-3-lobed,2-5,2/3,20-30,3-7,5-8,acute,along,anther,apex,appearing,basal,base,berry,bilobed,blue,branched,brown,capitate,cell,chartaceous,cm,colour,cordate,coriaceous,corolla,dark,deeply,dendritic,densely,diameter,ecuador,elliptic,entire,evenly,filament,flattened-reniform,fleshy,flower,glabrous,globose,growth,hairy,hastate,inflorescence,lamina,lateral,leaf,leathery,length,lengthening,like,lobed,lower,margin,markedly,metallic,minutely,mm,narrowly,nearly,occasionally,one,ovate,papillate,pedicel,peduncle,per,perfect,pericarp,petiole,pinnately,pinnatifid,pore,poricidal,puberulent,pubescent,purple,red,reddish,rest,ripe,sagittate,several,shiny,simple,slit,sometimes,somewhat,stellate,stem,stigma,style,surface,tapering,terminal,testa,thin,time,tiny,tip,trichome,truncate,uniseriate,upper,vein,vine,violet,w,wall,white,woody,x	-11,-20,-30+,.5,0.3,0.5,1,1-1.5,1.5,1.5-,1.5-2.5,100,12-16,2.5-,3-9,4,4-20,5-merou,6-15,6-8,absent,adaxial,ag,alyx,anthesi,apart,apiculae,apparently,arching,ark,articulated,axi,berr,branch,broadly,bu,calyx,canopy,cast,climbing,conical,connivent,conspicuously,cucullat,deltate,denser,distally,distinct,dried,eaf,early,eed,ellipsoid,enlarged,equal,erect,especially,exerted,finely,flowering,free,fruiting,geminat,giving,glabrescen,groove,hanging,held,hollow,ilament,keeled,large,leaving,less,lobe,long,longer,longest,material,mean,mere,middle,midrib,midvein,minute,mixture,near,new,nflorescence,nipple,often,older,orolla,pair,papillae,papillat,part,particularly,peg,pentagonal,planar,plurifoliate,pointed,portion,primary,probably,pubescence,rhachi,rim,ruit,scar,sleeve,small,spaced,sparser,spreading,stout,tem,testal,third,tightly,tube,twinin,twining,ud,unequal,unit,usually,variable,vary,weight,widest,within,yellow,ympodial	'',2.5-15-20,4-20-30+,5-merous,[,``,age,arrangement,bark,branching,characteristic,form,fruit,glabrescent,number,ovary,position,seed,shape,size,texture,type,value,{,}
516	wfo-0001032232	success	137	99	77	60	22	0.562	.5,0.1,0.5,0.5-1,0.6-3,0.8-1,1-3,1.8-2,18.8-27.5,2-2.6,20-100-flowered,3/4,4.8-7.3,5-6,anther,anthesi,apex,attenuate,bark,base,clavate,closely,cm,corolla,dark-papillose,deflexed,elliptic,evenly,filament,filiform,flower,fruiting,glabrous,globose,green,greenish-brown,lateral,leaf,lenticellate,less,light,lightly,lobed,long-acuminate,main,margin,minutely,mm,narrowly,opposite,ovary,ovoid-reniform,packed,pair,pale,pedicel,petiole,pitted,pore,revolute,scar,shaped,short-styled,shrub,slightly,stem,stigma,style,subshrub,surface,tear-drop,tip,translucent,undulate,vein,way,winged	0.25,2,?,abruptly,age,ba,becoming,berry,calyx,cup-shaped,decurrent,dia,distally,eaf,edicel,eed,erect,erose,exfoliatin,free,immature,irregular,lobe,long,lower,middle,midrib,minute,nflorescence,node,occasionally,onto,overlappin,paler,papillo,papillose,poricidal,portion,prominent,raised,reflexed,rounded,ruit,simple,somewhat,sparsely,straight,tall,ti,tub,tube,ud,umbonate,unifoliat,unit,wide,widening,widest,woody,ympodial	arrangement,bud,colour,diameter,form,fruit,growth,hair,height,inflorescence,length,number,packing,pattern,plant,position,seed,shape,texture,unifoliate,width,winging
517	wfo-0001032233	success	160	125	92	68	33	0.575	0.3-2,1-1.5,1-2,1.5-2.5,10-15,157,2-15,2-3,2-5.5,2-6,20-100+,25-40,3-15,3-4,3-4.5,3-5,3.5-4,4-7,5-16,5-6,adaxial,adaxially,almost,apex,basal,base,branched,calyx,chartaceous,cm,connective,convex,cordate,coriaceous,cylindrical,dark,densely,diameter,dilated,directed,distally,ellipsoidal,entire,flattened,fleischmann,flower,fruit,glabrescent,glabrous,glandular-puberulent,globose,green,laterally,lobe,longitudinal,margin,mm,moderately,oblong,obtuse,orange,ovate,ovoid,pedicel,peduncle,petiole,pore,puberulent,pubescent,purple,radiu,shallowly,simple,slightly,somewhat,sparsely,stellate,stigma,stripe,style,subcoriaceous,subpeltiform,tip,tree,triangular,truncate,unbranched,unit,x,yellow,yellow-green,yellow-orange	0-2,1-3,2-4,2.5-4,4-18,4-5,4-foliat,6-25,8-12,abaxially,absen,absent,acuminate,acute,aggregate,apart,ape,articulated,axe,bent,beyond,biglandula,blade,brow,cell,connivent,eaf,eed,equal,especially,exceeding,exserted,fleshy,glabrate,leaving,lon,long,lower,narrowly,nflorescence,nther,orolla,pedicellar,perfect,present,projection,puberulen,rachise,remnant,ruit,shorter,small,spaced,stamen,stone,tal,tem,thecae,time,tomento,toward,tube,ud,vary,vein,white,wide,ympodial	4-foliate,abaxial,anther,articulation,biglandular,branching,brown,bud,colour,corolla,direction,form,growth,hair,height,inflorescence,leaf,length,number,ovary,plant,position,rachi,seed,shape,size,spacing,stem,structure,sympodial,texture,theca,type
518	wfo-0001032259	success	202	77	61	141	16	0.302	.5,0-20,0.5-0.8,0.8-1.3,0.9-1.2,1.5-4.5,20-60,abaxial,acute,adaxial,almost,anther,apex,base,berry,branched,brown,chartaceous,cm,conical,cordate,cuneate,dark,densely,diameter,equal,evenly,flattened,flattened-reniform,flower,fruit,fruiting,glabrous,green,lateral,leaf,length,lobed,margin,maturity,mauve,mm,orange,ovate,pedicel,per,petiole,poricidal,prickle,red,shrub,simple,spherical,stellate-pubescent,straight,surface,tapering,terminal,tip,white,young	-4,/3,/4,0,0-10,0-2,0-4,0-5,0.1-0.2,0.1-0.3,0.15-0.3,0.45-0.6,0.5-1.5,0.7-1.1,1-1.8,1-2,1-2.5,1/2,1/3,1/4-1/3,1/6-1/5,10-30,15-40,2-2.5,2-4,2-5,2.2-3,3-4,3/,4,4-5,4-6,4-9,5,5-30,5-merous,5.5-8,7-16,7-8,9-22,abaxially,acut,alyx,apar,apart,apically,apparently,articulated,bark,becoming,blade,broad-deltate,brownish,calyx,connivent,deltate,difoliate,discolorous,distance,drying,dull,eaf,eed,elongating,erect,extending,filament,free,fully,geminate,glabrescent,gland,green-brow,hair,infructescence,lobe,long,longer,lower,mature,midpoint,midvein,minute,moderately,nflorescence,older,one,open,opening,orange-brown,orolla,oung,pair,peduncle,pendulous,perfec,pericarp,porrect,portion,prickl,prickly,primary,pubescent,ray,recurved,reduced,rounded,ruit,scar,sessile,shorter,side,slender,smooth,sometimes,spaced,sparsely,spreading,stellate,stem,strongly,style,tamen,terete,tertiary,time,toward,trichome,tube,unarmed,unit,vary,vein,venation,visible,way,wide,woody,yellow,yellow-green,ympodial	branching,colour,corolla,form,growth,heteromorphism,inflorescence,number,orientation,ovary,position,seed,shape,staman,texture,type
519	wfo-0001032260	success	216	91	62	154	29	0.287	0.5-2,0.7-1.5,6-10,abaxial,acuminate,acute,adaxial,anther,apex,articulated,base,berry,branched,calyx,chartaceous,cm,connivent,cuneate,densely,dull,elliptic,elongating,filament,flattened-reniform,fruit,fruiting,glaucous,green-brown,lateral,leaf,length,lobed,long,lower,margin,mature,maturity,mauve,mm,orange-brown,ovate,pedicel,petiole,poricidal,prickle,purple,red,reflexed,rounded,shallowly,shrub,simple,spherical,stellate-pubescent,stem,subentire,surface,tapering,terminal,tip,yellow,yellow-green	-0.5,-1.5,-10,-3,-8,.1,/5,0-,0-0.5,0-10,0-20,0-5,0-8,0.1,0.1-0.3,0.1-0.4,0.15-0.3,0.2,0.2-0.5,0.4,0.5-0.8,0.5-5,0.6-0.8,0.7,0.8-1.1,1-1.7,1-3,1-5,1-6,1.2-1.7,1.5-4,1/2,1/3,1/3-1/2,1/3-1/5,10-30,2,2-20,2-4,2-5,2.5,2.5-3,2.5-3.5,3-10,3-5,3-8,3-9,4-,5-,5-20,5-merous,6-8,7-15,abaxially,acuminat,alyx,apar,apart,apically,apparently,bark,blade,broad-deltate,cell,curved,deltate,diameter,difoliate,discolorous,distance,drying,eaf,eed,equal,erect,extending,eye,flattened,flower,free,geminat,glabrescent,glabrou,glabrous,gland,globular,gray-brow,infructescence,lobe,lon,long-styled,longer,midpoint,midvein,moderately,naked,narrow-ovate,nflorescence,older,one,open,orolla,oung,outline,pair,pale,peduncle,pendulous,per,perfec,pericarp,pit,porrect,portion,prickl,prickly,primary,pubescent,raised,ray,reduced,ruit,scandent,scar,sessile,shorter,side,slender,small,smooth,spaced,sparsely,spreading,stalk,stalked,stellate,strongly,style,tamen,terete,tertiary,time,trichome,tube,unit,variously,vary,vein,venation,visible,way,wide,woody,ympodial	appressed,articulation,bract,branching,colour,corolla,form,growth,hair,heteromorphism,inflated,inflorescence,insertion,marking,modification,na,needle-like,odour,orientation,placement,pore,position,seed,shape,spot,staman,symmetry,texture,type
520	wfo-0001032264	success	183	103	90	93	13	0.492	.2,.5,0.25-0.5,0.25-0.75,0.5-1,0.6-2.2,0.8-10,0.8-4,1-1.5,1.2-2,1.5-1.8,1.8-3,2-50-flowered,3,3-15,3-9,4.5-5,acuminate,acute,anther,apex,apiculate,base,branched,broadly,calyx,cell,cm,corolla,cup-like,dia,elliptic,filament,flattened-reniform,fleshy,flower,fruiting,glabrous,globose,green,hair,inflorescence,leaf,lobed,long,minor,minute,minutely,mm,multiseriate,narrowly,nearly,occasionally,opposite,ovary,pale,papillose,pedicel,petiole,pitted,plant,pore,poricidal,red-papillose,reddish-tan,several,shaped,short,shrub,simple,size,slender,small-capitate,stem,stigma,straight,style,surface,tapering,tear-drop,time,tip,tree,trichome,tube,uniseriate,white,wide,x,yellowish-brown	10-22,2-6,5-9,6-17,along,anthesi,apar,appearing,ba,bark,berry,bud,bullate,cell-layer,closely,curling,deciduous,deflexed,densely,differing,difoliate,dry,eaf,edicel,eed,epidermal,exserted,free,geminat,gnarled,greyi,habitat,incrassate,lamina,large,larger,lateral,layer,like,live,lobe,lon,lower,main,major,margin,material,middle,nflorescence,often,older,one,overlapping,ovoid,pair,papillo,parallel,peeling,planar,pointed,portion,primarily,prominent,pubescent,quite,raised,reddish,revolute,rounded-deltoid,ruit,scar,scattered,sheet,sheltered,small-celled,somewhat,soon,spaced,sparsely,tall,thick,transversely,trunk,ud,unit,upper,vein,weak,whitish,widest,woody,ympodial,young	branching,colour,diameter,form,fruit,growth,height,length,number,position,seed,shape,texture
521	wfo-0001032274	invalid_json	192	119	90	102	29	0.469	.5,0,0.5,0.5-0.7,0.5-1,1-1.2,1-1.5,1-3,1.5-2,3-4,3-6,3/4,5-7,<,acuminate,acute,anther,apex,arching,base,berry,brown,capitate,cell,cm,corolla,dendritic,densely,diameter,distal,ellipsoid,entire,filament,flattened-reniform,flower,fruiting,glabrous,globose,growth,inflorescence,lanceolate,leaf,lobe,lobed,margin,minute,minutely,mm,occasionally,once-branched,pale,pedicel,peduncle,per,perfect,petiole,pitted,pore,poricidal,pubescent,purple,red,reddish,ridge,ridged,ripe,rounded,shape,shiny,shrub,simple,size,square,stellate,stem,stigma,strongly,style,suckering,surface,terminal,testal,tip,trichome,truncate,tube,uniseriate,way,white,x	0.15-0.2,0.5-1.5,0.7-1.8,0.9-1,2,2-3.5,2-7,3-10,3-5,5-merou,ag,alyx,anthesi,apiculate,apparently,appearance,ark,articulated,axillary,ba,basal,borne,branch,calyx,clustered,conical,connivent,deltate,eaf,eed,elliptic,exserted,filiform,fleshy,free,geminat,glabrou,green,grey,group,highly,ilament,irregular,lax,lengthening,less,like,long,loosely,lower,markedly,membranous,new,nflorescence,nodding,non-reproductive,obtusely,often,older,one,orolla,pair,papillo,peg,pendan,pericarp,platfor,platform,plurifoliate,portion,primary,puberulent,quadrate,reflexed,reproductive,ruit,scar,shoot,short,sleeve,slit,small,sometimes,somewhat,sparsely,tem,thin,tinged,twinin,two,ud,unit,upper,usually,variable,vary,vein,violet,visible,woody,yellow,ympodial	'',5-merous,[,``,arrangement,articulation,branching,bud,characteristic,colour,form,fruit,hair,height,length,na,number,ovary,pattern,plant,position,seed,symmetry,twining,type,value,ye,{,}
522	wfo-0001032276	success	152	102	84	68	18	0.553	-,.25,.5,0.25-1.5,0.3-1,0.5-0.75,0.5-1,0.8-1,1,1-1.5,1-2,1.8-2,2-2.5,2.5-4,3-3.5,3-6-flowered,5-7,9-18,along,anther,anthesi,attenuate,base,beneath,blade,broadly,brown,calyx,cm,corolla,cup-shaped,dark,deltoid,dia,dry,elliptic,filament,filiform,fruiting,glabrous,globose,green,lamina,leaf,like,lobe,lobed,long,long-pubescent,material,minutely,mm,narrowly,nearly,occasionally,onto,opposite,ovary,ovoid-reniform,pedicel,petiole,pitted,plant,pore,pubescent,rest,shaped,shrub,simple,slender,sparsely,stigma,style,surface,tapering,tear-drop,triangular,trichome,tube,uniseriate,vein,white,winged,x	7-8,acute,apart,apex,ba,bark,capitat,converging,curly-tipped,decurrent,deflexed,densely,eaf,edicel,eed,ellipsoid,evenly,except,exserted,free,geminate,greyish-gree,later,lateral,lower,main,margin,middle,minute,nflorescence,node,non-reproductive,obovoid,older,pair,pale,papillose,perhaps,poricidal,portion,prominent,raise,raised,reflexed,remaining,ruit,scar,short,slightly,somewhat,soon,spaced,stem,straight,straw-colored,strongly,tall,tip,tub,ud,unifoliate,unit,widely,widest,woody,yellow,ympodial,young	branching,capitate,colour,diameter,flower,form,fruit,growth,height,inflorescence,length,number,position,seed,shape,size,texture,type
523	wfo-0001032277	success	163	96	77	86	19	0.472	.5,0.1-0.5,0.2-0.6,0.75-1,0.8-3,1-1.1,1-1.2,1-2,2-2.5,2-4,3-3.5,5-6,8-9,anther,area,base,blunt,bright,calyx,cm,coriaceous,corolla,cup-shaped,densely,elliptic,filament,flattened-reniform,fruit,fruiting,glabrous,globose,green,immature,incrassate,inflorescence,internodal,lax,leaf,margin,minutely,mm,opposite,ovary,pale,paler,papillae,papillose,pedicel,petiole,pitted,pore,poricidal,puberulent,pubescent,revolute,ripe,round,shrub,simple,slender,small,sparsely,spicy-fragrant,stigma,straight,style,surface,tip,translucent,trichome,tube,uniseriate,white,woody,x,yellow,yellowish-tan	1-1.5,1-5,1.5-1.8,1/2,10-14,2-6-flowered,3-9,acute,along,anthesi,apex,apiculate,appear,appearing,auriculate,ba,bark,beneath,berry,blade,branched,closely,deltoid,dia,drooping,dry,eaf,edicel,eed,ellipsoid,erect,exserted,free,geminat,gre,impressed,indentation,lateral,like,lobe,lobed,long,lower,main,mature,middle,nflorescence,number,obscured,occasionally,older,overlapping,pair,partially,portion,prominent,pubescenc,raised,reddish,remaining,rest,rounded,ruit,scar,slende,spaced,specimen,stem,strict,strongly,styl,tall,tapering,truncate,trunk,tub,two,ud,unit,varying,vein,virgately,way,widest,ympodial,young	abaxial,adaxial,branching,colour,diameter,flower,form,fragrance,growth,hair,height,length,plant,position,seed,shape,size,texture,type
524	wfo-0001032304	success	249	99	85	164	14	0.341	0.3-1.5,0.5-3,0.5-4.5,0.9-1.3,10,18,2-4,2-5,2.5-19.5,3-10,3-15,3-20,3-6,3.2-3.8,5-6,7-27,abaxially,acuminate,acute,adaxially,anther,apart,apex,appressed-tomentose,bark,base,blackish,blunt-tipped,branch,branched,brownish,bud,calyx,campanulate,cm,corolla,diameter,entire,few-,flower,fruit,glabrescent,granular-tomentose,greenish,growth,hair,leaf,length,long-attenuate,many-rayed,margin,mm,mostly,multangulate,oblong,opaque,ovate,pale,pedicel,peduncle,petiole,plant,porrect-stellate,probably,rachi,ripe,scabridulous,short-,shrub,simple,small,stellate-tomentose,subglobose,thick,time,tomentose,tree,velutinous,violet,white,whitish,x,yellow,yellowish,young	-3,.6-1.2,.9-1.4,/20,0-120,0.2-0.3,1,1-3.5,1.1-2,1.2-2.3,1.2-3,1.3-2.1,1.5-3.2,1.6-1.9,1.8-4,1/2,1/3-1/2,1/5,1/8,2-4.2,2/3-3/4,21,3-4.5,3.2-5.5,4-7.5,44,5.5-9,7.5-12,9-13,accrescent,ag,along,anthesi,apical-lateral,apparently,articulated,ascending,axe,axillary,ba,becoming,berry,blade,broadly,brown,capitat,chartaceous,closely,conical,continued,dark,decurrent,dehiscing,deltoid,dendritic,dendritic-echinoi,dendritic-echinoid,densely,directed,distal,due,eaf,echinoi,echinoid,elliptic,especially,exserted,extend,few-rayed,filament,fleshy,free,fruiting,glabrescen,glabrous,green,high,honeycombed,inserted,introrse,juvenile,large,lateral,least,lobe,lobed,long,long-,long-stalked,longitudinal,lower,m.,main,many,midvein,mixed,multangulat,nflorescence,obscured,obtuse,occasionally,often,older,orbicular,orolla,ovat,ovate-lanceolate,overlapping,partly,perfect,plurifoliate,pore,present,pseudo-terminal,pubescent,rarely,rather,ray,relatively,reniform,reticulate-punctate,rotate-stellate,ruit,runk,seed,sessile,short,short-stalked,side,slit,somewhat,spaced,sparingly,spreading,stamen,stem,stigma,strongly,style,suborbicular,sulcate,suture,tamen,terete,testa,thick-stalked,thin,thin-,thin-stalked,tomentu,touching,toward,triangular-ovate,tube,unarme,unarmed,unit,usually,vary,vein,way,wide,within,ympodial	0.9-1.4,arrangement,branching,colour,form,height,inflorescence,shape,size,spacing,texture,thicknes,trunk,type
525	wfo-0001032307	success	153	113	93	60	20	0.608	.5,/3,0.2-0.5,0.4-1.3,1-2,1.5-5,10-20,2-5,2.5-12,2.5-3,2.5-3.5,3.5-4,30,4-8,5-12,5-25-flowered,7-18,abaxial,acute,anther,apex,bark,base,branch,branched,calyx,capitate,cm,corolla,dark,dendritic,densely,ellipsoid,elliptic,elongate,erect,exserted,filament,flattened-reniform,fleshy,fruiting,glabrous,globose,green,growth,incrassate,inflorescence,later,lateral,leaf,lobed,long,many,margin,minute,minutely,mm,ovary,pair,pale,papillae,pedicel,petal,petiole,plant,pore,prominent,pubescent,reddish-brown,scar,shaped,shrub,small,spaced,sparsely,stem,stigma,strongly,style,surface,tan,tear-drop,terminal,time,tree,tree-like,trichome,truncate,tube,unevenly,vein,way,white	1-1.5,1.5-2,?,adaxial,along,anthesi,apar,berry,blade,body,brow,campanulate,christmas-tree-like,congested,deltate,dia,eaf,edicel,eed,either,flat,free,glabrate,immature,inflorescenc,like,lobe,lon,loose,lower,main,middle,new,nflorescence,older,papillo,pitted,planar,plurifoliat,poricidal,portion,reddish,rest,ruit,stout,tall,thick,thickened,tip,tub,type,ud,upper,variable,wide,widest,within,woody,ympodia,young	apart,branching,brown,bud,colour,diameter,exsertion,flower,form,fruit,hair,height,length,papillose,plurifoliate,position,seed,shape,sympodia,width
526	wfo-0001032308	success	190	108	93	97	15	0.489	1-10,1.5-2.5,1.8-2.5,2,3-10,4-7,4-8,6,abaxially,absent,acute,adaxially,anther,apex,base,broadly,brownish,cell,ciliate,cm,condition,cordate,corolla,covering,cuneate,deep,distal,dorsally,drying,edge,elliptic,flat,flower,folded,forked,fresh,fruit,generally,glabrous,globose,green,green-white,greenish,hair,hair-like,half,interjected,irregular,lanceolate,lateral,leaflet,lengthening,lobed,long,make,margin,medium,minute,minutely,mm,mucilaginous,obtuse,odd-pinnate,orbicular,ovate,ovoid,pedicel,peduncle,pentagonal,petiole,pore,poricidal,puberulent,pubescent,pure,ripe,rounded,seed,shape,slightly,slit,substellate,terminal,testal,thick,throughout,tip,truncate,typically,wall,wet,white,whitish	0-3,0.2-2.1,0.3-5,0.7-1,0.7-1.2,1-2,1.9-3,12-16,2-3,2-4,2-6,3-6,3.8-5,4.8-7.7,5-7,5-merou,6-11,8-9,acumen,ag,along,alyx,apart,apparently,articulated,axe,axillary,berry,blade,bud,capitat,chartaceous,clavate,connivent,diameter,digestion,dot,eaf,eed,enzyme,especially,exceeding,filament,geminat,glabrou,greatly,hal,homostylous,honeycomb-shaped,invested,larger,leave,like,living,lobe,lower,membranous,midrib,much,narrowly,nflorescence,non-glandular,often,orolla,pair,perfect,petiolulate,petiolule,plant,plurifoliate,removed,ruit,scattered,sessile,seudostipule,short,spaced,specimen,stamen,ste,stem,stigma,straight,style,subtending,sympodial,tamen,tri-,trichome,tube,unit,usually,vary,varying,wide,x,yellow	age,arrangement,articulation,branching,colour,connective,inflorescence,leaf,length,number,pseudostipule,spacing,stellate,symmetry,texture
527	wfo-0001032335	success	215	151	131	84	20	0.609	.2,.5,0,0.2â0.3,0.4,0.9â1,1.5â2,100,15,16,1â1.5,1â3,2.5â3,2â10,2â2.5,2â5,4â14,4â5,4â6-rayed,5â6,6â19,6â6.5,>,abaxial,acuminate,acute,along,anther,apex,appearing,articulated,attenuate,base,berry,branched,branching,bright,c.,capitate,cell,chartaceous,closely,cm,connivent,corolla,densely,diameter,drying,ellipsoidal,elliptic,entire,evenly,filament,flattened-reniform,fruiting,globose,gold,golden-yellow,growth,inflorescence,length,lengthening,less,like,lobe,lobed,long,loosely,lower,many,margin,membranous,minute,minutely,mm,moderately,multangulate,narrowly,new,onto,orange,pale,pedicel,peduncle,peltate,per,persistent,petiole,pitted,plane,pore,poricidal,porrect,porrect-stellate,pubescent,ray,reddish,regularly,ripe,scar,scurfy,sessile,short-stalked,shrub,simple,slit,small,somewhat,spaced,square,stellate,stem,stigma,style,surface,terminal,testal,time,tip,tree,trichome,tube,unevenly,upper,varying,way,white,wide,yellow,â4,âstellate	'',0.05,0.2,0.5,0.5â1,100+,10â12,12â15,1â1.2,3361,5-merou,7â10,abaxially,adaxial,ag,alyx,anthesi,apar,ark,axe,beneath,boh,calyx,center,covered,cup-shaped,deltate,dichasia,discolorous,eaf,eed,elongate,equal,erec,exserted,fide,flower,free,fused,glabrous,golden-brow,gradually,half,ilament,impressed,lamina,markedly,midpoint,narrowing,near,nflorescence,nodding,older,orolla,pair,papillo,part,perfect,pericarp,plurifoliate,portion,primary,pubescence,reflexed,ruit,shiny,short,silvery,slightly,sometimes,sparsely,stout,strongly,stub,tal,tem,thin,ud,unit,vary,vein,visible,woody,ympodial	age,apart,articulation,bark,bud,colour,form,fruit,golden-brown,hair,height,leaf,number,ovary,plant,seed,shape,texture,type,width
528	wfo-0001032337	invalid_json	225	147	119	106	28	0.529	0.4-1.5,0.5-3.5,1-2,1.2-2.8,1.4-2,1.5,2-3.5,2-7,2.3-11.5,3-4,3-8,3.6-5,4-17,4-6,4-9,4.5-14.5,8-10,8-17,9-29,abaxially,adaxially,anther,berry,blade,borne,brownish,canescent,cell,chartaceous,clavate,cm,condition,connivent,corolla,covering,darker,deep,densely,diameter,distal,dot,drying,end,filament,flower,forked,fresh,fruit,generally,glabrous,globose,green,green-white,greenish,hair,hair-like,half,herb,homostylous,lanceolate,lateral,leaf,leaflet,lengthening,light,like,make,membranous,mm,mottled,mucilaginous,odd-pinnate,often,ovoid,pair,pedicel,peduncle,pentagonal,petiole,plant,pore,poricidal,pubescent,purple,ray,ripe,rotate,scattered,seed,short,singly,size,slit,sometimes,sparsely,stem,stigma,straight,style,subglabrous,terminal,testal,thick,throughout,tip,tube,tuber,typically,unwinged,usually,violet,violet-purple,wall,wet,white,whitish,wide,wing,x	0,1,1-10,1-4,1.6-4,10,2,2-14,2-4,2-4.5,2.3-4.8,5-11,5-merou,9-21,acumen,acuminate,acute,ag,along,alyx,apart,apex,apiculate,apparently,articulated,attenuate,axe,axillary,base,basiscopic,broadly,bud,capitat,ciliate,cordate,cuneate,decurrent,digestion,dorsally,eaf,edge,eed,elliptic,enzyme,erec,especially,exceeding,except,flat,folded,frequently,geminat,glabrou,greatly,honeycomb-shaped,interjected,living,lobe,long,lower,margin,middl,midrib,minutely,nflorescence,oblique,obtuse,orbicular,orolla,ovate,paired,perfect,petiolulate,petiolule,plurifoliate,proximal,puberulent,rarely,reduced,removed,rounded,ruit,sessile,seudostipule,side,slightly,small,spaced,specimen,stamen,ste,stolo,subequal,subsessile,subtending,tall,tamen,tem,tertiary,tissue,tri-,unit,unpaired,vary,yellow,ympodial	'',[,``,abaxial,adaxial,age,arrangement,branching,calyx,capitate,characteristic,colour,form,growth,height,inflorescence,length,ovary,presence,pseudostipule,shape,staman,stolon,symmetry,texture,value,{,}
529	wfo-0001032344	success	157	91	66	91	25	0.42	0.2-0.5,1-1.3,1-4,1.5-6,10-29,2-2.8,2-3,3-5,3-7,3-8.5,3-9,3.5-6.5,4-11,4-8,5-10,6-15,9.5-21,absent,apically,bluish,branched,calyx,cm,connate,corolla,cyme,dark,dehiscent,diameter,dichasially,filament,flower,forked,globose,green,hair-like,herbaceous,interjected,lateral,leaf,leaflet,medium,mm,odd-pinnate,ovoid,pedicel,peduncle,perennial,petiole,plant,poricidally,puberulent,pubescent,purple,rotate,rotate-pentagonal,scarce,seed,size,style,terminal,tuber-bearing,typically,unit,violet,wall	1-3,1.5-4.5,1.6-2.4,2.2-4,2.8,3-6-foliat,abaxially,abruptly,acumen,acuminate,acute,adaxially,apex,apical,articulate,base,belo,broadly,cell,covering,cuneate,decurrent,dichasial,digestion,diminishing,distal,dorsally,dot,eaf,ebracteate,edge,eed,elliptical,emoval,enzyme,exceeding,generally,globo,green-white,half,honeycomb,inrolled,introrse,layeral,living,lobe,lon,long,long-attenuate,lower,lunat,make,maturing,monochasial,mucilaginous,nflorescence,nther,oblique,often,orolla,ovate,pair,pattern,perfect,petiolule,plan,proximal,reveal,ruit,sessile,seudostipule,short,slit,smooth,sometimes,specimen,stamen,stigma,straight,tal,tem,testal,thick,throughout,toward,vary,white,wide,yellow,ympodial,Â¼	3-6-foliate,7,anther,branching,colour,form,fruit,growth,height,inflorescence,length,lunate,margin,number,ovary,pore,present,pseudostipule,shape,stem,structure,sympodial,texture,type,width
530	wfo-0001032354	success	171	108	89	82	19	0.52	0,0.5-1,1-10,1-2,1-3,2-2.5,2.5-3,3-4,38/2,40-75,5-15,anther,aster,axillary,base,becoming,bilobed,branch,branched,broadly,brown,calyx,capitate,cell,cm,coarsely,colour,corolla,cuneate,dia,discoidal,ellipsoid,exerted,filament,fork,glabrous,glandular,globose,green,greenish-ivory,greyish,hair,lasting,leaf,linear,maturity,minute,mm,narrow,obovate,obovoid,occasionally,oval,ovary,ovoid,pebble-shaped,pedicel,pinnatisect,pore,poricidal,rh,rotate,rugose-reticulate,several,shape,shrub,simple,size,slightly,soft,somewhat,sparse,spreading,stellate,stem,stigma,stone,strongly,style,surface,tall,tip,violet,wide,wing,wooded,woody,x,year	0-5,0.3,0.8-1,0.8-1.2,1-5,10-lobed,2,25,250-400,29,4-6,5-10,acuminate,acute,almost,angular,anthesi,apex,aspect,axi,berry,c.,campanulate,creating,cut,decurrent,deep,deeply,distal,eaf,eed,effect,except,facetted,fleshy,flower,general,gre,gree,halfway,lanceolat,large,lengthening,lobe,lobed,lower,midrib,minutely,nflorescence,ovate,pair,pale,pedicellate,peduncle,plurifoliat,puberulent,pubescent,rather,rounded,ruit,secondary,seedling,shoot,single,sinus,slit,small,smaller,smel,straight,trichome,tub,ud,uniseriate,unit,unpleasant,usually,variable,vein,within,ympodial,young	branching,bud,decurren,exertion,form,fruit,growth,height,inflorescence,lanceolate,length,plant,position,seed,spread,symmetry,texture,tube,woodednes
531	wfo-0001032358	success	216	84	70	146	14	0.324	0.2-4,0.5-3,0.7-1,12-20,13-20,2,2-10,2-4,3-4,4-8,anther,apart,base,berry,branched,capitate,cm,cordate,corolla,curved,densely,entire,flattened,flower,fruit,furcate,globose,green,growth,inflorescence,internodal,leaf,margin,membranous,mm,orangish,ovate,pale,pedicel,peduncle,perfect,petiole,pore,poricidal,present,prickle,pubescent,purple,red,reniform,ripening,rotate-stellate,scar,shrub,simple,sinuate,slightly,spaced,sparsely,staman,stem,stigma,strongly,style,tan,time,type,unevenly,unisexual,yellowish	.1,.2,.3,.4,.5,/2,0,0.6-0.8,0.6-1,1-1.6,1-2,1.3-1.7,1.5-2,1.5-2.5,1/4-1/2,15-40,2-3,2-5,2.2-7.5,3-10,3.5-13,4-4.5,4-7,4-merous,4.5-5,abaxially,abscissio,acute,adaxially,along,another,anthesi,apex,appearing,armed,away,bark,basal,based,broad,brown,bulbous,calyx,cell,center,cupuliform,diameter,difoliate,dorsal,drying,eaf,eed,equal,erect,expanding,exserted,filament,free,frui,fruiting,geminate,glabrescen,glabrescent,glabrous,heteromorphic,interpetalar,irregular,irregularly,lamina,left,lengthening,like,linear,lobe,lobed,long,longer,lower,lowermost,margined,markedly,maturity,midpoint,midrib,midvein,minutely,new,nflorescence,nodding,occasionally,often,older,one,ovoid,pair,paler,papillat,papillate,part,peg,per,pericarp,persistent,pitted,planar,porrect,portion,prickly,primary,ray,rhachi,ruffly,ruit,sessile,shiny,short,short-stalked,sinus,slit,small,sometimes,somewhat,space,spreading,stellate,surface,thick,thin,three,tip,trichome,tub,tube,tuberculate,two,ud,unit,upper,usually,vein,way,whitish,widely,x,ympodial,zygomorphic	abaxial,adaxial,branching,broad-based,colour,form,heteromorphism,length,needle-like,orientation,position,seed,shape,texture
532	wfo-0001032367	success	231	115	87	144	28	0.377	0.4-0.5,1.2,100-300,2-3-celled,2-4,3-5,3-celled,5-merous,6-8,8,acicular,acute,anther,base,berry,branch,broad-based,calyx,capitate,cm,conical,cordate,dark,diameter,erect,flattened-reniform,flower,free,glabrous,gland-tipped,globose,green,greenish,hair,heterostylous,hyaline,immature,inflorescence,lateral,leaf,length,light,lobe,lobed,long,many,margin,maturity,minutely,mm,mottled,nearly,obtuse,ovary,ovate,pair,pale,per,petiole,pore,poricidal,prickle,recurved,red-brown,sessile,shallow,shrub,simple,size,spreading,stellate,stem,stigma,straight,style,suborbicular,tapering,tip,triangular,trichome,truncate,unbranched,uniseriate,usually,white,wide,yellow	-3,.2,.4,0-0.3,0.2â0.35,0.4â0.5,0.4â0.6,0.4â1,0.5â0.8,0.5â2,0.6,0.6â0.8,0.7-1.1,0.8,0.8â2,1-2,1-2.1,1â1.5,1â1.8,2,2.2â2.5,2.2â2.8,2.5â3,2â2.5,3.2â4,3â10,3â5,3â6,4,4â6.5,5.5â6.9,5â18,6.8â8.2,7â10,abaxial,abaxially,accrescent,adaxial,adaxiall,adaxially,also,alyx,anthesi,apex,arme,around,axi,ba,blade,congested,connivent,copious,cream,curved,deciduous,densely,difoliate,directed,distall,eaf,eed,enlarged,entire,equal,expand,fertile,filament,fruiting,geminat,geminate,glandular-puberulent,grading,herbarium,infructescence,lanceolate,largest,layer,least,long-styled,longer,lower,lowermost,major,membranous,mesocarp,midpoint,minute,mixed,mixture,moderately,narrowly,nflorescence,often,one,orolla,oung,papillat,pedicel,peduncle,portion,prickly,puberulent,pubescence,pubescent,rarely,ray,rest,ruit,scarcely,scattered,secondary,short-styled,shorter,similar,slender,small,smaller,somewhat,sparsely,specimen,spongy,spreadin,staminat,ste,surface,tall,tamen,terete,thick,tightly,time,tooth,tube,twice,unarmed,uniformly,unit,variable,vary,vein,whitish,ympodial,â15,â5	0.2-0.35,0.4-1,0.5-2,1-1.8,15,2.2-2.5,5-18,5.5-6.9,6.8-8.2,7-10,armed,arming,branching,colour,corolla,form,fruit,growth,height,number,papillate,pattern,plant,position,seed,shape,staman,type
533	wfo-0001032407	invalid_json	216	140	115	101	25	0.532	0-4,0.4-4,0.5-3,1-10,1-2,1-2.4,1.2-7,1.4-2.7,1.5-2.2,10-19.5,10-27,2-10.5,2.5-10.5,2.5-9,3-15,3.1-13.5,4-11,4-48,4-7,5,5-23,5-30,7-9,8-10,abaxially,adaxially,anther,berry,blade,brownish,cell,chartaceous,ciliate,clavate,cm,coarsely,condition,conical,corolla,covering,dark,densely,diameter,drying,edge,filament,finely,flower,folded,forked,fresh,fruit,glabrous,green,green-white,greenish,hair,hair-like,herb,homostylous,interjected,lanceolate,lateral,leaf,leaflet,lengthening,light,like,lobe,make,margin,medium,membranous,minute,minutely,mm,moniliform,mottled,mucilaginous,odd-pinnate,ovoid,pedicel,peduncle,pentagonal,petiole,plant,pore,poricidal,puberulent,pubescent,purple,rarely,ripe,rotate,seed,simple,size,slit,sparsely,stem,stigma,straight,style,terminal,testal,thick,throughout,tip,tube,tuber,wall,wet,white,whitish,x	0.3-0.6,0.3-8,0.8,0.8-0.3,1-5,12,2-4,30,38,5-merou,6,absent,acumen,acuminate,ag,along,alyx,apart,apex,apparently,arranged,articulated,asymmetrical,attenuate,axe,axillary,base,basiscopic,bead,bud,capitat,commonly,connivent,decreasing,digestion,distal,eaf,eed,elliptic,elongated,enzyme,erec,especially,exceeding,geminat,generally,glabrou,gradually,half,honeycomb-shaped,larger,less,living,long,lower,middle,multiple,narrow,necklace,nflorescence,obtuse,orbicular,orolla,ovate,pair,perfect,petiolule,plurifoliate,proximal,pubescen,ray,removed,round,ruit,secondary,semierect,sessile,seudostipule,side,spaced,specimen,stamen,ste,stolon,subequal,subtending,symmetrical,tall,tamen,tem,tissue,tri-,typically,unit,unwinged,usually,vary,wide,wing,yellow,ympodial	'',[,``,age,arrangement,branching,calyx,capitate,characteristic,colour,form,growth,height,inflorescence,length,ovary,pseudostipule,shape,spacing,staman,texture,value,width,{,}
534	wfo-0001032465	success	233	149	133	100	16	0.571	-10,-11,-9,.2,.5,0,0.5-,0.5-2,1-,1-1.5,1-1.7,1-celled,1.2-1.5,1.5-5,1/3,2,2.5-5.5,3-4,4,5-8,abaxial,acuminate,acute,anther,apex,articulated,axi,basal,base,berry,black,branched,brown,capitate,cell,cm,commonly,connivent,cordate,corolla,de,deeply,densely,diameter,ellipsoid,elliptic,elongate,entire,filament,flattened,flower,fruiting,glabrous,glandular-tipped,globose,greenish,growth,half,inflorescence,janeiro,later,lateral,leaf,leaving,length,lengthening,lobed,long,loosely,lower,margin,mature,minute,minutely,mm,narrowly,ovate,papillate,pedicel,peduncle,peg,pentagonal,per,perfect,petiole,pinnate,pinnatifid,pore,poricidal,puberulent,pubescent,purplish,reddish,reniform,reticulate,revolute,rio,ripe,scattered,seed,shape,similar,simple,size,sleeve,slit,sparsely,stellate-rotate,stem,stigma,style,surface,terminal,testal,time,tiny,tip,transparent,trichome,truncate,twining,uniseriate,upper,variously,varying,vine,violet,wall,way,white,woody,x,Â½	+,-14,0.2,1.5,1.5-1.8,1.5-2,2-2.5,25,3-3.5,3-5,3-8,3-9,5,5-7,5-merou,9,ag,alyx,angled,anthesi,apar,apically,appearing,ark,calyx,ciliate,clasping,conical,coriaceous,decreasing,deep,deeper,deltate,distal,drying,eaf,edge,eed,erect,exserte,filiform,free,fringe,glabrescen,gland,glandular,green,growing,ilament,included,irregular,irregularly,larger,like,lobe,membranous,new,nflorescence,nodding,occasionally,often,older,orolla,outline,pair,paired,papillo,pendan,pericarp,planar,plurifoliat,portion,primary,ruit,scar,shallow,shiny,sinus,somewhat,spaced,splitting,strongly,subshrub,tem,thicker,thin,toward,tube,tuft,twinin,ud,unicellular,unit,usually,vary,vein,widest,yellowish,ympodial,young	5-merous,age,appearance,articulation,bark,branching,colour,form,fruit,hair,number,ovary,papillose,position,texture,type
535	wfo-0001032494	invalid_json	163	120	90	73	30	0.552	.4,.5,0.6-1,0.75-1,0.8-1,0.9-1.2,1-1.5,1.45-1.5,1.5,1.5-8,1.6-2,1.8-4.5,2.3-2.5,2.5-8,3.4-14.5,3/4,5-40,acuminate,anther,anthesi,apart,apex,attenuate,axil,base,beneath,brown,calyx,clavate,cm,corolla,decurrent,expanded,filament,flattened-reniform,fruit,fruiting,furcate,glabrous,globose,incrassate,leaf,light,lobe,lobed,margin,minor,minutely,mm,narrowly,occasionally,opposite,ovary,ovate,pale,papillae,papillose,pedicel,petiole,pitted,pore,prominent,pubescent,raised,scar,shaped,shrub,simple,size,small,stem,stigma,style,surface,tan,tear-drop,tip,tree,trichome,tube,two-winged,uniseriate,upper,venation,way,white,whitish-green,winged,x,yellow	.1,1.1-1.2,16.5-20.5,2.5,3-4,4-8,5-6.4,8-11,accrescent,appearing,ba,bark,beginning,berry,bullate,deflexed,dia,differing,difoliate,dry,eaf,edicel,eed,equal,evenly,except,exserted,flowered,free,geminat,geminate,greenish-yellow,inflorescenc,lateral,lax,lenticellat,lon,long,lower,main,major,material,middle,nearly,nflorescence,node,orange,ovoid,pair,papillo,planar,poricidal,portion,proximal,quite,revolute,ridge,ruit,slender,slightly,somewhat,spaced,straight,tall,tapering,triangular,ud,unit,vein,widest,woody,ympodial,zig-zag	'',[,],``,branching,characteristic,colour,diameter,flower,form,glabrousnes,growth,height,inflorescence,length,lobing,number,plant,position,seed,shape,spacing,texture,type,value,winging,ye,zig-zagging,{,}
536	wfo-0001032507	invalid_json	206	185	143	63	42	0.694	.2,.5,/4,0.25,0.3,0.5,0.8,1,1.3,1.5â7,10â20,15â20,1â1.5,1â10,2,2.5â4,20â30,3â5,3â7,5â10,5â20,5â8,6,8â15,abaxial,abaxially,absent,acuminate,acute,adaxially,anther,apex,armed,articulated,base,becoming,blue,branched,broadly,brown,bud,calyx,cell,chartaceous,cm,collection,compound,connivent,corolla,cream,curved,deltate,diameter,distally,ellipsoid,elliptic,entire,exserted,fertile,filament,flattened-reniform,flower,flowering,four,fruiting,glabrous,globose,green,hair,herbaceous,herbarium,internode,lateral,leaflet,lengthening,light,lobe,long,major,margin,material,midrib,minutely,mm,narrowly,oblong,occasionally,often,one,ovate,pale,pedicel,peduncle,pentagonal,perennial,pericarp,petiole,pinnate,pinnately,pinnatifid,pistillate,pitted,pore,poricidal,present,prickle,puberulent,pulp,purple,purplish,rachi,rarely,reddish,rotate-pentagonal,rounded,rugose,shape,side,simple,slit,sometimes,staminate,stem,stigma,straight,strongly,style,surface,testal,time,tip,tube,unbranched,variously,vein,vine,way,white,wide,widest,woody,yellowish,Ã	0.7-1.2,1.2-1.7,1.5â2,2.5â6,2â9,4â10,abundant,adaxiall,adjacent,ag,alyx,anthesi,apiculate,berry,blade,campanulate,confluent,deep,distinct,dr.,eaf,eed,either,elongating,equal,fifth,highly,individual,interpetalar,larger,lobed,longer,lower,nearly,nflorescence,observe,orolla,papery,plant,plurifoliat,quadrate,ranging,recurve,regularly,ruit,single,sinus,slender,slightly,spreading,stout,tamen,tear,terminal,tissue,unequal,unit,unlobed,usually,variable,vary,wood,ympodial	'',[,``,age,armament,arrangement,articulation,branching,characteristic,colour,dry,exsertion,form,fruit,growth,hairines,herbaceousnes,inflorescence,leaf,length,lobing,number,observed,orientation,ovary,perenniality,plurifoliate,position,presence,ratio,recurved,seed,size,staman,symmetry,texture,type,value,width,woodines,{,}
537	wfo-0001032523	success	200	90	70	130	20	0.35	-5,/4,1.5-3,15-30,3.5-4,5-12,5-20,abaxial,adaxial,anther,base,berry,branching,calyx,cm,discolorous,drying,dull,elliptic,entire,evenly,flattened-reniform,flower,fruit,fruiting,glabrescent,green,inflated,lateral,leaf,length,lobed,long,lower,margin,maturity,mauve,membranous,mm,moderately,one,open,orange-brown,ovate,per,petiole,poricidal,prickle,primary,red,reflexed,secondary,shrub,simple,sometimes,spherical,stellate-pubescent,stem,straight,strongly,subentire,surface,tapering,terminal,time,tip,way,weakly,yellow,young	-2,.2,.5,0-0.15,0-10,0-12,0-15,0-3,0.1-0.2,0.2,0.2-0.4,0.3-0.5,0.4-1,0.4-1.5,0.5-1,0.6-0.7,0.6-0.8,1-1.5,1-2,1-3,1-8,1.3-1.6,1/3-1/2,1/4-1/3,10-50,2,2-2.4,2-2.5,2-4,2-5.5,2.5-6,2.7-3,3-15,3-4,4-5-merous,4-7,6-10,6-20,6-8,abaxially,acuminat,acuminate,acute,alyx,ame,apar,apart,apex,apically,apparently,articulated,bark,blade,brow,c.,conical,connivent,cuneate,curved,deltate,diameter,eaf,eed,elongating,equal,erect,filament,filiform,free,gently,glabrou,glabrous,hair,herbaceous,infructescence,lobe,lon,longer,mature,midpoint,minute,multangulate,narrow-deltate,nflorescence,older,orange,orolla,oung,pair,pale,pedicel,peduncle,perfec,pericarp,perpendicular,plurifoliat,porrect,portion,prickly,ray,recurved,red-brown,ruit,scandent,scar,sessile,smooth,spaced,sparsely,spreading,stalk,stalked,stellate,style,tamen,terete,tertiary,trichome,tube,unarme,unarmed,unit,variously,vary,vein,venation,visible,wide,woody,ympodial	appressed,colour,corolla,form,growth,heteromorphism,inflorescence,number,orientation,placement,pore,position,present,seed,shape,staman,symmetry,texture,type,zygomorphy
538	wfo-0001032524	success	205	115	99	106	16	0.483	1-2,1-2.5,1.5-2,1.5-4,10-35,12-13,2-5,2.5-8,25-90,4.5-8,5-9,6-13,6-16.5,7-8,abaxially,acumen,adaxially,anther,berry,blade,brownish,cell,chartaceous,clavate,cm,condition,connivent,corolla,covering,densely,diameter,dorsally,drying,edge,filament,flat,flower,folded,forked,fresh,fruit,glabrous,globose,grayish-green,green,green-white,greenish,hair,hair-like,herb,homostylous,lanceolate,lateral,leaflet,length,lengthening,light,lilac,make,membranous,minutely,mm,moniliform,mucilaginous,odd-pinnate,ovoid,pair,pedicel,peduncle,pentagonal,petiole,plant,pore,poricidal,puberulent,pubescent,purple,ripe,rotate,seed,size,slit,stem,stigma,straight,style,terminal,testal,thick,throughout,tip,tube,tuber,unwinged,violet,wall,wet,whitish,x	1-10,120-210,14-50,2-3,3-4,3-5,3-8.5,3.5-4.5,4,4-5,4.5-5,5-6,5-merou,50-70,7-35,?,acute,ag,along,alyx,apart,apex,apparently,arranged,articulated,ascending,attenuate,axe,axillary,base,bead,bud,capitat,ciliate,cuneate,different,digestion,distal,eaf,eed,elliptic,enzyme,erec,especially,exceeding,except,geminat,generally,glabrou,greatly,hal,half,head,honeycomb-shaped,interjected,like,living,lobe,long,lower,margin,middle,midrib,multicellular,multiple,narrowly,necklace,nflorescence,non-glandular,obtuse,often,orolla,ovate,perfect,petiolulate,petiolule,plurifoliate,proximal,reduced,removed,rounded,ruit,sessile,seudostipule,short,silky,silvery-white,spaced,specimen,stamen,ste,stolon,subequal,subtending,tall,tamen,tem,tetralobulate,tri-,trichome,typically,unit,usually,vary,yellow,ympodial	age,arrangement,branching,capitate,colour,form,growth,height,inflorescence,leaf,ovary,pseudostipule,shape,staman,symmetry,texture
539	wfo-0001032532	success	161	96	68	93	28	0.422	0.3-2.5,1-4,1.5-2.6,1.5-4.3,13-52,15-30,2-10,2-13,2-3,2.8-3.6,2.8-9.5,3-10,3.4-12.2,4-5.5,4.5,6,6-22,8-38,apically,branched,calyx,cm,conical,connate,corolla,cyme,deep,dehiscent,diameter,dichasially,distal,filament,finely,flower,forked,green,green-white,hair-like,herbaceous,interjected,lateral,leaf,leaflet,light,medium,mm,odd-pinnate,ovoid,pair,pedicel,peduncle,perennial,petiole,plant,poricidally,proximal,pubescent,purple,rotate,seed,straight,style,terminal,tuber-bearing,unit,wall,yellow,Â¼	0-.,1-1.5,1.5-3.2,2,2-,3-5,3-6-foliat,3.7-10,abaxiall,abaxially,absent,acumen,acuminate,acute,adaxially,apex,apical,articulate,attenuate,base,cell,coarsel,covering,cuneate,dichasial,digestion,diminishing,dorsally,eaf,ebracteate,edge,eed,elliptical,emoval,enzyme,exceeding,flat,folded,generally,globo,gradually,half,honeycomb,introrse,living,lobe,lon,long,long-attenuate,lower,lunat,make,maturing,minute,monochasial,mucilaginous,narrowly,nflorescence,nther,oblique,obtuse,often,orolla,ovate,pattern,perfect,petiolule,plan,reveal,rounded,ruit,sessile,seudostipule,short,size,slit,specimen,stamen,stigma,subequal,subsessile,tal,tem,testal,thick,throughou,throughout,tip,toward,typically,vary,wide,ympodial	0-2,2-5,3-6-foliate,anther,arrangement,articulation,branching,coarsely,colour,form,fruit,growth,height,inflorescence,length,lunate,number,ovary,pore,present,pseudostipule,shape,stem,structure,sympodial,texture,type,width
540	wfo-0001032536	success	254	104	88	166	16	0.346	/3,10,10-50,100,14-16,20-22,4-9,5-6,5-8,7-10,>,abaxial,adaxial,almost,anther,appressed,base,berry,bright,broad-based,brown,calyx,capitate,chartaceous,clavate,cm,conical,curved,dark,deeply,densely,depressed,diameter,elliptic,entire,equal,fading,flattened,flower,fruit,fruiting,globose,growth,inflorescence,juvenile,lateral,leaf,leaf-opposed,length,lobed,margin,membranous,mm,number,oblique,olive-green,once-branched,ovary,pentagonal,per,pericarp,petiole,plant,pore,poricidal,porrect,prickle,pubescent,purple,reddish,reniform,shallowly,simple,slightly,somewhat,stellate,stigma,style,tapering,tip,tree,trichome,truncate,trunk,unequal,way,white,yellow-green	-3,0.5,1,1-2,1-2.5,1.3-2.2,1.5,10-20,10-30,13-24,2-3,2.5-3,20-25,20-50,3,3-3.5,3-6,4-6,4-8,5,5-merous,5.5-8,<,abaxially,abruptly,acute,adaxiall,adaxially,age,along,alyx,angle,anthesi,apar,apex,armed,around,articulated,axi,bark,basal-most,berr,blade,bristle,bristly,broadly,caudat,caudate,cell,clearly,coriaceous,cu,dbh,deltate,denser,difoliate,directed,diverging,eaf,eed,enlarged,evenly,filament,free,geminate,glabrescent,glabrous,glandular,glandular-puberulent,grayish,halfway,hanging,heterostylous,inflorescenc,infructesecnce,interpetalar,irregularly,lamina,leaving,like,lobe,long,long-stalked,long-styled,lower,mature,maturity,midpoint,midrib,midvein,minute,minutely,mixed,mixture,multangulate,multiseriate,narrowing,narrowly,near,new,nflorescence,occasionally,occurring,odor,older,open,orolla,oung,papillae,papillat,papillate,part,pedicel,peduncle,portion,potato,prickl,prickly,primary,prominent,protuberance,rarely,ray,reproductive,rough,ruit,scar,scattered,short-,short-styled,slender,small,smooth,soft,spaced,sparsely,spreading,stalk,staminate,stellate-pubescent,stem,strongly,surface,tall,tamen,terete,terminal,thick,time,tissue,triangular,tube,unarmed,unit,upward,urceolate,usually,vary,vein,visible,wide,wood,woody,yellowish,ympodial,younger	branching,colour,corolla,form,hair,height,heteromorphism,lobing,placement,position,seed,shape,staman,texture,thicknes,type
541	wfo-0001032542	success	161	83	68	93	15	0.422	0.5-1,0.7-1,1-1.3,1-1.5,1-5,1.5-3.5,2-3,2-3.5,2.5-5,3-4,4.5-5,5-8,abaxial,anther,bark,bluish-green,bright,brown,calyx,capitate,cm,conical,corolla,dark,deflexed,dendritic,densely,elliptic,elliptic-obovate,filament,flattened-reniform,fruiting,glabrous,globose,golden,green,growth,inflorescence,leaf,less,long,minor,mm,opposite,ovary,pedicel,petiole,pore,pubescent,reddish-brown,rounded,shape,shaped,shining,shrub,size,small,somewhat,sparsely,stem,stigma,style,tear-drop,treelet,trichome,tube,wide,yellow-green	.25,.25-0.5,.5,.5-1,/4,1-2,10-15-flowered,10-28,3-5,4-7,4-9.5,abaxially,acuminate,acute,adaxially,along,anthesi,apex,apical,attenuate,axi,ba,basal,base,beginning,berry,closely,compact,deltate,di,dia,differing,difoliate,distal,dry,eaf,edicel,eed,either,erect,exserted,free,geminat,incrassate,inflorescenc,lamina,later,lateral,like,lobe,lobed,lon,loose,lower,main,major,margin,minute,minutely,narrowly,near,new,nflorescence,older,overlapping,pair,papillo,persisten,pitted,planar,poricidal,portion,ruit,scar,simple,slender,slightly,spaced,strongly,surface,swollen,tip,triangular,tub,ud,unit,vein,way,woody,x,yellowish,ympodial,young	0.25,adaxial,colour,deflexion,diameter,form,fruit,hair,length,persistence,persistent,position,seed,texture,width
542	wfo-0001032564	success	160	86	65	95	21	0.406	0.3-1,0.75-1,1-1.2,1-1.3,1-1.5,1-2,1.5,2-2.5,4-5,6-7,anther,anthesi,apex,base,becoming,broadly,brown,calyx,clavate,cm,conical,corolla,dark,densely,dry,elliptic,expanded,fresh,fruiting,glabrous,globose,golden,green,greenish-white,leaf,lobed,long-acuminate,material,minutely,mm,narrowly,nearly,opposite,ovary,ovate,ovoid-reniform,pedicel,petiole,pore,puberulent,ripe,shaped,shrub,slightly,stigma,style,tan,tear-drop,thread-like,trichome,truncate,tube,winged,x,yellowish-green	.05,.05-0.1,.1,.5,0.25-0.5,1.3-2.5,4-6-flowered,5.5-9,8-9,along,apar,apart,arched,aspec,ba,bark,beneath,berry,branch,bud,converging,deflexed,deltoid,dia,eaf,edicel,eed,except,exserted,extreme,filiform,flattened,flower,geminate,giving,glabrate,greyish-red,halfway,lamina,later,lateral,like,lobe,long,lower,main,margin,member,middle,minute,nflorescence,node,non-reproductive,obovoi,often,older,one,open,pair,papillo,papillose,pitted,planar,point,poricidal,projection,prominent,proximal,raised,reflexed,rounded,ruit,scar,shiny,simple,small,soon,stem,straight,strongly,surface,tall,tapering,time,tiny,tip,ud,unifoliate,uniseriate,unit,vein,widest,woody,ympodial,young	0.05,0.05-0.1,0.5,2,abaxial,adaxial,colour,diameter,form,fruit,growth,height,inflorescence,length,plant,position,pubescence,seed,shape,size,texture
543	wfo-0001032569	success	164	87	70	94	17	0.427	.5,/3,0.5-10,0.8-1,1-1.2,1-1.5,1-2,1.2-5,1.5,1.5-2,1.7-2,2-3,2-4,4-8,5-6,5-60-flowered,7-9,abaxially,adaxially,anther,apex,base,berry,bilobed,branched,broadly,calyx,cm,conical,corolla,decurrent,dendritic,elliptic,filament,flattened,fleshy,fruiting,glabrous,globose,inflorescence,leaf,lobed,long,minor,minutely,mm,occasionally,onto,opposite,ovary,ovate,pedicel,petiole,pitted,pore,reniform,shaped,shrub,simple,size,stigma,style,surface,tear-drop,thick,trichome,tube,way,white,x	1-4,4-18,7-27,acute,along,anthesi,apparently,appearing,axi,bark,bearing,brown,bullate,cell,closely,corrugated,dark,deflexed,dense,densely,denser,dia,differing,difoliate,dry,drying,eaf,edicel,eed,ellipsoid,erect,exserted,free,geminate,golden,gra,green,incrassate,irregularly,later,lateral,lea,like,lobe,lon,los,lower,main,major,margin,matted,mature,middle,moderately,nflorescence,obscured,open,otherwise,pair,paler,papillo,papillose,pericar,planar,poricidal,portion,present,pubecsence,pubescent,rich,ruit,scar,somewhat,spaced,sparsely,splitting,stem,stone,strongly,tall,time,tip,triangular,tub,tuft,ud,unifoliate,unit,vein,waxy,widest,woody,ympodial,young	branching,colour,diameter,flower,form,fruit,growth,hair,height,length,number,plant,position,seed,shape,texture,type
544	wfo-0001032576	success	229	82	64	165	18	0.279	/5,0.5-4,2-10,2.5-4,4-6.5,5-30,anther,base,berry,branched,branching,bright,brown-green,calyx,chartaceous,cm,dull,elongating,entire,equal,evenly,flattened-reniform,flower,fruit,fruiting,green,hair,herb,lanceolate,lateral,leaf,length,lobed,long,lower,margin,maturity,membranous,mm,moderately,orange-brown,ovate,per,petiole,poricidal,prickle,purple,red,red-green,shrub,simple,spherical,spreading,stellate-pubescent,stem,surface,tapering,terminal,tip,way,white,yellow,yellow-green,young	-10,-12,-2,-2/3,/4,0,0-1.5,0-3,0-30,0-5,0.1,0.1-0.15,0.1-0.2,0.1-0.25,0.3-0.5,0.3-0.7,0.5-1,0.5-1.5,0.5-2,0.8-1.2,0.8-1.4,0.8-2,1-3,1-4,1.2-1.8,1.5-2,1.5-2.3,1.5-7.5,1.8-2.5,1/2,1/3,1/3-1/6,2-3,2-4,2-5,2.5-3,3-14,4,4-,4-5-merous,4-6,6-8,7-8,abaxially,acuminat,acute,alyx,apar,apart,apex,apically,apparently,articulated,ascendant,ba,bark,blade,brow,brown,cell,concolorous,conical,cuneate,curved,deltate,densely,diameter,difoliate,distance,drying,eaf,eed,ellipsoid,erect,extending,eye,faint,filament,flattened,free,geminat,glabrescent,glabrous,gland,glandular,globular,gray,herbaceous,infructescence,lobe,longer,mature,midpoint,midvein,minutely,naked,narrow-deltate,narrow-ovate,near,nflorescence,obovate,obtuse,often,older,one,open,orolla,oung,outline,pair,pale,pedicel,peduncle,perfec,pericarp,pit,porrect,portion,prickl,prickly,primary,raised,ray,reduced,reflexed,reticulate,rounded,ruit,scandent,scar,sessile,shiny,short,shorter,side,slender,slightly,small,smooth,sometimes,spaced,sparsely,stalk,stalked,stellate,straight,style,tamen,tertiary,time,trichome,tube,unarmed,unit,upper,usually,variously,vary,vein,venation,visible,wide,woody,yellow-orange,ympodial	colour,corolla,form,growth,heteromorphism,inflorescence,needle-like,number,orientation,placement,position,seed,shape,staman,symmetry,texture,type,zygomorphy
545	wfo-0001032595	success	200	110	89	111	21	0.445	-20,-25,1-3,1-6.5,1.5-5,15-25,2-4,25-40,3-10,3-12,3-4,5-6,abaxially,acute,along,also,anther,apex,basal,base,branch,branched,brownish,brownish-purple,cm,connective,cordate,coriaceous,deeply,densely,dull,eglandular,ellipsoidal,entire,filament,finely,flattened,flower,fork,forked,fruit,fusiform,glabrous,greenish,hair,homostylous,lanceolate,leaf-opposed,leaving,lobe,long,margin,mature,mm,moderately,near,oblique,often,ovate,ovoid,pale,pedicel,pedicellar,peduncle,petiole,pilose,pore,pseudohair,puberulent,pubescent,purple,rachi,rarely,remnant,reniform,rugulose,shrub,simple,small,sparsely,stellate,subcoriaceous,tree,truncate,unbranched,violet,white,x,yellow	-pilose,0-,0.5-1,0.5-3.5,1,1-2,1-2.5,1-6,1.5-2,1.5-2.5,1.5-4.5,12-16,15-40,2-3,2.3-24,3-4-foliate,3-5,4-25,4-5,4-7,5-merou,6-7,9-14,accrescen,acuminate,adaxially,aggregate,alyx,apart,ape,apical,apiculate,articulated,axe,blade,calyx,cell,ciliat,connivent,cream,crow,cucullate,deltate,dense,denser,diameter,dilated,directed,distally,eaf,eed,equal,exceeding,free,fruiting,geminate,gland,glandular,larg,lon,longitudinal,loosely,lower,m.,major,midrib,narrowly,nflorescence,opening,orolla,part,per,perfect,pilo,produced,prominent,purplish,ruit,shallow,shorter,side,single,slightly,slit,spaced,spreading,stamen,stigma,stone,strongly,style,swelling,tall,tamen,tem,thecae,time,tip,tomentose,toward,triangular,trunk,tube,two,ud,umbrella-shaped,unit,vary,vein,wide,ympodial	articulation,branching,bud,colour,corolla,form,growth,height,inflorescence,leaf,length,na,odour,plant,position,seed,shape,size,symmetry,texture,type
